TML_DTA_SOMM,TML_VAX_FORNITORE,TML_COD_STRUTTURA,TML_DES_STRUTTURA,TML_AREA,TML_FASCIA_ETA,TML_SESSO_M,TML_SESSO_F,TML_GRAVIDANZA,TML_CAT_OSS,TML_CAT_PERSONALE,TML_CAT_RSA_OSPITI,TML_CAT_ALTRO,TML_DOSE_1,TML_DOSE_2,TML_TOT_SOMM,TML_REGIONE,TML_NUTS
2020-12-27,PF/BT,ND,Sede Regionale Protezione Civile,FVG,20-29,1,4,0,4,1,0,0,5,0,5,Friuli Venezia Giulia,ITH4
2020-12-27,PF/BT,ND,Sede Regionale Protezione Civile,FVG,30-39,9,7,0,16,0,0,0,16,0,16,Friuli Venezia Giulia,ITH4
2020-12-27,PF/BT,ND,Sede Regionale Protezione Civile,FVG,40-49,17,33,0,50,0,0,0,50,0,50,Friuli Venezia Giulia,ITH4
2020-12-27,PF/BT,ND,Sede Regionale Protezione Civile,FVG,50-59,58,44,0,100,2,0,0,102,0,102,Friuli Venezia Giulia,ITH4
2020-12-27,PF/BT,ND,Sede Regionale Protezione Civile,FVG,60-69,62,23,0,85,0,0,0,85,0,85,Friuli Venezia Giulia,ITH4
2020-12-27,PF/BT,ND,Sede Regionale Protezione Civile,FVG,70-79,3,2,0,5,0,0,0,5,0,5,Friuli Venezia Giulia,ITH4
2020-12-30,PF/BT,117510,Ospedale Pordenone,FVG,20-29,6,9,0,14,0,0,1,15,0,15,Friuli Venezia Giulia,ITH4
2020-12-30,PF/BT,117510,Ospedale Pordenone,FVG,30-39,15,18,0,32,1,0,0,33,0,33,Friuli Venezia Giulia,ITH4
2020-12-30,PF/BT,117510,Ospedale Pordenone,FVG,40-49,14,48,0,60,2,0,0,62,0,62,Friuli Venezia Giulia,ITH4
2020-12-30,PF/BT,117510,Ospedale Pordenone,FVG,50-59,24,46,0,67,2,0,1,70,0,70,Friuli Venezia Giulia,ITH4
2020-12-30,PF/BT,117510,Ospedale Pordenone,FVG,60-69,14,10,0,24,0,0,0,24,0,24,Friuli Venezia Giulia,ITH4
2020-12-30,PF/BT,117510,Ospedale Pordenone,FVG,70-79,2,0,0,2,0,0,0,2,0,2,Friuli Venezia Giulia,ITH4
2020-12-30,PF/BT,12M810,Ospedale Monfalcone,FVG,20-29,3,4,0,7,0,0,0,7,0,7,Friuli Venezia Giulia,ITH4
2020-12-30,PF/BT,12M810,Ospedale Monfalcone,FVG,30-39,9,19,0,25,2,0,1,28,0,28,Friuli Venezia Giulia,ITH4
2020-12-30,PF/BT,12M810,Ospedale Monfalcone,FVG,40-49,7,19,0,23,3,0,0,26,0,26,Friuli Venezia Giulia,ITH4
2020-12-30,PF/BT,12M810,Ospedale Monfalcone,FVG,50-59,8,17,0,23,2,0,0,25,0,25,Friuli Venezia Giulia,ITH4
2020-12-30,PF/BT,12M810,Ospedale Monfalcone,FVG,60-69,17,8,0,23,2,0,0,25,0,25,Friuli Venezia Giulia,ITH4
2020-12-30,PF/BT,12M810,Ospedale Monfalcone,FVG,70-79,1,0,0,1,0,0,0,1,0,1,Friuli Venezia Giulia,ITH4
2020-12-30,PF/BT,12M810,Ospedale Monfalcone,FVG,80-89,1,1,0,2,0,0,0,2,0,2,Friuli Venezia Giulia,ITH4
2020-12-30,PF/BT,14VP13,Ospedale Udine,FVG,20-29,4,5,0,9,0,0,0,9,0,9,Friuli Venezia Giulia,ITH4
2020-12-30,PF/BT,14VP13,Ospedale Udine,FVG,30-39,17,23,0,35,1,0,4,40,0,40,Friuli Venezia Giulia,ITH4
2020-12-30,PF/BT,14VP13,Ospedale Udine,FVG,40-49,10,30,0,38,2,0,0,40,0,40,Friuli Venezia Giulia,ITH4
2020-12-30,PF/BT,14VP13,Ospedale Udine,FVG,50-59,13,21,0,31,3,0,0,34,0,34,Friuli Venezia Giulia,ITH4
2020-12-30,PF/BT,14VP13,Ospedale Udine,FVG,60-69,7,11,0,17,1,0,0,18,0,18,Friuli Venezia Giulia,ITH4
2020-12-30,PF/BT,14VP13,Ospedale Udine,FVG,70-79,3,0,0,3,0,0,0,3,0,3,Friuli Venezia Giulia,ITH4
2020-12-30,PF/BT,201010,Ospedale Cattinara,FVG,20-29,4,15,0,11,2,0,6,19,0,19,Friuli Venezia Giulia,ITH4
2020-12-30,PF/BT,201010,Ospedale Cattinara,FVG,30-39,12,14,0,20,1,0,5,26,0,26,Friuli Venezia Giulia,ITH4
2020-12-30,PF/BT,201010,Ospedale Cattinara,FVG,40-49,9,9,0,18,0,0,0,18,0,18,Friuli Venezia Giulia,ITH4
2020-12-30,PF/BT,201010,Ospedale Cattinara,FVG,50-59,8,16,0,23,1,0,0,24,0,24,Friuli Venezia Giulia,ITH4
2020-12-30,PF/BT,201010,Ospedale Cattinara,FVG,60-69,9,6,0,15,0,0,0,15,0,15,Friuli Venezia Giulia,ITH4
2020-12-30,PF/BT,201010,Ospedale Cattinara,FVG,70-79,4,2,0,6,0,0,0,6,0,6,Friuli Venezia Giulia,ITH4
2020-12-30,PF/BT,220101,H Tolmezzo,FVG,20-29,1,1,0,1,0,0,1,2,0,2,Friuli Venezia Giulia,ITH4
2020-12-30,PF/BT,220101,H Tolmezzo,FVG,30-39,3,7,0,10,0,0,0,10,0,10,Friuli Venezia Giulia,ITH4
2020-12-30,PF/BT,220101,H Tolmezzo,FVG,40-49,6,12,0,15,3,0,0,18,0,18,Friuli Venezia Giulia,ITH4
2020-12-30,PF/BT,220101,H Tolmezzo,FVG,50-59,7,9,0,16,0,0,0,16,0,16,Friuli Venezia Giulia,ITH4
2020-12-30,PF/BT,220101,H Tolmezzo,FVG,60-69,6,4,0,9,1,0,0,10,0,10,Friuli Venezia Giulia,ITH4
2020-12-30,PF/BT,220101,H Tolmezzo,FVG,70-79,3,0,0,3,0,0,0,3,0,3,Friuli Venezia Giulia,ITH4
2020-12-31,PF/BT,117510,SANTA MARIA DEGLI ANGELI,FVG,20-29,9,21,0,28,2,0,0,30,0,30,Friuli Venezia Giulia,ITH4
2020-12-31,PF/BT,117510,SANTA MARIA DEGLI ANGELI,FVG,30-39,6,20,0,25,1,0,0,26,0,26,Friuli Venezia Giulia,ITH4
2020-12-31,PF/BT,117510,SANTA MARIA DEGLI ANGELI,FVG,40-49,22,33,0,52,3,0,0,55,0,55,Friuli Venezia Giulia,ITH4
2020-12-31,PF/BT,117510,SANTA MARIA DEGLI ANGELI,FVG,50-59,22,39,0,59,2,0,0,61,0,61,Friuli Venezia Giulia,ITH4
2020-12-31,PF/BT,117510,SANTA MARIA DEGLI ANGELI,FVG,60-69,23,12,0,35,0,0,0,35,0,35,Friuli Venezia Giulia,ITH4
2020-12-31,PF/BT,117510,SANTA MARIA DEGLI ANGELI,FVG,70-79,3,0,0,2,1,0,0,3,0,3,Friuli Venezia Giulia,ITH4
2020-12-31,PF/BT,12M810,MONFALCONE,FVG,20-29,1,15,0,13,0,0,3,16,0,16,Friuli Venezia Giulia,ITH4
2020-12-31,PF/BT,12M810,MONFALCONE,FVG,30-39,14,23,0,35,1,0,1,37,0,37,Friuli Venezia Giulia,ITH4
2020-12-31,PF/BT,12M810,MONFALCONE,FVG,40-49,14,40,0,51,3,0,0,54,0,54,Friuli Venezia Giulia,ITH4
2020-12-31,PF/BT,12M810,MONFALCONE,FVG,50-59,17,52,0,67,2,0,0,69,0,69,Friuli Venezia Giulia,ITH4
2020-12-31,PF/BT,12M810,MONFALCONE,FVG,60-69,23,21,0,41,3,0,0,44,0,44,Friuli Venezia Giulia,ITH4
2020-12-31,PF/BT,12M810,MONFALCONE,FVG,70-79,3,2,0,5,0,0,0,5,0,5,Friuli Venezia Giulia,ITH4
2020-12-31,PF/BT,12M810,MONFALCONE,FVG,80-89,1,0,0,1,0,0,0,1,0,1,Friuli Venezia Giulia,ITH4
2020-12-31,PF/BT,14VP13,SANTA MARIA DELLA  MISERICORDIA,FVG,20-29,3,12,0,9,0,0,6,15,0,15,Friuli Venezia Giulia,ITH4
2020-12-31,PF/BT,14VP13,SANTA MARIA DELLA  MISERICORDIA,FVG,30-39,22,38,0,53,1,0,6,60,0,60,Friuli Venezia Giulia,ITH4
2020-12-31,PF/BT,14VP13,SANTA MARIA DELLA  MISERICORDIA,FVG,40-49,11,19,0,29,1,0,0,30,0,30,Friuli Venezia Giulia,ITH4
2020-12-31,PF/BT,14VP13,SANTA MARIA DELLA  MISERICORDIA,FVG,50-59,9,12,0,21,0,0,0,21,0,21,Friuli Venezia Giulia,ITH4
2020-12-31,PF/BT,14VP13,SANTA MARIA DELLA  MISERICORDIA,FVG,60-69,9,8,0,17,0,0,0,17,0,17,Friuli Venezia Giulia,ITH4
2020-12-31,PF/BT,14VP13,SANTA MARIA DELLA  MISERICORDIA,FVG,70-79,1,0,0,1,0,0,0,1,0,1,Friuli Venezia Giulia,ITH4
2020-12-31,PF/BT,201010,CATTINARA,FVG,20-29,16,20,0,17,0,0,19,36,0,36,Friuli Venezia Giulia,ITH4
2020-12-31,PF/BT,201010,CATTINARA,FVG,30-39,33,26,0,52,1,0,6,59,0,59,Friuli Venezia Giulia,ITH4
2020-12-31,PF/BT,201010,CATTINARA,FVG,40-49,17,36,0,49,3,0,1,53,0,53,Friuli Venezia Giulia,ITH4
2020-12-31,PF/BT,201010,CATTINARA,FVG,50-59,13,40,0,51,2,0,0,53,0,53,Friuli Venezia Giulia,ITH4
2020-12-31,PF/BT,201010,CATTINARA,FVG,60-69,12,13,0,24,1,0,0,25,0,25,Friuli Venezia Giulia,ITH4
2020-12-31,PF/BT,201010,CATTINARA,FVG,70-79,6,0,0,6,0,0,0,6,0,6,Friuli Venezia Giulia,ITH4
2020-12-31,PF/BT,201010,CATTINARA,FVG,90+,1,0,0,1,0,0,0,1,0,1,Friuli Venezia Giulia,ITH4
2020-12-31,PF/BT,220101,TOLMEZZO,FVG,20-29,9,16,0,21,3,0,1,25,0,25,Friuli Venezia Giulia,ITH4
2020-12-31,PF/BT,220101,TOLMEZZO,FVG,30-39,14,25,0,37,1,0,1,39,0,39,Friuli Venezia Giulia,ITH4
2020-12-31,PF/BT,220101,TOLMEZZO,FVG,40-49,9,51,0,56,4,0,0,60,0,60,Friuli Venezia Giulia,ITH4
2020-12-31,PF/BT,220101,TOLMEZZO,FVG,50-59,22,67,0,82,7,0,0,89,0,89,Friuli Venezia Giulia,ITH4
2020-12-31,PF/BT,220101,TOLMEZZO,FVG,60-69,17,8,0,25,0,0,0,25,0,25,Friuli Venezia Giulia,ITH4
2020-12-31,PF/BT,220101,TOLMEZZO,FVG,70-79,2,0,0,2,0,0,0,2,0,2,Friuli Venezia Giulia,ITH4
2021-01-02,PF/BT,117510,SANTA MARIA DEGLI ANGELI,FVG,20-29,9,25,0,27,1,0,6,34,0,34,Friuli Venezia Giulia,ITH4
2021-01-02,PF/BT,117510,SANTA MARIA DEGLI ANGELI,FVG,30-39,17,39,0,54,2,0,0,56,0,56,Friuli Venezia Giulia,ITH4
2021-01-02,PF/BT,117510,SANTA MARIA DEGLI ANGELI,FVG,40-49,21,34,0,51,4,0,0,55,0,55,Friuli Venezia Giulia,ITH4
2021-01-02,PF/BT,117510,SANTA MARIA DEGLI ANGELI,FVG,50-59,14,45,0,54,5,0,0,59,0,59,Friuli Venezia Giulia,ITH4
2021-01-02,PF/BT,117510,SANTA MARIA DEGLI ANGELI,FVG,60-69,32,7,0,34,5,0,0,39,0,39,Friuli Venezia Giulia,ITH4
2021-01-02,PF/BT,117510,SANTA MARIA DEGLI ANGELI,FVG,70-79,8,1,0,9,0,0,0,9,0,9,Friuli Venezia Giulia,ITH4
2021-01-02,PF/BT,12M810,MONFALCONE,FVG,20-29,22,25,0,41,0,0,6,47,0,47,Friuli Venezia Giulia,ITH4
2021-01-02,PF/BT,12M810,MONFALCONE,FVG,30-39,23,40,0,55,7,0,1,63,0,63,Friuli Venezia Giulia,ITH4
2021-01-02,PF/BT,12M810,MONFALCONE,FVG,40-49,16,63,0,78,1,0,0,79,0,79,Friuli Venezia Giulia,ITH4
2021-01-02,PF/BT,12M810,MONFALCONE,FVG,50-59,30,93,0,114,9,0,0,123,0,123,Friuli Venezia Giulia,ITH4
2021-01-02,PF/BT,12M810,MONFALCONE,FVG,60-69,32,22,0,53,1,0,0,54,0,54,Friuli Venezia Giulia,ITH4
2021-01-02,PF/BT,12M810,MONFALCONE,FVG,70-79,9,0,0,8,1,0,0,9,0,9,Friuli Venezia Giulia,ITH4
2021-01-02,PF/BT,12M810,MONFALCONE,FVG,80-89,1,0,0,1,0,0,0,1,0,1,Friuli Venezia Giulia,ITH4
2021-01-02,PF/BT,14VP13,SANTA MARIA DELLA  MISERICORDIA,FVG,20-29,12,23,0,27,0,0,8,35,0,35,Friuli Venezia Giulia,ITH4
2021-01-02,PF/BT,14VP13,SANTA MARIA DELLA  MISERICORDIA,FVG,30-39,28,26,0,51,2,0,1,54,0,54,Friuli Venezia Giulia,ITH4
2021-01-02,PF/BT,14VP13,SANTA MARIA DELLA  MISERICORDIA,FVG,40-49,25,35,0,56,4,0,0,60,0,60,Friuli Venezia Giulia,ITH4
2021-01-02,PF/BT,14VP13,SANTA MARIA DELLA  MISERICORDIA,FVG,50-59,18,37,0,50,5,0,0,55,0,55,Friuli Venezia Giulia,ITH4
2021-01-02,PF/BT,14VP13,SANTA MARIA DELLA  MISERICORDIA,FVG,60-69,18,12,0,29,1,0,0,30,0,30,Friuli Venezia Giulia,ITH4
2021-01-02,PF/BT,14VP13,SANTA MARIA DELLA  MISERICORDIA,FVG,70-79,4,1,0,5,0,0,0,5,0,5,Friuli Venezia Giulia,ITH4
2021-01-02,PF/BT,201010,CATTINARA,FVG,20-29,20,24,0,29,2,0,13,44,0,44,Friuli Venezia Giulia,ITH4
2021-01-02,PF/BT,201010,CATTINARA,FVG,30-39,27,38,0,57,3,0,5,65,0,65,Friuli Venezia Giulia,ITH4
2021-01-02,PF/BT,201010,CATTINARA,FVG,40-49,29,71,0,96,4,0,0,100,0,100,Friuli Venezia Giulia,ITH4
2021-01-02,PF/BT,201010,CATTINARA,FVG,50-59,25,60,0,75,10,0,0,85,0,85,Friuli Venezia Giulia,ITH4
2021-01-02,PF/BT,201010,CATTINARA,FVG,60-69,27,24,0,51,0,0,0,51,0,51,Friuli Venezia Giulia,ITH4
2021-01-02,PF/BT,201010,CATTINARA,FVG,70-79,4,1,0,5,0,0,0,5,0,5,Friuli Venezia Giulia,ITH4
2021-01-03,PF/BT,201010,CATTINARA,FVG,16-19,0,1,0,0,0,0,1,1,0,1,Friuli Venezia Giulia,ITH4
2021-01-03,PF/BT,201010,CATTINARA,FVG,20-29,29,49,0,38,5,0,35,78,0,78,Friuli Venezia Giulia,ITH4
2021-01-03,PF/BT,201010,CATTINARA,FVG,30-39,20,36,0,45,1,0,10,56,0,56,Friuli Venezia Giulia,ITH4
2021-01-03,PF/BT,201010,CATTINARA,FVG,40-49,21,44,0,58,6,0,1,65,0,65,Friuli Venezia Giulia,ITH4
2021-01-03,PF/BT,201010,CATTINARA,FVG,50-59,19,45,0,55,9,0,0,64,0,64,Friuli Venezia Giulia,ITH4
2021-01-03,PF/BT,201010,CATTINARA,FVG,60-69,21,13,0,31,3,0,0,34,0,34,Friuli Venezia Giulia,ITH4
2021-01-03,PF/BT,201010,CATTINARA,FVG,70-79,12,1,0,11,2,0,0,13,0,13,Friuli Venezia Giulia,ITH4
2021-01-03,PF/BT,201010,CATTINARA,FVG,90+,0,1,0,0,0,1,0,1,0,1,Friuli Venezia Giulia,ITH4
2021-01-04,PF/BT,117510,SANTA MARIA DEGLI ANGELI,FVG,20-29,19,25,0,39,3,0,2,44,0,44,Friuli Venezia Giulia,ITH4
2021-01-04,PF/BT,117510,SANTA MARIA DEGLI ANGELI,FVG,30-39,20,60,0,75,4,0,1,80,0,80,Friuli Venezia Giulia,ITH4
2021-01-04,PF/BT,117510,SANTA MARIA DEGLI ANGELI,FVG,40-49,24,53,0,73,4,0,0,77,0,77,Friuli Venezia Giulia,ITH4
2021-01-04,PF/BT,117510,SANTA MARIA DEGLI ANGELI,FVG,50-59,20,62,0,78,4,0,0,82,0,82,Friuli Venezia Giulia,ITH4
2021-01-04,PF/BT,117510,SANTA MARIA DEGLI ANGELI,FVG,60-69,33,15,0,47,1,0,0,48,0,48,Friuli Venezia Giulia,ITH4
2021-01-04,PF/BT,117510,SANTA MARIA DEGLI ANGELI,FVG,70-79,10,1,0,11,0,0,0,11,0,11,Friuli Venezia Giulia,ITH4
2021-01-04,PF/BT,12M810,MONFALCONE,FVG,20-29,27,29,0,36,5,0,15,56,0,56,Friuli Venezia Giulia,ITH4
2021-01-04,PF/BT,12M810,MONFALCONE,FVG,30-39,15,22,0,29,6,0,2,37,0,37,Friuli Venezia Giulia,ITH4
2021-01-04,PF/BT,12M810,MONFALCONE,FVG,40-49,15,41,0,45,11,0,0,56,0,56,Friuli Venezia Giulia,ITH4
2021-01-04,PF/BT,12M810,MONFALCONE,FVG,50-59,8,38,0,39,7,0,0,46,0,46,Friuli Venezia Giulia,ITH4
2021-01-04,PF/BT,12M810,MONFALCONE,FVG,60-69,18,21,0,34,5,0,0,39,0,39,Friuli Venezia Giulia,ITH4
2021-01-04,PF/BT,12M810,MONFALCONE,FVG,70-79,5,1,0,4,2,0,0,6,0,6,Friuli Venezia Giulia,ITH4
2021-01-04,PF/BT,14VP13,SANTA MARIA DELLA  MISERICORDIA,FVG,20-29,13,33,0,36,1,0,9,46,0,46,Friuli Venezia Giulia,ITH4
2021-01-04,PF/BT,14VP13,SANTA MARIA DELLA  MISERICORDIA,FVG,30-39,22,24,0,44,2,0,0,46,0,46,Friuli Venezia Giulia,ITH4
2021-01-04,PF/BT,14VP13,SANTA MARIA DELLA  MISERICORDIA,FVG,40-49,24,41,0,64,1,0,0,65,0,65,Friuli Venezia Giulia,ITH4
2021-01-04,PF/BT,14VP13,SANTA MARIA DELLA  MISERICORDIA,FVG,50-59,18,37,0,53,2,0,0,55,0,55,Friuli Venezia Giulia,ITH4
2021-01-04,PF/BT,14VP13,SANTA MARIA DELLA  MISERICORDIA,FVG,60-69,8,10,0,16,2,0,0,18,0,18,Friuli Venezia Giulia,ITH4
2021-01-04,PF/BT,14VP13,SANTA MARIA DELLA  MISERICORDIA,FVG,70-79,3,4,0,7,0,0,0,7,0,7,Friuli Venezia Giulia,ITH4
2021-01-04,PF/BT,14VP13,SANTA MARIA DELLA  MISERICORDIA,FVG,80-89,2,0,0,2,0,0,0,2,0,2,Friuli Venezia Giulia,ITH4
2021-01-04,PF/BT,201010,CATTINARA,FVG,16-19,0,1,0,0,0,0,1,1,0,1,Friuli Venezia Giulia,ITH4
2021-01-04,PF/BT,201010,CATTINARA,FVG,20-29,27,45,0,40,4,0,28,72,0,72,Friuli Venezia Giulia,ITH4
2021-01-04,PF/BT,201010,CATTINARA,FVG,30-39,37,44,0,68,3,0,10,81,0,81,Friuli Venezia Giulia,ITH4
2021-01-04,PF/BT,201010,CATTINARA,FVG,40-49,25,64,0,76,12,0,1,89,0,89,Friuli Venezia Giulia,ITH4
2021-01-04,PF/BT,201010,CATTINARA,FVG,50-59,46,84,0,119,11,0,0,130,0,130,Friuli Venezia Giulia,ITH4
2021-01-04,PF/BT,201010,CATTINARA,FVG,60-69,36,28,0,61,3,0,0,64,0,64,Friuli Venezia Giulia,ITH4
2021-01-04,PF/BT,201010,CATTINARA,FVG,70-79,10,0,0,10,0,0,0,10,0,10,Friuli Venezia Giulia,ITH4
2021-01-04,PF/BT,201010,CATTINARA,FVG,80-89,1,1,0,0,2,0,0,2,0,2,Friuli Venezia Giulia,ITH4
2021-01-04,PF/BT,220101,TOLMEZZO,FVG,20-29,6,17,0,16,2,0,5,23,0,23,Friuli Venezia Giulia,ITH4
2021-01-04,PF/BT,220101,TOLMEZZO,FVG,30-39,11,29,0,36,3,0,1,40,0,40,Friuli Venezia Giulia,ITH4
2021-01-04,PF/BT,220101,TOLMEZZO,FVG,40-49,16,40,0,50,5,0,1,56,0,56,Friuli Venezia Giulia,ITH4
2021-01-04,PF/BT,220101,TOLMEZZO,FVG,50-59,19,63,0,72,10,0,0,82,0,82,Friuli Venezia Giulia,ITH4
2021-01-04,PF/BT,220101,TOLMEZZO,FVG,60-69,18,17,0,32,3,0,0,35,0,35,Friuli Venezia Giulia,ITH4
2021-01-04,PF/BT,220101,TOLMEZZO,FVG,70-79,2,0,0,2,0,0,0,2,0,2,Friuli Venezia Giulia,ITH4
2021-01-04,PF/BT,220101,TOLMEZZO,FVG,80-89,1,0,0,1,0,0,0,1,0,1,Friuli Venezia Giulia,ITH4
2021-01-05,PF/BT,117510,SANTA MARIA DEGLI ANGELI,FVG,20-29,14,29,0,34,3,0,6,43,0,43,Friuli Venezia Giulia,ITH4
2021-01-05,PF/BT,117510,SANTA MARIA DEGLI ANGELI,FVG,30-39,19,43,0,58,3,0,1,62,0,62,Friuli Venezia Giulia,ITH4
2021-01-05,PF/BT,117510,SANTA MARIA DEGLI ANGELI,FVG,40-49,23,75,0,92,6,0,0,98,0,98,Friuli Venezia Giulia,ITH4
2021-01-05,PF/BT,117510,SANTA MARIA DEGLI ANGELI,FVG,50-59,25,77,0,92,10,0,0,102,0,102,Friuli Venezia Giulia,ITH4
2021-01-05,PF/BT,117510,SANTA MARIA DEGLI ANGELI,FVG,60-69,32,40,0,68,4,0,0,72,0,72,Friuli Venezia Giulia,ITH4
2021-01-05,PF/BT,117510,SANTA MARIA DEGLI ANGELI,FVG,70-79,4,1,0,4,0,1,0,5,0,5,Friuli Venezia Giulia,ITH4
2021-01-05,PF/BT,117510,SANTA MARIA DEGLI ANGELI,FVG,80-89,0,1,0,0,0,1,0,1,0,1,Friuli Venezia Giulia,ITH4
2021-01-05,PF/BT,117510,SANTA MARIA DEGLI ANGELI,FVG,90+,1,0,0,0,0,1,0,1,0,1,Friuli Venezia Giulia,ITH4
2021-01-05,PF/BT,14VP13,SANTA MARIA DELLA  MISERICORDIA,FVG,20-29,8,16,0,18,0,0,6,24,0,24,Friuli Venezia Giulia,ITH4
2021-01-05,PF/BT,14VP13,SANTA MARIA DELLA  MISERICORDIA,FVG,30-39,17,34,0,46,3,0,2,51,0,51,Friuli Venezia Giulia,ITH4
2021-01-05,PF/BT,14VP13,SANTA MARIA DELLA  MISERICORDIA,FVG,40-49,16,49,0,55,10,0,0,65,0,65,Friuli Venezia Giulia,ITH4
2021-01-05,PF/BT,14VP13,SANTA MARIA DELLA  MISERICORDIA,FVG,50-59,14,41,0,50,5,0,0,55,0,55,Friuli Venezia Giulia,ITH4
2021-01-05,PF/BT,14VP13,SANTA MARIA DELLA  MISERICORDIA,FVG,60-69,20,16,0,34,2,0,0,36,0,36,Friuli Venezia Giulia,ITH4
2021-01-05,PF/BT,14VP13,SANTA MARIA DELLA  MISERICORDIA,FVG,70-79,6,3,0,9,0,0,0,9,0,9,Friuli Venezia Giulia,ITH4
2021-01-05,PF/BT,201010,CATTINARA,FVG,20-29,40,83,0,72,6,0,45,123,0,123,Friuli Venezia Giulia,ITH4
2021-01-05,PF/BT,201010,CATTINARA,FVG,30-39,42,66,0,94,7,0,7,108,0,108,Friuli Venezia Giulia,ITH4
2021-01-05,PF/BT,201010,CATTINARA,FVG,40-49,39,87,0,105,21,0,0,126,0,126,Friuli Venezia Giulia,ITH4
2021-01-05,PF/BT,201010,CATTINARA,FVG,50-59,44,121,0,136,29,0,0,165,0,165,Friuli Venezia Giulia,ITH4
2021-01-05,PF/BT,201010,CATTINARA,FVG,60-69,27,36,0,52,11,0,0,63,0,63,Friuli Venezia Giulia,ITH4
2021-01-05,PF/BT,201010,CATTINARA,FVG,70-79,18,6,0,23,1,0,0,24,0,24,Friuli Venezia Giulia,ITH4
2021-01-05,PF/BT,201010,CATTINARA,FVG,80-89,2,0,0,2,0,0,0,2,0,2,Friuli Venezia Giulia,ITH4
2021-01-05,PF/BT,220101,TOLMEZZO,FVG,20-29,15,19,0,31,1,0,2,34,0,34,Friuli Venezia Giulia,ITH4
2021-01-05,PF/BT,220101,TOLMEZZO,FVG,30-39,9,33,0,40,1,0,1,42,0,42,Friuli Venezia Giulia,ITH4
2021-01-05,PF/BT,220101,TOLMEZZO,FVG,40-49,15,46,0,59,2,0,0,61,0,61,Friuli Venezia Giulia,ITH4
2021-01-05,PF/BT,220101,TOLMEZZO,FVG,50-59,9,58,0,62,5,0,0,67,0,67,Friuli Venezia Giulia,ITH4
2021-01-05,PF/BT,220101,TOLMEZZO,FVG,60-69,24,14,0,37,1,0,0,38,0,38,Friuli Venezia Giulia,ITH4
2021-01-05,PF/BT,220101,TOLMEZZO,FVG,70-79,7,1,0,7,1,0,0,8,0,8,Friuli Venezia Giulia,ITH4
2021-01-05,PF/BT,220101,TOLMEZZO,FVG,80-89,2,0,0,1,1,0,0,2,0,2,Friuli Venezia Giulia,ITH4
2021-01-05,PF/BT,9A0041,CASA SERENA PORDENONE,FVG,40-49,1,0,0,0,0,1,0,1,0,1,Friuli Venezia Giulia,ITH4
2021-01-05,PF/BT,9A0041,CASA SERENA PORDENONE,FVG,50-59,3,1,0,0,0,4,0,4,0,4,Friuli Venezia Giulia,ITH4
2021-01-05,PF/BT,9A0041,CASA SERENA PORDENONE,FVG,60-69,3,4,0,0,0,7,0,7,0,7,Friuli Venezia Giulia,ITH4
2021-01-05,PF/BT,9A0041,CASA SERENA PORDENONE,FVG,70-79,10,15,0,0,0,25,0,25,0,25,Friuli Venezia Giulia,ITH4
2021-01-05,PF/BT,9A0041,CASA SERENA PORDENONE,FVG,80-89,24,37,0,0,0,61,0,61,0,61,Friuli Venezia Giulia,ITH4
2021-01-05,PF/BT,9A0041,CASA SERENA PORDENONE,FVG,90+,10,58,0,0,0,68,0,68,0,68,Friuli Venezia Giulia,ITH4
2021-01-05,PF/BT,9C0040,FONDAZ. C. DI RIP. CORDENONS,FVG,60-69,1,0,0,0,0,1,0,1,0,1,Friuli Venezia Giulia,ITH4
2021-01-05,PF/BT,9C0040,FONDAZ. C. DI RIP. CORDENONS,FVG,70-79,1,4,0,0,0,5,0,5,0,5,Friuli Venezia Giulia,ITH4
2021-01-05,PF/BT,9C0040,FONDAZ. C. DI RIP. CORDENONS,FVG,80-89,5,9,0,0,0,14,0,14,0,14,Friuli Venezia Giulia,ITH4
2021-01-05,PF/BT,9C0040,FONDAZ. C. DI RIP. CORDENONS,FVG,90+,1,8,0,0,0,9,0,9,0,9,Friuli Venezia Giulia,ITH4
2021-01-06,PF/BT,14VP13,SANTA MARIA DELLA  MISERICORDIA,FVG,20-29,21,40,0,41,6,0,14,61,0,61,Friuli Venezia Giulia,ITH4
2021-01-06,PF/BT,14VP13,SANTA MARIA DELLA  MISERICORDIA,FVG,30-39,22,35,0,40,16,0,1,57,0,57,Friuli Venezia Giulia,ITH4
2021-01-06,PF/BT,14VP13,SANTA MARIA DELLA  MISERICORDIA,FVG,40-49,28,69,0,49,47,0,1,97,0,97,Friuli Venezia Giulia,ITH4
2021-01-06,PF/BT,14VP13,SANTA MARIA DELLA  MISERICORDIA,FVG,50-59,32,78,0,61,49,0,0,110,0,110,Friuli Venezia Giulia,ITH4
2021-01-06,PF/BT,14VP13,SANTA MARIA DELLA  MISERICORDIA,FVG,60-69,27,17,0,33,11,0,0,44,0,44,Friuli Venezia Giulia,ITH4
2021-01-06,PF/BT,14VP13,SANTA MARIA DELLA  MISERICORDIA,FVG,70-79,7,1,0,6,2,0,0,8,0,8,Friuli Venezia Giulia,ITH4
2021-01-06,PF/BT,201010,CATTINARA,FVG,16-19,0,1,0,0,0,0,1,1,0,1,Friuli Venezia Giulia,ITH4
2021-01-06,PF/BT,201010,CATTINARA,FVG,20-29,25,50,0,31,2,0,42,75,0,75,Friuli Venezia Giulia,ITH4
2021-01-06,PF/BT,201010,CATTINARA,FVG,30-39,21,36,0,45,4,0,8,57,0,57,Friuli Venezia Giulia,ITH4
2021-01-06,PF/BT,201010,CATTINARA,FVG,40-49,16,45,0,44,15,0,2,61,0,61,Friuli Venezia Giulia,ITH4
2021-01-06,PF/BT,201010,CATTINARA,FVG,50-59,31,35,0,40,25,0,1,66,0,66,Friuli Venezia Giulia,ITH4
2021-01-06,PF/BT,201010,CATTINARA,FVG,60-69,20,27,0,33,14,0,0,47,0,47,Friuli Venezia Giulia,ITH4
2021-01-06,PF/BT,201010,CATTINARA,FVG,70-79,11,10,0,18,3,0,0,21,0,21,Friuli Venezia Giulia,ITH4
2021-01-06,PF/BT,201010,CATTINARA,FVG,80-89,3,0,0,2,1,0,0,3,0,3,Friuli Venezia Giulia,ITH4
2021-01-06,PF/BT,201010,CATTINARA,FVG,90+,0,1,0,1,0,0,0,1,0,1,Friuli Venezia Giulia,ITH4
2021-01-07,PF/BT,117510,SANTA MARIA DEGLI ANGELI,FVG,20-29,7,33,0,32,0,0,8,40,0,40,Friuli Venezia Giulia,ITH4
2021-01-07,PF/BT,117510,SANTA MARIA DEGLI ANGELI,FVG,30-39,22,55,0,70,5,0,2,77,0,77,Friuli Venezia Giulia,ITH4
2021-01-07,PF/BT,117510,SANTA MARIA DEGLI ANGELI,FVG,40-49,23,66,0,75,14,0,0,89,0,89,Friuli Venezia Giulia,ITH4
2021-01-07,PF/BT,117510,SANTA MARIA DEGLI ANGELI,FVG,50-59,26,82,0,91,17,0,0,108,0,108,Friuli Venezia Giulia,ITH4
2021-01-07,PF/BT,117510,SANTA MARIA DEGLI ANGELI,FVG,60-69,16,36,0,41,11,0,0,52,0,52,Friuli Venezia Giulia,ITH4
2021-01-07,PF/BT,117510,SANTA MARIA DEGLI ANGELI,FVG,70-79,7,2,0,6,3,0,0,9,0,9,Friuli Venezia Giulia,ITH4
2021-01-07,PF/BT,117510,SANTA MARIA DEGLI ANGELI,FVG,80-89,1,1,0,1,0,1,0,2,0,2,Friuli Venezia Giulia,ITH4
2021-01-07,PF/BT,12M810,MONFALCONE,FVG,16-19,0,2,0,0,0,0,2,2,0,2,Friuli Venezia Giulia,ITH4
2021-01-07,PF/BT,12M810,MONFALCONE,FVG,20-29,13,12,0,20,1,0,4,25,0,25,Friuli Venezia Giulia,ITH4
2021-01-07,PF/BT,12M810,MONFALCONE,FVG,30-39,7,20,0,23,2,0,2,27,0,27,Friuli Venezia Giulia,ITH4
2021-01-07,PF/BT,12M810,MONFALCONE,FVG,40-49,14,39,0,44,9,0,0,53,0,53,Friuli Venezia Giulia,ITH4
2021-01-07,PF/BT,12M810,MONFALCONE,FVG,50-59,23,59,0,73,9,0,0,82,0,82,Friuli Venezia Giulia,ITH4
2021-01-07,PF/BT,12M810,MONFALCONE,FVG,60-69,19,25,0,37,7,0,0,44,0,44,Friuli Venezia Giulia,ITH4
2021-01-07,PF/BT,12M810,MONFALCONE,FVG,70-79,5,1,0,5,1,0,0,6,0,6,Friuli Venezia Giulia,ITH4
2021-01-07,PF/BT,12M810,MONFALCONE,FVG,80-89,1,0,0,1,0,0,0,1,0,1,Friuli Venezia Giulia,ITH4
2021-01-07,PF/BT,14VP13,SANTA MARIA DELLA  MISERICORDIA,FVG,20-29,24,49,0,56,5,0,12,73,0,73,Friuli Venezia Giulia,ITH4
2021-01-07,PF/BT,14VP13,SANTA MARIA DELLA  MISERICORDIA,FVG,30-39,34,69,0,87,5,0,11,103,0,103,Friuli Venezia Giulia,ITH4
2021-01-07,PF/BT,14VP13,SANTA MARIA DELLA  MISERICORDIA,FVG,40-49,43,103,0,132,12,0,2,146,0,146,Friuli Venezia Giulia,ITH4
2021-01-07,PF/BT,14VP13,SANTA MARIA DELLA  MISERICORDIA,FVG,50-59,50,112,0,138,24,0,0,162,0,162,Friuli Venezia Giulia,ITH4
2021-01-07,PF/BT,14VP13,SANTA MARIA DELLA  MISERICORDIA,FVG,60-69,48,24,0,66,6,0,0,72,0,72,Friuli Venezia Giulia,ITH4
2021-01-07,PF/BT,14VP13,SANTA MARIA DELLA  MISERICORDIA,FVG,70-79,6,2,0,8,0,0,0,8,0,8,Friuli Venezia Giulia,ITH4
2021-01-07,PF/BT,14VP13,SANTA MARIA DELLA  MISERICORDIA,FVG,80-89,2,0,0,2,0,0,0,2,0,2,Friuli Venezia Giulia,ITH4
2021-01-07,PF/BT,201010,CATTINARA,FVG,20-29,43,72,0,70,7,0,38,115,0,115,Friuli Venezia Giulia,ITH4
2021-01-07,PF/BT,201010,CATTINARA,FVG,30-39,52,80,0,110,15,0,7,132,0,132,Friuli Venezia Giulia,ITH4
2021-01-07,PF/BT,201010,CATTINARA,FVG,40-49,41,100,0,118,19,0,4,141,0,141,Friuli Venezia Giulia,ITH4
2021-01-07,PF/BT,201010,CATTINARA,FVG,50-59,34,106,0,117,23,0,0,140,0,140,Friuli Venezia Giulia,ITH4
2021-01-07,PF/BT,201010,CATTINARA,FVG,60-69,23,29,0,47,5,0,0,52,0,52,Friuli Venezia Giulia,ITH4
2021-01-07,PF/BT,201010,CATTINARA,FVG,70-79,8,1,0,8,1,0,0,9,0,9,Friuli Venezia Giulia,ITH4
2021-01-07,PF/BT,201010,CATTINARA,FVG,80-89,4,0,0,4,0,0,0,4,0,4,Friuli Venezia Giulia,ITH4
2021-01-07,PF/BT,220101,TOLMEZZO,FVG,20-29,6,14,0,19,1,0,0,20,0,20,Friuli Venezia Giulia,ITH4
2021-01-07,PF/BT,220101,TOLMEZZO,FVG,30-39,16,22,0,34,3,0,1,38,0,38,Friuli Venezia Giulia,ITH4
2021-01-07,PF/BT,220101,TOLMEZZO,FVG,40-49,14,37,0,49,2,0,0,51,0,51,Friuli Venezia Giulia,ITH4
2021-01-07,PF/BT,220101,TOLMEZZO,FVG,50-59,23,47,0,60,10,0,0,70,0,70,Friuli Venezia Giulia,ITH4
2021-01-07,PF/BT,220101,TOLMEZZO,FVG,60-69,16,12,0,24,4,0,0,28,0,28,Friuli Venezia Giulia,ITH4
2021-01-07,PF/BT,220101,TOLMEZZO,FVG,70-79,2,1,0,3,0,0,0,3,0,3,Friuli Venezia Giulia,ITH4
2021-01-07,PF/BT,9B0040,CASA PER ANZIANI UMBERTO I,FVG,30-39,0,1,0,0,0,1,0,1,0,1,Friuli Venezia Giulia,ITH4
2021-01-07,PF/BT,9B0040,CASA PER ANZIANI UMBERTO I,FVG,50-59,1,1,0,0,0,2,0,2,0,2,Friuli Venezia Giulia,ITH4
2021-01-07,PF/BT,9B0040,CASA PER ANZIANI UMBERTO I,FVG,70-79,1,1,0,0,0,2,0,2,0,2,Friuli Venezia Giulia,ITH4
2021-01-07,PF/BT,9B0040,CASA PER ANZIANI UMBERTO I,FVG,80-89,4,11,0,0,0,15,0,15,0,15,Friuli Venezia Giulia,ITH4
2021-01-07,PF/BT,9B0040,CASA PER ANZIANI UMBERTO I,FVG,90+,1,13,0,0,0,14,0,14,0,14,Friuli Venezia Giulia,ITH4
2021-01-07,PF/BT,9I0042,C. DI RIP. SAN VITO AL TAGL.TO,FVG,40-49,1,1,0,0,0,2,0,2,0,2,Friuli Venezia Giulia,ITH4
2021-01-07,PF/BT,9I0042,C. DI RIP. SAN VITO AL TAGL.TO,FVG,60-69,4,0,0,0,0,4,0,4,0,4,Friuli Venezia Giulia,ITH4
2021-01-07,PF/BT,9I0042,C. DI RIP. SAN VITO AL TAGL.TO,FVG,70-79,12,4,0,0,0,16,0,16,0,16,Friuli Venezia Giulia,ITH4
2021-01-07,PF/BT,9I0042,C. DI RIP. SAN VITO AL TAGL.TO,FVG,80-89,13,10,0,0,0,23,0,23,0,23,Friuli Venezia Giulia,ITH4
2021-01-07,PF/BT,9I0042,C. DI RIP. SAN VITO AL TAGL.TO,FVG,90+,9,20,0,0,0,29,0,29,0,29,Friuli Venezia Giulia,ITH4
2021-01-08,PF/BT,117510,SANTA MARIA DEGLI ANGELI,FVG,16-19,0,1,0,0,0,0,1,1,0,1,Friuli Venezia Giulia,ITH4
2021-01-08,PF/BT,117510,SANTA MARIA DEGLI ANGELI,FVG,20-29,16,31,0,31,1,0,15,47,0,47,Friuli Venezia Giulia,ITH4
2021-01-08,PF/BT,117510,SANTA MARIA DEGLI ANGELI,FVG,30-39,15,45,0,50,9,0,1,60,0,60,Friuli Venezia Giulia,ITH4
2021-01-08,PF/BT,117510,SANTA MARIA DEGLI ANGELI,FVG,40-49,18,66,0,70,14,0,0,84,0,84,Friuli Venezia Giulia,ITH4
2021-01-08,PF/BT,117510,SANTA MARIA DEGLI ANGELI,FVG,50-59,22,86,0,86,22,0,0,108,0,108,Friuli Venezia Giulia,ITH4
2021-01-08,PF/BT,117510,SANTA MARIA DEGLI ANGELI,FVG,60-69,35,33,0,57,11,0,0,68,0,68,Friuli Venezia Giulia,ITH4
2021-01-08,PF/BT,117510,SANTA MARIA DEGLI ANGELI,FVG,70-79,7,6,0,9,4,0,0,13,0,13,Friuli Venezia Giulia,ITH4
2021-01-08,PF/BT,117510,SANTA MARIA DEGLI ANGELI,FVG,80-89,2,0,0,2,0,0,0,2,0,2,Friuli Venezia Giulia,ITH4
2021-01-08,PF/BT,12M810,MONFALCONE,FVG,20-29,16,25,0,15,4,0,22,41,0,41,Friuli Venezia Giulia,ITH4
2021-01-08,PF/BT,12M810,MONFALCONE,FVG,30-39,21,19,0,31,6,0,3,40,0,40,Friuli Venezia Giulia,ITH4
2021-01-08,PF/BT,12M810,MONFALCONE,FVG,40-49,12,32,0,35,6,0,3,44,0,44,Friuli Venezia Giulia,ITH4
2021-01-08,PF/BT,12M810,MONFALCONE,FVG,50-59,11,62,0,65,8,0,0,73,0,73,Friuli Venezia Giulia,ITH4
2021-01-08,PF/BT,12M810,MONFALCONE,FVG,60-69,16,17,0,28,5,0,0,33,0,33,Friuli Venezia Giulia,ITH4
2021-01-08,PF/BT,12M810,MONFALCONE,FVG,70-79,8,1,0,7,2,0,0,9,0,9,Friuli Venezia Giulia,ITH4
2021-01-08,PF/BT,14VP13,SANTA MARIA DELLA  MISERICORDIA,FVG,20-29,35,50,0,58,6,0,21,85,0,85,Friuli Venezia Giulia,ITH4
2021-01-08,PF/BT,14VP13,SANTA MARIA DELLA  MISERICORDIA,FVG,30-39,41,63,0,84,14,0,6,104,0,104,Friuli Venezia Giulia,ITH4
2021-01-08,PF/BT,14VP13,SANTA MARIA DELLA  MISERICORDIA,FVG,40-49,33,122,0,133,22,0,0,155,0,155,Friuli Venezia Giulia,ITH4
2021-01-08,PF/BT,14VP13,SANTA MARIA DELLA  MISERICORDIA,FVG,50-59,37,110,0,131,16,0,0,147,0,147,Friuli Venezia Giulia,ITH4
2021-01-08,PF/BT,14VP13,SANTA MARIA DELLA  MISERICORDIA,FVG,60-69,42,35,0,68,8,1,0,77,0,77,Friuli Venezia Giulia,ITH4
2021-01-08,PF/BT,14VP13,SANTA MARIA DELLA  MISERICORDIA,FVG,70-79,9,2,0,8,1,2,0,11,0,11,Friuli Venezia Giulia,ITH4
2021-01-08,PF/BT,14VP13,SANTA MARIA DELLA  MISERICORDIA,FVG,80-89,2,8,0,0,0,10,0,10,0,10,Friuli Venezia Giulia,ITH4
2021-01-08,PF/BT,14VP13,SANTA MARIA DELLA  MISERICORDIA,FVG,90+,1,17,0,0,1,17,0,18,0,18,Friuli Venezia Giulia,ITH4
2021-01-08,PF/BT,201010,CATTINARA,FVG,16-19,1,0,0,1,0,0,0,1,0,1,Friuli Venezia Giulia,ITH4
2021-01-08,PF/BT,201010,CATTINARA,FVG,20-29,23,83,0,65,6,1,34,106,0,106,Friuli Venezia Giulia,ITH4
2021-01-08,PF/BT,201010,CATTINARA,FVG,30-39,38,64,0,86,10,0,6,102,0,102,Friuli Venezia Giulia,ITH4
2021-01-08,PF/BT,201010,CATTINARA,FVG,40-49,44,72,0,101,15,0,0,116,0,116,Friuli Venezia Giulia,ITH4
2021-01-08,PF/BT,201010,CATTINARA,FVG,50-59,46,98,0,113,29,1,1,144,0,144,Friuli Venezia Giulia,ITH4
2021-01-08,PF/BT,201010,CATTINARA,FVG,60-69,33,25,0,53,5,0,0,58,0,58,Friuli Venezia Giulia,ITH4
2021-01-08,PF/BT,201010,CATTINARA,FVG,70-79,19,5,0,18,2,4,0,24,0,24,Friuli Venezia Giulia,ITH4
2021-01-08,PF/BT,201010,CATTINARA,FVG,80-89,3,6,0,1,0,8,0,9,0,9,Friuli Venezia Giulia,ITH4
2021-01-08,PF/BT,201010,CATTINARA,FVG,90+,1,7,0,0,0,8,0,8,0,8,Friuli Venezia Giulia,ITH4
2021-01-08,PF/BT,220101,TOLMEZZO,FVG,20-29,9,11,0,16,1,0,3,20,0,20,Friuli Venezia Giulia,ITH4
2021-01-08,PF/BT,220101,TOLMEZZO,FVG,30-39,7,11,0,15,1,0,2,18,0,18,Friuli Venezia Giulia,ITH4
2021-01-08,PF/BT,220101,TOLMEZZO,FVG,40-49,8,37,0,37,6,0,2,45,0,45,Friuli Venezia Giulia,ITH4
2021-01-08,PF/BT,220101,TOLMEZZO,FVG,50-59,6,48,0,41,6,0,7,54,0,54,Friuli Venezia Giulia,ITH4
2021-01-08,PF/BT,220101,TOLMEZZO,FVG,60-69,8,12,0,18,0,0,2,20,0,20,Friuli Venezia Giulia,ITH4
2021-01-08,PF/BT,220101,TOLMEZZO,FVG,70-79,2,0,0,2,0,0,0,2,0,2,Friuli Venezia Giulia,ITH4
2021-01-08,PF/BT,221504,ASP COVIL 'Matteo Brunetti',FVG,50-59,2,2,0,0,0,4,0,4,0,4,Friuli Venezia Giulia,ITH4
2021-01-08,PF/BT,221504,ASP COVIL 'Matteo Brunetti',FVG,60-69,1,0,0,0,0,1,0,1,0,1,Friuli Venezia Giulia,ITH4
2021-01-08,PF/BT,221504,ASP COVIL 'Matteo Brunetti',FVG,70-79,4,5,0,0,0,9,0,9,0,9,Friuli Venezia Giulia,ITH4
2021-01-08,PF/BT,221504,ASP COVIL 'Matteo Brunetti',FVG,80-89,6,20,0,0,0,26,0,26,0,26,Friuli Venezia Giulia,ITH4
2021-01-08,PF/BT,221504,ASP COVIL 'Matteo Brunetti',FVG,90+,2,17,0,0,0,19,0,19,0,19,Friuli Venezia Giulia,ITH4
2021-01-08,PF/BT,453001,A.S.P. 'GIOVANNI CHIABA` SAN GIORGIO DI NOGARO,FVG,50-59,1,0,0,0,0,1,0,1,0,1,Friuli Venezia Giulia,ITH4
2021-01-08,PF/BT,453001,A.S.P. 'GIOVANNI CHIABA` SAN GIORGIO DI NOGARO,FVG,60-69,1,2,0,0,0,3,0,3,0,3,Friuli Venezia Giulia,ITH4
2021-01-08,PF/BT,453001,A.S.P. 'GIOVANNI CHIABA` SAN GIORGIO DI NOGARO,FVG,70-79,1,1,0,0,0,2,0,2,0,2,Friuli Venezia Giulia,ITH4
2021-01-08,PF/BT,453001,A.S.P. 'GIOVANNI CHIABA` SAN GIORGIO DI NOGARO,FVG,80-89,5,5,0,0,0,10,0,10,0,10,Friuli Venezia Giulia,ITH4
2021-01-08,PF/BT,453001,A.S.P. 'GIOVANNI CHIABA` SAN GIORGIO DI NOGARO,FVG,90+,2,11,0,0,0,13,0,13,0,13,Friuli Venezia Giulia,ITH4
2021-01-08,PF/BT,453002,A.S.P. ' UMBERTO I' - LATISANA,FVG,60-69,0,1,0,0,0,1,0,1,0,1,Friuli Venezia Giulia,ITH4
2021-01-08,PF/BT,453002,A.S.P. ' UMBERTO I' - LATISANA,FVG,70-79,3,5,0,0,0,8,0,8,0,8,Friuli Venezia Giulia,ITH4
2021-01-08,PF/BT,453002,A.S.P. ' UMBERTO I' - LATISANA,FVG,80-89,0,11,0,0,0,11,0,11,0,11,Friuli Venezia Giulia,ITH4
2021-01-08,PF/BT,453002,A.S.P. ' UMBERTO I' - LATISANA,FVG,90+,0,8,0,0,0,8,0,8,0,8,Friuli Venezia Giulia,ITH4
2021-01-08,PF/BT,920002,CASA ALBERGO ANZIANI DOMENICO CORRADINI - RONCHI,FVG,40-49,0,1,0,0,1,0,0,1,0,1,Friuli Venezia Giulia,ITH4
2021-01-08,PF/BT,920002,CASA ALBERGO ANZIANI DOMENICO CORRADINI - RONCHI,FVG,50-59,2,0,0,1,0,1,0,2,0,2,Friuli Venezia Giulia,ITH4
2021-01-08,PF/BT,920002,CASA ALBERGO ANZIANI DOMENICO CORRADINI - RONCHI,FVG,60-69,3,1,0,1,0,3,0,4,0,4,Friuli Venezia Giulia,ITH4
2021-01-08,PF/BT,920002,CASA ALBERGO ANZIANI DOMENICO CORRADINI - RONCHI,FVG,70-79,5,4,0,0,0,9,0,9,0,9,Friuli Venezia Giulia,ITH4
2021-01-08,PF/BT,920002,CASA ALBERGO ANZIANI DOMENICO CORRADINI - RONCHI,FVG,80-89,3,11,0,0,0,14,0,14,0,14,Friuli Venezia Giulia,ITH4
2021-01-08,PF/BT,920002,CASA ALBERGO ANZIANI DOMENICO CORRADINI - RONCHI,FVG,90+,4,20,0,0,0,24,0,24,0,24,Friuli Venezia Giulia,ITH4
2021-01-08,PF/BT,94BC9F,C.DI R. COMUNE DI BUJA,FVG,30-39,1,0,0,0,0,1,0,1,0,1,Friuli Venezia Giulia,ITH4
2021-01-08,PF/BT,94BC9F,C.DI R. COMUNE DI BUJA,FVG,40-49,0,1,0,1,0,0,0,1,0,1,Friuli Venezia Giulia,ITH4
2021-01-08,PF/BT,94BC9F,C.DI R. COMUNE DI BUJA,FVG,70-79,0,1,0,0,0,1,0,1,0,1,Friuli Venezia Giulia,ITH4
2021-01-08,PF/BT,94BC9F,C.DI R. COMUNE DI BUJA,FVG,80-89,5,10,0,0,0,15,0,15,0,15,Friuli Venezia Giulia,ITH4
2021-01-08,PF/BT,94BC9F,C.DI R. COMUNE DI BUJA,FVG,90+,0,7,0,0,0,7,0,7,0,7,Friuli Venezia Giulia,ITH4
2021-01-08,PF/BT,94KA9X,RESIDENZA PROTETTA 'ZAFFIRO MAGNANO' s.r.l.,FVG,50-59,0,2,0,0,0,2,0,2,0,2,Friuli Venezia Giulia,ITH4
2021-01-08,PF/BT,94KA9X,RESIDENZA PROTETTA 'ZAFFIRO MAGNANO' s.r.l.,FVG,60-69,1,1,0,0,0,2,0,2,0,2,Friuli Venezia Giulia,ITH4
2021-01-08,PF/BT,94KA9X,RESIDENZA PROTETTA 'ZAFFIRO MAGNANO' s.r.l.,FVG,70-79,5,5,0,0,0,10,0,10,0,10,Friuli Venezia Giulia,ITH4
2021-01-08,PF/BT,94KA9X,RESIDENZA PROTETTA 'ZAFFIRO MAGNANO' s.r.l.,FVG,80-89,5,7,0,0,0,12,0,12,0,12,Friuli Venezia Giulia,ITH4
2021-01-08,PF/BT,94KA9X,RESIDENZA PROTETTA 'ZAFFIRO MAGNANO' s.r.l.,FVG,90+,1,3,0,0,0,4,0,4,0,4,Friuli Venezia Giulia,ITH4
2021-01-08,PF/BT,94XA9W,A.S.P. 'FONDAZIONE E. MUNER DE GIUDICI' PRADAMANO,FVG,20-29,0,1,0,1,0,0,0,1,0,1,Friuli Venezia Giulia,ITH4
2021-01-08,PF/BT,94XA9W,A.S.P. 'FONDAZIONE E. MUNER DE GIUDICI' PRADAMANO,FVG,40-49,0,1,0,1,0,0,0,1,0,1,Friuli Venezia Giulia,ITH4
2021-01-08,PF/BT,94XA9W,A.S.P. 'FONDAZIONE E. MUNER DE GIUDICI' PRADAMANO,FVG,50-59,1,0,0,0,0,1,0,1,0,1,Friuli Venezia Giulia,ITH4
2021-01-08,PF/BT,94XA9W,A.S.P. 'FONDAZIONE E. MUNER DE GIUDICI' PRADAMANO,FVG,60-69,1,2,0,0,0,3,0,3,0,3,Friuli Venezia Giulia,ITH4
2021-01-08,PF/BT,94XA9W,A.S.P. 'FONDAZIONE E. MUNER DE GIUDICI' PRADAMANO,FVG,80-89,1,5,0,0,0,6,0,6,0,6,Friuli Venezia Giulia,ITH4
2021-01-08,PF/BT,94XA9W,A.S.P. 'FONDAZIONE E. MUNER DE GIUDICI' PRADAMANO,FVG,90+,1,5,0,0,0,6,0,6,0,6,Friuli Venezia Giulia,ITH4
2021-01-08,PF/BT,9D0040,C. DI RIP. SPILIMBERGO,FVG,40-49,1,1,0,2,0,0,0,2,0,2,Friuli Venezia Giulia,ITH4
2021-01-08,PF/BT,9D0040,C. DI RIP. SPILIMBERGO,FVG,50-59,2,0,0,0,0,2,0,2,0,2,Friuli Venezia Giulia,ITH4
2021-01-08,PF/BT,9D0040,C. DI RIP. SPILIMBERGO,FVG,70-79,1,0,0,0,0,1,0,1,0,1,Friuli Venezia Giulia,ITH4
2021-01-08,PF/BT,9D0040,C. DI RIP. SPILIMBERGO,FVG,80-89,0,1,0,0,0,1,0,1,0,1,Friuli Venezia Giulia,ITH4
2021-01-08,PF/BT,9D0040,C. DI RIP. SPILIMBERGO,FVG,90+,0,2,0,0,0,2,0,2,0,2,Friuli Venezia Giulia,ITH4
2021-01-08,PF/BT,9F0040,CENTRO ASS.ZA ANZ. MANIAGO,FVG,60-69,2,0,0,0,0,2,0,2,0,2,Friuli Venezia Giulia,ITH4
2021-01-08,PF/BT,9F0040,CENTRO ASS.ZA ANZ. MANIAGO,FVG,70-79,2,1,0,0,0,3,0,3,0,3,Friuli Venezia Giulia,ITH4
2021-01-08,PF/BT,9F0040,CENTRO ASS.ZA ANZ. MANIAGO,FVG,80-89,1,2,0,0,0,3,0,3,0,3,Friuli Venezia Giulia,ITH4
2021-01-08,PF/BT,9F0040,CENTRO ASS.ZA ANZ. MANIAGO,FVG,90+,0,6,0,0,0,6,0,6,0,6,Friuli Venezia Giulia,ITH4
2021-01-08,PF/BT,9H0040,"C.E. ""C. E A. CARNERA"" SEQUALS",FVG,40-49,0,1,0,1,0,0,0,1,0,1,Friuli Venezia Giulia,ITH4
2021-01-08,PF/BT,9H0040,"C.E. ""C. E A. CARNERA"" SEQUALS",FVG,60-69,2,1,0,1,0,2,0,3,0,3,Friuli Venezia Giulia,ITH4
2021-01-08,PF/BT,9H0040,"C.E. ""C. E A. CARNERA"" SEQUALS",FVG,70-79,3,2,0,0,0,5,0,5,0,5,Friuli Venezia Giulia,ITH4
2021-01-08,PF/BT,9H0040,"C.E. ""C. E A. CARNERA"" SEQUALS",FVG,80-89,0,5,0,0,0,5,0,5,0,5,Friuli Venezia Giulia,ITH4
2021-01-08,PF/BT,9H0040,"C.E. ""C. E A. CARNERA"" SEQUALS",FVG,90+,0,3,0,0,0,3,0,3,0,3,Friuli Venezia Giulia,ITH4
2021-01-08,PF/BT,9N0040,C. DI RIP. SACILE,FVG,20-29,0,1,0,1,0,0,0,1,0,1,Friuli Venezia Giulia,ITH4
2021-01-08,PF/BT,9N0040,C. DI RIP. SACILE,FVG,40-49,0,1,0,1,0,0,0,1,0,1,Friuli Venezia Giulia,ITH4
2021-01-08,PF/BT,9N0040,C. DI RIP. SACILE,FVG,50-59,1,0,0,1,0,0,0,1,0,1,Friuli Venezia Giulia,ITH4
2021-01-08,PF/BT,9N0040,C. DI RIP. SACILE,FVG,60-69,1,2,0,0,0,3,0,3,0,3,Friuli Venezia Giulia,ITH4
2021-01-08,PF/BT,9N0040,C. DI RIP. SACILE,FVG,70-79,2,7,0,0,0,9,0,9,0,9,Friuli Venezia Giulia,ITH4
2021-01-08,PF/BT,9N0040,C. DI RIP. SACILE,FVG,80-89,6,19,0,0,0,25,0,25,0,25,Friuli Venezia Giulia,ITH4
2021-01-08,PF/BT,9N0040,C. DI RIP. SACILE,FVG,90+,3,22,0,0,0,25,0,25,0,25,Friuli Venezia Giulia,ITH4
2021-01-08,PF/BT,9P0040,C. DI RIP. AVIANO,FVG,70-79,1,1,0,0,0,2,0,2,0,2,Friuli Venezia Giulia,ITH4
2021-01-08,PF/BT,9P0040,C. DI RIP. AVIANO,FVG,80-89,1,0,0,0,0,1,0,1,0,1,Friuli Venezia Giulia,ITH4
2021-01-08,PF/BT,9P0040,C. DI RIP. AVIANO,FVG,90+,0,2,0,0,0,2,0,2,0,2,Friuli Venezia Giulia,ITH4
2021-01-08,PF/BT,9X0040,"CDR ""LA PANORAMICA"" PINZANO",FVG,20-29,1,0,0,1,0,0,0,1,0,1,Friuli Venezia Giulia,ITH4
2021-01-08,PF/BT,9X0040,"CDR ""LA PANORAMICA"" PINZANO",FVG,30-39,1,0,0,1,0,0,0,1,0,1,Friuli Venezia Giulia,ITH4
2021-01-08,PF/BT,9X0040,"CDR ""LA PANORAMICA"" PINZANO",FVG,40-49,0,1,0,1,0,0,0,1,0,1,Friuli Venezia Giulia,ITH4
2021-01-08,PF/BT,9X0040,"CDR ""LA PANORAMICA"" PINZANO",FVG,50-59,0,2,0,2,0,0,0,2,0,2,Friuli Venezia Giulia,ITH4
2021-01-08,PF/BT,9X0040,"CDR ""LA PANORAMICA"" PINZANO",FVG,70-79,1,1,0,0,0,2,0,2,0,2,Friuli Venezia Giulia,ITH4
2021-01-08,PF/BT,9X0040,"CDR ""LA PANORAMICA"" PINZANO",FVG,80-89,0,3,0,0,0,3,0,3,0,3,Friuli Venezia Giulia,ITH4
2021-01-09,PF/BT,117510,SANTA MARIA DEGLI ANGELI,FVG,16-19,1,2,0,1,0,0,2,3,0,3,Friuli Venezia Giulia,ITH4
2021-01-09,PF/BT,117510,SANTA MARIA DEGLI ANGELI,FVG,20-29,26,62,0,51,4,0,33,88,0,88,Friuli Venezia Giulia,ITH4
2021-01-09,PF/BT,117510,SANTA MARIA DEGLI ANGELI,FVG,30-39,24,62,0,63,20,0,3,86,0,86,Friuli Venezia Giulia,ITH4
2021-01-09,PF/BT,117510,SANTA MARIA DEGLI ANGELI,FVG,40-49,35,100,0,101,33,0,1,135,0,135,Friuli Venezia Giulia,ITH4
2021-01-09,PF/BT,117510,SANTA MARIA DEGLI ANGELI,FVG,50-59,44,95,0,101,38,0,0,139,0,139,Friuli Venezia Giulia,ITH4
2021-01-09,PF/BT,117510,SANTA MARIA DEGLI ANGELI,FVG,60-69,32,50,0,67,15,0,0,82,0,82,Friuli Venezia Giulia,ITH4
2021-01-09,PF/BT,117510,SANTA MARIA DEGLI ANGELI,FVG,70-79,8,3,0,10,1,0,0,11,0,11,Friuli Venezia Giulia,ITH4
2021-01-09,PF/BT,117510,SANTA MARIA DEGLI ANGELI,FVG,80-89,1,1,0,1,1,0,0,2,0,2,Friuli Venezia Giulia,ITH4
2021-01-09,PF/BT,117510,SANTA MARIA DEGLI ANGELI,FVG,90+,1,0,0,1,0,0,0,1,0,1,Friuli Venezia Giulia,ITH4
2021-01-09,PF/BT,12M810,MONFALCONE,FVG,20-29,6,20,0,13,8,0,5,26,0,26,Friuli Venezia Giulia,ITH4
2021-01-09,PF/BT,12M810,MONFALCONE,FVG,30-39,8,12,0,17,3,0,0,20,0,20,Friuli Venezia Giulia,ITH4
2021-01-09,PF/BT,12M810,MONFALCONE,FVG,40-49,6,30,0,22,14,0,0,36,0,36,Friuli Venezia Giulia,ITH4
2021-01-09,PF/BT,12M810,MONFALCONE,FVG,50-59,18,44,0,38,24,0,0,62,0,62,Friuli Venezia Giulia,ITH4
2021-01-09,PF/BT,12M810,MONFALCONE,FVG,60-69,11,8,0,8,11,0,0,19,0,19,Friuli Venezia Giulia,ITH4
2021-01-09,PF/BT,12M810,MONFALCONE,FVG,70-79,3,2,0,2,3,0,0,5,0,5,Friuli Venezia Giulia,ITH4
2021-01-09,PF/BT,14VP13,SANTA MARIA DELLA MISERICORDIA,FVG,16-19,3,6,0,1,0,0,8,9,0,9,Friuli Venezia Giulia,ITH4
2021-01-09,PF/BT,14VP13,SANTA MARIA DELLA MISERICORDIA,FVG,20-29,101,184,0,96,16,0,173,285,0,285,Friuli Venezia Giulia,ITH4
2021-01-09,PF/BT,14VP13,SANTA MARIA DELLA MISERICORDIA,FVG,30-39,50,87,0,104,23,0,10,137,0,137,Friuli Venezia Giulia,ITH4
2021-01-09,PF/BT,14VP13,SANTA MARIA DELLA MISERICORDIA,FVG,40-49,52,132,0,137,45,1,1,184,0,184,Friuli Venezia Giulia,ITH4
2021-01-09,PF/BT,14VP13,SANTA MARIA DELLA MISERICORDIA,FVG,50-59,64,156,0,156,62,2,0,220,0,220,Friuli Venezia Giulia,ITH4
2021-01-09,PF/BT,14VP13,SANTA MARIA DELLA MISERICORDIA,FVG,60-69,55,52,0,91,14,2,0,107,0,107,Friuli Venezia Giulia,ITH4
2021-01-09,PF/BT,14VP13,SANTA MARIA DELLA MISERICORDIA,FVG,70-79,29,7,0,26,1,9,0,36,0,36,Friuli Venezia Giulia,ITH4
2021-01-09,PF/BT,14VP13,SANTA MARIA DELLA MISERICORDIA,FVG,80-89,7,9,0,1,2,13,0,16,0,16,Friuli Venezia Giulia,ITH4
2021-01-09,PF/BT,14VP13,SANTA MARIA DELLA MISERICORDIA,FVG,90+,6,10,0,0,0,16,0,16,0,16,Friuli Venezia Giulia,ITH4
2021-01-09,PF/BT,201010,CATTINARA,FVG,16-19,0,1,0,0,0,0,1,1,0,1,Friuli Venezia Giulia,ITH4
2021-01-09,PF/BT,201010,CATTINARA,FVG,20-29,12,23,0,14,5,0,16,35,0,35,Friuli Venezia Giulia,ITH4
2021-01-09,PF/BT,201010,CATTINARA,FVG,30-39,11,20,0,21,6,0,4,31,0,31,Friuli Venezia Giulia,ITH4
2021-01-09,PF/BT,201010,CATTINARA,FVG,40-49,7,30,0,24,11,0,2,37,0,37,Friuli Venezia Giulia,ITH4
2021-01-09,PF/BT,201010,CATTINARA,FVG,50-59,16,43,0,30,29,0,0,59,0,59,Friuli Venezia Giulia,ITH4
2021-01-09,PF/BT,201010,CATTINARA,FVG,60-69,8,15,0,17,6,0,0,23,0,23,Friuli Venezia Giulia,ITH4
2021-01-09,PF/BT,201010,CATTINARA,FVG,70-79,8,1,0,6,2,1,0,9,0,9,Friuli Venezia Giulia,ITH4
2021-01-09,PF/BT,201010,CATTINARA,FVG,80-89,0,4,0,0,0,4,0,4,0,4,Friuli Venezia Giulia,ITH4
2021-01-09,PF/BT,201010,CATTINARA,FVG,90+,0,10,0,0,0,10,0,10,0,10,Friuli Venezia Giulia,ITH4
2021-01-09,PF/BT,212404,CdR SERENI ORIZZONTI spa,FVG,50-59,1,1,0,0,0,2,0,2,0,2,Friuli Venezia Giulia,ITH4
2021-01-09,PF/BT,212404,CdR SERENI ORIZZONTI spa,FVG,60-69,3,3,0,0,0,6,0,6,0,6,Friuli Venezia Giulia,ITH4
2021-01-09,PF/BT,212404,CdR SERENI ORIZZONTI spa,FVG,70-79,4,9,0,0,0,13,0,13,0,13,Friuli Venezia Giulia,ITH4
2021-01-09,PF/BT,212404,CdR SERENI ORIZZONTI spa,FVG,80-89,2,9,0,0,0,11,0,11,0,11,Friuli Venezia Giulia,ITH4
2021-01-09,PF/BT,212404,CdR SERENI ORIZZONTI spa,FVG,90+,1,8,0,0,0,9,0,9,0,9,Friuli Venezia Giulia,ITH4
2021-01-09,PF/BT,220101,TOLMEZZO,FVG,20-29,0,3,0,3,0,0,0,3,0,3,Friuli Venezia Giulia,ITH4
2021-01-09,PF/BT,220101,TOLMEZZO,FVG,30-39,0,1,0,1,0,0,0,1,0,1,Friuli Venezia Giulia,ITH4
2021-01-09,PF/BT,220101,TOLMEZZO,FVG,40-49,0,2,0,2,0,0,0,2,0,2,Friuli Venezia Giulia,ITH4
2021-01-09,PF/BT,220101,TOLMEZZO,FVG,50-59,0,1,0,1,0,0,0,1,0,1,Friuli Venezia Giulia,ITH4
2021-01-09,PF/BT,221404,ASP DELLA CARNIA 'SAN LUIGI SCROSOPPI',FVG,50-59,1,0,0,0,0,1,0,1,0,1,Friuli Venezia Giulia,ITH4
2021-01-09,PF/BT,221404,ASP DELLA CARNIA 'SAN LUIGI SCROSOPPI',FVG,60-69,1,0,0,0,0,1,0,1,0,1,Friuli Venezia Giulia,ITH4
2021-01-09,PF/BT,221404,ASP DELLA CARNIA 'SAN LUIGI SCROSOPPI',FVG,70-79,2,2,0,0,0,4,0,4,0,4,Friuli Venezia Giulia,ITH4
2021-01-09,PF/BT,221404,ASP DELLA CARNIA 'SAN LUIGI SCROSOPPI',FVG,80-89,1,3,0,0,0,4,0,4,0,4,Friuli Venezia Giulia,ITH4
2021-01-09,PF/BT,221404,ASP DELLA CARNIA 'SAN LUIGI SCROSOPPI',FVG,90+,1,3,0,0,0,4,0,4,0,4,Friuli Venezia Giulia,ITH4
2021-01-09,PF/BT,222904,ASP 'STATI UNITI D'AMERICA',FVG,60-69,1,1,0,0,0,2,0,2,0,2,Friuli Venezia Giulia,ITH4
2021-01-09,PF/BT,222904,ASP 'STATI UNITI D'AMERICA',FVG,70-79,2,2,0,0,0,4,0,4,0,4,Friuli Venezia Giulia,ITH4
2021-01-09,PF/BT,222904,ASP 'STATI UNITI D'AMERICA',FVG,80-89,4,8,0,0,0,12,0,12,0,12,Friuli Venezia Giulia,ITH4
2021-01-09,PF/BT,222904,ASP 'STATI UNITI D'AMERICA',FVG,90+,1,9,0,0,0,10,0,10,0,10,Friuli Venezia Giulia,ITH4
2021-01-09,PF/BT,23RA42,C.DI R. SAN DANIELE,FVG,50-59,0,2,0,0,0,2,0,2,0,2,Friuli Venezia Giulia,ITH4
2021-01-09,PF/BT,23RA42,C.DI R. SAN DANIELE,FVG,60-69,2,0,0,0,0,2,0,2,0,2,Friuli Venezia Giulia,ITH4
2021-01-09,PF/BT,23RA42,C.DI R. SAN DANIELE,FVG,70-79,5,4,0,0,0,9,0,9,0,9,Friuli Venezia Giulia,ITH4
2021-01-09,PF/BT,23RA42,C.DI R. SAN DANIELE,FVG,80-89,5,18,0,0,0,23,0,23,0,23,Friuli Venezia Giulia,ITH4
2021-01-09,PF/BT,23RA42,C.DI R. SAN DANIELE,FVG,90+,2,4,0,0,0,6,0,6,0,6,Friuli Venezia Giulia,ITH4
2021-01-09,PF/BT,443002,"A.S.P. ""ARDITO DESIO"" - PALMANOVA",FVG,40-49,1,0,0,0,0,1,0,1,0,1,Friuli Venezia Giulia,ITH4
2021-01-09,PF/BT,443002,"A.S.P. ""ARDITO DESIO"" - PALMANOVA",FVG,50-59,2,0,0,0,0,2,0,2,0,2,Friuli Venezia Giulia,ITH4
2021-01-09,PF/BT,443002,"A.S.P. ""ARDITO DESIO"" - PALMANOVA",FVG,60-69,3,3,0,0,0,6,0,6,0,6,Friuli Venezia Giulia,ITH4
2021-01-09,PF/BT,443002,"A.S.P. ""ARDITO DESIO"" - PALMANOVA",FVG,70-79,5,1,0,0,0,6,0,6,0,6,Friuli Venezia Giulia,ITH4
2021-01-09,PF/BT,443002,"A.S.P. ""ARDITO DESIO"" - PALMANOVA",FVG,80-89,2,5,0,0,0,7,0,7,0,7,Friuli Venezia Giulia,ITH4
2021-01-09,PF/BT,443002,"A.S.P. ""ARDITO DESIO"" - PALMANOVA",FVG,90+,0,1,0,0,0,1,0,1,0,1,Friuli Venezia Giulia,ITH4
2021-01-09,PF/BT,443005,SERENI ORIZZONTI - AIELLO DEL FRIULI,FVG,30-39,0,2,0,1,1,0,0,2,0,2,Friuli Venezia Giulia,ITH4
2021-01-09,PF/BT,443005,SERENI ORIZZONTI - AIELLO DEL FRIULI,FVG,40-49,0,2,0,1,1,0,0,2,0,2,Friuli Venezia Giulia,ITH4
2021-01-09,PF/BT,443005,SERENI ORIZZONTI - AIELLO DEL FRIULI,FVG,50-59,0,5,0,0,4,1,0,5,0,5,Friuli Venezia Giulia,ITH4
2021-01-09,PF/BT,443005,SERENI ORIZZONTI - AIELLO DEL FRIULI,FVG,60-69,4,2,0,0,0,6,0,6,0,6,Friuli Venezia Giulia,ITH4
2021-01-09,PF/BT,443005,SERENI ORIZZONTI - AIELLO DEL FRIULI,FVG,70-79,4,3,0,0,0,7,0,7,0,7,Friuli Venezia Giulia,ITH4
2021-01-09,PF/BT,443005,SERENI ORIZZONTI - AIELLO DEL FRIULI,FVG,80-89,8,9,0,0,0,17,0,17,0,17,Friuli Venezia Giulia,ITH4
2021-01-09,PF/BT,443005,SERENI ORIZZONTI - AIELLO DEL FRIULI,FVG,90+,1,7,0,0,0,8,0,8,0,8,Friuli Venezia Giulia,ITH4
2021-01-09,PF/BT,60206,ASUFC,FVG,50-59,0,2,0,2,0,0,0,2,0,2,Friuli Venezia Giulia,ITH4
2021-01-09,PF/BT,60206,ASUFC,FVG,60-69,2,1,0,0,0,3,0,3,0,3,Friuli Venezia Giulia,ITH4
2021-01-09,PF/BT,60206,ASUFC,FVG,70-79,1,1,0,0,0,2,0,2,0,2,Friuli Venezia Giulia,ITH4
2021-01-09,PF/BT,60206,ASUFC,FVG,80-89,4,14,0,0,0,18,0,18,0,18,Friuli Venezia Giulia,ITH4
2021-01-09,PF/BT,60206,ASUFC,FVG,90+,5,13,0,0,0,18,0,18,0,18,Friuli Venezia Giulia,ITH4
2021-01-09,PF/BT,900040,A.S.P. CASA LUCIA PASIANO,FVG,20-29,1,1,0,2,0,0,0,2,0,2,Friuli Venezia Giulia,ITH4
2021-01-09,PF/BT,900040,A.S.P. CASA LUCIA PASIANO,FVG,40-49,0,1,0,1,0,0,0,1,0,1,Friuli Venezia Giulia,ITH4
2021-01-09,PF/BT,900040,A.S.P. CASA LUCIA PASIANO,FVG,60-69,0,1,0,0,0,1,0,1,0,1,Friuli Venezia Giulia,ITH4
2021-01-09,PF/BT,900040,A.S.P. CASA LUCIA PASIANO,FVG,70-79,0,1,0,0,0,1,0,1,0,1,Friuli Venezia Giulia,ITH4
2021-01-09,PF/BT,900040,A.S.P. CASA LUCIA PASIANO,FVG,80-89,0,1,0,0,0,1,0,1,0,1,Friuli Venezia Giulia,ITH4
2021-01-09,PF/BT,900040,A.S.P. CASA LUCIA PASIANO,FVG,90+,0,1,0,0,0,1,0,1,0,1,Friuli Venezia Giulia,ITH4
2021-01-09,PF/BT,94EA9P,A.S.P. 'DANIELE MORO' CODROIPO,FVG,70-79,0,11,0,0,0,11,0,11,0,11,Friuli Venezia Giulia,ITH4
2021-01-09,PF/BT,94EA9P,A.S.P. 'DANIELE MORO' CODROIPO,FVG,80-89,3,11,0,0,0,14,0,14,0,14,Friuli Venezia Giulia,ITH4
2021-01-09,PF/BT,94EA9P,A.S.P. 'DANIELE MORO' CODROIPO,FVG,90+,0,11,0,0,0,11,0,11,0,11,Friuli Venezia Giulia,ITH4
2021-01-09,PF/BT,94NB9Z,POLIFUNZ. 'SERENI ORIZZONTI' PAVIA UD - RISANO,FVG,30-39,0,1,0,1,0,0,0,1,0,1,Friuli Venezia Giulia,ITH4
2021-01-09,PF/BT,94NB9Z,POLIFUNZ. 'SERENI ORIZZONTI' PAVIA UD - RISANO,FVG,50-59,3,9,0,2,0,10,0,12,0,12,Friuli Venezia Giulia,ITH4
2021-01-09,PF/BT,94NB9Z,POLIFUNZ. 'SERENI ORIZZONTI' PAVIA UD - RISANO,FVG,60-69,13,4,0,0,0,17,0,17,0,17,Friuli Venezia Giulia,ITH4
2021-01-09,PF/BT,94NB9Z,POLIFUNZ. 'SERENI ORIZZONTI' PAVIA UD - RISANO,FVG,70-79,8,2,0,0,0,10,0,10,0,10,Friuli Venezia Giulia,ITH4
2021-01-09,PF/BT,94NB9Z,POLIFUNZ. 'SERENI ORIZZONTI' PAVIA UD - RISANO,FVG,80-89,2,4,0,0,0,6,0,6,0,6,Friuli Venezia Giulia,ITH4
2021-01-09,PF/BT,94NB9Z,POLIFUNZ. 'SERENI ORIZZONTI' PAVIA UD - RISANO,FVG,90+,0,4,0,0,0,4,0,4,0,4,Friuli Venezia Giulia,ITH4
2021-01-09,PF/BT,94NC91,POLIFUNZ. 'SERENI ORIZZONTI' PAVIA UD - PERCOTO,FVG,20-29,1,0,0,1,0,0,0,1,0,1,Friuli Venezia Giulia,ITH4
2021-01-09,PF/BT,94NC91,POLIFUNZ. 'SERENI ORIZZONTI' PAVIA UD - PERCOTO,FVG,40-49,1,1,0,1,0,1,0,2,0,2,Friuli Venezia Giulia,ITH4
2021-01-09,PF/BT,94NC91,POLIFUNZ. 'SERENI ORIZZONTI' PAVIA UD - PERCOTO,FVG,50-59,0,1,0,1,0,0,0,1,0,1,Friuli Venezia Giulia,ITH4
2021-01-09,PF/BT,94NC91,POLIFUNZ. 'SERENI ORIZZONTI' PAVIA UD - PERCOTO,FVG,60-69,1,3,0,0,0,4,0,4,0,4,Friuli Venezia Giulia,ITH4
2021-01-09,PF/BT,94NC91,POLIFUNZ. 'SERENI ORIZZONTI' PAVIA UD - PERCOTO,FVG,70-79,6,2,0,0,1,7,0,8,0,8,Friuli Venezia Giulia,ITH4
2021-01-09,PF/BT,94NC91,POLIFUNZ. 'SERENI ORIZZONTI' PAVIA UD - PERCOTO,FVG,80-89,3,12,0,0,0,15,0,15,0,15,Friuli Venezia Giulia,ITH4
2021-01-09,PF/BT,94NC91,POLIFUNZ. 'SERENI ORIZZONTI' PAVIA UD - PERCOTO,FVG,90+,2,3,0,0,0,5,0,5,0,5,Friuli Venezia Giulia,ITH4
2021-01-09,PF/BT,9L0040,"ENTE MOR. C. DI RIP. ""D.MORO""",FVG,20-29,0,1,0,0,0,1,0,1,0,1,Friuli Venezia Giulia,ITH4
2021-01-09,PF/BT,9L0040,"ENTE MOR. C. DI RIP. ""D.MORO""",FVG,30-39,0,1,0,0,0,1,0,1,0,1,Friuli Venezia Giulia,ITH4
2021-01-09,PF/BT,9L0040,"ENTE MOR. C. DI RIP. ""D.MORO""",FVG,40-49,0,2,0,1,0,1,0,2,0,2,Friuli Venezia Giulia,ITH4
2021-01-09,PF/BT,9L0040,"ENTE MOR. C. DI RIP. ""D.MORO""",FVG,50-59,3,8,0,0,0,11,0,11,0,11,Friuli Venezia Giulia,ITH4
2021-01-09,PF/BT,9L0040,"ENTE MOR. C. DI RIP. ""D.MORO""",FVG,60-69,6,6,0,0,0,12,0,12,0,12,Friuli Venezia Giulia,ITH4
2021-01-09,PF/BT,9L0040,"ENTE MOR. C. DI RIP. ""D.MORO""",FVG,70-79,15,8,0,0,0,23,0,23,0,23,Friuli Venezia Giulia,ITH4
2021-01-09,PF/BT,9L0040,"ENTE MOR. C. DI RIP. ""D.MORO""",FVG,80-89,14,23,0,0,0,37,0,37,0,37,Friuli Venezia Giulia,ITH4
2021-01-09,PF/BT,9L0040,"ENTE MOR. C. DI RIP. ""D.MORO""",FVG,90+,5,21,0,0,0,26,0,26,0,26,Friuli Venezia Giulia,ITH4
2021-01-09,PF/BT,9M0040,"C.D.R.""TOSCANO""E PENS.""BRUSSA""",FVG,60-69,3,1,0,0,0,4,0,4,0,4,Friuli Venezia Giulia,ITH4
2021-01-09,PF/BT,9M0040,"C.D.R.""TOSCANO""E PENS.""BRUSSA""",FVG,70-79,4,5,0,0,0,9,0,9,0,9,Friuli Venezia Giulia,ITH4
2021-01-09,PF/BT,9M0040,"C.D.R.""TOSCANO""E PENS.""BRUSSA""",FVG,80-89,1,11,0,0,0,12,0,12,0,12,Friuli Venezia Giulia,ITH4
2021-01-09,PF/BT,9M0040,"C.D.R.""TOSCANO""E PENS.""BRUSSA""",FVG,90+,1,20,0,0,0,21,0,21,0,21,Friuli Venezia Giulia,ITH4
2021-01-09,PF/BT,9Z0040,"CRD ""SOLIDARIETA`"" AZZANO X",FVG,40-49,2,6,0,7,0,1,0,8,0,8,Friuli Venezia Giulia,ITH4
2021-01-09,PF/BT,9Z0040,"CRD ""SOLIDARIETA`"" AZZANO X",FVG,50-59,4,4,0,7,0,1,0,8,0,8,Friuli Venezia Giulia,ITH4
2021-01-09,PF/BT,9Z0040,"CRD ""SOLIDARIETA`"" AZZANO X",FVG,60-69,2,6,0,5,0,3,0,8,0,8,Friuli Venezia Giulia,ITH4
2021-01-09,PF/BT,9Z0040,"CRD ""SOLIDARIETA`"" AZZANO X",FVG,70-79,2,4,0,0,0,6,0,6,0,6,Friuli Venezia Giulia,ITH4
2021-01-09,PF/BT,9Z0040,"CRD ""SOLIDARIETA`"" AZZANO X",FVG,80-89,0,8,0,0,0,8,0,8,0,8,Friuli Venezia Giulia,ITH4
2021-01-09,PF/BT,9Z0040,"CRD ""SOLIDARIETA`"" AZZANO X",FVG,90+,0,8,0,0,0,8,0,8,0,8,Friuli Venezia Giulia,ITH4
2021-01-10,PF/BT,117510,SANTA MARIA DEGLI ANGELI,FVG,16-19,1,1,0,0,1,0,1,2,0,2,Friuli Venezia Giulia,ITH4
2021-01-10,PF/BT,117510,SANTA MARIA DEGLI ANGELI,FVG,20-29,21,39,0,33,12,0,15,60,0,60,Friuli Venezia Giulia,ITH4
2021-01-10,PF/BT,117510,SANTA MARIA DEGLI ANGELI,FVG,30-39,13,50,0,43,19,0,1,63,0,63,Friuli Venezia Giulia,ITH4
2021-01-10,PF/BT,117510,SANTA MARIA DEGLI ANGELI,FVG,40-49,19,66,0,52,33,0,0,85,0,85,Friuli Venezia Giulia,ITH4
2021-01-10,PF/BT,117510,SANTA MARIA DEGLI ANGELI,FVG,50-59,31,64,0,45,50,0,0,95,0,95,Friuli Venezia Giulia,ITH4
2021-01-10,PF/BT,117510,SANTA MARIA DEGLI ANGELI,FVG,60-69,23,30,0,22,31,0,0,53,0,53,Friuli Venezia Giulia,ITH4
2021-01-10,PF/BT,117510,SANTA MARIA DEGLI ANGELI,FVG,70-79,10,8,0,12,6,0,0,18,0,18,Friuli Venezia Giulia,ITH4
2021-01-10,PF/BT,117510,SANTA MARIA DEGLI ANGELI,FVG,80-89,1,0,0,1,0,0,0,1,0,1,Friuli Venezia Giulia,ITH4
2021-01-10,PF/BT,12M810,MONFALCONE,FVG,16-19,1,0,0,0,0,0,1,1,0,1,Friuli Venezia Giulia,ITH4
2021-01-10,PF/BT,12M810,MONFALCONE,FVG,20-29,5,19,0,11,5,0,8,24,0,24,Friuli Venezia Giulia,ITH4
2021-01-10,PF/BT,12M810,MONFALCONE,FVG,30-39,6,23,0,25,4,0,0,29,0,29,Friuli Venezia Giulia,ITH4
2021-01-10,PF/BT,12M810,MONFALCONE,FVG,40-49,13,28,0,23,18,0,0,41,0,41,Friuli Venezia Giulia,ITH4
2021-01-10,PF/BT,12M810,MONFALCONE,FVG,50-59,9,35,0,28,16,0,0,44,0,44,Friuli Venezia Giulia,ITH4
2021-01-10,PF/BT,12M810,MONFALCONE,FVG,60-69,5,8,0,8,5,0,0,13,0,13,Friuli Venezia Giulia,ITH4
2021-01-10,PF/BT,12M810,MONFALCONE,FVG,70-79,7,3,0,7,3,0,0,10,0,10,Friuli Venezia Giulia,ITH4
2021-01-10,PF/BT,14VP13,SANTA MARIA DELLA MISERICORDIA,FVG,16-19,2,3,0,3,0,0,2,5,0,5,Friuli Venezia Giulia,ITH4
2021-01-10,PF/BT,14VP13,SANTA MARIA DELLA MISERICORDIA,FVG,20-29,73,141,0,88,57,0,69,214,0,214,Friuli Venezia Giulia,ITH4
2021-01-10,PF/BT,14VP13,SANTA MARIA DELLA MISERICORDIA,FVG,30-39,63,149,0,141,60,3,8,212,0,212,Friuli Venezia Giulia,ITH4
2021-01-10,PF/BT,14VP13,SANTA MARIA DELLA MISERICORDIA,FVG,40-49,75,240,0,188,124,3,0,315,0,315,Friuli Venezia Giulia,ITH4
2021-01-10,PF/BT,14VP13,SANTA MARIA DELLA MISERICORDIA,FVG,50-59,95,249,0,190,152,2,0,344,0,344,Friuli Venezia Giulia,ITH4
2021-01-10,PF/BT,14VP13,SANTA MARIA DELLA MISERICORDIA,FVG,60-69,51,92,0,87,52,4,0,143,0,143,Friuli Venezia Giulia,ITH4
2021-01-10,PF/BT,14VP13,SANTA MARIA DELLA MISERICORDIA,FVG,70-79,21,10,0,16,15,0,0,31,0,31,Friuli Venezia Giulia,ITH4
2021-01-10,PF/BT,14VP13,SANTA MARIA DELLA MISERICORDIA,FVG,80-89,4,3,0,2,1,4,0,7,0,7,Friuli Venezia Giulia,ITH4
2021-01-10,PF/BT,201010,CATTINARA,FVG,16-19,3,3,0,0,0,0,6,6,0,6,Friuli Venezia Giulia,ITH4
2021-01-10,PF/BT,201010,CATTINARA,FVG,20-29,57,108,0,47,17,0,101,165,0,165,Friuli Venezia Giulia,ITH4
2021-01-10,PF/BT,201010,CATTINARA,FVG,30-39,53,77,0,73,42,0,15,130,0,130,Friuli Venezia Giulia,ITH4
2021-01-10,PF/BT,201010,CATTINARA,FVG,40-49,40,118,0,85,69,0,4,158,0,158,Friuli Venezia Giulia,ITH4
2021-01-10,PF/BT,201010,CATTINARA,FVG,50-59,52,117,0,99,70,0,0,169,0,169,Friuli Venezia Giulia,ITH4
2021-01-10,PF/BT,201010,CATTINARA,FVG,60-69,31,47,0,50,28,0,0,78,0,78,Friuli Venezia Giulia,ITH4
2021-01-10,PF/BT,201010,CATTINARA,FVG,70-79,8,5,0,10,3,0,0,13,0,13,Friuli Venezia Giulia,ITH4
2021-01-10,PF/BT,201010,CATTINARA,FVG,80-89,1,0,0,1,0,0,0,1,0,1,Friuli Venezia Giulia,ITH4
2021-01-10,PF/BT,201010,CATTINARA,FVG,90+,1,0,0,1,0,0,0,1,0,1,Friuli Venezia Giulia,ITH4
2021-01-10,PF/BT,220101,TOLMEZZO,FVG,16-19,0,1,0,0,0,0,1,1,0,1,Friuli Venezia Giulia,ITH4
2021-01-10,PF/BT,220101,TOLMEZZO,FVG,20-29,6,15,0,8,6,0,7,21,0,21,Friuli Venezia Giulia,ITH4
2021-01-10,PF/BT,220101,TOLMEZZO,FVG,30-39,4,18,0,13,9,0,0,22,0,22,Friuli Venezia Giulia,ITH4
2021-01-10,PF/BT,220101,TOLMEZZO,FVG,40-49,7,28,0,23,12,0,0,35,0,35,Friuli Venezia Giulia,ITH4
2021-01-10,PF/BT,220101,TOLMEZZO,FVG,50-59,11,40,0,38,13,0,0,51,0,51,Friuli Venezia Giulia,ITH4
2021-01-10,PF/BT,220101,TOLMEZZO,FVG,60-69,5,19,0,16,8,0,0,24,0,24,Friuli Venezia Giulia,ITH4
2021-01-10,PF/BT,220101,TOLMEZZO,FVG,70-79,2,0,0,1,1,0,0,2,0,2,Friuli Venezia Giulia,ITH4
2021-01-10,PF/BT,60206,ASUFC,FVG,40-49,0,1,0,1,0,0,0,1,0,1,Friuli Venezia Giulia,ITH4
2021-01-10,PF/BT,60206,ASUFC,FVG,50-59,0,3,0,2,0,1,0,3,0,3,Friuli Venezia Giulia,ITH4
2021-01-10,PF/BT,60206,ASUFC,FVG,60-69,2,0,0,0,0,2,0,2,0,2,Friuli Venezia Giulia,ITH4
2021-01-10,PF/BT,60206,ASUFC,FVG,70-79,7,1,0,0,0,8,0,8,0,8,Friuli Venezia Giulia,ITH4
2021-01-10,PF/BT,60206,ASUFC,FVG,80-89,13,6,0,0,0,19,0,19,0,19,Friuli Venezia Giulia,ITH4
2021-01-10,PF/BT,60206,ASUFC,FVG,90+,4,3,0,0,0,7,0,7,0,7,Friuli Venezia Giulia,ITH4
2021-01-10,PF/BT,60207,ASUGI,FVG,40-49,0,3,0,2,1,0,0,3,0,3,Friuli Venezia Giulia,ITH4
2021-01-10,PF/BT,60207,ASUGI,FVG,50-59,1,6,0,4,3,0,0,7,0,7,Friuli Venezia Giulia,ITH4
2021-01-10,PF/BT,60207,ASUGI,FVG,60-69,1,1,0,0,0,2,0,2,0,2,Friuli Venezia Giulia,ITH4
2021-01-10,PF/BT,60207,ASUGI,FVG,70-79,1,1,0,0,0,2,0,2,0,2,Friuli Venezia Giulia,ITH4
2021-01-10,PF/BT,60207,ASUGI,FVG,80-89,0,6,0,0,0,6,0,6,0,6,Friuli Venezia Giulia,ITH4
2021-01-10,PF/BT,60207,ASUGI,FVG,90+,0,2,0,0,0,2,0,2,0,2,Friuli Venezia Giulia,ITH4
2021-01-10,PF/BT,910037,CASA RIPOSO 'F.LLI STUPARICH',FVG,50-59,1,0,0,0,0,1,0,1,0,1,Friuli Venezia Giulia,ITH4
2021-01-10,PF/BT,910037,CASA RIPOSO 'F.LLI STUPARICH',FVG,60-69,1,2,0,0,0,3,0,3,0,3,Friuli Venezia Giulia,ITH4
2021-01-10,PF/BT,910037,CASA RIPOSO 'F.LLI STUPARICH',FVG,70-79,1,4,0,0,0,5,0,5,0,5,Friuli Venezia Giulia,ITH4
2021-01-10,PF/BT,910037,CASA RIPOSO 'F.LLI STUPARICH',FVG,80-89,3,12,0,0,0,15,0,15,0,15,Friuli Venezia Giulia,ITH4
2021-01-10,PF/BT,910037,CASA RIPOSO 'F.LLI STUPARICH',FVG,90+,0,6,0,0,0,6,0,6,0,6,Friuli Venezia Giulia,ITH4
2021-01-10,PF/BT,94DC9Q,A.S.P. 'CASA PER ANZIANI' CIVIDALE,FVG,20-29,1,0,0,0,1,0,0,1,0,1,Friuli Venezia Giulia,ITH4
2021-01-10,PF/BT,94DC9Q,A.S.P. 'CASA PER ANZIANI' CIVIDALE,FVG,30-39,0,1,0,1,0,0,0,1,0,1,Friuli Venezia Giulia,ITH4
2021-01-10,PF/BT,94DC9Q,A.S.P. 'CASA PER ANZIANI' CIVIDALE,FVG,40-49,0,1,0,1,0,0,0,1,0,1,Friuli Venezia Giulia,ITH4
2021-01-10,PF/BT,94DC9Q,A.S.P. 'CASA PER ANZIANI' CIVIDALE,FVG,50-59,1,2,0,1,1,1,0,3,0,3,Friuli Venezia Giulia,ITH4
2021-01-10,PF/BT,94DC9Q,A.S.P. 'CASA PER ANZIANI' CIVIDALE,FVG,60-69,0,1,0,0,0,1,0,1,0,1,Friuli Venezia Giulia,ITH4
2021-01-10,PF/BT,94DC9Q,A.S.P. 'CASA PER ANZIANI' CIVIDALE,FVG,70-79,2,0,0,0,0,2,0,2,0,2,Friuli Venezia Giulia,ITH4
2021-01-10,PF/BT,94DC9Q,A.S.P. 'CASA PER ANZIANI' CIVIDALE,FVG,80-89,1,3,0,0,0,4,0,4,0,4,Friuli Venezia Giulia,ITH4
2021-01-10,PF/BT,94DC9Q,A.S.P. 'CASA PER ANZIANI' CIVIDALE,FVG,90+,0,4,0,0,0,4,0,4,0,4,Friuli Venezia Giulia,ITH4
2021-01-10,PF/BT,94VL9S,A.S.P. 'LA QUIETE' DI UDINE,FVG,40-49,0,1,0,0,0,1,0,1,0,1,Friuli Venezia Giulia,ITH4
2021-01-10,PF/BT,94VL9S,A.S.P. 'LA QUIETE' DI UDINE,FVG,50-59,1,1,0,0,0,2,0,2,0,2,Friuli Venezia Giulia,ITH4
2021-01-10,PF/BT,94VL9S,A.S.P. 'LA QUIETE' DI UDINE,FVG,60-69,3,1,0,0,0,4,0,4,0,4,Friuli Venezia Giulia,ITH4
2021-01-10,PF/BT,94VL9S,A.S.P. 'LA QUIETE' DI UDINE,FVG,70-79,10,9,0,0,0,19,0,19,0,19,Friuli Venezia Giulia,ITH4
2021-01-10,PF/BT,94VL9S,A.S.P. 'LA QUIETE' DI UDINE,FVG,80-89,16,26,0,0,0,42,0,42,0,42,Friuli Venezia Giulia,ITH4
2021-01-10,PF/BT,94VL9S,A.S.P. 'LA QUIETE' DI UDINE,FVG,90+,6,29,0,0,0,35,0,35,0,35,Friuli Venezia Giulia,ITH4
2021-01-10,PF/BT,94VS9A,RESID. PROTETTA 'S. ANNA' UDINE,FVG,30-39,1,0,0,0,0,0,1,1,0,1,Friuli Venezia Giulia,ITH4
2021-01-10,PF/BT,94VS9A,RESID. PROTETTA 'S. ANNA' UDINE,FVG,40-49,1,0,0,1,0,0,0,1,0,1,Friuli Venezia Giulia,ITH4
2021-01-10,PF/BT,94VS9A,RESID. PROTETTA 'S. ANNA' UDINE,FVG,50-59,2,1,0,1,0,2,0,3,0,3,Friuli Venezia Giulia,ITH4
2021-01-10,PF/BT,94VS9A,RESID. PROTETTA 'S. ANNA' UDINE,FVG,60-69,2,1,0,0,1,2,0,3,0,3,Friuli Venezia Giulia,ITH4
2021-01-10,PF/BT,94VS9A,RESID. PROTETTA 'S. ANNA' UDINE,FVG,70-79,3,3,0,0,0,6,0,6,0,6,Friuli Venezia Giulia,ITH4
2021-01-10,PF/BT,94VS9A,RESID. PROTETTA 'S. ANNA' UDINE,FVG,80-89,4,4,0,0,0,8,0,8,0,8,Friuli Venezia Giulia,ITH4
2021-01-10,PF/BT,94VS9A,RESID. PROTETTA 'S. ANNA' UDINE,FVG,90+,0,15,0,0,0,15,0,15,0,15,Friuli Venezia Giulia,ITH4
2021-01-11,PF/BT,117510,SANTA MARIA DEGLI ANGELI,FVG,20-29,12,43,0,38,5,0,12,55,0,55,Friuli Venezia Giulia,ITH4
2021-01-11,PF/BT,117510,SANTA MARIA DEGLI ANGELI,FVG,30-39,17,61,0,61,11,0,6,78,0,78,Friuli Venezia Giulia,ITH4
2021-01-11,PF/BT,117510,SANTA MARIA DEGLI ANGELI,FVG,40-49,19,70,0,66,23,0,0,89,0,89,Friuli Venezia Giulia,ITH4
2021-01-11,PF/BT,117510,SANTA MARIA DEGLI ANGELI,FVG,50-59,22,77,0,79,20,0,0,99,0,99,Friuli Venezia Giulia,ITH4
2021-01-11,PF/BT,117510,SANTA MARIA DEGLI ANGELI,FVG,60-69,19,23,0,33,9,0,0,42,0,42,Friuli Venezia Giulia,ITH4
2021-01-11,PF/BT,117510,SANTA MARIA DEGLI ANGELI,FVG,70-79,6,2,0,6,2,0,0,8,0,8,Friuli Venezia Giulia,ITH4
2021-01-11,PF/BT,117510,SANTA MARIA DEGLI ANGELI,FVG,80-89,0,1,0,1,0,0,0,1,0,1,Friuli Venezia Giulia,ITH4
2021-01-11,PF/BT,12M810,MONFALCONE,FVG,16-19,0,1,0,0,0,0,1,1,0,1,Friuli Venezia Giulia,ITH4
2021-01-11,PF/BT,12M810,MONFALCONE,FVG,20-29,9,29,0,24,2,0,12,38,0,38,Friuli Venezia Giulia,ITH4
2021-01-11,PF/BT,12M810,MONFALCONE,FVG,30-39,17,18,0,27,8,0,0,35,0,35,Friuli Venezia Giulia,ITH4
2021-01-11,PF/BT,12M810,MONFALCONE,FVG,40-49,8,39,0,38,8,0,1,47,0,47,Friuli Venezia Giulia,ITH4
2021-01-11,PF/BT,12M810,MONFALCONE,FVG,50-59,21,47,0,50,18,0,0,68,0,68,Friuli Venezia Giulia,ITH4
2021-01-11,PF/BT,12M810,MONFALCONE,FVG,60-69,16,23,0,31,8,0,0,39,0,39,Friuli Venezia Giulia,ITH4
2021-01-11,PF/BT,12M810,MONFALCONE,FVG,70-79,9,4,0,9,4,0,0,13,0,13,Friuli Venezia Giulia,ITH4
2021-01-11,PF/BT,12M810,MONFALCONE,FVG,80-89,0,1,0,0,0,1,0,1,0,1,Friuli Venezia Giulia,ITH4
2021-01-11,PF/BT,12M810,MONFALCONE,FVG,90+,0,1,0,0,0,1,0,1,0,1,Friuli Venezia Giulia,ITH4
2021-01-11,PF/BT,14VP13,SANTA MARIA DELLA MISERICORDIA,FVG,16-19,0,1,0,0,0,0,1,1,0,1,Friuli Venezia Giulia,ITH4
2021-01-11,PF/BT,14VP13,SANTA MARIA DELLA MISERICORDIA,FVG,20-29,40,76,0,55,4,0,57,116,0,116,Friuli Venezia Giulia,ITH4
2021-01-11,PF/BT,14VP13,SANTA MARIA DELLA MISERICORDIA,FVG,30-39,31,61,0,70,15,0,7,92,0,92,Friuli Venezia Giulia,ITH4
2021-01-11,PF/BT,14VP13,SANTA MARIA DELLA MISERICORDIA,FVG,40-49,30,95,0,107,16,0,2,125,0,125,Friuli Venezia Giulia,ITH4
2021-01-11,PF/BT,14VP13,SANTA MARIA DELLA MISERICORDIA,FVG,50-59,47,106,0,117,36,0,0,153,0,153,Friuli Venezia Giulia,ITH4
2021-01-11,PF/BT,14VP13,SANTA MARIA DELLA MISERICORDIA,FVG,60-69,39,36,0,61,14,0,0,75,0,75,Friuli Venezia Giulia,ITH4
2021-01-11,PF/BT,14VP13,SANTA MARIA DELLA MISERICORDIA,FVG,70-79,8,6,0,10,4,0,0,14,0,14,Friuli Venezia Giulia,ITH4
2021-01-11,PF/BT,14VP13,SANTA MARIA DELLA MISERICORDIA,FVG,80-89,1,2,0,2,1,0,0,3,0,3,Friuli Venezia Giulia,ITH4
2021-01-11,PF/BT,201010,CATTINARA,FVG,16-19,1,1,0,1,0,0,1,2,0,2,Friuli Venezia Giulia,ITH4
2021-01-11,PF/BT,201010,CATTINARA,FVG,20-29,43,72,0,37,8,0,70,115,0,115,Friuli Venezia Giulia,ITH4
2021-01-11,PF/BT,201010,CATTINARA,FVG,30-39,33,49,0,63,12,0,7,82,0,82,Friuli Venezia Giulia,ITH4
2021-01-11,PF/BT,201010,CATTINARA,FVG,40-49,38,73,0,78,33,0,0,111,0,111,Friuli Venezia Giulia,ITH4
2021-01-11,PF/BT,201010,CATTINARA,FVG,50-59,38,100,0,97,41,0,0,138,0,138,Friuli Venezia Giulia,ITH4
2021-01-11,PF/BT,201010,CATTINARA,FVG,60-69,41,36,0,61,16,0,0,77,0,77,Friuli Venezia Giulia,ITH4
2021-01-11,PF/BT,201010,CATTINARA,FVG,70-79,9,3,0,12,0,0,0,12,0,12,Friuli Venezia Giulia,ITH4
2021-01-11,PF/BT,201010,CATTINARA,FVG,80-89,1,1,0,1,1,0,0,2,0,2,Friuli Venezia Giulia,ITH4
2021-01-11,PF/BT,220101,TOLMEZZO,FVG,16-19,0,1,0,0,0,0,1,1,0,1,Friuli Venezia Giulia,ITH4
2021-01-11,PF/BT,220101,TOLMEZZO,FVG,20-29,3,6,0,5,1,1,2,9,0,9,Friuli Venezia Giulia,ITH4
2021-01-11,PF/BT,220101,TOLMEZZO,FVG,30-39,1,15,0,14,2,0,0,16,0,16,Friuli Venezia Giulia,ITH4
2021-01-11,PF/BT,220101,TOLMEZZO,FVG,40-49,3,14,0,14,3,0,0,17,0,17,Friuli Venezia Giulia,ITH4
2021-01-11,PF/BT,220101,TOLMEZZO,FVG,50-59,3,31,0,27,7,0,0,34,0,34,Friuli Venezia Giulia,ITH4
2021-01-11,PF/BT,220101,TOLMEZZO,FVG,60-69,6,5,0,9,2,0,0,11,0,11,Friuli Venezia Giulia,ITH4
2021-01-11,PF/BT,220101,TOLMEZZO,FVG,70-79,2,0,0,2,0,0,0,2,0,2,Friuli Venezia Giulia,ITH4
2021-01-11,PF/BT,94A042,CASA DI RIPOSO LE CJASE - CORMONS,FVG,30-39,0,4,0,3,0,1,0,4,0,4,Friuli Venezia Giulia,ITH4
2021-01-11,PF/BT,94A042,CASA DI RIPOSO LE CJASE - CORMONS,FVG,40-49,0,1,0,1,0,0,0,1,0,1,Friuli Venezia Giulia,ITH4
2021-01-11,PF/BT,94A042,CASA DI RIPOSO LE CJASE - CORMONS,FVG,50-59,1,2,0,2,0,1,0,3,0,3,Friuli Venezia Giulia,ITH4
2021-01-11,PF/BT,94A042,CASA DI RIPOSO LE CJASE - CORMONS,FVG,60-69,0,1,0,0,0,1,0,1,0,1,Friuli Venezia Giulia,ITH4
2021-01-11,PF/BT,94A042,CASA DI RIPOSO LE CJASE - CORMONS,FVG,70-79,3,2,0,0,0,5,0,5,0,5,Friuli Venezia Giulia,ITH4
2021-01-11,PF/BT,94A042,CASA DI RIPOSO LE CJASE - CORMONS,FVG,80-89,5,12,0,0,0,17,0,17,0,17,Friuli Venezia Giulia,ITH4
2021-01-11,PF/BT,94A042,CASA DI RIPOSO LE CJASE - CORMONS,FVG,90+,4,15,0,0,0,19,0,19,0,19,Friuli Venezia Giulia,ITH4
2021-01-12,PF/BT,060206,ASUFC,FVG,20-29,0,1,0,1,0,0,0,1,0,1,Friuli Venezia Giulia,ITH4
2021-01-12,PF/BT,060206,ASUFC,FVG,30-39,0,2,0,2,0,0,0,2,0,2,Friuli Venezia Giulia,ITH4
2021-01-12,PF/BT,060206,ASUFC,FVG,40-49,0,3,0,2,1,0,0,3,0,3,Friuli Venezia Giulia,ITH4
2021-01-12,PF/BT,060206,ASUFC,FVG,50-59,0,3,0,0,3,0,0,3,0,3,Friuli Venezia Giulia,ITH4
2021-01-12,PF/BT,060206,ASUFC,FVG,60-69,1,1,0,0,0,2,0,2,0,2,Friuli Venezia Giulia,ITH4
2021-01-12,PF/BT,060206,ASUFC,FVG,80-89,3,17,0,0,0,20,0,20,0,20,Friuli Venezia Giulia,ITH4
2021-01-12,PF/BT,060206,ASUFC,FVG,90+,0,10,0,0,0,10,0,10,0,10,Friuli Venezia Giulia,ITH4
2021-01-12,PF/BT,117510,SANTA MARIA DEGLI ANGELI,FVG,20-29,11,28,0,21,5,0,13,39,0,39,Friuli Venezia Giulia,ITH4
2021-01-12,PF/BT,117510,SANTA MARIA DEGLI ANGELI,FVG,30-39,25,47,0,56,14,0,2,72,0,72,Friuli Venezia Giulia,ITH4
2021-01-12,PF/BT,117510,SANTA MARIA DEGLI ANGELI,FVG,40-49,20,81,0,81,20,0,0,101,0,101,Friuli Venezia Giulia,ITH4
2021-01-12,PF/BT,117510,SANTA MARIA DEGLI ANGELI,FVG,50-59,35,82,0,82,35,0,0,117,0,117,Friuli Venezia Giulia,ITH4
2021-01-12,PF/BT,117510,SANTA MARIA DEGLI ANGELI,FVG,60-69,23,18,0,33,8,0,0,41,0,41,Friuli Venezia Giulia,ITH4
2021-01-12,PF/BT,117510,SANTA MARIA DEGLI ANGELI,FVG,70-79,7,1,0,8,0,0,0,8,0,8,Friuli Venezia Giulia,ITH4
2021-01-12,PF/BT,12M810,MONFALCONE,FVG,20-29,4,24,0,23,1,0,4,28,0,28,Friuli Venezia Giulia,ITH4
2021-01-12,PF/BT,12M810,MONFALCONE,FVG,30-39,8,22,0,25,4,0,1,30,0,30,Friuli Venezia Giulia,ITH4
2021-01-12,PF/BT,12M810,MONFALCONE,FVG,40-49,16,45,0,40,19,1,1,61,0,61,Friuli Venezia Giulia,ITH4
2021-01-12,PF/BT,12M810,MONFALCONE,FVG,50-59,17,52,0,48,20,0,1,69,0,69,Friuli Venezia Giulia,ITH4
2021-01-12,PF/BT,12M810,MONFALCONE,FVG,60-69,16,19,0,26,9,0,0,35,0,35,Friuli Venezia Giulia,ITH4
2021-01-12,PF/BT,12M810,MONFALCONE,FVG,70-79,13,7,0,17,2,1,0,20,0,20,Friuli Venezia Giulia,ITH4
2021-01-12,PF/BT,12M810,MONFALCONE,FVG,80-89,0,8,0,2,0,6,0,8,0,8,Friuli Venezia Giulia,ITH4
2021-01-12,PF/BT,12M810,MONFALCONE,FVG,90+,0,3,0,0,0,3,0,3,0,3,Friuli Venezia Giulia,ITH4
2021-01-12,PF/BT,14VP13,SANTA MARIA DELLA MISERICORDIA,FVG,20-29,33,77,0,46,9,0,55,110,0,110,Friuli Venezia Giulia,ITH4
2021-01-12,PF/BT,14VP13,SANTA MARIA DELLA MISERICORDIA,FVG,30-39,38,72,0,77,22,0,11,110,0,110,Friuli Venezia Giulia,ITH4
2021-01-12,PF/BT,14VP13,SANTA MARIA DELLA MISERICORDIA,FVG,40-49,21,103,0,104,20,0,0,124,0,124,Friuli Venezia Giulia,ITH4
2021-01-12,PF/BT,14VP13,SANTA MARIA DELLA MISERICORDIA,FVG,50-59,39,109,0,116,32,0,0,148,0,148,Friuli Venezia Giulia,ITH4
2021-01-12,PF/BT,14VP13,SANTA MARIA DELLA MISERICORDIA,FVG,60-69,38,37,0,68,7,0,0,75,0,75,Friuli Venezia Giulia,ITH4
2021-01-12,PF/BT,14VP13,SANTA MARIA DELLA MISERICORDIA,FVG,70-79,5,1,0,6,0,0,0,6,0,6,Friuli Venezia Giulia,ITH4
2021-01-12,PF/BT,201010,CATTINARA,FVG,16-19,0,7,0,0,0,0,7,7,0,7,Friuli Venezia Giulia,ITH4
2021-01-12,PF/BT,201010,CATTINARA,FVG,20-29,79,126,0,29,10,0,166,205,0,205,Friuli Venezia Giulia,ITH4
2021-01-12,PF/BT,201010,CATTINARA,FVG,30-39,29,42,0,41,21,3,6,71,0,71,Friuli Venezia Giulia,ITH4
2021-01-12,PF/BT,201010,CATTINARA,FVG,40-49,38,66,0,78,25,0,1,104,0,104,Friuli Venezia Giulia,ITH4
2021-01-12,PF/BT,201010,CATTINARA,FVG,50-59,30,88,0,82,36,0,0,118,0,118,Friuli Venezia Giulia,ITH4
2021-01-12,PF/BT,201010,CATTINARA,FVG,60-69,26,35,0,41,15,5,0,61,0,61,Friuli Venezia Giulia,ITH4
2021-01-12,PF/BT,201010,CATTINARA,FVG,70-79,15,13,0,16,2,10,0,28,0,28,Friuli Venezia Giulia,ITH4
2021-01-12,PF/BT,201010,CATTINARA,FVG,80-89,12,17,0,1,0,28,0,29,0,29,Friuli Venezia Giulia,ITH4
2021-01-12,PF/BT,201010,CATTINARA,FVG,90+,7,23,0,1,0,29,0,30,0,30,Friuli Venezia Giulia,ITH4
2021-01-12,PF/BT,220101,TOLMEZZO,FVG,20-29,3,11,0,8,4,0,2,14,0,14,Friuli Venezia Giulia,ITH4
2021-01-12,PF/BT,220101,TOLMEZZO,FVG,30-39,4,9,0,8,4,0,1,13,0,13,Friuli Venezia Giulia,ITH4
2021-01-12,PF/BT,220101,TOLMEZZO,FVG,40-49,3,20,0,19,4,0,0,23,0,23,Friuli Venezia Giulia,ITH4
2021-01-12,PF/BT,220101,TOLMEZZO,FVG,50-59,9,17,0,21,5,0,0,26,0,26,Friuli Venezia Giulia,ITH4
2021-01-12,PF/BT,220101,TOLMEZZO,FVG,60-69,7,6,0,10,3,0,0,13,0,13,Friuli Venezia Giulia,ITH4
2021-01-12,PF/BT,220101,TOLMEZZO,FVG,70-79,1,1,0,2,0,0,0,2,0,2,Friuli Venezia Giulia,ITH4
2021-01-12,PF/BT,443001,CASA DI RIPOSO VALENTINO SARCINELLI - CERVIGNANO,FVG,60-69,1,0,0,0,0,1,0,1,0,1,Friuli Venezia Giulia,ITH4
2021-01-12,PF/BT,443001,CASA DI RIPOSO VALENTINO SARCINELLI - CERVIGNANO,FVG,70-79,5,6,0,0,0,11,0,11,0,11,Friuli Venezia Giulia,ITH4
2021-01-12,PF/BT,443001,CASA DI RIPOSO VALENTINO SARCINELLI - CERVIGNANO,FVG,80-89,5,19,0,0,0,24,0,24,0,24,Friuli Venezia Giulia,ITH4
2021-01-12,PF/BT,443001,CASA DI RIPOSO VALENTINO SARCINELLI - CERVIGNANO,FVG,90+,2,9,0,0,0,11,0,11,0,11,Friuli Venezia Giulia,ITH4
2021-01-12,PF/BT,910001,CASA DI RIPOSO ANGELO CULOT - GORIZIA,FVG,16-19,1,0,0,0,1,0,0,1,0,1,Friuli Venezia Giulia,ITH4
2021-01-12,PF/BT,910001,CASA DI RIPOSO ANGELO CULOT - GORIZIA,FVG,20-29,0,2,0,2,0,0,0,2,0,2,Friuli Venezia Giulia,ITH4
2021-01-12,PF/BT,910001,CASA DI RIPOSO ANGELO CULOT - GORIZIA,FVG,30-39,2,2,0,2,2,0,0,4,0,4,Friuli Venezia Giulia,ITH4
2021-01-12,PF/BT,910001,CASA DI RIPOSO ANGELO CULOT - GORIZIA,FVG,50-59,0,5,0,1,4,0,0,5,0,5,Friuli Venezia Giulia,ITH4
2021-01-12,PF/BT,910001,CASA DI RIPOSO ANGELO CULOT - GORIZIA,FVG,60-69,1,1,0,0,2,0,0,2,0,2,Friuli Venezia Giulia,ITH4
2021-01-12,PF/BT,910001,CASA DI RIPOSO ANGELO CULOT - GORIZIA,FVG,70-79,4,2,0,0,0,6,0,6,0,6,Friuli Venezia Giulia,ITH4
2021-01-12,PF/BT,910001,CASA DI RIPOSO ANGELO CULOT - GORIZIA,FVG,80-89,6,11,0,0,0,17,0,17,0,17,Friuli Venezia Giulia,ITH4
2021-01-12,PF/BT,910001,CASA DI RIPOSO ANGELO CULOT - GORIZIA,FVG,90+,2,11,0,0,0,13,0,13,0,13,Friuli Venezia Giulia,ITH4
2021-01-12,PF/BT,910077,"Residenza ""LE MAGNOLIE""",FVG,70-79,0,1,0,0,0,1,0,1,0,1,Friuli Venezia Giulia,ITH4
2021-01-12,PF/BT,910077,"Residenza ""LE MAGNOLIE""",FVG,80-89,0,4,0,0,0,4,0,4,0,4,Friuli Venezia Giulia,ITH4
2021-01-12,PF/BT,910077,"Residenza ""LE MAGNOLIE""",FVG,90+,1,5,0,0,0,6,0,6,0,6,Friuli Venezia Giulia,ITH4
2021-01-12,PF/BT,94HB94,Casa Albergo 'M.STANGO RODINO'-Majano,FVG,50-59,1,1,0,0,0,2,0,2,0,2,Friuli Venezia Giulia,ITH4
2021-01-12,PF/BT,94HB94,Casa Albergo 'M.STANGO RODINO'-Majano,FVG,60-69,2,4,0,0,0,6,0,6,0,6,Friuli Venezia Giulia,ITH4
2021-01-12,PF/BT,94HB94,Casa Albergo 'M.STANGO RODINO'-Majano,FVG,70-79,7,12,0,0,0,19,0,19,0,19,Friuli Venezia Giulia,ITH4
2021-01-12,PF/BT,94HB94,Casa Albergo 'M.STANGO RODINO'-Majano,FVG,80-89,8,18,0,0,0,26,0,26,0,26,Friuli Venezia Giulia,ITH4
2021-01-12,PF/BT,94HB94,Casa Albergo 'M.STANGO RODINO'-Majano,FVG,90+,3,9,0,0,0,12,0,12,0,12,Friuli Venezia Giulia,ITH4
2021-01-12,PF/BT,94LB9M,C. ASSIST. 'ITALIA ROVERE BIANCHI' MORTEGLIANO,FVG,30-39,1,0,0,1,0,0,0,1,0,1,Friuli Venezia Giulia,ITH4
2021-01-12,PF/BT,94LB9M,C. ASSIST. 'ITALIA ROVERE BIANCHI' MORTEGLIANO,FVG,40-49,1,3,0,3,0,1,0,4,0,4,Friuli Venezia Giulia,ITH4
2021-01-12,PF/BT,94LB9M,C. ASSIST. 'ITALIA ROVERE BIANCHI' MORTEGLIANO,FVG,60-69,1,1,0,1,0,1,0,2,0,2,Friuli Venezia Giulia,ITH4
2021-01-12,PF/BT,94LB9M,C. ASSIST. 'ITALIA ROVERE BIANCHI' MORTEGLIANO,FVG,70-79,4,2,0,0,0,6,0,6,0,6,Friuli Venezia Giulia,ITH4
2021-01-12,PF/BT,94LB9M,C. ASSIST. 'ITALIA ROVERE BIANCHI' MORTEGLIANO,FVG,80-89,4,7,0,0,0,11,0,11,0,11,Friuli Venezia Giulia,ITH4
2021-01-12,PF/BT,94LB9M,C. ASSIST. 'ITALIA ROVERE BIANCHI' MORTEGLIANO,FVG,90+,2,10,0,0,0,12,0,12,0,12,Friuli Venezia Giulia,ITH4
2021-01-12,PF/BT,94VW9G,RESID.PROTETTA 'CARIS' (UNIGEFA s.r.l.) UDINE,FVG,60-69,1,1,0,0,0,2,0,2,0,2,Friuli Venezia Giulia,ITH4
2021-01-12,PF/BT,94VW9G,RESID.PROTETTA 'CARIS' (UNIGEFA s.r.l.) UDINE,FVG,70-79,3,3,0,0,0,6,0,6,0,6,Friuli Venezia Giulia,ITH4
2021-01-12,PF/BT,94VW9G,RESID.PROTETTA 'CARIS' (UNIGEFA s.r.l.) UDINE,FVG,80-89,5,17,0,0,0,22,0,22,0,22,Friuli Venezia Giulia,ITH4
2021-01-12,PF/BT,94VW9G,RESID.PROTETTA 'CARIS' (UNIGEFA s.r.l.) UDINE,FVG,90+,2,17,0,0,0,19,0,19,0,19,Friuli Venezia Giulia,ITH4
2021-01-13,PF/BT,060206,ASUFC,FVG,20-29,1,1,0,2,0,0,0,2,0,2,Friuli Venezia Giulia,ITH4
2021-01-13,PF/BT,060206,ASUFC,FVG,40-49,0,2,0,2,0,0,0,2,0,2,Friuli Venezia Giulia,ITH4
2021-01-13,PF/BT,060206,ASUFC,FVG,50-59,1,0,0,0,0,1,0,1,0,1,Friuli Venezia Giulia,ITH4
2021-01-13,PF/BT,060206,ASUFC,FVG,60-69,2,3,0,0,0,5,0,5,0,5,Friuli Venezia Giulia,ITH4
2021-01-13,PF/BT,060206,ASUFC,FVG,70-79,2,4,0,0,0,6,0,6,0,6,Friuli Venezia Giulia,ITH4
2021-01-13,PF/BT,060206,ASUFC,FVG,80-89,5,16,0,0,0,21,0,21,0,21,Friuli Venezia Giulia,ITH4
2021-01-13,PF/BT,060206,ASUFC,FVG,90+,0,11,0,0,0,11,0,11,0,11,Friuli Venezia Giulia,ITH4
2021-01-13,PF/BT,060207,ASUGI,FVG,20-29,1,0,0,0,1,0,0,1,0,1,Friuli Venezia Giulia,ITH4
2021-01-13,PF/BT,060207,ASUGI,FVG,30-39,0,5,0,3,2,0,0,5,0,5,Friuli Venezia Giulia,ITH4
2021-01-13,PF/BT,060207,ASUGI,FVG,40-49,0,4,0,3,1,0,0,4,0,4,Friuli Venezia Giulia,ITH4
2021-01-13,PF/BT,060207,ASUGI,FVG,50-59,2,9,0,10,0,1,0,11,0,11,Friuli Venezia Giulia,ITH4
2021-01-13,PF/BT,060207,ASUGI,FVG,60-69,5,7,0,8,0,4,0,12,0,12,Friuli Venezia Giulia,ITH4
2021-01-13,PF/BT,060207,ASUGI,FVG,70-79,5,9,0,8,0,6,0,14,0,14,Friuli Venezia Giulia,ITH4
2021-01-13,PF/BT,060207,ASUGI,FVG,80-89,9,27,0,10,0,26,0,36,0,36,Friuli Venezia Giulia,ITH4
2021-01-13,PF/BT,060207,ASUGI,FVG,90+,5,38,0,10,0,33,0,43,0,43,Friuli Venezia Giulia,ITH4
2021-01-13,PF/BT,117510,SANTA MARIA DEGLI ANGELI,FVG,16-19,1,1,0,0,1,0,1,2,0,2,Friuli Venezia Giulia,ITH4
2021-01-13,PF/BT,117510,SANTA MARIA DEGLI ANGELI,FVG,20-29,20,41,0,30,11,0,20,61,0,61,Friuli Venezia Giulia,ITH4
2021-01-13,PF/BT,117510,SANTA MARIA DEGLI ANGELI,FVG,30-39,26,73,0,65,34,0,0,99,0,99,Friuli Venezia Giulia,ITH4
2021-01-13,PF/BT,117510,SANTA MARIA DEGLI ANGELI,FVG,40-49,47,120,0,95,72,0,0,167,0,167,Friuli Venezia Giulia,ITH4
2021-01-13,PF/BT,117510,SANTA MARIA DEGLI ANGELI,FVG,50-59,53,126,0,109,70,0,0,179,0,179,Friuli Venezia Giulia,ITH4
2021-01-13,PF/BT,117510,SANTA MARIA DEGLI ANGELI,FVG,60-69,26,46,0,49,23,0,0,72,0,72,Friuli Venezia Giulia,ITH4
2021-01-13,PF/BT,117510,SANTA MARIA DEGLI ANGELI,FVG,70-79,22,6,0,19,9,0,0,28,0,28,Friuli Venezia Giulia,ITH4
2021-01-13,PF/BT,117510,SANTA MARIA DEGLI ANGELI,FVG,80-89,3,1,0,3,1,0,0,4,0,4,Friuli Venezia Giulia,ITH4
2021-01-13,PF/BT,12M810,MONFALCONE,FVG,16-19,0,1,0,0,0,0,1,1,0,1,Friuli Venezia Giulia,ITH4
2021-01-13,PF/BT,12M810,MONFALCONE,FVG,20-29,1,6,0,4,1,0,2,7,0,7,Friuli Venezia Giulia,ITH4
2021-01-13,PF/BT,12M810,MONFALCONE,FVG,30-39,3,9,0,8,4,0,0,12,0,12,Friuli Venezia Giulia,ITH4
2021-01-13,PF/BT,12M810,MONFALCONE,FVG,40-49,4,19,0,15,8,0,0,23,0,23,Friuli Venezia Giulia,ITH4
2021-01-13,PF/BT,12M810,MONFALCONE,FVG,50-59,6,15,0,18,3,0,0,21,0,21,Friuli Venezia Giulia,ITH4
2021-01-13,PF/BT,12M810,MONFALCONE,FVG,60-69,6,5,0,9,2,0,0,11,0,11,Friuli Venezia Giulia,ITH4
2021-01-13,PF/BT,12M810,MONFALCONE,FVG,70-79,4,3,0,6,1,0,0,7,0,7,Friuli Venezia Giulia,ITH4
2021-01-13,PF/BT,14VP13,SANTA MARIA DELLA MISERICORDIA,FVG,20-29,41,66,0,64,5,0,38,107,0,107,Friuli Venezia Giulia,ITH4
2021-01-13,PF/BT,14VP13,SANTA MARIA DELLA MISERICORDIA,FVG,30-39,28,67,0,71,17,0,7,95,0,95,Friuli Venezia Giulia,ITH4
2021-01-13,PF/BT,14VP13,SANTA MARIA DELLA MISERICORDIA,FVG,40-49,35,82,0,91,25,0,1,117,0,117,Friuli Venezia Giulia,ITH4
2021-01-13,PF/BT,14VP13,SANTA MARIA DELLA MISERICORDIA,FVG,50-59,38,113,0,122,28,1,0,151,0,151,Friuli Venezia Giulia,ITH4
2021-01-13,PF/BT,14VP13,SANTA MARIA DELLA MISERICORDIA,FVG,60-69,36,55,0,73,18,0,0,91,0,91,Friuli Venezia Giulia,ITH4
2021-01-13,PF/BT,14VP13,SANTA MARIA DELLA MISERICORDIA,FVG,70-79,7,3,0,10,0,0,0,10,0,10,Friuli Venezia Giulia,ITH4
2021-01-13,PF/BT,14VP13,SANTA MARIA DELLA MISERICORDIA,FVG,80-89,3,10,0,1,0,12,0,13,0,13,Friuli Venezia Giulia,ITH4
2021-01-13,PF/BT,14VP13,SANTA MARIA DELLA MISERICORDIA,FVG,90+,0,5,0,0,0,5,0,5,0,5,Friuli Venezia Giulia,ITH4
2021-01-13,PF/BT,201010,CATTINARA,FVG,16-19,0,5,0,0,0,0,5,5,0,5,Friuli Venezia Giulia,ITH4
2021-01-13,PF/BT,201010,CATTINARA,FVG,20-29,91,138,0,44,16,1,168,229,0,229,Friuli Venezia Giulia,ITH4
2021-01-13,PF/BT,201010,CATTINARA,FVG,30-39,31,40,0,43,18,0,10,71,0,71,Friuli Venezia Giulia,ITH4
2021-01-13,PF/BT,201010,CATTINARA,FVG,40-49,24,60,0,49,32,0,3,84,0,84,Friuli Venezia Giulia,ITH4
2021-01-13,PF/BT,201010,CATTINARA,FVG,50-59,41,70,0,74,37,0,0,111,0,111,Friuli Venezia Giulia,ITH4
2021-01-13,PF/BT,201010,CATTINARA,FVG,60-69,19,24,0,32,11,0,0,43,0,43,Friuli Venezia Giulia,ITH4
2021-01-13,PF/BT,201010,CATTINARA,FVG,70-79,8,3,0,9,2,0,0,11,0,11,Friuli Venezia Giulia,ITH4
2021-01-13,PF/BT,201010,CATTINARA,FVG,80-89,1,1,0,1,0,1,0,2,0,2,Friuli Venezia Giulia,ITH4
2021-01-13,PF/BT,220101,TOLMEZZO,FVG,20-29,4,9,0,9,3,1,0,13,0,13,Friuli Venezia Giulia,ITH4
2021-01-13,PF/BT,220101,TOLMEZZO,FVG,30-39,3,13,0,11,4,0,1,16,0,16,Friuli Venezia Giulia,ITH4
2021-01-13,PF/BT,220101,TOLMEZZO,FVG,40-49,3,18,0,13,8,0,0,21,0,21,Friuli Venezia Giulia,ITH4
2021-01-13,PF/BT,220101,TOLMEZZO,FVG,50-59,5,32,0,27,8,2,0,37,0,37,Friuli Venezia Giulia,ITH4
2021-01-13,PF/BT,220101,TOLMEZZO,FVG,60-69,5,4,0,8,0,1,0,9,0,9,Friuli Venezia Giulia,ITH4
2021-01-13,PF/BT,220101,TOLMEZZO,FVG,70-79,7,0,0,5,0,2,0,7,0,7,Friuli Venezia Giulia,ITH4
2021-01-13,PF/BT,220101,TOLMEZZO,FVG,80-89,0,3,0,0,0,3,0,3,0,3,Friuli Venezia Giulia,ITH4
2021-01-13,PF/BT,910076,Casa Enrico Caratti,FVG,40-49,0,2,0,0,2,0,0,2,0,2,Friuli Venezia Giulia,ITH4
2021-01-13,PF/BT,910076,Casa Enrico Caratti,FVG,60-69,0,1,0,0,0,1,0,1,0,1,Friuli Venezia Giulia,ITH4
2021-01-13,PF/BT,910076,Casa Enrico Caratti,FVG,70-79,0,2,0,0,0,2,0,2,0,2,Friuli Venezia Giulia,ITH4
2021-01-13,PF/BT,910076,Casa Enrico Caratti,FVG,90+,0,1,0,0,0,1,0,1,0,1,Friuli Venezia Giulia,ITH4
2021-01-13,PF/BT,920002,CASA ALBERGO ANZIANI DOMENICO CORRADINI - RONCHI,FVG,70-79,0,1,0,0,0,1,0,1,0,1,Friuli Venezia Giulia,ITH4
2021-01-13,PF/BT,920002,CASA ALBERGO ANZIANI DOMENICO CORRADINI - RONCHI,FVG,80-89,2,9,0,0,0,11,0,11,0,11,Friuli Venezia Giulia,ITH4
2021-01-13,PF/BT,920002,CASA ALBERGO ANZIANI DOMENICO CORRADINI - RONCHI,FVG,90+,0,12,0,0,0,12,0,12,0,12,Friuli Venezia Giulia,ITH4
2021-01-13,PF/BT,94EA9P,A.S.P. 'DANIELE MORO' CODROIPO,FVG,40-49,1,1,0,0,0,2,0,2,0,2,Friuli Venezia Giulia,ITH4
2021-01-13,PF/BT,94EA9P,A.S.P. 'DANIELE MORO' CODROIPO,FVG,60-69,2,1,0,0,0,3,0,3,0,3,Friuli Venezia Giulia,ITH4
2021-01-13,PF/BT,94EA9P,A.S.P. 'DANIELE MORO' CODROIPO,FVG,70-79,5,2,0,0,0,7,0,7,0,7,Friuli Venezia Giulia,ITH4
2021-01-13,PF/BT,94EA9P,A.S.P. 'DANIELE MORO' CODROIPO,FVG,80-89,3,15,0,0,0,18,0,18,0,18,Friuli Venezia Giulia,ITH4
2021-01-13,PF/BT,94EA9P,A.S.P. 'DANIELE MORO' CODROIPO,FVG,90+,0,20,0,0,0,20,0,20,0,20,Friuli Venezia Giulia,ITH4
2021-01-13,PF/BT,94QA9R,A.S.P. 'GIUSEPPE SIRCH' SAN PIETRO N.,FVG,50-59,0,1,0,1,0,0,0,1,0,1,Friuli Venezia Giulia,ITH4
2021-01-13,PF/BT,94QA9R,A.S.P. 'GIUSEPPE SIRCH' SAN PIETRO N.,FVG,70-79,2,2,0,0,0,4,0,4,0,4,Friuli Venezia Giulia,ITH4
2021-01-13,PF/BT,94QA9R,A.S.P. 'GIUSEPPE SIRCH' SAN PIETRO N.,FVG,80-89,0,1,0,0,0,1,0,1,0,1,Friuli Venezia Giulia,ITH4
2021-01-14,PF/BT,060206,ASUFC,FVG,20-29,1,1,0,2,0,0,0,2,0,2,Friuli Venezia Giulia,ITH4
2021-01-14,PF/BT,060206,ASUFC,FVG,30-39,1,2,0,3,0,0,0,3,0,3,Friuli Venezia Giulia,ITH4
2021-01-14,PF/BT,060206,ASUFC,FVG,40-49,0,8,0,8,0,0,0,8,0,8,Friuli Venezia Giulia,ITH4
2021-01-14,PF/BT,060206,ASUFC,FVG,50-59,0,5,0,5,0,0,0,5,0,5,Friuli Venezia Giulia,ITH4
2021-01-14,PF/BT,060206,ASUFC,FVG,60-69,0,2,0,2,0,0,0,2,0,2,Friuli Venezia Giulia,ITH4
2021-01-14,PF/BT,060207,ASUGI,FVG,40-49,0,2,0,2,0,0,0,2,0,2,Friuli Venezia Giulia,ITH4
2021-01-14,PF/BT,060207,ASUGI,FVG,50-59,0,1,0,1,0,0,0,1,0,1,Friuli Venezia Giulia,ITH4
2021-01-14,PF/BT,060207,ASUGI,FVG,60-69,6,1,0,0,0,7,0,7,0,7,Friuli Venezia Giulia,ITH4
2021-01-14,PF/BT,060207,ASUGI,FVG,70-79,10,7,0,0,0,17,0,17,0,17,Friuli Venezia Giulia,ITH4
2021-01-14,PF/BT,060207,ASUGI,FVG,80-89,9,26,0,0,0,35,0,35,0,35,Friuli Venezia Giulia,ITH4
2021-01-14,PF/BT,060207,ASUGI,FVG,90+,4,54,0,0,0,58,0,58,0,58,Friuli Venezia Giulia,ITH4
2021-01-14,PF/BT,117510,SANTA MARIA DEGLI ANGELI,FVG,16-19,1,1,0,2,0,0,0,2,0,2,Friuli Venezia Giulia,ITH4
2021-01-14,PF/BT,117510,SANTA MARIA DEGLI ANGELI,FVG,20-29,25,28,0,22,10,0,21,53,0,53,Friuli Venezia Giulia,ITH4
2021-01-14,PF/BT,117510,SANTA MARIA DEGLI ANGELI,FVG,30-39,18,41,0,38,19,0,2,59,0,59,Friuli Venezia Giulia,ITH4
2021-01-14,PF/BT,117510,SANTA MARIA DEGLI ANGELI,FVG,40-49,20,63,0,55,27,0,1,83,0,83,Friuli Venezia Giulia,ITH4
2021-01-14,PF/BT,117510,SANTA MARIA DEGLI ANGELI,FVG,50-59,31,85,0,87,29,0,0,116,0,116,Friuli Venezia Giulia,ITH4
2021-01-14,PF/BT,117510,SANTA MARIA DEGLI ANGELI,FVG,60-69,27,25,0,39,13,0,0,52,0,52,Friuli Venezia Giulia,ITH4
2021-01-14,PF/BT,117510,SANTA MARIA DEGLI ANGELI,FVG,70-79,12,5,0,14,3,0,0,17,0,17,Friuli Venezia Giulia,ITH4
2021-01-14,PF/BT,117510,SANTA MARIA DEGLI ANGELI,FVG,80-89,1,0,0,1,0,0,0,1,0,1,Friuli Venezia Giulia,ITH4
2021-01-14,PF/BT,12M810,MONFALCONE,FVG,16-19,0,2,0,0,0,0,2,2,0,2,Friuli Venezia Giulia,ITH4
2021-01-14,PF/BT,12M810,MONFALCONE,FVG,20-29,13,43,0,24,22,0,10,56,0,56,Friuli Venezia Giulia,ITH4
2021-01-14,PF/BT,12M810,MONFALCONE,FVG,30-39,20,34,0,33,19,0,2,54,0,54,Friuli Venezia Giulia,ITH4
2021-01-14,PF/BT,12M810,MONFALCONE,FVG,40-49,14,79,0,64,28,0,1,93,0,93,Friuli Venezia Giulia,ITH4
2021-01-14,PF/BT,12M810,MONFALCONE,FVG,50-59,31,79,0,79,31,0,0,110,0,110,Friuli Venezia Giulia,ITH4
2021-01-14,PF/BT,12M810,MONFALCONE,FVG,60-69,30,32,0,43,19,0,0,62,0,62,Friuli Venezia Giulia,ITH4
2021-01-14,PF/BT,12M810,MONFALCONE,FVG,70-79,11,2,0,10,3,0,0,13,0,13,Friuli Venezia Giulia,ITH4
2021-01-14,PF/BT,12M810,MONFALCONE,FVG,80-89,3,0,0,1,2,0,0,3,0,3,Friuli Venezia Giulia,ITH4
2021-01-14,PF/BT,14VP13,SANTA MARIA DELLA MISERICORDIA,FVG,20-29,33,47,0,37,12,0,31,80,0,80,Friuli Venezia Giulia,ITH4
2021-01-14,PF/BT,14VP13,SANTA MARIA DELLA MISERICORDIA,FVG,30-39,22,53,0,63,9,0,3,75,0,75,Friuli Venezia Giulia,ITH4
2021-01-14,PF/BT,14VP13,SANTA MARIA DELLA MISERICORDIA,FVG,40-49,44,99,0,109,34,0,0,143,0,143,Friuli Venezia Giulia,ITH4
2021-01-14,PF/BT,14VP13,SANTA MARIA DELLA MISERICORDIA,FVG,50-59,41,144,0,133,52,0,0,185,0,185,Friuli Venezia Giulia,ITH4
2021-01-14,PF/BT,14VP13,SANTA MARIA DELLA MISERICORDIA,FVG,60-69,32,51,0,65,18,0,0,83,0,83,Friuli Venezia Giulia,ITH4
2021-01-14,PF/BT,14VP13,SANTA MARIA DELLA MISERICORDIA,FVG,70-79,17,3,0,19,1,0,0,20,0,20,Friuli Venezia Giulia,ITH4
2021-01-14,PF/BT,14VP13,SANTA MARIA DELLA MISERICORDIA,FVG,80-89,1,0,0,1,0,0,0,1,0,1,Friuli Venezia Giulia,ITH4
2021-01-14,PF/BT,14VP13,SANTA MARIA DELLA MISERICORDIA,FVG,90+,0,1,0,0,0,1,0,1,0,1,Friuli Venezia Giulia,ITH4
2021-01-14,PF/BT,201010,CATTINARA,FVG,16-19,0,9,0,0,1,0,8,9,0,9,Friuli Venezia Giulia,ITH4
2021-01-14,PF/BT,201010,CATTINARA,FVG,20-29,48,103,0,47,12,0,92,151,0,151,Friuli Venezia Giulia,ITH4
2021-01-14,PF/BT,201010,CATTINARA,FVG,30-39,21,58,0,50,20,0,9,79,0,79,Friuli Venezia Giulia,ITH4
2021-01-14,PF/BT,201010,CATTINARA,FVG,40-49,31,81,0,74,36,0,2,112,0,112,Friuli Venezia Giulia,ITH4
2021-01-14,PF/BT,201010,CATTINARA,FVG,50-59,43,76,0,70,46,0,3,119,0,119,Friuli Venezia Giulia,ITH4
2021-01-14,PF/BT,201010,CATTINARA,FVG,60-69,27,39,0,48,18,0,0,66,0,66,Friuli Venezia Giulia,ITH4
2021-01-14,PF/BT,201010,CATTINARA,FVG,70-79,9,3,0,8,3,1,0,12,0,12,Friuli Venezia Giulia,ITH4
2021-01-14,PF/BT,201010,CATTINARA,FVG,80-89,4,1,0,5,0,0,0,5,0,5,Friuli Venezia Giulia,ITH4
2021-01-14,PF/BT,220101,TOLMEZZO,FVG,16-19,1,0,0,0,0,0,1,1,0,1,Friuli Venezia Giulia,ITH4
2021-01-14,PF/BT,220101,TOLMEZZO,FVG,20-29,3,8,0,5,4,0,2,11,0,11,Friuli Venezia Giulia,ITH4
2021-01-14,PF/BT,220101,TOLMEZZO,FVG,30-39,3,13,0,10,6,0,0,16,0,16,Friuli Venezia Giulia,ITH4
2021-01-14,PF/BT,220101,TOLMEZZO,FVG,40-49,7,21,0,23,5,0,0,28,0,28,Friuli Venezia Giulia,ITH4
2021-01-14,PF/BT,220101,TOLMEZZO,FVG,50-59,8,25,0,20,13,0,0,33,0,33,Friuli Venezia Giulia,ITH4
2021-01-14,PF/BT,220101,TOLMEZZO,FVG,60-69,8,12,0,14,6,0,0,20,0,20,Friuli Venezia Giulia,ITH4
2021-01-14,PF/BT,220101,TOLMEZZO,FVG,70-79,2,0,0,1,1,0,0,2,0,2,Friuli Venezia Giulia,ITH4
2021-01-14,PF/BT,221504,ASP COVIL 'Matteo Brunetti',FVG,60-69,1,0,0,0,0,1,0,1,0,1,Friuli Venezia Giulia,ITH4
2021-01-14,PF/BT,221504,ASP COVIL 'Matteo Brunetti',FVG,70-79,1,4,0,0,0,5,0,5,0,5,Friuli Venezia Giulia,ITH4
2021-01-14,PF/BT,221504,ASP COVIL 'Matteo Brunetti',FVG,80-89,0,13,0,0,0,13,0,13,0,13,Friuli Venezia Giulia,ITH4
2021-01-14,PF/BT,221504,ASP COVIL 'Matteo Brunetti',FVG,90+,1,10,0,0,0,11,0,11,0,11,Friuli Venezia Giulia,ITH4
2021-01-14,PF/BT,222804,CENTRO RESIDENZIALE PER ANZIANI,FVG,50-59,1,1,0,0,0,2,0,2,0,2,Friuli Venezia Giulia,ITH4
2021-01-14,PF/BT,222804,CENTRO RESIDENZIALE PER ANZIANI,FVG,70-79,0,1,0,0,0,1,0,1,0,1,Friuli Venezia Giulia,ITH4
2021-01-14,PF/BT,222804,CENTRO RESIDENZIALE PER ANZIANI,FVG,80-89,2,0,0,0,0,2,0,2,0,2,Friuli Venezia Giulia,ITH4
2021-01-14,PF/BT,222904,ASP 'STATI UNITI D'AMERICA',FVG,50-59,0,1,0,0,0,1,0,1,0,1,Friuli Venezia Giulia,ITH4
2021-01-14,PF/BT,222904,ASP 'STATI UNITI D'AMERICA',FVG,60-69,5,0,0,0,0,5,0,5,0,5,Friuli Venezia Giulia,ITH4
2021-01-14,PF/BT,222904,ASP 'STATI UNITI D'AMERICA',FVG,70-79,1,3,0,0,0,4,0,4,0,4,Friuli Venezia Giulia,ITH4
2021-01-14,PF/BT,222904,ASP 'STATI UNITI D'AMERICA',FVG,80-89,3,6,0,0,0,9,0,9,0,9,Friuli Venezia Giulia,ITH4
2021-01-14,PF/BT,222904,ASP 'STATI UNITI D'AMERICA',FVG,90+,0,3,0,0,0,3,0,3,0,3,Friuli Venezia Giulia,ITH4
2021-01-14,PF/BT,453001,A.S.P. 'GIOVANNI CHIABA` SAN GIORGIO DI NOGARO,FVG,40-49,0,1,0,1,0,0,0,1,0,1,Friuli Venezia Giulia,ITH4
2021-01-14,PF/BT,453001,A.S.P. 'GIOVANNI CHIABA` SAN GIORGIO DI NOGARO,FVG,50-59,1,0,0,0,0,1,0,1,0,1,Friuli Venezia Giulia,ITH4
2021-01-14,PF/BT,453001,A.S.P. 'GIOVANNI CHIABA` SAN GIORGIO DI NOGARO,FVG,60-69,3,1,0,0,0,4,0,4,0,4,Friuli Venezia Giulia,ITH4
2021-01-14,PF/BT,453001,A.S.P. 'GIOVANNI CHIABA` SAN GIORGIO DI NOGARO,FVG,70-79,5,5,0,0,0,10,0,10,0,10,Friuli Venezia Giulia,ITH4
2021-01-14,PF/BT,453001,A.S.P. 'GIOVANNI CHIABA` SAN GIORGIO DI NOGARO,FVG,80-89,3,20,0,0,0,23,0,23,0,23,Friuli Venezia Giulia,ITH4
2021-01-14,PF/BT,453001,A.S.P. 'GIOVANNI CHIABA` SAN GIORGIO DI NOGARO,FVG,90+,6,33,0,0,0,39,0,39,0,39,Friuli Venezia Giulia,ITH4
2021-01-14,PF/BT,910058,RESIDENZA PER ANZIANI 'CARDUCCI',FVG,70-79,3,2,0,0,0,5,0,5,0,5,Friuli Venezia Giulia,ITH4
2021-01-14,PF/BT,910058,RESIDENZA PER ANZIANI 'CARDUCCI',FVG,80-89,3,8,0,0,0,11,0,11,0,11,Friuli Venezia Giulia,ITH4
2021-01-14,PF/BT,910058,RESIDENZA PER ANZIANI 'CARDUCCI',FVG,90+,2,17,0,0,0,19,0,19,0,19,Friuli Venezia Giulia,ITH4
2021-01-14,PF/BT,910059,RESIDENZA PER ANZIANI 'AD MAIORES',FVG,30-39,0,2,0,2,0,0,0,2,0,2,Friuli Venezia Giulia,ITH4
2021-01-14,PF/BT,910059,RESIDENZA PER ANZIANI 'AD MAIORES',FVG,40-49,0,2,0,0,2,0,0,2,0,2,Friuli Venezia Giulia,ITH4
2021-01-14,PF/BT,910059,RESIDENZA PER ANZIANI 'AD MAIORES',FVG,50-59,1,0,0,0,0,1,0,1,0,1,Friuli Venezia Giulia,ITH4
2021-01-14,PF/BT,910059,RESIDENZA PER ANZIANI 'AD MAIORES',FVG,60-69,1,1,0,0,0,2,0,2,0,2,Friuli Venezia Giulia,ITH4
2021-01-14,PF/BT,910059,RESIDENZA PER ANZIANI 'AD MAIORES',FVG,70-79,1,8,0,0,0,9,0,9,0,9,Friuli Venezia Giulia,ITH4
2021-01-14,PF/BT,910059,RESIDENZA PER ANZIANI 'AD MAIORES',FVG,80-89,3,14,0,0,0,17,0,17,0,17,Friuli Venezia Giulia,ITH4
2021-01-14,PF/BT,910059,RESIDENZA PER ANZIANI 'AD MAIORES',FVG,90+,2,13,0,0,0,15,0,15,0,15,Friuli Venezia Giulia,ITH4
2021-01-14,PF/BT,94VL9S,A.S.P. 'LA QUIETE' DI UDINE,FVG,50-59,0,1,0,0,0,1,0,1,0,1,Friuli Venezia Giulia,ITH4
2021-01-14,PF/BT,94VL9S,A.S.P. 'LA QUIETE' DI UDINE,FVG,60-69,1,0,0,0,0,1,0,1,0,1,Friuli Venezia Giulia,ITH4
2021-01-14,PF/BT,94VL9S,A.S.P. 'LA QUIETE' DI UDINE,FVG,70-79,3,6,0,0,0,9,0,9,0,9,Friuli Venezia Giulia,ITH4
2021-01-14,PF/BT,94VL9S,A.S.P. 'LA QUIETE' DI UDINE,FVG,80-89,7,24,0,0,0,31,0,31,0,31,Friuli Venezia Giulia,ITH4
2021-01-14,PF/BT,94VL9S,A.S.P. 'LA QUIETE' DI UDINE,FVG,90+,4,27,0,0,0,31,0,31,0,31,Friuli Venezia Giulia,ITH4
2021-01-14,PF/BT,94XA9W,A.S.P. 'FONDAZIONE E. MUNER DE GIUDICI' PRADAMANO,FVG,50-59,1,0,0,0,0,1,0,1,0,1,Friuli Venezia Giulia,ITH4
2021-01-14,PF/BT,94XA9W,A.S.P. 'FONDAZIONE E. MUNER DE GIUDICI' PRADAMANO,FVG,70-79,1,6,0,0,0,7,0,7,0,7,Friuli Venezia Giulia,ITH4
2021-01-14,PF/BT,94XA9W,A.S.P. 'FONDAZIONE E. MUNER DE GIUDICI' PRADAMANO,FVG,80-89,1,8,0,0,0,9,0,9,0,9,Friuli Venezia Giulia,ITH4
2021-01-14,PF/BT,94XA9W,A.S.P. 'FONDAZIONE E. MUNER DE GIUDICI' PRADAMANO,FVG,90+,0,7,0,0,0,7,0,7,0,7,Friuli Venezia Giulia,ITH4
2021-01-15,PF/BT,060206,ASUFC,FVG,40-49,0,1,0,1,0,0,0,1,0,1,Friuli Venezia Giulia,ITH4
2021-01-15,PF/BT,060206,ASUFC,FVG,50-59,3,0,0,3,0,0,0,3,0,3,Friuli Venezia Giulia,ITH4
2021-01-15,PF/BT,060207,ASUGI,FVG,30-39,0,1,0,1,0,0,0,1,0,1,Friuli Venezia Giulia,ITH4
2021-01-15,PF/BT,060207,ASUGI,FVG,50-59,1,1,0,2,0,0,0,2,0,2,Friuli Venezia Giulia,ITH4
2021-01-15,PF/BT,060207,ASUGI,FVG,60-69,0,4,0,1,0,3,0,4,0,4,Friuli Venezia Giulia,ITH4
2021-01-15,PF/BT,060207,ASUGI,FVG,70-79,3,6,0,0,0,9,0,9,0,9,Friuli Venezia Giulia,ITH4
2021-01-15,PF/BT,060207,ASUGI,FVG,80-89,2,34,0,0,0,36,0,36,0,36,Friuli Venezia Giulia,ITH4
2021-01-15,PF/BT,060207,ASUGI,FVG,90+,3,23,0,0,0,26,0,26,0,26,Friuli Venezia Giulia,ITH4
2021-01-15,PF/BT,117510,SANTA MARIA DEGLI ANGELI,FVG,20-29,9,42,0,30,7,0,14,51,0,51,Friuli Venezia Giulia,ITH4
2021-01-15,PF/BT,117510,SANTA MARIA DEGLI ANGELI,FVG,30-39,11,38,0,31,15,0,3,49,0,49,Friuli Venezia Giulia,ITH4
2021-01-15,PF/BT,117510,SANTA MARIA DEGLI ANGELI,FVG,40-49,23,66,0,63,26,0,0,89,0,89,Friuli Venezia Giulia,ITH4
2021-01-15,PF/BT,117510,SANTA MARIA DEGLI ANGELI,FVG,50-59,30,93,0,81,42,0,0,123,0,123,Friuli Venezia Giulia,ITH4
2021-01-15,PF/BT,117510,SANTA MARIA DEGLI ANGELI,FVG,60-69,26,35,0,43,18,0,0,61,0,61,Friuli Venezia Giulia,ITH4
2021-01-15,PF/BT,117510,SANTA MARIA DEGLI ANGELI,FVG,70-79,6,3,0,8,1,0,0,9,0,9,Friuli Venezia Giulia,ITH4
2021-01-15,PF/BT,117510,SANTA MARIA DEGLI ANGELI,FVG,80-89,3,1,0,2,2,0,0,4,0,4,Friuli Venezia Giulia,ITH4
2021-01-15,PF/BT,12M810,MONFALCONE,FVG,20-29,1,0,0,1,0,0,0,1,0,1,Friuli Venezia Giulia,ITH4
2021-01-15,PF/BT,12M810,MONFALCONE,FVG,40-49,0,1,0,1,0,0,0,1,0,1,Friuli Venezia Giulia,ITH4
2021-01-15,PF/BT,12M810,MONFALCONE,FVG,50-59,1,1,0,1,1,0,0,2,0,2,Friuli Venezia Giulia,ITH4
2021-01-15,PF/BT,12M810,MONFALCONE,FVG,60-69,0,1,0,1,0,0,0,1,0,1,Friuli Venezia Giulia,ITH4
2021-01-15,PF/BT,14VP13,SANTA MARIA DELLA MISERICORDIA,FVG,16-19,1,2,0,1,0,0,2,3,0,3,Friuli Venezia Giulia,ITH4
2021-01-15,PF/BT,14VP13,SANTA MARIA DELLA MISERICORDIA,FVG,20-29,33,75,0,63,5,0,40,108,0,108,Friuli Venezia Giulia,ITH4
2021-01-15,PF/BT,14VP13,SANTA MARIA DELLA MISERICORDIA,FVG,30-39,30,69,0,82,13,0,4,99,0,99,Friuli Venezia Giulia,ITH4
2021-01-15,PF/BT,14VP13,SANTA MARIA DELLA MISERICORDIA,FVG,40-49,30,107,0,107,29,0,1,137,0,137,Friuli Venezia Giulia,ITH4
2021-01-15,PF/BT,14VP13,SANTA MARIA DELLA MISERICORDIA,FVG,50-59,24,112,0,103,33,0,0,136,0,136,Friuli Venezia Giulia,ITH4
2021-01-15,PF/BT,14VP13,SANTA MARIA DELLA MISERICORDIA,FVG,60-69,40,34,0,60,14,0,0,74,0,74,Friuli Venezia Giulia,ITH4
2021-01-15,PF/BT,14VP13,SANTA MARIA DELLA MISERICORDIA,FVG,70-79,15,3,0,16,1,1,0,18,0,18,Friuli Venezia Giulia,ITH4
2021-01-15,PF/BT,14VP13,SANTA MARIA DELLA MISERICORDIA,FVG,80-89,0,2,0,0,0,2,0,2,0,2,Friuli Venezia Giulia,ITH4
2021-01-15,PF/BT,14VP13,SANTA MARIA DELLA MISERICORDIA,FVG,90+,2,1,0,1,0,2,0,3,0,3,Friuli Venezia Giulia,ITH4
2021-01-15,PF/BT,201010,CATTINARA,FVG,16-19,0,8,0,0,0,0,8,8,0,8,Friuli Venezia Giulia,ITH4
2021-01-15,PF/BT,201010,CATTINARA,FVG,20-29,47,84,0,36,11,0,84,131,0,131,Friuli Venezia Giulia,ITH4
2021-01-15,PF/BT,201010,CATTINARA,FVG,30-39,48,80,0,81,33,0,14,128,0,128,Friuli Venezia Giulia,ITH4
2021-01-15,PF/BT,201010,CATTINARA,FVG,40-49,43,63,0,69,36,0,1,106,0,106,Friuli Venezia Giulia,ITH4
2021-01-15,PF/BT,201010,CATTINARA,FVG,50-59,37,89,0,84,40,1,1,126,0,126,Friuli Venezia Giulia,ITH4
2021-01-15,PF/BT,201010,CATTINARA,FVG,60-69,24,34,0,43,15,0,0,58,0,58,Friuli Venezia Giulia,ITH4
2021-01-15,PF/BT,201010,CATTINARA,FVG,70-79,5,2,0,5,1,1,0,7,0,7,Friuli Venezia Giulia,ITH4
2021-01-15,PF/BT,210704,CASA DI SOGGIORNO PER ANZIANI,FVG,50-59,0,1,0,0,0,1,0,1,0,1,Friuli Venezia Giulia,ITH4
2021-01-15,PF/BT,210704,CASA DI SOGGIORNO PER ANZIANI,FVG,60-69,0,1,0,0,0,1,0,1,0,1,Friuli Venezia Giulia,ITH4
2021-01-15,PF/BT,210704,CASA DI SOGGIORNO PER ANZIANI,FVG,70-79,2,6,0,0,0,8,0,8,0,8,Friuli Venezia Giulia,ITH4
2021-01-15,PF/BT,210704,CASA DI SOGGIORNO PER ANZIANI,FVG,80-89,3,5,0,0,0,8,0,8,0,8,Friuli Venezia Giulia,ITH4
2021-01-15,PF/BT,210704,CASA DI SOGGIORNO PER ANZIANI,FVG,90+,0,3,0,0,0,3,0,3,0,3,Friuli Venezia Giulia,ITH4
2021-01-15,PF/BT,210904,CENTRO ANZIANI 'ETTORE TOLAZZI',FVG,70-79,1,1,0,0,0,2,0,2,0,2,Friuli Venezia Giulia,ITH4
2021-01-15,PF/BT,210904,CENTRO ANZIANI 'ETTORE TOLAZZI',FVG,80-89,1,6,0,0,0,7,0,7,0,7,Friuli Venezia Giulia,ITH4
2021-01-15,PF/BT,210904,CENTRO ANZIANI 'ETTORE TOLAZZI',FVG,90+,0,3,0,0,0,3,0,3,0,3,Friuli Venezia Giulia,ITH4
2021-01-15,PF/BT,212404,CdR SERENI ORIZZONTI spa,FVG,50-59,0,1,0,0,0,1,0,1,0,1,Friuli Venezia Giulia,ITH4
2021-01-15,PF/BT,212404,CdR SERENI ORIZZONTI spa,FVG,70-79,2,0,0,0,0,2,0,2,0,2,Friuli Venezia Giulia,ITH4
2021-01-15,PF/BT,212404,CdR SERENI ORIZZONTI spa,FVG,80-89,2,2,0,0,0,4,0,4,0,4,Friuli Venezia Giulia,ITH4
2021-01-15,PF/BT,212404,CdR SERENI ORIZZONTI spa,FVG,90+,0,5,0,0,0,5,0,5,0,5,Friuli Venezia Giulia,ITH4
2021-01-15,PF/BT,213104,CENTRO SOCIALE COMUNALE - coop.soc.agorà,FVG,60-69,1,2,0,0,0,3,0,3,0,3,Friuli Venezia Giulia,ITH4
2021-01-15,PF/BT,213104,CENTRO SOCIALE COMUNALE - coop.soc.agorà,FVG,70-79,2,2,0,0,0,4,0,4,0,4,Friuli Venezia Giulia,ITH4
2021-01-15,PF/BT,213104,CENTRO SOCIALE COMUNALE - coop.soc.agorà,FVG,80-89,1,0,0,0,0,1,0,1,0,1,Friuli Venezia Giulia,ITH4
2021-01-15,PF/BT,213104,CENTRO SOCIALE COMUNALE - coop.soc.agorà,FVG,90+,0,3,0,0,0,3,0,3,0,3,Friuli Venezia Giulia,ITH4
2021-01-15,PF/BT,220101,TOLMEZZO,FVG,16-19,0,1,0,0,0,0,1,1,0,1,Friuli Venezia Giulia,ITH4
2021-01-15,PF/BT,220101,TOLMEZZO,FVG,20-29,6,7,0,7,2,0,4,13,0,13,Friuli Venezia Giulia,ITH4
2021-01-15,PF/BT,220101,TOLMEZZO,FVG,30-39,4,13,0,13,4,0,0,17,0,17,Friuli Venezia Giulia,ITH4
2021-01-15,PF/BT,220101,TOLMEZZO,FVG,40-49,5,21,0,21,5,0,0,26,0,26,Friuli Venezia Giulia,ITH4
2021-01-15,PF/BT,220101,TOLMEZZO,FVG,50-59,5,25,0,23,7,0,0,30,0,30,Friuli Venezia Giulia,ITH4
2021-01-15,PF/BT,220101,TOLMEZZO,FVG,60-69,4,6,0,6,4,0,0,10,0,10,Friuli Venezia Giulia,ITH4
2021-01-15,PF/BT,220101,TOLMEZZO,FVG,70-79,3,0,0,3,0,0,0,3,0,3,Friuli Venezia Giulia,ITH4
2021-01-15,PF/BT,910040,CASA DI RIPOSO ' EMMAUS ',FVG,30-39,0,1,0,1,0,0,0,1,0,1,Friuli Venezia Giulia,ITH4
2021-01-15,PF/BT,910040,CASA DI RIPOSO ' EMMAUS ',FVG,50-59,0,1,0,0,0,1,0,1,0,1,Friuli Venezia Giulia,ITH4
2021-01-15,PF/BT,910040,CASA DI RIPOSO ' EMMAUS ',FVG,70-79,7,4,0,0,0,11,0,11,0,11,Friuli Venezia Giulia,ITH4
2021-01-15,PF/BT,910040,CASA DI RIPOSO ' EMMAUS ',FVG,80-89,3,10,0,0,0,13,0,13,0,13,Friuli Venezia Giulia,ITH4
2021-01-15,PF/BT,910040,CASA DI RIPOSO ' EMMAUS ',FVG,90+,0,2,0,0,0,2,0,2,0,2,Friuli Venezia Giulia,ITH4
2021-01-15,PF/BT,920003,CASA DI RIPOSO CASA SERENA - GRADO,FVG,60-69,2,3,0,0,0,5,0,5,0,5,Friuli Venezia Giulia,ITH4
2021-01-15,PF/BT,920003,CASA DI RIPOSO CASA SERENA - GRADO,FVG,70-79,8,11,0,0,0,19,0,19,0,19,Friuli Venezia Giulia,ITH4
2021-01-15,PF/BT,920003,CASA DI RIPOSO CASA SERENA - GRADO,FVG,80-89,9,28,0,0,0,37,0,37,0,37,Friuli Venezia Giulia,ITH4
2021-01-15,PF/BT,920003,CASA DI RIPOSO CASA SERENA - GRADO,FVG,90+,4,34,0,0,0,38,0,38,0,38,Friuli Venezia Giulia,ITH4
2021-01-15,PF/BT,94B742,CASA DI RIPOSO VILLA SAN GIUSTO - GORIZIA,FVG,30-39,2,1,0,3,0,0,0,3,0,3,Friuli Venezia Giulia,ITH4
2021-01-15,PF/BT,94B742,CASA DI RIPOSO VILLA SAN GIUSTO - GORIZIA,FVG,40-49,1,3,0,3,0,1,0,4,0,4,Friuli Venezia Giulia,ITH4
2021-01-15,PF/BT,94B742,CASA DI RIPOSO VILLA SAN GIUSTO - GORIZIA,FVG,50-59,1,4,0,4,0,1,0,5,0,5,Friuli Venezia Giulia,ITH4
2021-01-15,PF/BT,94B742,CASA DI RIPOSO VILLA SAN GIUSTO - GORIZIA,FVG,60-69,0,2,0,2,0,0,0,2,0,2,Friuli Venezia Giulia,ITH4
2021-01-15,PF/BT,94B742,CASA DI RIPOSO VILLA SAN GIUSTO - GORIZIA,FVG,70-79,0,3,0,0,0,3,0,3,0,3,Friuli Venezia Giulia,ITH4
2021-01-15,PF/BT,94B742,CASA DI RIPOSO VILLA SAN GIUSTO - GORIZIA,FVG,80-89,1,4,0,0,0,5,0,5,0,5,Friuli Venezia Giulia,ITH4
2021-01-15,PF/BT,94B742,CASA DI RIPOSO VILLA SAN GIUSTO - GORIZIA,FVG,90+,1,2,0,0,0,3,0,3,0,3,Friuli Venezia Giulia,ITH4
2021-01-15,PF/BT,94KA9X,RESIDENZA PROTETTA 'ZAFFIRO MAGNANO' s.r.l.,FVG,50-59,1,0,0,0,0,1,0,1,0,1,Friuli Venezia Giulia,ITH4
2021-01-15,PF/BT,94KA9X,RESIDENZA PROTETTA 'ZAFFIRO MAGNANO' s.r.l.,FVG,60-69,0,2,0,0,0,2,0,2,0,2,Friuli Venezia Giulia,ITH4
2021-01-15,PF/BT,94KA9X,RESIDENZA PROTETTA 'ZAFFIRO MAGNANO' s.r.l.,FVG,70-79,5,3,0,0,0,8,0,8,0,8,Friuli Venezia Giulia,ITH4
2021-01-15,PF/BT,94KA9X,RESIDENZA PROTETTA 'ZAFFIRO MAGNANO' s.r.l.,FVG,80-89,8,32,0,0,0,40,0,40,0,40,Friuli Venezia Giulia,ITH4
2021-01-15,PF/BT,94KA9X,RESIDENZA PROTETTA 'ZAFFIRO MAGNANO' s.r.l.,FVG,90+,4,28,0,0,0,32,0,32,0,32,Friuli Venezia Giulia,ITH4
2021-01-15,PF/BT,94SD9N,A.S.P. 'OPERA PIA COIANIZ' TARCENTO,FVG,60-69,0,2,0,0,0,2,0,2,0,2,Friuli Venezia Giulia,ITH4
2021-01-15,PF/BT,94SD9N,A.S.P. 'OPERA PIA COIANIZ' TARCENTO,FVG,70-79,1,1,0,0,0,2,0,2,0,2,Friuli Venezia Giulia,ITH4
2021-01-15,PF/BT,94SD9N,A.S.P. 'OPERA PIA COIANIZ' TARCENTO,FVG,80-89,2,3,0,0,0,5,0,5,0,5,Friuli Venezia Giulia,ITH4
2021-01-15,PF/BT,94SD9N,A.S.P. 'OPERA PIA COIANIZ' TARCENTO,FVG,90+,1,4,0,0,0,5,0,5,0,5,Friuli Venezia Giulia,ITH4
2021-01-16,PF/BT,060206,ASUFC,FVG,20-29,3,1,0,4,0,0,0,4,0,4,Friuli Venezia Giulia,ITH4
2021-01-16,PF/BT,060206,ASUFC,FVG,30-39,1,0,0,1,0,0,0,1,0,1,Friuli Venezia Giulia,ITH4
2021-01-16,PF/BT,060206,ASUFC,FVG,40-49,0,2,0,2,0,0,0,2,0,2,Friuli Venezia Giulia,ITH4
2021-01-16,PF/BT,060206,ASUFC,FVG,50-59,0,2,0,2,0,0,0,2,0,2,Friuli Venezia Giulia,ITH4
2021-01-16,PF/BT,060207,ASUGI,FVG,50-59,1,1,0,1,0,1,0,2,0,2,Friuli Venezia Giulia,ITH4
2021-01-16,PF/BT,060207,ASUGI,FVG,60-69,0,2,0,1,0,1,0,2,0,2,Friuli Venezia Giulia,ITH4
2021-01-16,PF/BT,060207,ASUGI,FVG,70-79,3,4,0,0,0,7,0,7,0,7,Friuli Venezia Giulia,ITH4
2021-01-16,PF/BT,060207,ASUGI,FVG,80-89,3,15,0,0,0,18,0,18,0,18,Friuli Venezia Giulia,ITH4
2021-01-16,PF/BT,060207,ASUGI,FVG,90+,2,22,0,0,0,24,0,24,0,24,Friuli Venezia Giulia,ITH4
2021-01-16,PF/BT,117510,SANTA MARIA DEGLI ANGELI,FVG,16-19,0,1,0,0,0,0,1,1,0,1,Friuli Venezia Giulia,ITH4
2021-01-16,PF/BT,117510,SANTA MARIA DEGLI ANGELI,FVG,20-29,13,47,0,30,11,0,19,60,0,60,Friuli Venezia Giulia,ITH4
2021-01-16,PF/BT,117510,SANTA MARIA DEGLI ANGELI,FVG,30-39,16,48,0,49,15,0,0,64,0,64,Friuli Venezia Giulia,ITH4
2021-01-16,PF/BT,117510,SANTA MARIA DEGLI ANGELI,FVG,40-49,16,64,0,48,31,0,1,80,0,80,Friuli Venezia Giulia,ITH4
2021-01-16,PF/BT,117510,SANTA MARIA DEGLI ANGELI,FVG,50-59,24,86,0,67,43,0,0,110,0,110,Friuli Venezia Giulia,ITH4
2021-01-16,PF/BT,117510,SANTA MARIA DEGLI ANGELI,FVG,60-69,33,26,0,41,18,0,0,59,0,59,Friuli Venezia Giulia,ITH4
2021-01-16,PF/BT,117510,SANTA MARIA DEGLI ANGELI,FVG,70-79,6,1,0,7,0,0,0,7,0,7,Friuli Venezia Giulia,ITH4
2021-01-16,PF/BT,14VP13,SANTA MARIA DELLA MISERICORDIA,FVG,16-19,1,1,0,1,1,0,0,2,0,2,Friuli Venezia Giulia,ITH4
2021-01-16,PF/BT,14VP13,SANTA MARIA DELLA MISERICORDIA,FVG,20-29,35,75,0,57,13,0,40,110,0,110,Friuli Venezia Giulia,ITH4
2021-01-16,PF/BT,14VP13,SANTA MARIA DELLA MISERICORDIA,FVG,30-39,32,55,0,79,6,0,2,87,0,87,Friuli Venezia Giulia,ITH4
2021-01-16,PF/BT,14VP13,SANTA MARIA DELLA MISERICORDIA,FVG,40-49,27,96,0,99,24,0,0,123,0,123,Friuli Venezia Giulia,ITH4
2021-01-16,PF/BT,14VP13,SANTA MARIA DELLA MISERICORDIA,FVG,50-59,39,128,0,132,35,0,0,167,0,167,Friuli Venezia Giulia,ITH4
2021-01-16,PF/BT,14VP13,SANTA MARIA DELLA MISERICORDIA,FVG,60-69,32,41,0,59,14,0,0,72,1,73,Friuli Venezia Giulia,ITH4
2021-01-16,PF/BT,14VP13,SANTA MARIA DELLA MISERICORDIA,FVG,70-79,12,1,0,12,1,0,0,13,0,13,Friuli Venezia Giulia,ITH4
2021-01-16,PF/BT,14VP13,SANTA MARIA DELLA MISERICORDIA,FVG,80-89,2,2,0,4,0,0,0,4,0,4,Friuli Venezia Giulia,ITH4
2021-01-16,PF/BT,220101,TOLMEZZO,FVG,20-29,1,1,0,2,0,0,0,2,0,2,Friuli Venezia Giulia,ITH4
2021-01-16,PF/BT,220101,TOLMEZZO,FVG,30-39,1,1,0,2,0,0,0,2,0,2,Friuli Venezia Giulia,ITH4
2021-01-16,PF/BT,220101,TOLMEZZO,FVG,40-49,2,2,0,4,0,0,0,4,0,4,Friuli Venezia Giulia,ITH4
2021-01-16,PF/BT,220101,TOLMEZZO,FVG,50-59,0,1,0,0,0,1,0,1,0,1,Friuli Venezia Giulia,ITH4
2021-01-16,PF/BT,220101,TOLMEZZO,FVG,80-89,0,4,0,0,0,4,0,4,0,4,Friuli Venezia Giulia,ITH4
2021-01-16,PF/BT,220101,TOLMEZZO,FVG,90+,1,2,0,0,0,3,0,3,0,3,Friuli Venezia Giulia,ITH4
2021-01-16,PF/BT,23RA42,C.DI R. SAN DANIELE,FVG,40-49,1,1,0,0,0,2,0,2,0,2,Friuli Venezia Giulia,ITH4
2021-01-16,PF/BT,23RA42,C.DI R. SAN DANIELE,FVG,60-69,2,1,0,0,0,3,0,3,0,3,Friuli Venezia Giulia,ITH4
2021-01-16,PF/BT,23RA42,C.DI R. SAN DANIELE,FVG,70-79,3,3,0,0,0,6,0,6,0,6,Friuli Venezia Giulia,ITH4
2021-01-16,PF/BT,23RA42,C.DI R. SAN DANIELE,FVG,80-89,6,12,0,0,0,18,0,18,0,18,Friuli Venezia Giulia,ITH4
2021-01-16,PF/BT,23RA42,C.DI R. SAN DANIELE,FVG,90+,1,19,0,0,0,20,0,20,0,20,Friuli Venezia Giulia,ITH4
2021-01-16,PF/BT,910040,CASA DI RIPOSO ' EMMAUS ',FVG,60-69,1,1,0,0,0,2,0,2,0,2,Friuli Venezia Giulia,ITH4
2021-01-16,PF/BT,910040,CASA DI RIPOSO ' EMMAUS ',FVG,70-79,2,6,0,0,0,8,0,8,0,8,Friuli Venezia Giulia,ITH4
2021-01-16,PF/BT,910040,CASA DI RIPOSO ' EMMAUS ',FVG,80-89,10,29,0,0,0,39,0,39,0,39,Friuli Venezia Giulia,ITH4
2021-01-16,PF/BT,910040,CASA DI RIPOSO ' EMMAUS ',FVG,90+,2,33,0,0,0,35,0,35,0,35,Friuli Venezia Giulia,ITH4
2021-01-16,PF/BT,94WA9E,POLIFUNZ. 'SERENI ORIZZONTI' S.GIOVANNI AL N.,FVG,50-59,1,3,0,0,0,4,0,4,0,4,Friuli Venezia Giulia,ITH4
2021-01-16,PF/BT,94WA9E,POLIFUNZ. 'SERENI ORIZZONTI' S.GIOVANNI AL N.,FVG,60-69,8,5,0,0,0,13,0,13,0,13,Friuli Venezia Giulia,ITH4
2021-01-16,PF/BT,94WA9E,POLIFUNZ. 'SERENI ORIZZONTI' S.GIOVANNI AL N.,FVG,70-79,6,6,0,0,0,12,0,12,0,12,Friuli Venezia Giulia,ITH4
2021-01-16,PF/BT,94WA9E,POLIFUNZ. 'SERENI ORIZZONTI' S.GIOVANNI AL N.,FVG,80-89,6,12,0,0,0,18,0,18,0,18,Friuli Venezia Giulia,ITH4
2021-01-16,PF/BT,94WA9E,POLIFUNZ. 'SERENI ORIZZONTI' S.GIOVANNI AL N.,FVG,90+,2,7,0,0,0,9,0,9,0,9,Friuli Venezia Giulia,ITH4
2021-01-17,PF/BT,060206,ASUFC,FVG,20-29,4,5,0,7,2,0,0,9,0,9,Friuli Venezia Giulia,ITH4
2021-01-17,PF/BT,060206,ASUFC,FVG,30-39,0,4,0,4,0,0,0,4,0,4,Friuli Venezia Giulia,ITH4
2021-01-17,PF/BT,060206,ASUFC,FVG,40-49,2,0,0,1,1,0,0,2,0,2,Friuli Venezia Giulia,ITH4
2021-01-17,PF/BT,060206,ASUFC,FVG,50-59,3,4,0,4,3,0,0,7,0,7,Friuli Venezia Giulia,ITH4
2021-01-17,PF/BT,117510,SANTA MARIA DEGLI ANGELI,FVG,16-19,0,2,0,0,0,0,2,2,0,2,Friuli Venezia Giulia,ITH4
2021-01-17,PF/BT,117510,SANTA MARIA DEGLI ANGELI,FVG,20-29,11,41,0,12,15,0,25,52,0,52,Friuli Venezia Giulia,ITH4
2021-01-17,PF/BT,117510,SANTA MARIA DEGLI ANGELI,FVG,30-39,13,42,0,21,33,0,1,55,0,55,Friuli Venezia Giulia,ITH4
2021-01-17,PF/BT,117510,SANTA MARIA DEGLI ANGELI,FVG,40-49,20,58,0,35,43,0,0,78,0,78,Friuli Venezia Giulia,ITH4
2021-01-17,PF/BT,117510,SANTA MARIA DEGLI ANGELI,FVG,50-59,19,60,0,27,52,0,0,79,0,79,Friuli Venezia Giulia,ITH4
2021-01-17,PF/BT,117510,SANTA MARIA DEGLI ANGELI,FVG,60-69,32,28,0,18,42,0,0,60,0,60,Friuli Venezia Giulia,ITH4
2021-01-17,PF/BT,117510,SANTA MARIA DEGLI ANGELI,FVG,70-79,22,7,0,1,28,0,0,29,0,29,Friuli Venezia Giulia,ITH4
2021-01-17,PF/BT,117510,SANTA MARIA DEGLI ANGELI,FVG,80-89,4,1,0,0,5,0,0,5,0,5,Friuli Venezia Giulia,ITH4
2021-01-17,PF/BT,117510,SANTA MARIA DEGLI ANGELI,FVG,90+,1,0,0,0,1,0,0,1,0,1,Friuli Venezia Giulia,ITH4
2021-01-17,PF/BT,14VP13,SANTA MARIA DELLA MISERICORDIA,FVG,16-19,5,19,0,0,0,0,24,24,0,24,Friuli Venezia Giulia,ITH4
2021-01-17,PF/BT,14VP13,SANTA MARIA DELLA MISERICORDIA,FVG,20-29,41,109,0,32,29,0,89,150,0,150,Friuli Venezia Giulia,ITH4
2021-01-17,PF/BT,14VP13,SANTA MARIA DELLA MISERICORDIA,FVG,30-39,39,101,0,78,59,0,3,140,0,140,Friuli Venezia Giulia,ITH4
2021-01-17,PF/BT,14VP13,SANTA MARIA DELLA MISERICORDIA,FVG,40-49,41,139,0,91,88,0,1,180,0,180,Friuli Venezia Giulia,ITH4
2021-01-17,PF/BT,14VP13,SANTA MARIA DELLA MISERICORDIA,FVG,50-59,55,166,0,107,112,2,0,221,0,221,Friuli Venezia Giulia,ITH4
2021-01-17,PF/BT,14VP13,SANTA MARIA DELLA MISERICORDIA,FVG,60-69,47,52,0,58,33,8,0,99,0,99,Friuli Venezia Giulia,ITH4
2021-01-17,PF/BT,14VP13,SANTA MARIA DELLA MISERICORDIA,FVG,70-79,17,17,0,11,6,17,0,34,0,34,Friuli Venezia Giulia,ITH4
2021-01-17,PF/BT,14VP13,SANTA MARIA DELLA MISERICORDIA,FVG,80-89,13,20,0,3,2,28,0,33,0,33,Friuli Venezia Giulia,ITH4
2021-01-17,PF/BT,14VP13,SANTA MARIA DELLA MISERICORDIA,FVG,90+,2,14,0,0,0,16,0,16,0,16,Friuli Venezia Giulia,ITH4
2021-01-17,PF/BT,221404,ASP DELLA CARNIA 'SAN LUIGI SCROSOPPI',FVG,50-59,2,0,0,0,0,2,0,2,0,2,Friuli Venezia Giulia,ITH4
2021-01-17,PF/BT,221404,ASP DELLA CARNIA 'SAN LUIGI SCROSOPPI',FVG,60-69,4,2,0,0,0,6,0,6,0,6,Friuli Venezia Giulia,ITH4
2021-01-17,PF/BT,221404,ASP DELLA CARNIA 'SAN LUIGI SCROSOPPI',FVG,70-79,6,6,0,0,0,12,0,12,0,12,Friuli Venezia Giulia,ITH4
2021-01-17,PF/BT,221404,ASP DELLA CARNIA 'SAN LUIGI SCROSOPPI',FVG,80-89,15,25,0,0,0,40,0,40,0,40,Friuli Venezia Giulia,ITH4
2021-01-17,PF/BT,221404,ASP DELLA CARNIA 'SAN LUIGI SCROSOPPI',FVG,90+,5,19,0,0,0,24,0,24,0,24,Friuli Venezia Giulia,ITH4
2021-01-17,PF/BT,443002,"A.S.P. ""ARDITO DESIO"" - PALMANOVA",FVG,50-59,0,1,0,0,0,1,0,1,0,1,Friuli Venezia Giulia,ITH4
2021-01-17,PF/BT,443002,"A.S.P. ""ARDITO DESIO"" - PALMANOVA",FVG,60-69,0,4,0,0,0,4,0,4,0,4,Friuli Venezia Giulia,ITH4
2021-01-17,PF/BT,443002,"A.S.P. ""ARDITO DESIO"" - PALMANOVA",FVG,70-79,0,4,0,0,0,4,0,4,0,4,Friuli Venezia Giulia,ITH4
2021-01-17,PF/BT,443002,"A.S.P. ""ARDITO DESIO"" - PALMANOVA",FVG,80-89,0,17,0,0,0,17,0,17,0,17,Friuli Venezia Giulia,ITH4
2021-01-17,PF/BT,443002,"A.S.P. ""ARDITO DESIO"" - PALMANOVA",FVG,90+,0,16,0,0,0,16,0,16,0,16,Friuli Venezia Giulia,ITH4
2021-01-17,PF/BT,443003,CASA DI RIPOSO - AIELLO DEL FRIULI,FVG,50-59,1,0,0,0,0,1,0,1,0,1,Friuli Venezia Giulia,ITH4
2021-01-17,PF/BT,443003,CASA DI RIPOSO - AIELLO DEL FRIULI,FVG,60-69,2,1,0,0,0,3,0,3,0,3,Friuli Venezia Giulia,ITH4
2021-01-17,PF/BT,443003,CASA DI RIPOSO - AIELLO DEL FRIULI,FVG,70-79,3,4,0,0,0,7,0,7,0,7,Friuli Venezia Giulia,ITH4
2021-01-17,PF/BT,443003,CASA DI RIPOSO - AIELLO DEL FRIULI,FVG,80-89,3,5,0,0,0,8,0,8,0,8,Friuli Venezia Giulia,ITH4
2021-01-17,PF/BT,443003,CASA DI RIPOSO - AIELLO DEL FRIULI,FVG,90+,1,6,0,0,0,7,0,7,0,7,Friuli Venezia Giulia,ITH4
2021-01-17,PF/BT,443004,RESIDENZA POLIFUNZIONALE 'IANUS' - PALMANOVA,FVG,20-29,0,1,0,1,0,0,0,1,0,1,Friuli Venezia Giulia,ITH4
2021-01-17,PF/BT,443004,RESIDENZA POLIFUNZIONALE 'IANUS' - PALMANOVA,FVG,30-39,1,0,0,0,0,1,0,1,0,1,Friuli Venezia Giulia,ITH4
2021-01-17,PF/BT,443004,RESIDENZA POLIFUNZIONALE 'IANUS' - PALMANOVA,FVG,40-49,1,0,0,0,0,1,0,1,0,1,Friuli Venezia Giulia,ITH4
2021-01-17,PF/BT,443004,RESIDENZA POLIFUNZIONALE 'IANUS' - PALMANOVA,FVG,50-59,1,0,0,0,0,1,0,1,0,1,Friuli Venezia Giulia,ITH4
2021-01-17,PF/BT,443004,RESIDENZA POLIFUNZIONALE 'IANUS' - PALMANOVA,FVG,60-69,1,2,0,1,0,2,0,3,0,3,Friuli Venezia Giulia,ITH4
2021-01-17,PF/BT,443004,RESIDENZA POLIFUNZIONALE 'IANUS' - PALMANOVA,FVG,70-79,2,5,0,0,0,7,0,7,0,7,Friuli Venezia Giulia,ITH4
2021-01-17,PF/BT,443004,RESIDENZA POLIFUNZIONALE 'IANUS' - PALMANOVA,FVG,80-89,2,13,0,0,0,15,0,15,0,15,Friuli Venezia Giulia,ITH4
2021-01-17,PF/BT,443004,RESIDENZA POLIFUNZIONALE 'IANUS' - PALMANOVA,FVG,90+,1,11,0,0,0,12,0,12,0,12,Friuli Venezia Giulia,ITH4
2021-01-17,PF/BT,443005,SERENI ORIZZONTI - AIELLO DEL FRIULI,FVG,50-59,1,0,0,0,0,1,0,1,0,1,Friuli Venezia Giulia,ITH4
2021-01-17,PF/BT,443005,SERENI ORIZZONTI - AIELLO DEL FRIULI,FVG,70-79,1,3,0,0,0,4,0,4,0,4,Friuli Venezia Giulia,ITH4
2021-01-17,PF/BT,443005,SERENI ORIZZONTI - AIELLO DEL FRIULI,FVG,80-89,3,4,0,0,0,7,0,7,0,7,Friuli Venezia Giulia,ITH4
2021-01-17,PF/BT,443005,SERENI ORIZZONTI - AIELLO DEL FRIULI,FVG,90+,0,8,0,0,0,8,0,8,0,8,Friuli Venezia Giulia,ITH4
2021-01-17,PF/BT,94DC9Q,A.S.P. 'CASA PER ANZIANI' CIVIDALE,FVG,30-39,1,1,0,2,0,0,0,2,0,2,Friuli Venezia Giulia,ITH4
2021-01-17,PF/BT,94DC9Q,A.S.P. 'CASA PER ANZIANI' CIVIDALE,FVG,50-59,6,4,0,1,0,9,0,10,0,10,Friuli Venezia Giulia,ITH4
2021-01-17,PF/BT,94DC9Q,A.S.P. 'CASA PER ANZIANI' CIVIDALE,FVG,60-69,6,5,0,0,0,11,0,11,0,11,Friuli Venezia Giulia,ITH4
2021-01-17,PF/BT,94DC9Q,A.S.P. 'CASA PER ANZIANI' CIVIDALE,FVG,70-79,8,9,0,0,0,17,0,17,0,17,Friuli Venezia Giulia,ITH4
2021-01-17,PF/BT,94DC9Q,A.S.P. 'CASA PER ANZIANI' CIVIDALE,FVG,80-89,24,33,0,0,0,57,0,57,0,57,Friuli Venezia Giulia,ITH4
2021-01-17,PF/BT,94DC9Q,A.S.P. 'CASA PER ANZIANI' CIVIDALE,FVG,90+,7,27,0,0,0,34,0,34,0,34,Friuli Venezia Giulia,ITH4
2021-01-17,PF/BT,94SD9N,A.S.P. 'OPERA PIA COIANIZ' TARCENTO,FVG,50-59,1,2,0,1,0,2,0,3,0,3,Friuli Venezia Giulia,ITH4
2021-01-17,PF/BT,94SD9N,A.S.P. 'OPERA PIA COIANIZ' TARCENTO,FVG,60-69,1,2,0,0,0,3,0,3,0,3,Friuli Venezia Giulia,ITH4
2021-01-17,PF/BT,94SD9N,A.S.P. 'OPERA PIA COIANIZ' TARCENTO,FVG,70-79,4,10,0,0,0,14,0,14,0,14,Friuli Venezia Giulia,ITH4
2021-01-17,PF/BT,94SD9N,A.S.P. 'OPERA PIA COIANIZ' TARCENTO,FVG,80-89,6,22,0,0,0,28,0,28,0,28,Friuli Venezia Giulia,ITH4
2021-01-17,PF/BT,94SD9N,A.S.P. 'OPERA PIA COIANIZ' TARCENTO,FVG,90+,1,24,0,0,0,25,0,25,0,25,Friuli Venezia Giulia,ITH4
