TML_DTA_SOMM,TML_VAX_FORNITORE,TML_COD_STRUTTURA,TML_DES_STRUTTURA,TML_AREA,TML_FASCIA_ETA,TML_SESSO_M,TML_SESSO_F,TML_GRAVIDANZA,TML_CAT_OSS,TML_CAT_PERSONALE,TML_CAT_RSA_OSPITI,TML_CAT_ALTRO,TML_DOSE_1,TML_DOSE_2,TML_TOT_SOMM,TML_REGIONE,TML_NUTS
2020-12-27,PF/BT,.030042,ASST VAL - PRESIDIO OSPEDALIERO DI SONDRIO,LOM,20-29,1,0,0,1,0,0,0,1,0,1,Lombardia,ITC4
2020-12-27,PF/BT,.030042,ASST VAL - PRESIDIO OSPEDALIERO DI SONDRIO,LOM,30-39,5,0,0,2,3,0,0,5,0,5,Lombardia,ITC4
2020-12-27,PF/BT,.030042,ASST VAL - PRESIDIO OSPEDALIERO DI SONDRIO,LOM,40-49,8,4,0,11,1,0,0,12,0,12,Lombardia,ITC4
2020-12-27,PF/BT,.030042,ASST VAL - PRESIDIO OSPEDALIERO DI SONDRIO,LOM,50-59,9,8,0,15,1,0,1,17,0,17,Lombardia,ITC4
2020-12-27,PF/BT,.030042,ASST VAL - PRESIDIO OSPEDALIERO DI SONDRIO,LOM,60-69,8,5,0,12,1,0,0,13,0,13,Lombardia,ITC4
2020-12-27,PF/BT,.030042,ASST VAL - PRESIDIO OSPEDALIERO DI SONDRIO,LOM,70-79,0,1,0,0,1,0,0,1,0,1,Lombardia,ITC4
2020-12-27,PF/BT,.030042,ASST VAL - PRESIDIO OSPEDALIERO DI SONDRIO,LOM,80-89,1,0,0,0,0,0,1,1,0,1,Lombardia,ITC4
2020-12-27,PF/BT,000558,RSA PIO ALBERGO TRIVULZIO,LOM,20-29,3,5,0,8,0,0,0,8,0,8,Lombardia,ITC4
2020-12-27,PF/BT,000558,RSA PIO ALBERGO TRIVULZIO,LOM,30-39,4,2,0,6,0,0,0,6,0,6,Lombardia,ITC4
2020-12-27,PF/BT,000558,RSA PIO ALBERGO TRIVULZIO,LOM,40-49,2,4,0,5,1,0,0,6,0,6,Lombardia,ITC4
2020-12-27,PF/BT,000558,RSA PIO ALBERGO TRIVULZIO,LOM,50-59,3,4,0,7,0,0,0,7,0,7,Lombardia,ITC4
2020-12-27,PF/BT,000558,RSA PIO ALBERGO TRIVULZIO,LOM,60-69,5,6,0,11,0,0,0,11,0,11,Lombardia,ITC4
2020-12-27,PF/BT,000558,RSA PIO ALBERGO TRIVULZIO,LOM,70-79,0,2,0,0,0,2,0,2,0,2,Lombardia,ITC4
2020-12-27,PF/BT,000558,RSA PIO ALBERGO TRIVULZIO,LOM,80-89,2,6,0,0,0,8,0,8,0,8,Lombardia,ITC4
2020-12-27,PF/BT,000558,RSA PIO ALBERGO TRIVULZIO,LOM,90+,1,1,0,0,0,2,0,2,0,2,Lombardia,ITC4
2020-12-27,PF/BT,030903,AMB COVID LECCO,LOM,30-39,5,3,0,8,0,0,0,8,0,8,Lombardia,ITC4
2020-12-27,PF/BT,030903,AMB COVID LECCO,LOM,40-49,2,9,0,11,0,0,0,11,0,11,Lombardia,ITC4
2020-12-27,PF/BT,030903,AMB COVID LECCO,LOM,50-59,4,11,0,13,2,0,0,15,0,15,Lombardia,ITC4
2020-12-27,PF/BT,030903,AMB COVID LECCO,LOM,60-69,14,2,0,15,1,0,0,16,0,16,Lombardia,ITC4
2020-12-27,PF/BT,030924,IRCCS POLICLINICO S. MATTEO - PAVIA,LOM,20-29,1,0,0,1,0,0,0,1,0,1,Lombardia,ITC4
2020-12-27,PF/BT,030924,IRCCS POLICLINICO S. MATTEO - PAVIA,LOM,30-39,1,1,0,2,0,0,0,2,0,2,Lombardia,ITC4
2020-12-27,PF/BT,030924,IRCCS POLICLINICO S. MATTEO - PAVIA,LOM,40-49,4,7,0,11,0,0,0,11,0,11,Lombardia,ITC4
2020-12-27,PF/BT,030924,IRCCS POLICLINICO S. MATTEO - PAVIA,LOM,50-59,10,3,0,13,0,0,0,13,0,13,Lombardia,ITC4
2020-12-27,PF/BT,030924,IRCCS POLICLINICO S. MATTEO - PAVIA,LOM,60-69,19,3,0,22,0,0,0,22,0,22,Lombardia,ITC4
2020-12-27,PF/BT,030924,IRCCS POLICLINICO S. MATTEO - PAVIA,LOM,70-79,1,0,0,1,0,0,0,1,0,1,Lombardia,ITC4
2020-12-27,PF/BT,30701,ASST GRANDE OSPEDALE METROPOLITANO NIGUARDA,LOM,20-29,1,2,0,3,0,0,0,3,0,3,Lombardia,ITC4
2020-12-27,PF/BT,30701,ASST GRANDE OSPEDALE METROPOLITANO NIGUARDA,LOM,30-39,2,7,0,9,0,0,0,9,0,9,Lombardia,ITC4
2020-12-27,PF/BT,30701,ASST GRANDE OSPEDALE METROPOLITANO NIGUARDA,LOM,40-49,8,8,0,16,0,0,0,16,0,16,Lombardia,ITC4
2020-12-27,PF/BT,30701,ASST GRANDE OSPEDALE METROPOLITANO NIGUARDA,LOM,50-59,14,12,0,26,0,0,0,26,0,26,Lombardia,ITC4
2020-12-27,PF/BT,30701,ASST GRANDE OSPEDALE METROPOLITANO NIGUARDA,LOM,60-69,33,10,0,43,0,0,0,43,0,43,Lombardia,ITC4
2020-12-27,PF/BT,30701,ASST GRANDE OSPEDALE METROPOLITANO NIGUARDA,LOM,70-79,1,0,0,1,0,0,0,1,0,1,Lombardia,ITC4
2020-12-27,PF/BT,30701,ASST GRANDE OSPEDALE METROPOLITANO NIGUARDA,LOM,90+,1,0,0,1,0,0,0,1,0,1,Lombardia,ITC4
2020-12-27,PF/BT,30718,ASST PAPA GIOVANNI XXIII,LOM,20-29,1,4,0,5,0,0,0,5,0,5,Lombardia,ITC4
2020-12-27,PF/BT,30718,ASST PAPA GIOVANNI XXIII,LOM,30-39,0,4,0,3,0,0,1,4,0,4,Lombardia,ITC4
2020-12-27,PF/BT,30718,ASST PAPA GIOVANNI XXIII,LOM,40-49,5,6,0,11,0,0,0,11,0,11,Lombardia,ITC4
2020-12-27,PF/BT,30718,ASST PAPA GIOVANNI XXIII,LOM,50-59,10,8,0,18,0,0,0,18,0,18,Lombardia,ITC4
2020-12-27,PF/BT,30718,ASST PAPA GIOVANNI XXIII,LOM,60-69,9,3,0,12,0,0,0,12,0,12,Lombardia,ITC4
2020-12-27,PF/BT,30909,ASST -  MONZA,LOM,20-29,0,1,0,1,0,0,0,1,0,1,Lombardia,ITC4
2020-12-27,PF/BT,30909,ASST -  MONZA,LOM,30-39,1,1,0,2,0,0,0,2,0,2,Lombardia,ITC4
2020-12-27,PF/BT,30909,ASST -  MONZA,LOM,40-49,5,8,0,13,0,0,0,13,0,13,Lombardia,ITC4
2020-12-27,PF/BT,30909,ASST -  MONZA,LOM,50-59,12,9,0,21,0,0,0,21,0,21,Lombardia,ITC4
2020-12-27,PF/BT,30909,ASST -  MONZA,LOM,60-69,8,3,0,11,0,0,0,11,0,11,Lombardia,ITC4
2020-12-27,PF/BT,30909,ASST -  MONZA,LOM,70-79,1,1,0,2,0,0,0,2,0,2,Lombardia,ITC4
2020-12-27,PF/BT,32271022,ambulatorio covid Varese,LOM,30-39,3,2,0,5,0,0,0,5,0,5,Lombardia,ITC4
2020-12-27,PF/BT,32271022,ambulatorio covid Varese,LOM,40-49,7,5,0,7,5,0,0,12,0,12,Lombardia,ITC4
2020-12-27,PF/BT,32271022,ambulatorio covid Varese,LOM,50-59,15,9,0,23,1,0,0,24,0,24,Lombardia,ITC4
2020-12-27,PF/BT,32271022,ambulatorio covid Varese,LOM,60-69,22,2,0,22,2,0,0,24,0,24,Lombardia,ITC4
2020-12-27,PF/BT,32271022,ambulatorio covid Varese,LOM,70-79,1,0,0,1,0,0,0,1,0,1,Lombardia,ITC4
2020-12-27,PF/BT,32271022,ambulatorio covid Varese,LOM,80-89,1,0,0,1,0,0,0,1,0,1,Lombardia,ITC4
2020-12-27,PF/BT,32572021,Ambulatorio COVID PO Alzano Lombardo,LOM,20-29,0,3,0,3,0,0,0,3,0,3,Lombardia,ITC4
2020-12-27,PF/BT,32572021,Ambulatorio COVID PO Alzano Lombardo,LOM,30-39,4,4,0,8,0,0,0,8,0,8,Lombardia,ITC4
2020-12-27,PF/BT,32572021,Ambulatorio COVID PO Alzano Lombardo,LOM,40-49,6,5,0,10,1,0,0,11,0,11,Lombardia,ITC4
2020-12-27,PF/BT,32572021,Ambulatorio COVID PO Alzano Lombardo,LOM,50-59,10,9,0,19,0,0,0,19,0,19,Lombardia,ITC4
2020-12-27,PF/BT,32572021,Ambulatorio COVID PO Alzano Lombardo,LOM,60-69,6,2,0,8,0,0,0,8,0,8,Lombardia,ITC4
2020-12-27,PF/BT,32572021,Ambulatorio COVID PO Alzano Lombardo,LOM,70-79,1,0,0,1,0,0,0,1,0,1,Lombardia,ITC4
2020-12-27,PF/BT,32672126,AMBULATORIO COVID BRESCIA,LOM,20-29,3,5,0,8,0,0,0,8,0,8,Lombardia,ITC4
2020-12-27,PF/BT,32672126,AMBULATORIO COVID BRESCIA,LOM,30-39,6,5,0,11,0,0,0,11,0,11,Lombardia,ITC4
2020-12-27,PF/BT,32672126,AMBULATORIO COVID BRESCIA,LOM,40-49,5,10,0,15,0,0,0,15,0,15,Lombardia,ITC4
2020-12-27,PF/BT,32672126,AMBULATORIO COVID BRESCIA,LOM,50-59,14,24,0,38,0,0,0,38,0,38,Lombardia,ITC4
2020-12-27,PF/BT,32672126,AMBULATORIO COVID BRESCIA,LOM,60-69,27,1,0,28,0,0,0,28,0,28,Lombardia,ITC4
2020-12-27,PF/BT,32772513,Ambulatorio COVID MANTOVA,LOM,16-19,37,13,0,50,0,0,0,50,0,50,Lombardia,ITC4
2020-12-27,PF/BT,32772513,ASST DI MANTOVA - POMA,LOM,30-39,2,2,0,4,0,0,0,4,0,4,Lombardia,ITC4
2020-12-27,PF/BT,32772513,ASST DI MANTOVA - POMA,LOM,40-49,6,0,0,6,0,0,0,6,0,6,Lombardia,ITC4
2020-12-27,PF/BT,32772513,ASST DI MANTOVA - POMA,LOM,50-59,14,5,0,19,0,0,0,19,0,19,Lombardia,ITC4
2020-12-27,PF/BT,32772513,ASST DI MANTOVA - POMA,LOM,60-69,13,4,0,17,0,0,0,17,0,17,Lombardia,ITC4
2020-12-27,PF/BT,32772513,ASST DI MANTOVA - POMA,LOM,70-79,3,1,0,4,0,0,0,4,0,4,Lombardia,ITC4
2020-12-27,PF/BT,STS11,Ambulatorio COVID PO Codogno,LOM,20-29,1,1,0,2,0,0,0,2,0,2,Lombardia,ITC4
2020-12-27,PF/BT,STS11,Ambulatorio COVID PO Codogno,LOM,30-39,2,0,0,2,0,0,0,2,0,2,Lombardia,ITC4
2020-12-27,PF/BT,STS11,Ambulatorio COVID PO Codogno,LOM,40-49,1,8,0,9,0,0,0,9,0,9,Lombardia,ITC4
2020-12-27,PF/BT,STS11,Ambulatorio COVID PO Codogno,LOM,50-59,11,12,0,23,0,0,0,23,0,23,Lombardia,ITC4
2020-12-27,PF/BT,STS11,Ambulatorio COVID PO Codogno,LOM,60-69,11,3,0,14,0,0,0,14,0,14,Lombardia,ITC4
2020-12-28,PF/BT,30701,ASST GRANDE OSPEDALE METROPOLITANO NIGUARDA,LOM,20-29,17,17,0,28,1,0,5,34,0,34,Lombardia,ITC4
2020-12-28,PF/BT,30701,ASST GRANDE OSPEDALE METROPOLITANO NIGUARDA,LOM,30-39,31,47,0,67,9,0,2,78,0,78,Lombardia,ITC4
2020-12-28,PF/BT,30701,ASST GRANDE OSPEDALE METROPOLITANO NIGUARDA,LOM,40-49,31,43,0,65,6,0,3,74,0,74,Lombardia,ITC4
2020-12-28,PF/BT,30701,ASST GRANDE OSPEDALE METROPOLITANO NIGUARDA,LOM,50-59,31,41,0,58,13,0,1,72,0,72,Lombardia,ITC4
2020-12-28,PF/BT,30701,ASST GRANDE OSPEDALE METROPOLITANO NIGUARDA,LOM,60-69,17,16,0,21,7,0,5,33,0,33,Lombardia,ITC4
2020-12-28,PF/BT,HSP11-11bis - 703,AMBULATORIO OSPEDALE SACCO,LOM,20-29,3,3,0,6,0,0,0,6,0,6,Lombardia,ITC4
2020-12-28,PF/BT,HSP11-11bis - 703,AMBULATORIO OSPEDALE SACCO,LOM,30-39,8,11,0,19,0,0,0,19,0,19,Lombardia,ITC4
2020-12-28,PF/BT,HSP11-11bis - 703,AMBULATORIO OSPEDALE SACCO,LOM,40-49,9,18,0,27,0,0,0,27,0,27,Lombardia,ITC4
2020-12-28,PF/BT,HSP11-11bis - 703,AMBULATORIO OSPEDALE SACCO,LOM,50-59,16,19,0,34,1,0,0,35,0,35,Lombardia,ITC4
2020-12-28,PF/BT,HSP11-11bis - 703,AMBULATORIO OSPEDALE SACCO,LOM,60-69,8,5,0,13,0,0,0,13,0,13,Lombardia,ITC4
2020-12-29,PF/BT,30701,ASST GRANDE OSPEDALE METROPOLITANO NIGUARDA,LOM,16-19,1,0,0,0,1,0,0,1,0,1,Lombardia,ITC4
2020-12-29,PF/BT,30701,ASST GRANDE OSPEDALE METROPOLITANO NIGUARDA,LOM,20-29,13,14,0,26,0,0,1,27,0,27,Lombardia,ITC4
2020-12-29,PF/BT,30701,ASST GRANDE OSPEDALE METROPOLITANO NIGUARDA,LOM,30-39,32,47,0,73,6,0,0,79,0,79,Lombardia,ITC4
2020-12-29,PF/BT,30701,ASST GRANDE OSPEDALE METROPOLITANO NIGUARDA,LOM,40-49,27,44,0,60,11,0,0,71,0,71,Lombardia,ITC4
2020-12-29,PF/BT,30701,ASST GRANDE OSPEDALE METROPOLITANO NIGUARDA,LOM,50-59,28,67,0,63,30,0,2,95,0,95,Lombardia,ITC4
2020-12-29,PF/BT,30701,ASST GRANDE OSPEDALE METROPOLITANO NIGUARDA,LOM,60-69,28,15,0,35,5,0,3,43,0,43,Lombardia,ITC4
2020-12-29,PF/BT,HSP11-11bis - 703,AMBULATORIO OSPEDALE SACCO,LOM,20-29,1,8,0,9,0,0,0,9,0,9,Lombardia,ITC4
2020-12-29,PF/BT,HSP11-11bis - 703,AMBULATORIO OSPEDALE SACCO,LOM,30-39,15,15,0,30,0,0,0,30,0,30,Lombardia,ITC4
2020-12-29,PF/BT,HSP11-11bis - 703,AMBULATORIO OSPEDALE SACCO,LOM,40-49,11,17,0,28,0,0,0,28,0,28,Lombardia,ITC4
2020-12-29,PF/BT,HSP11-11bis - 703,AMBULATORIO OSPEDALE SACCO,LOM,50-59,9,13,0,22,0,0,0,22,0,22,Lombardia,ITC4
2020-12-29,PF/BT,HSP11-11bis - 703,AMBULATORIO OSPEDALE SACCO,LOM,60-69,7,4,0,11,0,0,0,11,0,11,Lombardia,ITC4
2020-12-30,PF/BT,030706,CV Garbagnate Milanese,LOM,40-49,2,0,0,2,0,0,0,2,0,2,Lombardia,ITC4
2020-12-30,PF/BT,030706,CV Garbagnate Milanese,LOM,50-59,3,1,0,1,3,0,0,4,0,4,Lombardia,ITC4
2020-12-30,PF/BT,30701,ASST GRANDE OSPEDALE METROPOLITANO NIGUARDA,LOM,20-29,1,3,0,1,1,0,2,4,0,4,Lombardia,ITC4
2020-12-30,PF/BT,30701,ASST GRANDE OSPEDALE METROPOLITANO NIGUARDA,LOM,30-39,0,2,0,0,1,0,1,2,0,2,Lombardia,ITC4
2020-12-30,PF/BT,30701,ASST GRANDE OSPEDALE METROPOLITANO NIGUARDA,LOM,50-59,1,5,0,5,1,0,0,6,0,6,Lombardia,ITC4
2020-12-30,PF/BT,30701,ASST GRANDE OSPEDALE METROPOLITANO NIGUARDA,LOM,60-69,0,2,0,1,1,0,0,2,0,2,Lombardia,ITC4
2020-12-30,PF/BT,32271022,ambulatorio covid Varese,LOM,20-29,3,9,0,12,0,0,0,12,0,12,Lombardia,ITC4
2020-12-30,PF/BT,32271022,ambulatorio covid Varese,LOM,30-39,7,17,0,24,0,0,0,24,0,24,Lombardia,ITC4
2020-12-30,PF/BT,32271022,ambulatorio covid Varese,LOM,40-49,5,14,0,19,0,0,0,19,0,19,Lombardia,ITC4
2020-12-30,PF/BT,32271022,ambulatorio covid Varese,LOM,50-59,7,13,0,20,0,0,0,20,0,20,Lombardia,ITC4
2020-12-30,PF/BT,32271022,ambulatorio covid Varese,LOM,60-69,2,1,0,3,0,0,0,3,0,3,Lombardia,ITC4
2020-12-30,PF/BT,HSP11-11bis - 703,AMBULATORIO OSPEDALE SACCO,LOM,30-39,3,6,0,9,0,0,0,9,0,9,Lombardia,ITC4
2020-12-30,PF/BT,HSP11-11bis - 703,AMBULATORIO OSPEDALE SACCO,LOM,40-49,3,3,0,6,0,0,0,6,0,6,Lombardia,ITC4
2020-12-30,PF/BT,HSP11-11bis - 703,AMBULATORIO OSPEDALE SACCO,LOM,50-59,5,6,0,11,0,0,0,11,0,11,Lombardia,ITC4
2020-12-30,PF/BT,HSP11-11bis - 703,AMBULATORIO OSPEDALE SACCO,LOM,60-69,2,2,0,4,0,0,0,4,0,4,Lombardia,ITC4
2020-12-31,PF/BT,0,Fondazione IRCCS Ca' Granda Ospedale Maggiore Policlinico,LOM,20-29,3,4,0,7,0,0,0,7,0,7,Lombardia,ITC4
2020-12-31,PF/BT,0,Fondazione IRCCS Ca' Granda Ospedale Maggiore Policlinico,LOM,30-39,6,6,0,12,0,0,0,12,0,12,Lombardia,ITC4
2020-12-31,PF/BT,0,Fondazione IRCCS Ca' Granda Ospedale Maggiore Policlinico,LOM,40-49,2,8,0,10,0,0,0,10,0,10,Lombardia,ITC4
2020-12-31,PF/BT,0,Fondazione IRCCS Ca' Granda Ospedale Maggiore Policlinico,LOM,50-59,10,2,0,12,0,0,0,12,0,12,Lombardia,ITC4
2020-12-31,PF/BT,0,Fondazione IRCCS Ca' Granda Ospedale Maggiore Policlinico,LOM,60-69,6,1,0,7,0,0,0,7,0,7,Lombardia,ITC4
2020-12-31,PF/BT,0,HUB COVID MAGENTA,LOM,30-39,1,3,0,3,1,0,0,4,0,4,Lombardia,ITC4
2020-12-31,PF/BT,0,HUB COVID MAGENTA,LOM,40-49,2,8,0,8,2,0,0,10,0,10,Lombardia,ITC4
2020-12-31,PF/BT,0,HUB COVID MAGENTA,LOM,50-59,6,16,0,21,1,0,0,22,0,22,Lombardia,ITC4
2020-12-31,PF/BT,0,HUB COVID MAGENTA,LOM,60-69,2,3,0,5,0,0,0,5,0,5,Lombardia,ITC4
2020-12-31,PF/BT,0,HUB LEGNANO,LOM,30-39,1,6,0,6,1,0,0,7,0,7,Lombardia,ITC4
2020-12-31,PF/BT,0,HUB LEGNANO,LOM,40-49,3,8,0,9,2,0,0,11,0,11,Lombardia,ITC4
2020-12-31,PF/BT,0,HUB LEGNANO,LOM,50-59,6,16,0,21,1,0,0,22,0,22,Lombardia,ITC4
2020-12-31,PF/BT,0,HUB LEGNANO,LOM,60-69,2,3,0,5,0,0,0,5,0,5,Lombardia,ITC4
2020-12-31,PF/BT,030078,PUNTO VACCINALE OSPEDALIERO VIMERCATE,LOM,20-29,0,1,0,1,0,0,0,1,0,1,Lombardia,ITC4
2020-12-31,PF/BT,030078,PUNTO VACCINALE OSPEDALIERO VIMERCATE,LOM,30-39,2,0,0,2,0,0,0,2,0,2,Lombardia,ITC4
2020-12-31,PF/BT,030078,PUNTO VACCINALE OSPEDALIERO VIMERCATE,LOM,40-49,1,2,0,2,1,0,0,3,0,3,Lombardia,ITC4
2020-12-31,PF/BT,030078,PUNTO VACCINALE OSPEDALIERO VIMERCATE,LOM,50-59,6,6,0,11,1,0,0,12,0,12,Lombardia,ITC4
2020-12-31,PF/BT,030078,PUNTO VACCINALE OSPEDALIERO VIMERCATE,LOM,60-69,5,1,0,5,1,0,0,6,0,6,Lombardia,ITC4
2020-12-31,PF/BT,030706,CV Garbagnate Milanese,LOM,30-39,2,0,0,2,0,0,0,2,0,2,Lombardia,ITC4
2020-12-31,PF/BT,030706,CV Garbagnate Milanese,LOM,40-49,8,9,0,17,0,0,0,17,0,17,Lombardia,ITC4
2020-12-31,PF/BT,030706,CV Garbagnate Milanese,LOM,50-59,8,14,0,22,0,0,0,22,0,22,Lombardia,ITC4
2020-12-31,PF/BT,030706,CV Garbagnate Milanese,LOM,60-69,8,2,0,10,0,0,0,10,0,10,Lombardia,ITC4
2020-12-31,PF/BT,030903,AMB COVID LECCO,LOM,30-39,1,6,0,5,2,0,0,7,0,7,Lombardia,ITC4
2020-12-31,PF/BT,030903,AMB COVID LECCO,LOM,40-49,0,6,0,6,0,0,0,6,0,6,Lombardia,ITC4
2020-12-31,PF/BT,030903,AMB COVID LECCO,LOM,50-59,2,13,0,12,3,0,0,15,0,15,Lombardia,ITC4
2020-12-31,PF/BT,030903,AMB COVID LECCO,LOM,60-69,2,0,0,2,0,0,0,2,0,2,Lombardia,ITC4
2020-12-31,PF/BT,030923,FOND.IRCCS IST.NAZ.NEUROLOGICO C.BESTA-M,LOM,30-39,2,2,0,1,3,0,0,4,0,4,Lombardia,ITC4
2020-12-31,PF/BT,030923,FOND.IRCCS IST.NAZ.NEUROLOGICO C.BESTA-M,LOM,40-49,4,6,0,7,3,0,0,10,0,10,Lombardia,ITC4
2020-12-31,PF/BT,030923,FOND.IRCCS IST.NAZ.NEUROLOGICO C.BESTA-M,LOM,50-59,5,4,0,8,1,0,0,9,0,9,Lombardia,ITC4
2020-12-31,PF/BT,030923,FOND.IRCCS IST.NAZ.NEUROLOGICO C.BESTA-M,LOM,60-69,4,3,0,6,1,0,0,7,0,7,Lombardia,ITC4
2020-12-31,PF/BT,30209,OSPEDALE MAGGIORE DI CREMA,LOM,20-29,1,4,0,5,0,0,0,5,0,5,Lombardia,ITC4
2020-12-31,PF/BT,30209,OSPEDALE MAGGIORE DI CREMA,LOM,30-39,3,7,0,10,0,0,0,10,0,10,Lombardia,ITC4
2020-12-31,PF/BT,30209,OSPEDALE MAGGIORE DI CREMA,LOM,40-49,0,6,0,6,0,0,0,6,0,6,Lombardia,ITC4
2020-12-31,PF/BT,30209,OSPEDALE MAGGIORE DI CREMA,LOM,50-59,6,12,0,17,1,0,0,18,0,18,Lombardia,ITC4
2020-12-31,PF/BT,30209,OSPEDALE MAGGIORE DI CREMA,LOM,60-69,9,0,0,9,0,0,0,9,0,9,Lombardia,ITC4
2020-12-31,PF/BT,30902,Ospedale S.Anna - Como,LOM,20-29,10,13,0,23,0,0,0,23,0,23,Lombardia,ITC4
2020-12-31,PF/BT,30902,Ospedale S.Anna - Como,LOM,30-39,17,17,0,34,0,0,0,34,0,34,Lombardia,ITC4
2020-12-31,PF/BT,30902,Ospedale S.Anna - Como,LOM,40-49,15,24,0,39,0,0,0,39,0,39,Lombardia,ITC4
2020-12-31,PF/BT,30902,Ospedale S.Anna - Como,LOM,50-59,12,30,0,42,0,0,0,42,0,42,Lombardia,ITC4
2020-12-31,PF/BT,30902,Ospedale S.Anna - Como,LOM,60-69,6,6,0,12,0,0,0,12,0,12,Lombardia,ITC4
2020-12-31,PF/BT,32271022,ambulatorio covid Varese,LOM,20-29,4,6,0,10,0,0,0,10,0,10,Lombardia,ITC4
2020-12-31,PF/BT,32271022,ambulatorio covid Varese,LOM,30-39,4,15,0,19,0,0,0,19,0,19,Lombardia,ITC4
2020-12-31,PF/BT,32271022,ambulatorio covid Varese,LOM,40-49,13,14,0,26,1,0,0,27,0,27,Lombardia,ITC4
2020-12-31,PF/BT,32271022,ambulatorio covid Varese,LOM,50-59,6,11,0,17,0,0,0,17,0,17,Lombardia,ITC4
2020-12-31,PF/BT,32271022,ambulatorio covid Varese,LOM,60-69,3,2,0,5,0,0,0,5,0,5,Lombardia,ITC4
2020-12-31,PF/BT,32471613,amb covid monza,LOM,20-29,2,0,0,2,0,0,0,2,0,2,Lombardia,ITC4
2020-12-31,PF/BT,32471613,amb covid monza,LOM,30-39,13,13,0,26,0,0,0,26,0,26,Lombardia,ITC4
2020-12-31,PF/BT,32471613,amb covid monza,LOM,40-49,8,15,0,23,0,0,0,23,0,23,Lombardia,ITC4
2020-12-31,PF/BT,32471613,amb covid monza,LOM,50-59,17,25,0,42,0,0,0,42,0,42,Lombardia,ITC4
2020-12-31,PF/BT,32471613,amb covid monza,LOM,60-69,6,2,0,8,0,0,0,8,0,8,Lombardia,ITC4
2020-12-31,PF/BT,32471613,amb covid monza,LOM,70-79,1,0,0,1,0,0,0,1,0,1,Lombardia,ITC4
2020-12-31,PF/BT,HSP11-11bis - 703,AMBULATORIO OSPEDALE SACCO,LOM,20-29,2,8,0,10,0,0,0,10,0,10,Lombardia,ITC4
2020-12-31,PF/BT,HSP11-11bis - 703,AMBULATORIO OSPEDALE SACCO,LOM,30-39,12,14,0,26,0,0,0,26,0,26,Lombardia,ITC4
2020-12-31,PF/BT,HSP11-11bis - 703,AMBULATORIO OSPEDALE SACCO,LOM,40-49,4,6,0,10,0,0,0,10,0,10,Lombardia,ITC4
2020-12-31,PF/BT,HSP11-11bis - 703,AMBULATORIO OSPEDALE SACCO,LOM,50-59,5,10,0,15,0,0,0,15,0,15,Lombardia,ITC4
2020-12-31,PF/BT,HSP11-11bis - 703,AMBULATORIO OSPEDALE SACCO,LOM,60-69,1,4,0,5,0,0,0,5,0,5,Lombardia,ITC4
2021-01-01,PF/BT,030943,Istituto Clinico Humanitas,LOM,20-29,0,2,0,2,0,0,0,2,0,2,Lombardia,ITC4
2021-01-01,PF/BT,030943,Istituto Clinico Humanitas,LOM,30-39,2,3,0,5,0,0,0,5,0,5,Lombardia,ITC4
2021-01-01,PF/BT,030943,Istituto Clinico Humanitas,LOM,40-49,0,6,0,6,0,0,0,6,0,6,Lombardia,ITC4
2021-01-01,PF/BT,030943,Istituto Clinico Humanitas,LOM,50-59,3,5,0,8,0,0,0,8,0,8,Lombardia,ITC4
2021-01-01,PF/BT,030943,Istituto Clinico Humanitas,LOM,60-69,1,1,0,2,0,0,0,2,0,2,Lombardia,ITC4
2021-01-01,PF/BT,030943,Istituto Clinico Humanitas,LOM,70-79,1,0,0,1,0,0,0,1,0,1,Lombardia,ITC4
2021-01-02,PF/BT,030706,CV Garbagnate Milanese,LOM,30-39,1,4,0,4,1,0,0,5,0,5,Lombardia,ITC4
2021-01-02,PF/BT,030706,CV Garbagnate Milanese,LOM,40-49,5,16,0,21,0,0,0,21,0,21,Lombardia,ITC4
2021-01-02,PF/BT,030706,CV Garbagnate Milanese,LOM,50-59,9,6,0,15,0,0,0,15,0,15,Lombardia,ITC4
2021-01-02,PF/BT,030706,CV Garbagnate Milanese,LOM,60-69,6,3,0,9,0,0,0,9,0,9,Lombardia,ITC4
2021-01-02,PF/BT,30209,OSPEDALE MAGGIORE DI CREMA,LOM,20-29,2,0,0,2,0,0,0,2,0,2,Lombardia,ITC4
2021-01-02,PF/BT,30209,OSPEDALE MAGGIORE DI CREMA,LOM,30-39,2,8,0,9,1,0,0,10,0,10,Lombardia,ITC4
2021-01-02,PF/BT,30209,OSPEDALE MAGGIORE DI CREMA,LOM,40-49,3,8,0,9,2,0,0,11,0,11,Lombardia,ITC4
2021-01-02,PF/BT,30209,OSPEDALE MAGGIORE DI CREMA,LOM,50-59,10,10,0,17,3,0,0,20,0,20,Lombardia,ITC4
2021-01-02,PF/BT,30209,OSPEDALE MAGGIORE DI CREMA,LOM,60-69,4,1,0,4,1,0,0,5,0,5,Lombardia,ITC4
2021-01-02,PF/BT,32271022,ambulatorio covid Varese,LOM,20-29,7,23,0,30,0,0,0,30,0,30,Lombardia,ITC4
2021-01-02,PF/BT,32271022,ambulatorio covid Varese,LOM,30-39,12,14,0,26,0,0,0,26,0,26,Lombardia,ITC4
2021-01-02,PF/BT,32271022,ambulatorio covid Varese,LOM,40-49,5,16,0,21,0,0,0,21,0,21,Lombardia,ITC4
2021-01-02,PF/BT,32271022,ambulatorio covid Varese,LOM,50-59,2,14,0,16,0,0,0,16,0,16,Lombardia,ITC4
2021-01-02,PF/BT,32271022,ambulatorio covid Varese,LOM,60-69,6,3,0,9,0,0,0,9,0,9,Lombardia,ITC4
2021-01-03,PF/BT,000293,IRCCS MultiMedica,LOM,20-29,3,4,0,7,0,0,0,7,0,7,Lombardia,ITC4
2021-01-03,PF/BT,000293,IRCCS MultiMedica,LOM,30-39,8,9,0,16,1,0,0,17,0,17,Lombardia,ITC4
2021-01-03,PF/BT,000293,IRCCS MultiMedica,LOM,40-49,11,18,0,26,3,0,0,29,0,29,Lombardia,ITC4
2021-01-03,PF/BT,000293,IRCCS MultiMedica,LOM,50-59,14,13,0,27,0,0,0,27,0,27,Lombardia,ITC4
2021-01-03,PF/BT,000293,IRCCS MultiMedica,LOM,60-69,7,3,0,8,2,0,0,10,0,10,Lombardia,ITC4
2021-01-03,PF/BT,000293,IRCCS MultiMedica,LOM,70-79,5,0,0,5,0,0,0,5,0,5,Lombardia,ITC4
2021-01-03,PF/BT,000293,IRCCS MultiMedica,LOM,80-89,1,0,0,1,0,0,0,1,0,1,Lombardia,ITC4
2021-01-03,PF/BT,000417,POLIAMBULATORIO IRCCS OSPEDALE,LOM,20-29,0,2,0,2,0,0,0,2,0,2,Lombardia,ITC4
2021-01-03,PF/BT,000417,POLIAMBULATORIO IRCCS OSPEDALE,LOM,40-49,0,2,0,2,0,0,0,2,0,2,Lombardia,ITC4
2021-01-03,PF/BT,000417,POLIAMBULATORIO IRCCS OSPEDALE,LOM,50-59,0,2,0,2,0,0,0,2,0,2,Lombardia,ITC4
2021-01-03,PF/BT,000500,RSA MONSIGNOR BICCHIERAI 2,LOM,80-89,0,2,0,0,0,2,0,2,0,2,Lombardia,ITC4
2021-01-03,PF/BT,000500,RSA MONSIGNOR BICCHIERAI 2,LOM,90+,0,1,0,0,0,1,0,1,0,1,Lombardia,ITC4
2021-01-03,PF/BT,000542,RSA MONSIGNOR BICCHIERAI 1,LOM,20-29,1,2,0,3,0,0,0,3,0,3,Lombardia,ITC4
2021-01-03,PF/BT,000542,RSA MONSIGNOR BICCHIERAI 1,LOM,30-39,0,1,0,1,0,0,0,1,0,1,Lombardia,ITC4
2021-01-03,PF/BT,000542,RSA MONSIGNOR BICCHIERAI 1,LOM,40-49,0,1,0,1,0,0,0,1,0,1,Lombardia,ITC4
2021-01-03,PF/BT,000542,RSA MONSIGNOR BICCHIERAI 1,LOM,50-59,1,7,0,8,0,0,0,8,0,8,Lombardia,ITC4
2021-01-03,PF/BT,000542,RSA MONSIGNOR BICCHIERAI 1,LOM,90+,0,1,0,0,0,1,0,1,0,1,Lombardia,ITC4
2021-01-03,PF/BT,030074,HUB COVID MAGENTA,LOM,30-39,3,6,0,9,0,0,0,9,0,9,Lombardia,ITC4
2021-01-03,PF/BT,030074,HUB COVID MAGENTA,LOM,40-49,1,7,0,8,0,0,0,8,0,8,Lombardia,ITC4
2021-01-03,PF/BT,030074,HUB COVID MAGENTA,LOM,50-59,2,10,0,12,0,0,0,12,0,12,Lombardia,ITC4
2021-01-03,PF/BT,030074,HUB COVID MAGENTA,LOM,60-69,4,7,0,11,0,0,0,11,0,11,Lombardia,ITC4
2021-01-03,PF/BT,30072,Centro Vaccinale Covid Vizzolo - ASST Melegnano Martesana,LOM,20-29,2,1,0,3,0,0,0,3,0,3,Lombardia,ITC4
2021-01-03,PF/BT,30072,Centro Vaccinale Covid Vizzolo - ASST Melegnano Martesana,LOM,30-39,0,3,0,3,0,0,0,3,0,3,Lombardia,ITC4
2021-01-03,PF/BT,30072,Centro Vaccinale Covid Vizzolo - ASST Melegnano Martesana,LOM,40-49,4,8,0,12,0,0,0,12,0,12,Lombardia,ITC4
2021-01-03,PF/BT,30072,Centro Vaccinale Covid Vizzolo - ASST Melegnano Martesana,LOM,50-59,4,18,0,22,0,0,0,22,0,22,Lombardia,ITC4
2021-01-03,PF/BT,30072,Centro Vaccinale Covid Vizzolo - ASST Melegnano Martesana,LOM,60-69,4,2,0,6,0,0,0,6,0,6,Lombardia,ITC4
2021-01-03,PF/BT,30072,Centro Vaccinale Covid Vizzolo - ASST Melegnano Martesana,LOM,70-79,1,0,0,1,0,0,0,1,0,1,Lombardia,ITC4
2021-01-03,PF/BT,30074,HUB COVID LEGNANO,LOM,20-29,0,5,0,5,0,0,0,5,0,5,Lombardia,ITC4
2021-01-03,PF/BT,30074,HUB COVID LEGNANO,LOM,30-39,4,8,0,12,0,0,0,12,0,12,Lombardia,ITC4
2021-01-03,PF/BT,30074,HUB COVID LEGNANO,LOM,40-49,1,10,0,11,0,0,0,11,0,11,Lombardia,ITC4
2021-01-03,PF/BT,30074,HUB COVID LEGNANO,LOM,50-59,5,10,0,15,0,0,0,15,0,15,Lombardia,ITC4
2021-01-03,PF/BT,30074,HUB COVID LEGNANO,LOM,60-69,1,1,0,1,1,0,0,2,0,2,Lombardia,ITC4
2021-01-03,PF/BT,30902,Ospedale S.Anna - Como,LOM,20-29,10,14,0,24,0,0,0,24,0,24,Lombardia,ITC4
2021-01-03,PF/BT,30902,Ospedale S.Anna - Como,LOM,30-39,17,19,0,36,0,0,0,36,0,36,Lombardia,ITC4
2021-01-03,PF/BT,30902,Ospedale S.Anna - Como,LOM,40-49,19,29,0,47,1,0,0,48,0,48,Lombardia,ITC4
2021-01-03,PF/BT,30902,Ospedale S.Anna - Como,LOM,50-59,22,65,0,83,4,0,0,87,0,87,Lombardia,ITC4
2021-01-03,PF/BT,30902,Ospedale S.Anna - Como,LOM,60-69,11,16,0,26,1,0,0,27,0,27,Lombardia,ITC4
2021-01-03,PF/BT,30909,amb covid monza,LOM,20-29,1,6,0,7,0,0,0,7,0,7,Lombardia,ITC4
2021-01-03,PF/BT,30909,amb covid monza,LOM,30-39,6,12,0,17,1,0,0,18,0,18,Lombardia,ITC4
2021-01-03,PF/BT,30909,amb covid monza,LOM,40-49,7,15,0,20,2,0,0,22,0,22,Lombardia,ITC4
2021-01-03,PF/BT,30909,amb covid monza,LOM,50-59,17,20,0,32,5,0,0,37,0,37,Lombardia,ITC4
2021-01-03,PF/BT,30909,amb covid monza,LOM,60-69,14,10,0,22,2,0,0,24,0,24,Lombardia,ITC4
2021-01-03,PF/BT,30935,IRCCS    S. RAFFAELE - MILANO,LOM,20-29,4,17,0,21,0,0,0,21,0,21,Lombardia,ITC4
2021-01-03,PF/BT,30935,IRCCS    S. RAFFAELE - MILANO,LOM,30-39,1,8,0,9,0,0,0,9,0,9,Lombardia,ITC4
2021-01-03,PF/BT,30935,IRCCS    S. RAFFAELE - MILANO,LOM,40-49,3,7,0,10,0,0,0,10,0,10,Lombardia,ITC4
2021-01-03,PF/BT,30935,IRCCS    S. RAFFAELE - MILANO,LOM,50-59,0,10,0,10,0,0,0,10,0,10,Lombardia,ITC4
2021-01-03,PF/BT,30935,IRCCS    S. RAFFAELE - MILANO,LOM,60-69,0,1,0,1,0,0,0,1,0,1,Lombardia,ITC4
2021-01-03,PF/BT,HPS11/11bis,ASST SPEDALICIVILI AMBULATORIO COVID BRESCIA,LOM,20-29,2,21,0,23,0,0,0,23,0,23,Lombardia,ITC4
2021-01-03,PF/BT,HPS11/11bis,ASST SPEDALICIVILI AMBULATORIO COVID BRESCIA,LOM,30-39,31,20,0,51,0,0,0,51,0,51,Lombardia,ITC4
2021-01-03,PF/BT,HPS11/11bis,ASST SPEDALICIVILI AMBULATORIO COVID BRESCIA,LOM,40-49,9,15,0,24,0,0,0,24,0,24,Lombardia,ITC4
2021-01-03,PF/BT,HPS11/11bis,ASST SPEDALICIVILI AMBULATORIO COVID BRESCIA,LOM,50-59,16,26,0,41,1,0,0,42,0,42,Lombardia,ITC4
2021-01-03,PF/BT,HPS11/11bis,ASST SPEDALICIVILI AMBULATORIO COVID BRESCIA,LOM,60-69,4,5,0,9,0,0,0,9,0,9,Lombardia,ITC4
2021-01-03,PF/BT,HSP11-11bis,ASST BERGAMO OVEST - OSPEDALE TREVIGLIO,LOM,20-29,0,1,0,1,0,0,0,1,0,1,Lombardia,ITC4
2021-01-03,PF/BT,HSP11-11bis,ASST BERGAMO OVEST - OSPEDALE TREVIGLIO,LOM,30-39,3,3,0,6,0,0,0,6,0,6,Lombardia,ITC4
2021-01-03,PF/BT,HSP11-11bis,ASST BERGAMO OVEST - OSPEDALE TREVIGLIO,LOM,40-49,3,9,0,11,1,0,0,12,0,12,Lombardia,ITC4
2021-01-03,PF/BT,HSP11-11bis,ASST BERGAMO OVEST - OSPEDALE TREVIGLIO,LOM,50-59,6,13,0,16,3,0,0,19,0,19,Lombardia,ITC4
2021-01-03,PF/BT,HSP11-11bis,ASST BERGAMO OVEST - OSPEDALE TREVIGLIO,LOM,60-69,18,4,0,22,0,0,0,22,0,22,Lombardia,ITC4
2021-01-04,PF/BT,.030042,ASST - Presidio Ospedaliero di Sondrio,LOM,20-29,3,1,0,4,0,0,0,4,0,4,Lombardia,ITC4
2021-01-04,PF/BT,.030042,ASST - Presidio Ospedaliero di Sondrio,LOM,30-39,6,7,0,11,2,0,0,13,0,13,Lombardia,ITC4
2021-01-04,PF/BT,.030042,ASST - Presidio Ospedaliero di Sondrio,LOM,40-49,9,12,0,19,2,0,0,21,0,21,Lombardia,ITC4
2021-01-04,PF/BT,.030042,ASST - Presidio Ospedaliero di Sondrio,LOM,50-59,8,20,0,18,10,0,0,28,0,28,Lombardia,ITC4
2021-01-04,PF/BT,.030042,ASST - Presidio Ospedaliero di Sondrio,LOM,60-69,5,1,0,6,0,0,0,6,0,6,Lombardia,ITC4
2021-01-04,PF/BT,0,cv rho,LOM,20-29,0,2,0,2,0,0,0,2,0,2,Lombardia,ITC4
2021-01-04,PF/BT,0,cv rho,LOM,30-39,2,5,0,6,1,0,0,7,0,7,Lombardia,ITC4
2021-01-04,PF/BT,0,cv rho,LOM,40-49,1,16,0,17,0,0,0,17,0,17,Lombardia,ITC4
2021-01-04,PF/BT,0,cv rho,LOM,50-59,4,20,0,23,1,0,0,24,0,24,Lombardia,ITC4
2021-01-04,PF/BT,0,cv rho,LOM,60-69,3,5,0,8,0,0,0,8,0,8,Lombardia,ITC4
2021-01-04,PF/BT,000542,RSA MONSIGNOR BICCHIERAI 1,LOM,30-39,0,2,0,2,0,0,0,2,0,2,Lombardia,ITC4
2021-01-04,PF/BT,000542,RSA MONSIGNOR BICCHIERAI 1,LOM,40-49,1,4,0,5,0,0,0,5,0,5,Lombardia,ITC4
2021-01-04,PF/BT,000542,RSA MONSIGNOR BICCHIERAI 1,LOM,50-59,1,2,0,3,0,0,0,3,0,3,Lombardia,ITC4
2021-01-04,PF/BT,000542,RSA MONSIGNOR BICCHIERAI 1,LOM,60-69,2,0,0,2,0,0,0,2,0,2,Lombardia,ITC4
2021-01-04,PF/BT,000558,RSA PIO ALBERGO TRIVULZIO,LOM,20-29,4,10,0,11,3,0,0,14,0,14,Lombardia,ITC4
2021-01-04,PF/BT,000558,RSA PIO ALBERGO TRIVULZIO,LOM,30-39,17,11,0,24,4,0,0,28,0,28,Lombardia,ITC4
2021-01-04,PF/BT,000558,RSA PIO ALBERGO TRIVULZIO,LOM,40-49,3,12,0,12,3,0,0,15,0,15,Lombardia,ITC4
2021-01-04,PF/BT,000558,RSA PIO ALBERGO TRIVULZIO,LOM,50-59,8,25,0,24,9,0,0,33,0,33,Lombardia,ITC4
2021-01-04,PF/BT,000558,RSA PIO ALBERGO TRIVULZIO,LOM,60-69,5,10,0,9,2,4,0,15,0,15,Lombardia,ITC4
2021-01-04,PF/BT,000558,RSA PIO ALBERGO TRIVULZIO,LOM,70-79,7,22,0,1,0,28,0,29,0,29,Lombardia,ITC4
2021-01-04,PF/BT,000558,RSA PIO ALBERGO TRIVULZIO,LOM,80-89,15,59,0,0,0,74,0,74,0,74,Lombardia,ITC4
2021-01-04,PF/BT,000558,RSA PIO ALBERGO TRIVULZIO,LOM,90+,5,63,0,0,0,68,0,68,0,68,Lombardia,ITC4
2021-01-04,PF/BT,000577,Ospedale S. Giuseppe - MultiMedica,LOM,20-29,5,16,0,21,0,0,0,21,0,21,Lombardia,ITC4
2021-01-04,PF/BT,000577,Ospedale S. Giuseppe - MultiMedica,LOM,30-39,14,11,0,25,0,0,0,25,0,25,Lombardia,ITC4
2021-01-04,PF/BT,000577,Ospedale S. Giuseppe - MultiMedica,LOM,40-49,14,21,0,34,1,0,0,35,0,35,Lombardia,ITC4
2021-01-04,PF/BT,000577,Ospedale S. Giuseppe - MultiMedica,LOM,50-59,16,31,0,47,0,0,0,47,0,47,Lombardia,ITC4
2021-01-04,PF/BT,000577,Ospedale S. Giuseppe - MultiMedica,LOM,60-69,13,8,0,21,0,0,0,21,0,21,Lombardia,ITC4
2021-01-04,PF/BT,000577,Ospedale S. Giuseppe - MultiMedica,LOM,70-79,1,0,0,1,0,0,0,1,0,1,Lombardia,ITC4
2021-01-04,PF/BT,002987,POLIAMBULATORIO OSPEDALE ESINE,LOM,20-29,1,0,0,1,0,0,0,1,0,1,Lombardia,ITC4
2021-01-04,PF/BT,002987,POLIAMBULATORIO OSPEDALE ESINE,LOM,30-39,9,4,0,12,1,0,0,13,0,13,Lombardia,ITC4
2021-01-04,PF/BT,002987,POLIAMBULATORIO OSPEDALE ESINE,LOM,40-49,3,13,0,15,1,0,0,16,0,16,Lombardia,ITC4
2021-01-04,PF/BT,002987,POLIAMBULATORIO OSPEDALE ESINE,LOM,50-59,4,13,0,16,1,0,0,17,0,17,Lombardia,ITC4
2021-01-04,PF/BT,002987,POLIAMBULATORIO OSPEDALE ESINE,LOM,60-69,5,2,0,6,1,0,0,7,0,7,Lombardia,ITC4
2021-01-04,PF/BT,030066,CV Garbagnate,LOM,20-29,1,6,0,4,3,0,0,7,0,7,Lombardia,ITC4
2021-01-04,PF/BT,030066,CV Garbagnate,LOM,30-39,4,6,0,7,3,0,0,10,0,10,Lombardia,ITC4
2021-01-04,PF/BT,030066,CV Garbagnate,LOM,40-49,6,13,0,18,1,0,0,19,0,19,Lombardia,ITC4
2021-01-04,PF/BT,030066,CV Garbagnate,LOM,50-59,12,24,0,30,6,0,0,36,0,36,Lombardia,ITC4
2021-01-04,PF/BT,030066,CV Garbagnate,LOM,60-69,4,8,0,11,1,0,0,12,0,12,Lombardia,ITC4
2021-01-04,PF/BT,030068,PUNTO VACCINALE OSPEDALIERO DESIO,LOM,20-29,1,2,0,3,0,0,0,3,0,3,Lombardia,ITC4
2021-01-04,PF/BT,030068,PUNTO VACCINALE OSPEDALIERO DESIO,LOM,30-39,16,18,0,33,1,0,0,34,0,34,Lombardia,ITC4
2021-01-04,PF/BT,030068,PUNTO VACCINALE OSPEDALIERO DESIO,LOM,40-49,13,32,0,43,2,0,0,45,0,45,Lombardia,ITC4
2021-01-04,PF/BT,030068,PUNTO VACCINALE OSPEDALIERO DESIO,LOM,50-59,19,63,0,76,6,0,0,82,0,82,Lombardia,ITC4
2021-01-04,PF/BT,030068,PUNTO VACCINALE OSPEDALIERO DESIO,LOM,60-69,10,9,0,17,2,0,0,19,0,19,Lombardia,ITC4
2021-01-04,PF/BT,030070,PUNTO VACCINALE OSPEDALIERO CARATE BRIANZA,LOM,20-29,1,5,0,6,0,0,0,6,0,6,Lombardia,ITC4
2021-01-04,PF/BT,030070,PUNTO VACCINALE OSPEDALIERO CARATE BRIANZA,LOM,30-39,12,25,0,33,4,0,0,37,0,37,Lombardia,ITC4
2021-01-04,PF/BT,030070,PUNTO VACCINALE OSPEDALIERO CARATE BRIANZA,LOM,40-49,15,30,0,40,5,0,0,45,0,45,Lombardia,ITC4
2021-01-04,PF/BT,030070,PUNTO VACCINALE OSPEDALIERO CARATE BRIANZA,LOM,50-59,13,45,0,55,3,0,0,58,0,58,Lombardia,ITC4
2021-01-04,PF/BT,030070,PUNTO VACCINALE OSPEDALIERO CARATE BRIANZA,LOM,60-69,6,7,0,11,2,0,0,13,0,13,Lombardia,ITC4
2021-01-04,PF/BT,030074,HUB COVID MAGENTA,LOM,20-29,1,4,0,5,0,0,0,5,0,5,Lombardia,ITC4
2021-01-04,PF/BT,030074,HUB COVID MAGENTA,LOM,30-39,6,14,0,20,0,0,0,20,0,20,Lombardia,ITC4
2021-01-04,PF/BT,030074,HUB COVID MAGENTA,LOM,40-49,13,36,0,49,0,0,0,49,0,49,Lombardia,ITC4
2021-01-04,PF/BT,030074,HUB COVID MAGENTA,LOM,50-59,12,61,0,71,2,0,0,73,0,73,Lombardia,ITC4
2021-01-04,PF/BT,030074,HUB COVID MAGENTA,LOM,60-69,6,2,0,8,0,0,0,8,0,8,Lombardia,ITC4
2021-01-04,PF/BT,030078,PUNTO VACCINALE OSPEDALIERO VIMERCATE,LOM,20-29,4,25,0,28,1,0,0,29,0,29,Lombardia,ITC4
2021-01-04,PF/BT,030078,PUNTO VACCINALE OSPEDALIERO VIMERCATE,LOM,30-39,21,38,0,57,2,0,0,59,0,59,Lombardia,ITC4
2021-01-04,PF/BT,030078,PUNTO VACCINALE OSPEDALIERO VIMERCATE,LOM,40-49,22,44,0,62,4,0,0,66,0,66,Lombardia,ITC4
2021-01-04,PF/BT,030078,PUNTO VACCINALE OSPEDALIERO VIMERCATE,LOM,50-59,17,51,0,64,4,0,0,68,0,68,Lombardia,ITC4
2021-01-04,PF/BT,030078,PUNTO VACCINALE OSPEDALIERO VIMERCATE,LOM,60-69,10,7,0,13,4,0,0,17,0,17,Lombardia,ITC4
2021-01-04,PF/BT,030704,Presidio Ospedaliero G. Pini,LOM,20-29,0,1,0,1,0,0,0,1,0,1,Lombardia,ITC4
2021-01-04,PF/BT,030704,Presidio Ospedaliero G. Pini,LOM,30-39,5,1,0,6,0,0,0,6,0,6,Lombardia,ITC4
2021-01-04,PF/BT,030704,Presidio Ospedaliero G. Pini,LOM,40-49,1,1,0,1,1,0,0,2,0,2,Lombardia,ITC4
2021-01-04,PF/BT,030704,Presidio Ospedaliero G. Pini,LOM,50-59,2,1,0,3,0,0,0,3,0,3,Lombardia,ITC4
2021-01-04,PF/BT,030722,HUB COV CHIARI - ASST FRANCIACORTA,LOM,16-19,1,6,0,7,0,0,0,7,0,7,Lombardia,ITC4
2021-01-04,PF/BT,030722,HUB COV CHIARI - ASST FRANCIACORTA,LOM,20-29,14,56,0,59,1,0,10,70,0,70,Lombardia,ITC4
2021-01-04,PF/BT,030722,HUB COV CHIARI - ASST FRANCIACORTA,LOM,30-39,15,39,0,42,6,0,6,54,0,54,Lombardia,ITC4
2021-01-04,PF/BT,030722,HUB COV CHIARI - ASST FRANCIACORTA,LOM,40-49,17,57,0,60,5,0,9,74,0,74,Lombardia,ITC4
2021-01-04,PF/BT,030722,HUB COV CHIARI - ASST FRANCIACORTA,LOM,50-59,24,65,0,63,18,0,8,89,0,89,Lombardia,ITC4
2021-01-04,PF/BT,030722,HUB COV CHIARI - ASST FRANCIACORTA,LOM,60-69,9,11,0,14,1,0,5,20,0,20,Lombardia,ITC4
2021-01-04,PF/BT,030903,AMB COVID LECCO,LOM,20-29,1,11,0,10,2,0,0,12,0,12,Lombardia,ITC4
2021-01-04,PF/BT,030903,AMB COVID LECCO,LOM,30-39,19,32,0,47,4,0,0,51,0,51,Lombardia,ITC4
2021-01-04,PF/BT,030903,AMB COVID LECCO,LOM,40-49,9,56,0,51,11,0,3,65,0,65,Lombardia,ITC4
2021-01-04,PF/BT,030903,AMB COVID LECCO,LOM,50-59,18,65,0,71,8,0,4,83,0,83,Lombardia,ITC4
2021-01-04,PF/BT,030903,AMB COVID LECCO,LOM,60-69,13,9,0,20,2,0,0,22,0,22,Lombardia,ITC4
2021-01-04,PF/BT,030922,"FOND.IRCCS ""ISTIT.NAZ.LE TUMORI""MILANO",LOM,20-29,0,5,0,5,0,0,0,5,0,5,Lombardia,ITC4
2021-01-04,PF/BT,030922,"FOND.IRCCS ""ISTIT.NAZ.LE TUMORI""MILANO",LOM,30-39,6,6,0,12,0,0,0,12,0,12,Lombardia,ITC4
2021-01-04,PF/BT,030922,"FOND.IRCCS ""ISTIT.NAZ.LE TUMORI""MILANO",LOM,40-49,2,6,0,7,1,0,0,8,0,8,Lombardia,ITC4
2021-01-04,PF/BT,030922,"FOND.IRCCS ""ISTIT.NAZ.LE TUMORI""MILANO",LOM,50-59,9,18,0,24,3,0,0,27,0,27,Lombardia,ITC4
2021-01-04,PF/BT,030922,"FOND.IRCCS ""ISTIT.NAZ.LE TUMORI""MILANO",LOM,60-69,5,3,0,8,0,0,0,8,0,8,Lombardia,ITC4
2021-01-04,PF/BT,030923,FOND.IRCCS IST.NAZ.NEUROLOGICO C.BESTA-M,LOM,20-29,2,3,0,4,1,0,0,5,0,5,Lombardia,ITC4
2021-01-04,PF/BT,030923,FOND.IRCCS IST.NAZ.NEUROLOGICO C.BESTA-M,LOM,30-39,9,10,0,13,6,0,0,19,0,19,Lombardia,ITC4
2021-01-04,PF/BT,030923,FOND.IRCCS IST.NAZ.NEUROLOGICO C.BESTA-M,LOM,40-49,12,14,0,20,6,0,0,26,0,26,Lombardia,ITC4
2021-01-04,PF/BT,030923,FOND.IRCCS IST.NAZ.NEUROLOGICO C.BESTA-M,LOM,50-59,3,16,0,16,3,0,0,19,0,19,Lombardia,ITC4
2021-01-04,PF/BT,030923,FOND.IRCCS IST.NAZ.NEUROLOGICO C.BESTA-M,LOM,60-69,6,8,0,11,3,0,0,14,0,14,Lombardia,ITC4
2021-01-04,PF/BT,030924,IRCCS POLICLINICO S. MATTEO - PAVIA,LOM,30-39,4,7,0,11,0,0,0,11,0,11,Lombardia,ITC4
2021-01-04,PF/BT,030924,IRCCS POLICLINICO S. MATTEO - PAVIA,LOM,40-49,12,15,0,27,0,0,0,27,0,27,Lombardia,ITC4
2021-01-04,PF/BT,030924,IRCCS POLICLINICO S. MATTEO - PAVIA,LOM,50-59,8,29,0,37,0,0,0,37,0,37,Lombardia,ITC4
2021-01-04,PF/BT,030924,IRCCS POLICLINICO S. MATTEO - PAVIA,LOM,60-69,8,7,0,15,0,0,0,15,0,15,Lombardia,ITC4
2021-01-04,PF/BT,030943,Istituto Clinico Humanitas,LOM,20-29,25,21,0,46,0,0,0,46,0,46,Lombardia,ITC4
2021-01-04,PF/BT,030943,Istituto Clinico Humanitas,LOM,30-39,38,18,0,56,0,0,0,56,0,56,Lombardia,ITC4
2021-01-04,PF/BT,030943,Istituto Clinico Humanitas,LOM,40-49,25,32,0,57,0,0,0,57,0,57,Lombardia,ITC4
2021-01-04,PF/BT,030943,Istituto Clinico Humanitas,LOM,50-59,16,14,0,30,0,0,0,30,0,30,Lombardia,ITC4
2021-01-04,PF/BT,030943,Istituto Clinico Humanitas,LOM,60-69,13,0,0,13,0,0,0,13,0,13,Lombardia,ITC4
2021-01-04,PF/BT,030943,Istituto Clinico Humanitas,LOM,70-79,2,0,0,2,0,0,0,2,0,2,Lombardia,ITC4
2021-01-04,PF/BT,20,cv cremona,LOM,20-29,2,4,0,5,1,0,0,6,0,6,Lombardia,ITC4
2021-01-04,PF/BT,20,cv cremona,LOM,30-39,5,6,0,8,3,0,0,11,0,11,Lombardia,ITC4
2021-01-04,PF/BT,20,cv cremona,LOM,40-49,3,13,0,12,4,0,0,16,0,16,Lombardia,ITC4
2021-01-04,PF/BT,20,cv cremona,LOM,50-59,5,19,0,18,6,0,0,24,0,24,Lombardia,ITC4
2021-01-04,PF/BT,20,cv cremona,LOM,60-69,3,5,0,8,0,0,0,8,0,8,Lombardia,ITC4
2021-01-04,PF/BT,30071,Centro Vaccinale Covid Melzo - ASST Melegnano Martesana,LOM,30-39,2,2,0,4,0,0,0,4,0,4,Lombardia,ITC4
2021-01-04,PF/BT,30071,Centro Vaccinale Covid Melzo - ASST Melegnano Martesana,LOM,40-49,5,15,0,20,0,0,0,20,0,20,Lombardia,ITC4
2021-01-04,PF/BT,30071,Centro Vaccinale Covid Melzo - ASST Melegnano Martesana,LOM,50-59,6,22,0,28,0,0,0,28,0,28,Lombardia,ITC4
2021-01-04,PF/BT,30071,Centro Vaccinale Covid Melzo - ASST Melegnano Martesana,LOM,60-69,2,5,0,7,0,0,0,7,0,7,Lombardia,ITC4
2021-01-04,PF/BT,30072,Centro Vaccinale Covid Vizzolo - ASST Melegnano Martesana,LOM,20-29,1,2,0,3,0,0,0,3,0,3,Lombardia,ITC4
2021-01-04,PF/BT,30072,Centro Vaccinale Covid Vizzolo - ASST Melegnano Martesana,LOM,30-39,5,8,0,13,0,0,0,13,0,13,Lombardia,ITC4
2021-01-04,PF/BT,30072,Centro Vaccinale Covid Vizzolo - ASST Melegnano Martesana,LOM,40-49,2,14,0,16,0,0,0,16,0,16,Lombardia,ITC4
2021-01-04,PF/BT,30072,Centro Vaccinale Covid Vizzolo - ASST Melegnano Martesana,LOM,50-59,9,32,0,41,0,0,0,41,0,41,Lombardia,ITC4
2021-01-04,PF/BT,30072,Centro Vaccinale Covid Vizzolo - ASST Melegnano Martesana,LOM,60-69,6,10,0,16,0,0,0,16,0,16,Lombardia,ITC4
2021-01-04,PF/BT,30073,cv rho,LOM,20-29,0,2,0,2,0,0,0,2,0,2,Lombardia,ITC4
2021-01-04,PF/BT,30073,cv rho,LOM,30-39,2,5,0,6,1,0,0,7,0,7,Lombardia,ITC4
2021-01-04,PF/BT,30073,cv rho,LOM,40-49,1,16,0,17,0,0,0,17,0,17,Lombardia,ITC4
2021-01-04,PF/BT,30073,cv rho,LOM,50-59,4,20,0,23,1,0,0,24,0,24,Lombardia,ITC4
2021-01-04,PF/BT,30073,cv rho,LOM,60-69,3,5,0,8,0,0,0,8,0,8,Lombardia,ITC4
2021-01-04,PF/BT,30156,Centro Vaccinale Covid Desenzano,LOM,20-29,1,7,0,2,1,0,5,8,0,8,Lombardia,ITC4
2021-01-04,PF/BT,30156,Centro Vaccinale Covid Desenzano,LOM,30-39,1,6,0,6,1,0,0,7,0,7,Lombardia,ITC4
2021-01-04,PF/BT,30156,Centro Vaccinale Covid Desenzano,LOM,40-49,3,4,0,5,1,0,1,7,0,7,Lombardia,ITC4
2021-01-04,PF/BT,30156,Centro Vaccinale Covid Desenzano,LOM,50-59,8,12,0,10,10,0,0,20,0,20,Lombardia,ITC4
2021-01-04,PF/BT,30156,Centro Vaccinale Covid Desenzano,LOM,60-69,5,7,0,11,1,0,0,12,0,12,Lombardia,ITC4
2021-01-04,PF/BT,30157,Centro Vaccinale Covid Gavardo,LOM,20-29,0,4,0,4,0,0,0,4,0,4,Lombardia,ITC4
2021-01-04,PF/BT,30157,Centro Vaccinale Covid Gavardo,LOM,30-39,3,6,0,9,0,0,0,9,0,9,Lombardia,ITC4
2021-01-04,PF/BT,30157,Centro Vaccinale Covid Gavardo,LOM,40-49,5,15,0,18,2,0,0,20,0,20,Lombardia,ITC4
2021-01-04,PF/BT,30157,Centro Vaccinale Covid Gavardo,LOM,50-59,4,17,0,21,0,0,0,21,0,21,Lombardia,ITC4
2021-01-04,PF/BT,30157,Centro Vaccinale Covid Gavardo,LOM,60-69,5,0,0,5,0,0,0,5,0,5,Lombardia,ITC4
2021-01-04,PF/BT,30184,Centro Vaccinale Covid Manerbio,LOM,20-29,0,2,0,2,0,0,0,2,0,2,Lombardia,ITC4
2021-01-04,PF/BT,30184,Centro Vaccinale Covid Manerbio,LOM,30-39,3,5,0,6,1,0,1,8,0,8,Lombardia,ITC4
2021-01-04,PF/BT,30184,Centro Vaccinale Covid Manerbio,LOM,40-49,1,18,0,17,2,0,0,19,0,19,Lombardia,ITC4
2021-01-04,PF/BT,30184,Centro Vaccinale Covid Manerbio,LOM,50-59,4,10,0,11,3,0,0,14,0,14,Lombardia,ITC4
2021-01-04,PF/BT,30184,Centro Vaccinale Covid Manerbio,LOM,60-69,9,2,0,11,0,0,0,11,0,11,Lombardia,ITC4
2021-01-04,PF/BT,30193,Ambulatorio HUB Vigevano,LOM,20-29,2,3,0,4,1,0,0,5,0,5,Lombardia,ITC4
2021-01-04,PF/BT,30193,Ambulatorio HUB Vigevano,LOM,30-39,5,9,0,10,4,0,0,14,0,14,Lombardia,ITC4
2021-01-04,PF/BT,30193,Ambulatorio HUB Vigevano,LOM,40-49,2,14,0,15,1,0,0,16,0,16,Lombardia,ITC4
2021-01-04,PF/BT,30193,Ambulatorio HUB Vigevano,LOM,50-59,11,18,0,23,6,0,0,29,0,29,Lombardia,ITC4
2021-01-04,PF/BT,30193,Ambulatorio HUB Vigevano,LOM,60-69,17,8,0,21,4,0,0,25,0,25,Lombardia,ITC4
2021-01-04,PF/BT,30209,OSPEDALE MAGGIORE DI CREMA,LOM,20-29,6,8,0,13,1,0,0,14,0,14,Lombardia,ITC4
2021-01-04,PF/BT,30209,OSPEDALE MAGGIORE DI CREMA,LOM,30-39,8,10,0,18,0,0,0,18,0,18,Lombardia,ITC4
2021-01-04,PF/BT,30209,OSPEDALE MAGGIORE DI CREMA,LOM,40-49,8,15,0,22,1,0,0,23,0,23,Lombardia,ITC4
2021-01-04,PF/BT,30209,OSPEDALE MAGGIORE DI CREMA,LOM,50-59,9,35,0,30,14,0,0,44,0,44,Lombardia,ITC4
2021-01-04,PF/BT,30209,OSPEDALE MAGGIORE DI CREMA,LOM,60-69,5,3,0,8,0,0,0,8,0,8,Lombardia,ITC4
2021-01-04,PF/BT,30281,HUB LEGNANO,LOM,20-29,3,6,0,9,0,0,0,9,0,9,Lombardia,ITC4
2021-01-04,PF/BT,30281,HUB LEGNANO,LOM,30-39,17,32,0,49,0,0,0,49,0,49,Lombardia,ITC4
2021-01-04,PF/BT,30281,HUB LEGNANO,LOM,40-49,22,30,0,51,1,0,0,52,0,52,Lombardia,ITC4
2021-01-04,PF/BT,30281,HUB LEGNANO,LOM,50-59,12,24,0,35,1,0,0,36,0,36,Lombardia,ITC4
2021-01-04,PF/BT,30281,HUB LEGNANO,LOM,60-69,8,6,0,14,0,0,0,14,0,14,Lombardia,ITC4
2021-01-04,PF/BT,30701,ASST GRANDE OSPEDALE METROPOLITANO NIGUARDA,LOM,20-29,22,46,0,62,0,0,6,68,0,68,Lombardia,ITC4
2021-01-04,PF/BT,30701,ASST GRANDE OSPEDALE METROPOLITANO NIGUARDA,LOM,30-39,53,56,0,97,7,0,5,109,0,109,Lombardia,ITC4
2021-01-04,PF/BT,30701,ASST GRANDE OSPEDALE METROPOLITANO NIGUARDA,LOM,40-49,40,72,0,92,13,0,7,112,0,112,Lombardia,ITC4
2021-01-04,PF/BT,30701,ASST GRANDE OSPEDALE METROPOLITANO NIGUARDA,LOM,50-59,49,101,0,115,29,0,6,150,0,150,Lombardia,ITC4
2021-01-04,PF/BT,30701,ASST GRANDE OSPEDALE METROPOLITANO NIGUARDA,LOM,60-69,33,24,0,53,3,0,1,57,0,57,Lombardia,ITC4
2021-01-04,PF/BT,30701,ASST GRANDE OSPEDALE METROPOLITANO NIGUARDA,LOM,70-79,0,1,0,1,0,0,0,1,0,1,Lombardia,ITC4
2021-01-04,PF/BT,30712,Ospedale Sant'Anna - Via Napoleona - Como,LOM,30-39,1,2,0,3,0,0,0,3,0,3,Lombardia,ITC4
2021-01-04,PF/BT,30712,Ospedale Sant'Anna - Via Napoleona - Como,LOM,40-49,1,9,0,9,1,0,0,10,0,10,Lombardia,ITC4
2021-01-04,PF/BT,30712,Ospedale Sant'Anna - Via Napoleona - Como,LOM,50-59,5,22,0,27,0,0,0,27,0,27,Lombardia,ITC4
2021-01-04,PF/BT,30712,Ospedale Sant'Anna - Via Napoleona - Como,LOM,60-69,4,10,0,14,0,0,0,14,0,14,Lombardia,ITC4
2021-01-04,PF/BT,30902,Ospedale S.Anna - Como,LOM,20-29,2,10,0,12,0,0,0,12,0,12,Lombardia,ITC4
2021-01-04,PF/BT,30902,Ospedale S.Anna - Como,LOM,30-39,16,21,0,37,0,0,0,37,0,37,Lombardia,ITC4
2021-01-04,PF/BT,30902,Ospedale S.Anna - Como,LOM,40-49,15,24,0,39,0,0,0,39,0,39,Lombardia,ITC4
2021-01-04,PF/BT,30902,Ospedale S.Anna - Como,LOM,50-59,15,29,0,44,0,0,0,44,0,44,Lombardia,ITC4
2021-01-04,PF/BT,30902,Ospedale S.Anna - Como,LOM,60-69,9,9,0,18,0,0,0,18,0,18,Lombardia,ITC4
2021-01-04,PF/BT,30909,amb covid monza,LOM,20-29,4,22,0,26,0,0,0,26,0,26,Lombardia,ITC4
2021-01-04,PF/BT,30909,amb covid monza,LOM,30-39,34,33,0,67,0,0,0,67,0,67,Lombardia,ITC4
2021-01-04,PF/BT,30909,amb covid monza,LOM,40-49,25,44,0,69,0,0,0,69,0,69,Lombardia,ITC4
2021-01-04,PF/BT,30909,amb covid monza,LOM,50-59,18,37,0,54,1,0,0,55,0,55,Lombardia,ITC4
2021-01-04,PF/BT,30909,amb covid monza,LOM,60-69,8,9,0,17,0,0,0,17,0,17,Lombardia,ITC4
2021-01-04,PF/BT,30925,Fondazione IRCCS Ca' Granda Ospedale Maggiore Policlinico,LOM,20-29,6,25,0,30,1,0,0,31,0,31,Lombardia,ITC4
2021-01-04,PF/BT,30925,Fondazione IRCCS Ca' Granda Ospedale Maggiore Policlinico,LOM,30-39,37,45,0,81,1,0,0,82,0,82,Lombardia,ITC4
2021-01-04,PF/BT,30925,Fondazione IRCCS Ca' Granda Ospedale Maggiore Policlinico,LOM,40-49,15,27,0,42,0,0,0,42,0,42,Lombardia,ITC4
2021-01-04,PF/BT,30925,Fondazione IRCCS Ca' Granda Ospedale Maggiore Policlinico,LOM,50-59,9,24,0,30,3,0,0,33,0,33,Lombardia,ITC4
2021-01-04,PF/BT,30925,Fondazione IRCCS Ca' Granda Ospedale Maggiore Policlinico,LOM,60-69,10,9,0,16,3,0,0,19,0,19,Lombardia,ITC4
2021-01-04,PF/BT,30925,Fondazione IRCCS Ca' Granda Ospedale Maggiore Policlinico,LOM,70-79,0,1,0,1,0,0,0,1,0,1,Lombardia,ITC4
2021-01-04,PF/BT,30935,IRCCS    S. RAFFAELE - MILANO,LOM,20-29,0,1,0,1,0,0,0,1,0,1,Lombardia,ITC4
2021-01-04,PF/BT,30935,IRCCS    S. RAFFAELE - MILANO,LOM,40-49,0,1,0,1,0,0,0,1,0,1,Lombardia,ITC4
2021-01-04,PF/BT,30935,IRCCS    S. RAFFAELE - MILANO,LOM,50-59,0,2,0,2,0,0,0,2,0,2,Lombardia,ITC4
2021-01-04,PF/BT,30935,IRCCS    S. RAFFAELE - MILANO,LOM,60-69,52,24,0,76,0,0,0,76,0,76,Lombardia,ITC4
2021-01-04,PF/BT,30935,IRCCS    S. RAFFAELE - MILANO,LOM,70-79,8,3,0,11,0,0,0,11,0,11,Lombardia,ITC4
2021-01-04,PF/BT,30943,Istituto Clinico Humanitas,LOM,20-29,25,21,0,46,0,0,0,46,0,46,Lombardia,ITC4
2021-01-04,PF/BT,30943,Istituto Clinico Humanitas,LOM,30-39,38,18,0,56,0,0,0,56,0,56,Lombardia,ITC4
2021-01-04,PF/BT,30943,Istituto Clinico Humanitas,LOM,40-49,25,32,0,57,0,0,0,57,0,57,Lombardia,ITC4
2021-01-04,PF/BT,30943,Istituto Clinico Humanitas,LOM,50-59,16,14,0,30,0,0,0,30,0,30,Lombardia,ITC4
2021-01-04,PF/BT,30943,Istituto Clinico Humanitas,LOM,60-69,13,0,0,13,0,0,0,13,0,13,Lombardia,ITC4
2021-01-04,PF/BT,30943,Istituto Clinico Humanitas,LOM,70-79,2,0,0,2,0,0,0,2,0,2,Lombardia,ITC4
2021-01-04,PF/BT,32170712,ambulatorio covid SESTO SAN GIOVANNI,LOM,30-39,3,3,0,4,2,0,0,6,0,6,Lombardia,ITC4
2021-01-04,PF/BT,32170712,ambulatorio covid SESTO SAN GIOVANNI,LOM,40-49,1,8,0,5,4,0,0,9,0,9,Lombardia,ITC4
2021-01-04,PF/BT,32170712,ambulatorio covid SESTO SAN GIOVANNI,LOM,50-59,4,9,0,7,6,0,0,13,0,13,Lombardia,ITC4
2021-01-04,PF/BT,32170712,ambulatorio covid SESTO SAN GIOVANNI,LOM,60-69,3,5,0,5,3,0,0,8,0,8,Lombardia,ITC4
2021-01-04,PF/BT,32271022,ambulatorio covid Varese +ambulatorio covid ospedale tradate +ambulatorio covid ospedale cittiglio,LOM,20-29,13,25,0,38,0,0,0,38,0,38,Lombardia,ITC4
2021-01-04,PF/BT,32271022,ambulatorio covid Varese +ambulatorio covid ospedale tradate +ambulatorio covid ospedale cittiglio,LOM,30-39,35,42,0,77,0,0,0,77,0,77,Lombardia,ITC4
2021-01-04,PF/BT,32271022,ambulatorio covid Varese +ambulatorio covid ospedale tradate +ambulatorio covid ospedale cittiglio,LOM,40-49,27,70,0,97,0,0,0,97,0,97,Lombardia,ITC4
2021-01-04,PF/BT,32271022,ambulatorio covid Varese +ambulatorio covid ospedale tradate +ambulatorio covid ospedale cittiglio,LOM,50-59,30,99,0,129,0,0,0,129,0,129,Lombardia,ITC4
2021-01-04,PF/BT,32271022,ambulatorio covid Varese +ambulatorio covid ospedale tradate +ambulatorio covid ospedale cittiglio,LOM,60-69,15,9,0,24,0,0,0,24,0,24,Lombardia,ITC4
2021-01-04,PF/BT,32271116,ambulatorio covid Gallarate,LOM,20-29,4,4,0,8,0,0,0,8,0,8,Lombardia,ITC4
2021-01-04,PF/BT,32271116,ambulatorio covid Gallarate,LOM,30-39,3,6,0,9,0,0,0,9,0,9,Lombardia,ITC4
2021-01-04,PF/BT,32271116,ambulatorio covid Gallarate,LOM,40-49,5,12,0,17,0,0,0,17,0,17,Lombardia,ITC4
2021-01-04,PF/BT,32271116,ambulatorio covid Gallarate,LOM,50-59,7,35,0,42,0,0,0,42,0,42,Lombardia,ITC4
2021-01-04,PF/BT,32271116,ambulatorio covid Gallarate,LOM,60-69,0,2,0,2,0,0,0,2,0,2,Lombardia,ITC4
2021-01-04,PF/BT,32271117,ambulatorio covid Saronno,LOM,20-29,0,1,0,1,0,0,0,1,0,1,Lombardia,ITC4
2021-01-04,PF/BT,32271117,ambulatorio covid Saronno,LOM,30-39,1,2,0,3,0,0,0,3,0,3,Lombardia,ITC4
2021-01-04,PF/BT,32271117,ambulatorio covid Saronno,LOM,40-49,0,7,0,7,0,0,0,7,0,7,Lombardia,ITC4
2021-01-04,PF/BT,32271117,ambulatorio covid Saronno,LOM,50-59,4,9,0,13,0,0,0,13,0,13,Lombardia,ITC4
2021-01-04,PF/BT,32271118,ambulatorio covid Busto A.,LOM,20-29,1,1,0,2,0,0,0,2,0,2,Lombardia,ITC4
2021-01-04,PF/BT,32271118,ambulatorio covid Busto A.,LOM,30-39,9,15,0,24,0,0,0,24,0,24,Lombardia,ITC4
2021-01-04,PF/BT,32271118,ambulatorio covid Busto A.,LOM,40-49,5,14,0,19,0,0,0,19,0,19,Lombardia,ITC4
2021-01-04,PF/BT,32271118,ambulatorio covid Busto A.,LOM,50-59,6,11,0,17,0,0,0,17,0,17,Lombardia,ITC4
2021-01-04,PF/BT,32271118,ambulatorio covid Busto A.,LOM,60-69,3,1,0,4,0,0,0,4,0,4,Lombardia,ITC4
2021-01-04,PF/BT,32572027,Ambulatorio COVID SERIATE,LOM,20-29,8,7,0,15,0,0,0,15,0,15,Lombardia,ITC4
2021-01-04,PF/BT,32572027,Ambulatorio COVID SERIATE,LOM,30-39,6,18,0,23,1,0,0,24,0,24,Lombardia,ITC4
2021-01-04,PF/BT,32572027,Ambulatorio COVID SERIATE,LOM,40-49,10,23,0,32,1,0,0,33,0,33,Lombardia,ITC4
2021-01-04,PF/BT,32572027,Ambulatorio COVID SERIATE,LOM,50-59,17,17,0,31,3,0,0,34,0,34,Lombardia,ITC4
2021-01-04,PF/BT,32572027,Ambulatorio COVID SERIATE,LOM,60-69,11,4,0,13,2,0,0,15,0,15,Lombardia,ITC4
2021-01-04,PF/BT,32772407,CD COVID CREMONA,LOM,20-29,3,16,0,19,0,0,0,19,0,19,Lombardia,ITC4
2021-01-04,PF/BT,32772407,CD COVID CREMONA,LOM,30-39,19,28,0,47,0,0,0,47,0,47,Lombardia,ITC4
2021-01-04,PF/BT,32772407,CD COVID CREMONA,LOM,40-49,20,41,0,61,0,0,0,61,0,61,Lombardia,ITC4
2021-01-04,PF/BT,32772407,CD COVID CREMONA,LOM,50-59,24,65,0,89,0,0,0,89,0,89,Lombardia,ITC4
2021-01-04,PF/BT,32772407,CD COVID CREMONA,LOM,60-69,8,14,0,22,0,0,0,22,0,22,Lombardia,ITC4
2021-01-04,PF/BT,32772513,Ambulatorio COVID MANTOVA,LOM,30-39,4,7,0,9,2,0,0,11,0,11,Lombardia,ITC4
2021-01-04,PF/BT,32772513,Ambulatorio COVID MANTOVA,LOM,40-49,8,15,0,16,7,0,0,23,0,23,Lombardia,ITC4
2021-01-04,PF/BT,32772513,Ambulatorio COVID MANTOVA,LOM,50-59,17,33,0,47,3,0,0,50,0,50,Lombardia,ITC4
2021-01-04,PF/BT,32772513,Ambulatorio COVID MANTOVA,LOM,60-69,13,10,0,23,0,0,0,23,0,23,Lombardia,ITC4
2021-01-04,PF/BT,32772513,Ambulatorio COVID MANTOVA,LOM,70-79,1,0,0,1,0,0,0,1,0,1,Lombardia,ITC4
2021-01-04,PF/BT,32772513,ASST DI MANTOVA - POMA,LOM,30-39,4,7,0,9,2,0,0,11,0,11,Lombardia,ITC4
2021-01-04,PF/BT,32772513,ASST DI MANTOVA - POMA,LOM,40-49,8,15,0,16,7,0,0,23,0,23,Lombardia,ITC4
2021-01-04,PF/BT,32772513,ASST DI MANTOVA - POMA,LOM,50-59,17,33,0,47,3,0,0,50,0,50,Lombardia,ITC4
2021-01-04,PF/BT,32772513,ASST DI MANTOVA - POMA,LOM,60-69,13,10,0,23,0,0,0,23,0,23,Lombardia,ITC4
2021-01-04,PF/BT,32772513,ASST DI MANTOVA - POMA,LOM,70-79,1,0,0,1,0,0,0,1,0,1,Lombardia,ITC4
2021-01-04,PF/BT,947,I.R.C.C.S. POLICLINICO SAN DONATO,LOM,20-29,0,3,0,3,0,0,0,3,0,3,Lombardia,ITC4
2021-01-04,PF/BT,947,I.R.C.C.S. POLICLINICO SAN DONATO,LOM,30-39,4,6,0,4,6,0,0,10,0,10,Lombardia,ITC4
2021-01-04,PF/BT,947,I.R.C.C.S. POLICLINICO SAN DONATO,LOM,40-49,5,11,0,15,1,0,0,16,0,16,Lombardia,ITC4
2021-01-04,PF/BT,947,I.R.C.C.S. POLICLINICO SAN DONATO,LOM,50-59,7,10,0,15,2,0,0,17,0,17,Lombardia,ITC4
2021-01-04,PF/BT,947,I.R.C.C.S. POLICLINICO SAN DONATO,LOM,60-69,6,2,0,7,1,0,0,8,0,8,Lombardia,ITC4
2021-01-04,PF/BT,947,I.R.C.C.S. POLICLINICO SAN DONATO,LOM,70-79,8,0,0,7,1,0,0,8,0,8,Lombardia,ITC4
2021-01-04,PF/BT,HPS11/11bis,ASST SPEDALI CIVILI AMBULATORIO COVID BRESCIA,LOM,20-29,4,19,0,23,0,0,0,23,0,23,Lombardia,ITC4
2021-01-04,PF/BT,HPS11/11bis,ASST SPEDALI CIVILI AMBULATORIO COVID BRESCIA,LOM,30-39,15,22,0,35,0,0,2,37,0,37,Lombardia,ITC4
2021-01-04,PF/BT,HPS11/11bis,ASST SPEDALI CIVILI AMBULATORIO COVID BRESCIA,LOM,40-49,20,28,0,47,0,0,1,48,0,48,Lombardia,ITC4
2021-01-04,PF/BT,HPS11/11bis,ASST SPEDALI CIVILI AMBULATORIO COVID BRESCIA,LOM,50-59,20,40,0,60,0,0,0,60,0,60,Lombardia,ITC4
2021-01-04,PF/BT,HPS11/11bis,ASST SPEDALI CIVILI AMBULATORIO COVID BRESCIA,LOM,60-69,11,5,0,16,0,0,0,16,0,16,Lombardia,ITC4
2021-01-04,PF/BT,HPS11/11bis,ASST SPEDALI CIVILI AMBULATORIO COVID BRESCIA,LOM,70-79,0,1,0,1,0,0,0,1,0,1,Lombardia,ITC4
2021-01-04,PF/BT,HSP11-11bis,Ambulatorio COVID PO CASALPASTURLENGO,LOM,30-39,4,3,0,7,0,0,0,7,0,7,Lombardia,ITC4
2021-01-04,PF/BT,HSP11-11bis,Ambulatorio COVID PO CASALPASTURLENGO,LOM,40-49,2,15,0,17,0,0,0,17,0,17,Lombardia,ITC4
2021-01-04,PF/BT,HSP11-11bis,Ambulatorio COVID PO CASALPASTURLENGO,LOM,50-59,5,22,0,26,1,0,0,27,0,27,Lombardia,ITC4
2021-01-04,PF/BT,HSP11-11bis,Ambulatorio COVID PO CASALPASTURLENGO,LOM,60-69,1,8,0,9,0,0,0,9,0,9,Lombardia,ITC4
2021-01-04,PF/BT,HSP11-11bis,Ambulatorio COVID PO Codogno,LOM,20-29,3,2,0,5,0,0,0,5,0,5,Lombardia,ITC4
2021-01-04,PF/BT,HSP11-11bis,Ambulatorio COVID PO Codogno,LOM,30-39,2,6,0,8,0,0,0,8,0,8,Lombardia,ITC4
2021-01-04,PF/BT,HSP11-11bis,Ambulatorio COVID PO Codogno,LOM,40-49,5,9,0,14,0,0,0,14,0,14,Lombardia,ITC4
2021-01-04,PF/BT,HSP11-11bis,Ambulatorio COVID PO Codogno,LOM,50-59,8,19,0,27,0,0,0,27,0,27,Lombardia,ITC4
2021-01-04,PF/BT,HSP11-11bis,Ambulatorio COVID PO Codogno,LOM,60-69,2,4,0,6,0,0,0,6,0,6,Lombardia,ITC4
2021-01-04,PF/BT,HSP11-11bis,Ambulatorio COVID PO LODI,LOM,20-29,3,2,0,5,0,0,0,5,0,5,Lombardia,ITC4
2021-01-04,PF/BT,HSP11-11bis,Ambulatorio COVID PO LODI,LOM,30-39,12,12,0,24,0,0,0,24,0,24,Lombardia,ITC4
2021-01-04,PF/BT,HSP11-11bis,Ambulatorio COVID PO LODI,LOM,40-49,5,8,0,13,0,0,0,13,0,13,Lombardia,ITC4
2021-01-04,PF/BT,HSP11-11bis,Ambulatorio COVID PO LODI,LOM,50-59,5,9,0,14,0,0,0,14,0,14,Lombardia,ITC4
2021-01-04,PF/BT,HSP11-11bis,Ambulatorio COVID PO LODI,LOM,60-69,3,1,0,4,0,0,0,4,0,4,Lombardia,ITC4
2021-01-04,PF/BT,HSP11-11bis,Ambulatorio COVID PO S.Angelo Lod.,LOM,20-29,2,4,0,6,0,0,0,6,0,6,Lombardia,ITC4
2021-01-04,PF/BT,HSP11-11bis,Ambulatorio COVID PO S.Angelo Lod.,LOM,30-39,1,4,0,4,1,0,0,5,0,5,Lombardia,ITC4
2021-01-04,PF/BT,HSP11-11bis,Ambulatorio COVID PO S.Angelo Lod.,LOM,40-49,2,13,0,12,3,0,0,15,0,15,Lombardia,ITC4
2021-01-04,PF/BT,HSP11-11bis,Ambulatorio COVID PO S.Angelo Lod.,LOM,50-59,5,22,0,21,6,0,0,27,0,27,Lombardia,ITC4
2021-01-04,PF/BT,HSP11-11bis,Ambulatorio COVID PO S.Angelo Lod.,LOM,60-69,4,3,0,6,1,0,0,7,0,7,Lombardia,ITC4
2021-01-04,PF/BT,HSP11-11bis,AMBULATORIO COVID PO SACCO,LOM,20-29,2,12,0,14,0,0,0,14,0,14,Lombardia,ITC4
2021-01-04,PF/BT,HSP11-11bis,AMBULATORIO COVID PO SACCO,LOM,30-39,11,11,0,22,0,0,0,22,0,22,Lombardia,ITC4
2021-01-04,PF/BT,HSP11-11bis,AMBULATORIO COVID PO SACCO,LOM,40-49,8,17,0,25,0,0,0,25,0,25,Lombardia,ITC4
2021-01-04,PF/BT,HSP11-11bis,AMBULATORIO COVID PO SACCO,LOM,50-59,7,20,0,27,0,0,0,27,0,27,Lombardia,ITC4
2021-01-04,PF/BT,HSP11-11bis,AMBULATORIO COVID PO SACCO,LOM,60-69,5,3,0,8,0,0,0,8,0,8,Lombardia,ITC4
2021-01-04,PF/BT,HSP11-11bis,ASST BERGAMO OVEST - OSPEDALE ROMANO DI L.DIA,LOM,20-29,2,1,0,3,0,0,0,3,0,3,Lombardia,ITC4
2021-01-04,PF/BT,HSP11-11bis,ASST BERGAMO OVEST - OSPEDALE ROMANO DI L.DIA,LOM,30-39,1,5,0,4,2,0,0,6,0,6,Lombardia,ITC4
2021-01-04,PF/BT,HSP11-11bis,ASST BERGAMO OVEST - OSPEDALE ROMANO DI L.DIA,LOM,40-49,6,23,0,26,3,0,0,29,0,29,Lombardia,ITC4
2021-01-04,PF/BT,HSP11-11bis,ASST BERGAMO OVEST - OSPEDALE ROMANO DI L.DIA,LOM,50-59,10,31,0,31,8,0,2,41,0,41,Lombardia,ITC4
2021-01-04,PF/BT,HSP11-11bis,ASST BERGAMO OVEST - OSPEDALE ROMANO DI L.DIA,LOM,60-69,4,7,0,9,2,0,0,11,0,11,Lombardia,ITC4
2021-01-04,PF/BT,HSP11-11bis,ASST BERGAMO OVEST - OSPEDALE TREVIGLIO,LOM,20-29,1,6,0,6,1,0,0,7,0,7,Lombardia,ITC4
2021-01-04,PF/BT,HSP11-11bis,ASST BERGAMO OVEST - OSPEDALE TREVIGLIO,LOM,30-39,6,13,0,19,0,0,0,19,0,19,Lombardia,ITC4
2021-01-04,PF/BT,HSP11-11bis,ASST BERGAMO OVEST - OSPEDALE TREVIGLIO,LOM,40-49,6,28,0,30,4,0,0,34,0,34,Lombardia,ITC4
2021-01-04,PF/BT,HSP11-11bis,ASST BERGAMO OVEST - OSPEDALE TREVIGLIO,LOM,50-59,8,21,0,25,4,0,0,29,0,29,Lombardia,ITC4
2021-01-04,PF/BT,HSP11-11bis,ASST BERGAMO OVEST - OSPEDALE TREVIGLIO,LOM,60-69,4,3,0,6,1,0,0,7,0,7,Lombardia,ITC4
2021-01-04,PF/BT,HSP11-11bis,ASST San Carlo,LOM,20-29,8,16,0,23,1,0,0,24,0,24,Lombardia,ITC4
2021-01-04,PF/BT,HSP11-11bis,ASST San Carlo,LOM,30-39,20,13,0,32,1,0,0,33,0,33,Lombardia,ITC4
2021-01-04,PF/BT,HSP11-11bis,ASST San Carlo,LOM,40-49,14,21,0,31,4,0,0,35,0,35,Lombardia,ITC4
2021-01-04,PF/BT,HSP11-11bis,ASST San Carlo,LOM,50-59,19,23,0,39,3,0,0,42,0,42,Lombardia,ITC4
2021-01-04,PF/BT,HSP11-11bis,ASST San Carlo,LOM,60-69,4,5,0,9,0,0,0,9,0,9,Lombardia,ITC4
2021-01-04,PF/BT,HSP11-11bis,ASST San Paolo,LOM,20-29,10,11,0,21,0,0,0,21,0,21,Lombardia,ITC4
2021-01-04,PF/BT,HSP11-11bis,ASST San Paolo,LOM,30-39,21,17,0,34,4,0,0,38,0,38,Lombardia,ITC4
2021-01-04,PF/BT,HSP11-11bis,ASST San Paolo,LOM,40-49,8,23,0,27,4,0,0,31,0,31,Lombardia,ITC4
2021-01-04,PF/BT,HSP11-11bis,ASST San Paolo,LOM,50-59,8,24,0,26,6,0,0,32,0,32,Lombardia,ITC4
2021-01-04,PF/BT,HSP11-11bis,ASST San Paolo,LOM,60-69,12,6,0,11,7,0,0,18,0,18,Lombardia,ITC4
2021-01-04,PF/BT,HSP11-11bis,ASST San Paolo,LOM,70-79,1,0,0,0,1,0,0,1,0,1,Lombardia,ITC4
2021-01-04,PF/BT,HSP11-11bis - 703,AMBULATORIO OSPEDALE SACCO,LOM,20-29,5,21,0,26,0,0,0,26,0,26,Lombardia,ITC4
2021-01-04,PF/BT,HSP11-11bis - 703,AMBULATORIO OSPEDALE SACCO,LOM,30-39,25,45,0,70,0,0,0,70,0,70,Lombardia,ITC4
2021-01-04,PF/BT,HSP11-11bis - 703,AMBULATORIO OSPEDALE SACCO,LOM,40-49,16,47,0,63,0,0,0,63,0,63,Lombardia,ITC4
2021-01-04,PF/BT,HSP11-11bis - 703,AMBULATORIO OSPEDALE SACCO,LOM,50-59,17,45,0,62,0,0,0,62,0,62,Lombardia,ITC4
2021-01-04,PF/BT,HSP11-11bis - 703,AMBULATORIO OSPEDALE SACCO,LOM,60-69,12,7,0,19,0,0,0,19,0,19,Lombardia,ITC4
2021-01-05,PF/BT,.030042,ASST - Presidio Ospedaliero di Sondrio,LOM,20-29,2,3,0,4,1,0,0,5,0,5,Lombardia,ITC4
2021-01-05,PF/BT,.030042,ASST - Presidio Ospedaliero di Sondrio,LOM,30-39,3,12,0,15,0,0,0,15,0,15,Lombardia,ITC4
2021-01-05,PF/BT,.030042,ASST - Presidio Ospedaliero di Sondrio,LOM,40-49,5,22,0,25,2,0,0,27,0,27,Lombardia,ITC4
2021-01-05,PF/BT,.030042,ASST - Presidio Ospedaliero di Sondrio,LOM,50-59,15,44,0,47,12,0,0,59,0,59,Lombardia,ITC4
2021-01-05,PF/BT,.030042,ASST - Presidio Ospedaliero di Sondrio,LOM,60-69,5,15,0,17,3,0,0,20,0,20,Lombardia,ITC4
2021-01-05,PF/BT,0,32170223   HUB COVID SS PAOLO E CARLO,LOM,20-29,17,19,0,36,0,0,0,36,0,36,Lombardia,ITC4
2021-01-05,PF/BT,0,32170223   HUB COVID SS PAOLO E CARLO,LOM,30-39,14,24,0,37,1,0,0,38,0,38,Lombardia,ITC4
2021-01-05,PF/BT,0,32170223   HUB COVID SS PAOLO E CARLO,LOM,40-49,9,22,0,30,1,0,0,31,0,31,Lombardia,ITC4
2021-01-05,PF/BT,0,32170223   HUB COVID SS PAOLO E CARLO,LOM,50-59,10,19,0,25,2,0,2,29,0,29,Lombardia,ITC4
2021-01-05,PF/BT,0,32170223   HUB COVID SS PAOLO E CARLO,LOM,60-69,10,3,0,13,0,0,0,13,0,13,Lombardia,ITC4
2021-01-05,PF/BT,0,32170223   HUB COVID SS PAOLO E CARLO,LOM,70-79,2,0,0,2,0,0,0,2,0,2,Lombardia,ITC4
2021-01-05,PF/BT,000050,POLIAMBULATORIO IRCCS OSPEDALE,LOM,20-29,0,1,0,1,0,0,0,1,0,1,Lombardia,ITC4
2021-01-05,PF/BT,000050,POLIAMBULATORIO IRCCS OSPEDALE,LOM,30-39,3,2,0,5,0,0,0,5,0,5,Lombardia,ITC4
2021-01-05,PF/BT,000050,POLIAMBULATORIO IRCCS OSPEDALE,LOM,40-49,5,7,0,12,0,0,0,12,0,12,Lombardia,ITC4
2021-01-05,PF/BT,000050,POLIAMBULATORIO IRCCS OSPEDALE,LOM,50-59,0,4,0,4,0,0,0,4,0,4,Lombardia,ITC4
2021-01-05,PF/BT,000050,POLIAMBULATORIO IRCCS OSPEDALE,LOM,60-69,1,1,0,2,0,0,0,2,0,2,Lombardia,ITC4
2021-01-05,PF/BT,000417,POLIAMBULATORIO IRCCS OSPEDALE,LOM,20-29,0,3,0,3,0,0,0,3,0,3,Lombardia,ITC4
2021-01-05,PF/BT,000417,POLIAMBULATORIO IRCCS OSPEDALE,LOM,30-39,1,3,0,4,0,0,0,4,0,4,Lombardia,ITC4
2021-01-05,PF/BT,000417,POLIAMBULATORIO IRCCS OSPEDALE,LOM,40-49,2,2,0,4,0,0,0,4,0,4,Lombardia,ITC4
2021-01-05,PF/BT,000417,POLIAMBULATORIO IRCCS OSPEDALE,LOM,50-59,4,3,0,7,0,0,0,7,0,7,Lombardia,ITC4
2021-01-05,PF/BT,000417,POLIAMBULATORIO IRCCS OSPEDALE,LOM,60-69,2,2,0,4,0,0,0,4,0,4,Lombardia,ITC4
2021-01-05,PF/BT,000417,POLIAMBULATORIO IRCCS OSPEDALE,LOM,70-79,2,0,0,2,0,0,0,2,0,2,Lombardia,ITC4
2021-01-05,PF/BT,000542,RSA MONSIGNOR BICCHIERAI 1,LOM,60-69,0,1,0,0,0,1,0,1,0,1,Lombardia,ITC4
2021-01-05,PF/BT,000542,RSA MONSIGNOR BICCHIERAI 1,LOM,70-79,1,0,0,0,0,1,0,1,0,1,Lombardia,ITC4
2021-01-05,PF/BT,000542,RSA MONSIGNOR BICCHIERAI 1,LOM,80-89,0,7,0,0,0,7,0,7,0,7,Lombardia,ITC4
2021-01-05,PF/BT,000542,RSA MONSIGNOR BICCHIERAI 1,LOM,90+,0,3,0,0,0,3,0,3,0,3,Lombardia,ITC4
2021-01-05,PF/BT,000799,Casa di Cura Santa Maria - MultiMedica,LOM,20-29,0,5,0,5,0,0,0,5,0,5,Lombardia,ITC4
2021-01-05,PF/BT,000799,Casa di Cura Santa Maria - MultiMedica,LOM,30-39,3,2,0,5,0,0,0,5,0,5,Lombardia,ITC4
2021-01-05,PF/BT,000799,Casa di Cura Santa Maria - MultiMedica,LOM,40-49,7,23,0,30,0,0,0,30,0,30,Lombardia,ITC4
2021-01-05,PF/BT,000799,Casa di Cura Santa Maria - MultiMedica,LOM,50-59,8,23,0,30,1,0,0,31,0,31,Lombardia,ITC4
2021-01-05,PF/BT,000799,Casa di Cura Santa Maria - MultiMedica,LOM,60-69,2,5,0,7,0,0,0,7,0,7,Lombardia,ITC4
2021-01-05,PF/BT,002987,POLIAMBULATORIO OSPEDALE ESINE,LOM,20-29,1,5,0,5,1,0,0,6,0,6,Lombardia,ITC4
2021-01-05,PF/BT,002987,POLIAMBULATORIO OSPEDALE ESINE,LOM,30-39,2,16,0,8,10,0,0,18,0,18,Lombardia,ITC4
2021-01-05,PF/BT,002987,POLIAMBULATORIO OSPEDALE ESINE,LOM,40-49,8,22,0,21,9,0,0,30,0,30,Lombardia,ITC4
2021-01-05,PF/BT,002987,POLIAMBULATORIO OSPEDALE ESINE,LOM,50-59,10,33,0,36,7,0,0,43,0,43,Lombardia,ITC4
2021-01-05,PF/BT,002987,POLIAMBULATORIO OSPEDALE ESINE,LOM,60-69,4,7,0,8,3,0,0,11,0,11,Lombardia,ITC4
2021-01-05,PF/BT,003328,HUB COV CHIARI - P.O. ISEO -  ASST FRANCIACORTA,LOM,16-19,2,8,0,10,0,0,0,10,0,10,Lombardia,ITC4
2021-01-05,PF/BT,003328,HUB COV CHIARI - P.O. ISEO -  ASST FRANCIACORTA,LOM,20-29,9,23,0,29,3,0,0,32,0,32,Lombardia,ITC4
2021-01-05,PF/BT,003328,HUB COV CHIARI - P.O. ISEO -  ASST FRANCIACORTA,LOM,30-39,8,13,0,17,4,0,0,21,0,21,Lombardia,ITC4
2021-01-05,PF/BT,003328,HUB COV CHIARI - P.O. ISEO -  ASST FRANCIACORTA,LOM,40-49,12,14,0,22,4,0,0,26,0,26,Lombardia,ITC4
2021-01-05,PF/BT,003328,HUB COV CHIARI - P.O. ISEO -  ASST FRANCIACORTA,LOM,50-59,13,28,0,35,6,0,0,41,0,41,Lombardia,ITC4
2021-01-05,PF/BT,003328,HUB COV CHIARI - P.O. ISEO -  ASST FRANCIACORTA,LOM,60-69,9,5,0,10,4,0,0,14,0,14,Lombardia,ITC4
2021-01-05,PF/BT,003335,HUB COV CHIARI - P.O. CHIARI ASST FRANCIACORTA,LOM,20-29,8,18,0,17,9,0,0,26,0,26,Lombardia,ITC4
2021-01-05,PF/BT,003335,HUB COV CHIARI - P.O. CHIARI ASST FRANCIACORTA,LOM,30-39,16,24,0,35,5,0,0,40,0,40,Lombardia,ITC4
2021-01-05,PF/BT,003335,HUB COV CHIARI - P.O. CHIARI ASST FRANCIACORTA,LOM,40-49,15,27,0,35,7,0,0,42,0,42,Lombardia,ITC4
2021-01-05,PF/BT,003335,HUB COV CHIARI - P.O. CHIARI ASST FRANCIACORTA,LOM,50-59,20,26,0,31,15,0,0,46,0,46,Lombardia,ITC4
2021-01-05,PF/BT,003335,HUB COV CHIARI - P.O. CHIARI ASST FRANCIACORTA,LOM,60-69,8,4,0,10,2,0,0,12,0,12,Lombardia,ITC4
2021-01-05,PF/BT,003335,HUB COV CHIARI - P.O. CHIARI ASST FRANCIACORTA,LOM,70-79,2,0,0,1,1,0,0,2,0,2,Lombardia,ITC4
2021-01-05,PF/BT,030066,CV Garbagnate,LOM,20-29,5,6,0,10,1,0,0,11,0,11,Lombardia,ITC4
2021-01-05,PF/BT,030066,CV Garbagnate,LOM,30-39,5,8,0,13,0,0,0,13,0,13,Lombardia,ITC4
2021-01-05,PF/BT,030066,CV Garbagnate,LOM,40-49,12,14,0,26,0,0,0,26,0,26,Lombardia,ITC4
2021-01-05,PF/BT,030066,CV Garbagnate,LOM,50-59,22,46,0,57,11,0,0,68,0,68,Lombardia,ITC4
2021-01-05,PF/BT,030066,CV Garbagnate,LOM,60-69,9,17,0,21,5,0,0,26,0,26,Lombardia,ITC4
2021-01-05,PF/BT,030070,PUNTO VACCINALE OSPEDALIERO CARATE BRIANZA,LOM,20-29,1,7,0,8,0,0,0,8,0,8,Lombardia,ITC4
2021-01-05,PF/BT,030070,PUNTO VACCINALE OSPEDALIERO CARATE BRIANZA,LOM,30-39,4,11,0,14,1,0,0,15,0,15,Lombardia,ITC4
2021-01-05,PF/BT,030070,PUNTO VACCINALE OSPEDALIERO CARATE BRIANZA,LOM,40-49,7,36,0,40,3,0,0,43,0,43,Lombardia,ITC4
2021-01-05,PF/BT,030070,PUNTO VACCINALE OSPEDALIERO CARATE BRIANZA,LOM,50-59,13,48,0,55,6,0,0,61,0,61,Lombardia,ITC4
2021-01-05,PF/BT,030070,PUNTO VACCINALE OSPEDALIERO CARATE BRIANZA,LOM,60-69,5,9,0,10,4,0,0,14,0,14,Lombardia,ITC4
2021-01-05,PF/BT,030074,HUB COVID MAGENTA,LOM,20-29,1,2,0,2,1,0,0,3,0,3,Lombardia,ITC4
2021-01-05,PF/BT,030074,HUB COVID MAGENTA,LOM,30-39,8,18,0,23,3,0,0,26,0,26,Lombardia,ITC4
2021-01-05,PF/BT,030074,HUB COVID MAGENTA,LOM,40-49,5,32,0,34,3,0,0,37,0,37,Lombardia,ITC4
2021-01-05,PF/BT,030074,HUB COVID MAGENTA,LOM,50-59,17,49,0,55,11,0,0,66,0,66,Lombardia,ITC4
2021-01-05,PF/BT,030074,HUB COVID MAGENTA,LOM,60-69,4,14,0,15,3,0,0,18,0,18,Lombardia,ITC4
2021-01-05,PF/BT,030078,PUNTO VACCINALE OSPEDALIERO VIMERCATE,LOM,20-29,6,24,0,29,1,0,0,30,0,30,Lombardia,ITC4
2021-01-05,PF/BT,030078,PUNTO VACCINALE OSPEDALIERO VIMERCATE,LOM,30-39,19,25,0,39,5,0,0,44,0,44,Lombardia,ITC4
2021-01-05,PF/BT,030078,PUNTO VACCINALE OSPEDALIERO VIMERCATE,LOM,40-49,12,33,0,41,4,0,0,45,0,45,Lombardia,ITC4
2021-01-05,PF/BT,030078,PUNTO VACCINALE OSPEDALIERO VIMERCATE,LOM,50-59,19,61,0,68,12,0,0,80,0,80,Lombardia,ITC4
2021-01-05,PF/BT,030078,PUNTO VACCINALE OSPEDALIERO VIMERCATE,LOM,60-69,9,13,0,17,5,0,0,22,0,22,Lombardia,ITC4
2021-01-05,PF/BT,030704,Presidio Ospedaliero G. Pini,LOM,20-29,0,2,0,2,0,0,0,2,0,2,Lombardia,ITC4
2021-01-05,PF/BT,030704,Presidio Ospedaliero G. Pini,LOM,30-39,2,2,0,4,0,0,0,4,0,4,Lombardia,ITC4
2021-01-05,PF/BT,030704,Presidio Ospedaliero G. Pini,LOM,40-49,7,4,0,11,0,0,0,11,0,11,Lombardia,ITC4
2021-01-05,PF/BT,030704,Presidio Ospedaliero G. Pini,LOM,50-59,4,2,0,6,0,0,0,6,0,6,Lombardia,ITC4
2021-01-05,PF/BT,030704,Presidio Ospedaliero G. Pini,LOM,60-69,1,0,0,1,0,0,0,1,0,1,Lombardia,ITC4
2021-01-05,PF/BT,030903,AMB COVID LECCO,LOM,20-29,2,16,0,16,2,0,0,18,0,18,Lombardia,ITC4
2021-01-05,PF/BT,030903,AMB COVID LECCO,LOM,30-39,23,38,0,50,11,0,0,61,0,61,Lombardia,ITC4
2021-01-05,PF/BT,030903,AMB COVID LECCO,LOM,40-49,20,76,0,76,20,0,0,96,0,96,Lombardia,ITC4
2021-01-05,PF/BT,030903,AMB COVID LECCO,LOM,50-59,28,75,0,82,21,0,0,103,0,103,Lombardia,ITC4
2021-01-05,PF/BT,030903,AMB COVID LECCO,LOM,60-69,19,12,0,22,9,0,0,31,0,31,Lombardia,ITC4
2021-01-05,PF/BT,030922,"FOND.IRCCS ""ISTIT.NAZ.LE TUMORI""MILANO",LOM,20-29,0,6,0,6,0,0,0,6,0,6,Lombardia,ITC4
2021-01-05,PF/BT,030922,"FOND.IRCCS ""ISTIT.NAZ.LE TUMORI""MILANO",LOM,30-39,18,17,0,34,1,0,0,35,0,35,Lombardia,ITC4
2021-01-05,PF/BT,030922,"FOND.IRCCS ""ISTIT.NAZ.LE TUMORI""MILANO",LOM,40-49,15,24,0,39,0,0,0,39,0,39,Lombardia,ITC4
2021-01-05,PF/BT,030922,"FOND.IRCCS ""ISTIT.NAZ.LE TUMORI""MILANO",LOM,50-59,26,32,0,56,2,0,0,58,0,58,Lombardia,ITC4
2021-01-05,PF/BT,030922,"FOND.IRCCS ""ISTIT.NAZ.LE TUMORI""MILANO",LOM,60-69,14,10,0,24,0,0,0,24,0,24,Lombardia,ITC4
2021-01-05,PF/BT,030923,FOND.IRCCS IST.NAZ.NEUROLOGICO C.BESTA-M,LOM,20-29,4,5,0,9,0,0,0,9,0,9,Lombardia,ITC4
2021-01-05,PF/BT,030923,FOND.IRCCS IST.NAZ.NEUROLOGICO C.BESTA-M,LOM,30-39,6,16,0,18,4,0,0,22,0,22,Lombardia,ITC4
2021-01-05,PF/BT,030923,FOND.IRCCS IST.NAZ.NEUROLOGICO C.BESTA-M,LOM,40-49,7,15,0,16,6,0,0,22,0,22,Lombardia,ITC4
2021-01-05,PF/BT,030923,FOND.IRCCS IST.NAZ.NEUROLOGICO C.BESTA-M,LOM,50-59,4,18,0,16,6,0,0,22,0,22,Lombardia,ITC4
2021-01-05,PF/BT,030923,FOND.IRCCS IST.NAZ.NEUROLOGICO C.BESTA-M,LOM,60-69,3,4,0,7,0,0,0,7,0,7,Lombardia,ITC4
2021-01-05,PF/BT,030923,FOND.IRCCS IST.NAZ.NEUROLOGICO C.BESTA-M,LOM,70-79,0,1,0,1,0,0,0,1,0,1,Lombardia,ITC4
2021-01-05,PF/BT,030924,IRCCS POLICLINICO S. MATTEO - PAVIA,LOM,20-29,7,9,0,16,0,0,0,16,0,16,Lombardia,ITC4
2021-01-05,PF/BT,030924,IRCCS POLICLINICO S. MATTEO - PAVIA,LOM,30-39,9,13,0,22,0,0,0,22,0,22,Lombardia,ITC4
2021-01-05,PF/BT,030924,IRCCS POLICLINICO S. MATTEO - PAVIA,LOM,40-49,18,31,0,49,0,0,0,49,0,49,Lombardia,ITC4
2021-01-05,PF/BT,030924,IRCCS POLICLINICO S. MATTEO - PAVIA,LOM,50-59,11,16,0,27,0,0,0,27,0,27,Lombardia,ITC4
2021-01-05,PF/BT,030924,IRCCS POLICLINICO S. MATTEO - PAVIA,LOM,60-69,5,1,0,6,0,0,0,6,0,6,Lombardia,ITC4
2021-01-05,PF/BT,030925,Fondazione IRCCS Ca' Granda Ospedale Maggiore Policlinico,LOM,20-29,23,34,0,55,2,0,0,57,0,57,Lombardia,ITC4
2021-01-05,PF/BT,030925,Fondazione IRCCS Ca' Granda Ospedale Maggiore Policlinico,LOM,30-39,29,54,0,78,5,0,0,83,0,83,Lombardia,ITC4
2021-01-05,PF/BT,030925,Fondazione IRCCS Ca' Granda Ospedale Maggiore Policlinico,LOM,40-49,28,31,0,52,7,0,0,59,0,59,Lombardia,ITC4
2021-01-05,PF/BT,030925,Fondazione IRCCS Ca' Granda Ospedale Maggiore Policlinico,LOM,50-59,16,32,0,43,5,0,0,48,0,48,Lombardia,ITC4
2021-01-05,PF/BT,030925,Fondazione IRCCS Ca' Granda Ospedale Maggiore Policlinico,LOM,60-69,11,9,0,19,1,0,0,20,0,20,Lombardia,ITC4
2021-01-05,PF/BT,030925,Fondazione IRCCS Ca' Granda Ospedale Maggiore Policlinico,LOM,70-79,1,1,0,2,0,0,0,2,0,2,Lombardia,ITC4
2021-01-05,PF/BT,030943,Istituto Clinico Humanitas,LOM,20-29,24,24,0,47,1,0,0,48,0,48,Lombardia,ITC4
2021-01-05,PF/BT,030943,Istituto Clinico Humanitas,LOM,30-39,25,30,0,54,1,0,0,55,0,55,Lombardia,ITC4
2021-01-05,PF/BT,030943,Istituto Clinico Humanitas,LOM,40-49,18,42,0,58,2,0,0,60,0,60,Lombardia,ITC4
2021-01-05,PF/BT,030943,Istituto Clinico Humanitas,LOM,50-59,17,22,0,39,0,0,0,39,0,39,Lombardia,ITC4
2021-01-05,PF/BT,030943,Istituto Clinico Humanitas,LOM,60-69,13,6,0,18,1,0,0,19,0,19,Lombardia,ITC4
2021-01-05,PF/BT,030943,Istituto Clinico Humanitas,LOM,70-79,1,0,0,1,0,0,0,1,0,1,Lombardia,ITC4
2021-01-05,PF/BT,30071,Centro Vaccinale Covid Melzo - ASST Melegnano Martesana,LOM,20-29,2,0,0,2,0,0,0,2,0,2,Lombardia,ITC4
2021-01-05,PF/BT,30071,Centro Vaccinale Covid Melzo - ASST Melegnano Martesana,LOM,30-39,2,4,0,6,0,0,0,6,0,6,Lombardia,ITC4
2021-01-05,PF/BT,30071,Centro Vaccinale Covid Melzo - ASST Melegnano Martesana,LOM,40-49,4,12,0,16,0,0,0,16,0,16,Lombardia,ITC4
2021-01-05,PF/BT,30071,Centro Vaccinale Covid Melzo - ASST Melegnano Martesana,LOM,50-59,7,22,0,29,0,0,0,29,0,29,Lombardia,ITC4
2021-01-05,PF/BT,30071,Centro Vaccinale Covid Melzo - ASST Melegnano Martesana,LOM,60-69,3,4,0,7,0,0,0,7,0,7,Lombardia,ITC4
2021-01-05,PF/BT,30072,Centro Vaccinale Covid Vizzolo - ASST Melegnano Martesana,LOM,20-29,0,3,0,3,0,0,0,3,0,3,Lombardia,ITC4
2021-01-05,PF/BT,30072,Centro Vaccinale Covid Vizzolo - ASST Melegnano Martesana,LOM,30-39,4,11,0,14,1,0,0,15,0,15,Lombardia,ITC4
2021-01-05,PF/BT,30072,Centro Vaccinale Covid Vizzolo - ASST Melegnano Martesana,LOM,40-49,6,15,0,20,1,0,0,21,0,21,Lombardia,ITC4
2021-01-05,PF/BT,30072,Centro Vaccinale Covid Vizzolo - ASST Melegnano Martesana,LOM,50-59,8,29,0,32,5,0,0,37,0,37,Lombardia,ITC4
2021-01-05,PF/BT,30072,Centro Vaccinale Covid Vizzolo - ASST Melegnano Martesana,LOM,60-69,4,10,0,11,3,0,0,14,0,14,Lombardia,ITC4
2021-01-05,PF/BT,30073,cv rho,LOM,20-29,1,5,0,6,0,0,0,6,0,6,Lombardia,ITC4
2021-01-05,PF/BT,30073,cv rho,LOM,30-39,6,8,0,14,0,0,0,14,0,14,Lombardia,ITC4
2021-01-05,PF/BT,30073,cv rho,LOM,40-49,7,20,0,27,0,0,0,27,0,27,Lombardia,ITC4
2021-01-05,PF/BT,30073,cv rho,LOM,50-59,11,30,0,35,6,0,0,41,0,41,Lombardia,ITC4
2021-01-05,PF/BT,30073,cv rho,LOM,60-69,7,7,0,13,1,0,0,14,0,14,Lombardia,ITC4
2021-01-05,PF/BT,30156,Centro Vaccinale Covid Desenzano,LOM,20-29,3,16,0,14,5,0,0,19,0,19,Lombardia,ITC4
2021-01-05,PF/BT,30156,Centro Vaccinale Covid Desenzano,LOM,30-39,8,8,0,12,4,0,0,16,0,16,Lombardia,ITC4
2021-01-05,PF/BT,30156,Centro Vaccinale Covid Desenzano,LOM,40-49,9,10,0,12,7,0,0,19,0,19,Lombardia,ITC4
2021-01-05,PF/BT,30156,Centro Vaccinale Covid Desenzano,LOM,50-59,10,24,0,27,7,0,0,34,0,34,Lombardia,ITC4
2021-01-05,PF/BT,30156,Centro Vaccinale Covid Desenzano,LOM,60-69,6,8,0,8,6,0,0,14,0,14,Lombardia,ITC4
2021-01-05,PF/BT,30157,Centro Vaccinale Covid Gavardo,LOM,20-29,2,3,0,3,2,0,0,5,0,5,Lombardia,ITC4
2021-01-05,PF/BT,30157,Centro Vaccinale Covid Gavardo,LOM,30-39,3,6,0,9,0,0,0,9,0,9,Lombardia,ITC4
2021-01-05,PF/BT,30157,Centro Vaccinale Covid Gavardo,LOM,40-49,4,21,0,20,5,0,0,25,0,25,Lombardia,ITC4
2021-01-05,PF/BT,30157,Centro Vaccinale Covid Gavardo,LOM,50-59,11,14,0,15,10,0,0,25,0,25,Lombardia,ITC4
2021-01-05,PF/BT,30157,Centro Vaccinale Covid Gavardo,LOM,60-69,3,5,0,6,2,0,0,8,0,8,Lombardia,ITC4
2021-01-05,PF/BT,30184,Centro Vaccinale Covid Manerbio,LOM,20-29,0,7,0,3,0,0,4,7,0,7,Lombardia,ITC4
2021-01-05,PF/BT,30184,Centro Vaccinale Covid Manerbio,LOM,30-39,4,5,0,6,1,0,2,9,0,9,Lombardia,ITC4
2021-01-05,PF/BT,30184,Centro Vaccinale Covid Manerbio,LOM,40-49,6,19,0,21,1,0,3,25,0,25,Lombardia,ITC4
2021-01-05,PF/BT,30184,Centro Vaccinale Covid Manerbio,LOM,50-59,8,35,0,35,6,0,2,43,0,43,Lombardia,ITC4
2021-01-05,PF/BT,30184,Centro Vaccinale Covid Manerbio,LOM,60-69,6,6,0,9,2,0,1,12,0,12,Lombardia,ITC4
2021-01-05,PF/BT,30193,Ambulatorio HUB Vigevano,LOM,20-29,4,15,0,17,2,0,0,19,0,19,Lombardia,ITC4
2021-01-05,PF/BT,30193,Ambulatorio HUB Vigevano,LOM,30-39,14,16,0,26,4,0,0,30,0,30,Lombardia,ITC4
2021-01-05,PF/BT,30193,Ambulatorio HUB Vigevano,LOM,40-49,12,39,0,46,5,0,0,51,0,51,Lombardia,ITC4
2021-01-05,PF/BT,30193,Ambulatorio HUB Vigevano,LOM,50-59,8,43,0,43,8,0,0,51,0,51,Lombardia,ITC4
2021-01-05,PF/BT,30193,Ambulatorio HUB Vigevano,LOM,60-69,8,4,0,12,0,0,0,12,0,12,Lombardia,ITC4
2021-01-05,PF/BT,30209,OSPEDALE MAGGIORE DI CREMA,LOM,20-29,1,6,0,6,1,0,0,7,0,7,Lombardia,ITC4
2021-01-05,PF/BT,30209,OSPEDALE MAGGIORE DI CREMA,LOM,30-39,9,15,0,21,3,0,0,24,0,24,Lombardia,ITC4
2021-01-05,PF/BT,30209,OSPEDALE MAGGIORE DI CREMA,LOM,40-49,7,20,0,21,6,0,0,27,0,27,Lombardia,ITC4
2021-01-05,PF/BT,30209,OSPEDALE MAGGIORE DI CREMA,LOM,50-59,7,39,0,38,8,0,0,46,0,46,Lombardia,ITC4
2021-01-05,PF/BT,30209,OSPEDALE MAGGIORE DI CREMA,LOM,60-69,5,5,0,6,4,0,0,10,0,10,Lombardia,ITC4
2021-01-05,PF/BT,30281,HUB COVID LEGNANO,LOM,20-29,1,14,0,14,1,0,0,15,0,15,Lombardia,ITC4
2021-01-05,PF/BT,30281,HUB COVID LEGNANO,LOM,30-39,9,22,0,20,11,0,0,31,0,31,Lombardia,ITC4
2021-01-05,PF/BT,30281,HUB COVID LEGNANO,LOM,40-49,16,37,0,44,9,0,0,53,0,53,Lombardia,ITC4
2021-01-05,PF/BT,30281,HUB COVID LEGNANO,LOM,50-59,15,51,0,66,0,0,0,66,0,66,Lombardia,ITC4
2021-01-05,PF/BT,30281,HUB COVID LEGNANO,LOM,60-69,14,13,0,27,0,0,0,27,0,27,Lombardia,ITC4
2021-01-05,PF/BT,30701,ASST GRANDE OSPEDALE METROPOLITANO NIGUARDA,LOM,20-29,21,45,0,59,5,0,2,66,0,66,Lombardia,ITC4
2021-01-05,PF/BT,30701,ASST GRANDE OSPEDALE METROPOLITANO NIGUARDA,LOM,30-39,59,65,0,109,11,0,4,124,0,124,Lombardia,ITC4
2021-01-05,PF/BT,30701,ASST GRANDE OSPEDALE METROPOLITANO NIGUARDA,LOM,40-49,51,70,0,99,21,0,1,121,0,121,Lombardia,ITC4
2021-01-05,PF/BT,30701,ASST GRANDE OSPEDALE METROPOLITANO NIGUARDA,LOM,50-59,42,106,0,107,38,0,3,148,0,148,Lombardia,ITC4
2021-01-05,PF/BT,30701,ASST GRANDE OSPEDALE METROPOLITANO NIGUARDA,LOM,60-69,24,21,0,35,10,0,0,45,0,45,Lombardia,ITC4
2021-01-05,PF/BT,30701,ASST GRANDE OSPEDALE METROPOLITANO NIGUARDA,LOM,70-79,3,1,0,2,0,0,2,4,0,4,Lombardia,ITC4
2021-01-05,PF/BT,30712,Ospedale Sant'Anna - Via Napoleona - Como,LOM,20-29,0,6,0,6,0,0,0,6,0,6,Lombardia,ITC4
2021-01-05,PF/BT,30712,Ospedale Sant'Anna - Via Napoleona - Como,LOM,30-39,3,5,0,8,0,0,0,8,0,8,Lombardia,ITC4
2021-01-05,PF/BT,30712,Ospedale Sant'Anna - Via Napoleona - Como,LOM,40-49,2,11,0,13,0,0,0,13,0,13,Lombardia,ITC4
2021-01-05,PF/BT,30712,Ospedale Sant'Anna - Via Napoleona - Como,LOM,50-59,0,21,0,21,0,0,0,21,0,21,Lombardia,ITC4
2021-01-05,PF/BT,30712,Ospedale Sant'Anna - Via Napoleona - Como,LOM,60-69,0,3,0,3,0,0,0,3,0,3,Lombardia,ITC4
2021-01-05,PF/BT,30712,Ospedale Sant'Anna - Via Napoleona - Como,LOM,70-79,3,0,0,3,0,0,0,3,0,3,Lombardia,ITC4
2021-01-05,PF/BT,30718,ASST PAPA GIOVANNI XXIII,LOM,20-29,5,15,0,18,2,0,0,20,0,20,Lombardia,ITC4
2021-01-05,PF/BT,30718,ASST PAPA GIOVANNI XXIII,LOM,30-39,10,20,0,28,2,0,0,30,0,30,Lombardia,ITC4
2021-01-05,PF/BT,30718,ASST PAPA GIOVANNI XXIII,LOM,40-49,15,23,0,35,3,0,0,38,0,38,Lombardia,ITC4
2021-01-05,PF/BT,30718,ASST PAPA GIOVANNI XXIII,LOM,50-59,19,33,0,49,3,0,0,52,0,52,Lombardia,ITC4
2021-01-05,PF/BT,30718,ASST PAPA GIOVANNI XXIII,LOM,60-69,9,6,0,13,2,0,0,15,0,15,Lombardia,ITC4
2021-01-05,PF/BT,30902,Ospedale S.Anna - Como,LOM,20-29,4,11,0,15,0,0,0,15,0,15,Lombardia,ITC4
2021-01-05,PF/BT,30902,Ospedale S.Anna - Como,LOM,30-39,9,29,0,37,1,0,0,38,0,38,Lombardia,ITC4
2021-01-05,PF/BT,30902,Ospedale S.Anna - Como,LOM,40-49,15,29,0,41,3,0,0,44,0,44,Lombardia,ITC4
2021-01-05,PF/BT,30902,Ospedale S.Anna - Como,LOM,50-59,15,27,0,36,6,0,0,42,0,42,Lombardia,ITC4
2021-01-05,PF/BT,30902,Ospedale S.Anna - Como,LOM,60-69,6,5,0,10,1,0,0,11,0,11,Lombardia,ITC4
2021-01-05,PF/BT,30909,AMBULATORIO COVID MONZA,LOM,20-29,9,11,0,20,0,0,0,20,0,20,Lombardia,ITC4
2021-01-05,PF/BT,30909,AMBULATORIO COVID MONZA,LOM,30-39,30,43,0,72,1,0,0,73,0,73,Lombardia,ITC4
2021-01-05,PF/BT,30909,AMBULATORIO COVID MONZA,LOM,40-49,19,37,0,55,1,0,0,56,0,56,Lombardia,ITC4
2021-01-05,PF/BT,30909,AMBULATORIO COVID MONZA,LOM,50-59,18,47,0,62,3,0,0,65,0,65,Lombardia,ITC4
2021-01-05,PF/BT,30909,AMBULATORIO COVID MONZA,LOM,60-69,13,12,0,24,0,0,1,25,0,25,Lombardia,ITC4
2021-01-05,PF/BT,30909,AMBULATORIO COVID MONZA,LOM,70-79,0,1,0,0,0,0,1,1,0,1,Lombardia,ITC4
2021-01-05,PF/BT,30935,IRCCS    S. RAFFAELE - MILANO,LOM,20-29,12,12,0,24,0,0,0,24,0,24,Lombardia,ITC4
2021-01-05,PF/BT,30935,IRCCS    S. RAFFAELE - MILANO,LOM,30-39,9,13,0,22,0,0,0,22,0,22,Lombardia,ITC4
2021-01-05,PF/BT,30935,IRCCS    S. RAFFAELE - MILANO,LOM,40-49,6,11,0,17,0,0,0,17,0,17,Lombardia,ITC4
2021-01-05,PF/BT,30935,IRCCS    S. RAFFAELE - MILANO,LOM,50-59,10,13,0,23,0,0,0,23,0,23,Lombardia,ITC4
2021-01-05,PF/BT,30935,IRCCS    S. RAFFAELE - MILANO,LOM,60-69,34,50,0,84,0,0,0,84,0,84,Lombardia,ITC4
2021-01-05,PF/BT,30935,IRCCS    S. RAFFAELE - MILANO,LOM,70-79,3,0,0,3,0,0,0,3,0,3,Lombardia,ITC4
2021-01-05,PF/BT,321000682,RSA CENTRO PADRE AMBROSOLI GIUSEPPE,LOM,20-29,0,1,0,1,0,0,0,1,0,1,Lombardia,ITC4
2021-01-05,PF/BT,321000682,RSA CENTRO PADRE AMBROSOLI GIUSEPPE,LOM,30-39,1,2,0,3,0,0,0,3,0,3,Lombardia,ITC4
2021-01-05,PF/BT,321000682,RSA CENTRO PADRE AMBROSOLI GIUSEPPE,LOM,40-49,1,0,0,1,0,0,0,1,0,1,Lombardia,ITC4
2021-01-05,PF/BT,321000682,RSA CENTRO PADRE AMBROSOLI GIUSEPPE,LOM,50-59,1,3,0,3,0,1,0,4,0,4,Lombardia,ITC4
2021-01-05,PF/BT,321000682,RSA CENTRO PADRE AMBROSOLI GIUSEPPE,LOM,60-69,7,1,0,2,0,6,0,8,0,8,Lombardia,ITC4
2021-01-05,PF/BT,321000682,RSA CENTRO PADRE AMBROSOLI GIUSEPPE,LOM,70-79,4,0,0,0,0,4,0,4,0,4,Lombardia,ITC4
2021-01-05,PF/BT,321000682,RSA CENTRO PADRE AMBROSOLI GIUSEPPE,LOM,80-89,10,0,0,0,0,10,0,10,0,10,Lombardia,ITC4
2021-01-05,PF/BT,321000682,RSA CENTRO PADRE AMBROSOLI GIUSEPPE,LOM,90+,5,0,0,0,0,5,0,5,0,5,Lombardia,ITC4
2021-01-05,PF/BT,32170712,ambulatorio covid SESTO SAN GIOVANNI,LOM,20-29,1,0,0,1,0,0,0,1,0,1,Lombardia,ITC4
2021-01-05,PF/BT,32170712,ambulatorio covid SESTO SAN GIOVANNI,LOM,30-39,6,3,0,8,1,0,0,9,0,9,Lombardia,ITC4
2021-01-05,PF/BT,32170712,ambulatorio covid SESTO SAN GIOVANNI,LOM,40-49,0,9,0,9,0,0,0,9,0,9,Lombardia,ITC4
2021-01-05,PF/BT,32170712,ambulatorio covid SESTO SAN GIOVANNI,LOM,50-59,7,15,0,20,2,0,0,22,0,22,Lombardia,ITC4
2021-01-05,PF/BT,32170712,ambulatorio covid SESTO SAN GIOVANNI,LOM,60-69,5,2,0,7,0,0,0,7,0,7,Lombardia,ITC4
2021-01-05,PF/BT,32271022,"ambulatorio covid Varese , ambulatorio covid Tradate , ambulatorio covid Luino",LOM,20-29,12,29,0,41,0,0,0,41,0,41,Lombardia,ITC4
2021-01-05,PF/BT,32271022,"ambulatorio covid Varese , ambulatorio covid Tradate , ambulatorio covid Luino",LOM,30-39,30,52,0,82,0,0,0,82,0,82,Lombardia,ITC4
2021-01-05,PF/BT,32271022,"ambulatorio covid Varese , ambulatorio covid Tradate , ambulatorio covid Luino",LOM,40-49,16,62,0,78,0,0,0,78,0,78,Lombardia,ITC4
2021-01-05,PF/BT,32271022,"ambulatorio covid Varese , ambulatorio covid Tradate , ambulatorio covid Luino",LOM,50-59,27,82,0,109,0,0,0,109,0,109,Lombardia,ITC4
2021-01-05,PF/BT,32271022,"ambulatorio covid Varese , ambulatorio covid Tradate , ambulatorio covid Luino",LOM,60-69,20,22,0,42,0,0,0,42,0,42,Lombardia,ITC4
2021-01-05,PF/BT,32572027,Ambulatorio COVID SERIATE,LOM,20-29,2,14,0,16,0,0,0,16,0,16,Lombardia,ITC4
2021-01-05,PF/BT,32572027,Ambulatorio COVID SERIATE,LOM,30-39,7,16,0,21,0,0,2,23,0,23,Lombardia,ITC4
2021-01-05,PF/BT,32572027,Ambulatorio COVID SERIATE,LOM,40-49,8,37,0,44,1,0,0,45,0,45,Lombardia,ITC4
2021-01-05,PF/BT,32572027,Ambulatorio COVID SERIATE,LOM,50-59,13,38,0,50,1,0,0,51,0,51,Lombardia,ITC4
2021-01-05,PF/BT,32572027,Ambulatorio COVID SERIATE,LOM,60-69,5,8,0,13,0,0,0,13,0,13,Lombardia,ITC4
2021-01-05,PF/BT,32572027,Ambulatorio COVID SERIATE,LOM,70-79,1,0,0,1,0,0,0,1,0,1,Lombardia,ITC4
2021-01-05,PF/BT,32772407,cv cremona,LOM,20-29,10,12,0,21,1,0,0,22,0,22,Lombardia,ITC4
2021-01-05,PF/BT,32772407,cv cremona,LOM,30-39,18,33,0,50,1,0,0,51,0,51,Lombardia,ITC4
2021-01-05,PF/BT,32772407,cv cremona,LOM,40-49,12,43,0,54,1,0,0,55,0,55,Lombardia,ITC4
2021-01-05,PF/BT,32772407,cv cremona,LOM,50-59,18,74,0,88,4,0,0,92,0,92,Lombardia,ITC4
2021-01-05,PF/BT,32772407,cv cremona,LOM,60-69,9,11,0,19,1,0,0,20,0,20,Lombardia,ITC4
2021-01-05,PF/BT,32772513,Ambulatorio COVID MANTOVA,LOM,20-29,6,11,0,17,0,0,0,17,0,17,Lombardia,ITC4
2021-01-05,PF/BT,32772513,Ambulatorio COVID MANTOVA,LOM,30-39,15,36,0,48,3,0,0,51,0,51,Lombardia,ITC4
2021-01-05,PF/BT,32772513,Ambulatorio COVID MANTOVA,LOM,40-49,20,45,0,60,5,0,0,65,0,65,Lombardia,ITC4
2021-01-05,PF/BT,32772513,Ambulatorio COVID MANTOVA,LOM,50-59,31,51,0,68,14,0,0,82,0,82,Lombardia,ITC4
2021-01-05,PF/BT,32772513,Ambulatorio COVID MANTOVA,LOM,60-69,15,7,0,21,1,0,0,22,0,22,Lombardia,ITC4
2021-01-05,PF/BT,32772513,ASST DI MANTOVA - POMA,LOM,20-29,6,11,0,17,0,0,0,17,0,17,Lombardia,ITC4
2021-01-05,PF/BT,32772513,ASST DI MANTOVA - POMA,LOM,30-39,15,36,0,48,3,0,0,51,0,51,Lombardia,ITC4
2021-01-05,PF/BT,32772513,ASST DI MANTOVA - POMA,LOM,40-49,20,45,0,60,5,0,0,65,0,65,Lombardia,ITC4
2021-01-05,PF/BT,32772513,ASST DI MANTOVA - POMA,LOM,50-59,31,51,0,68,14,0,0,82,0,82,Lombardia,ITC4
2021-01-05,PF/BT,32772513,ASST DI MANTOVA - POMA,LOM,60-69,15,7,0,21,1,0,0,22,0,22,Lombardia,ITC4
2021-01-05,PF/BT,558,RSA PIO ALBERGO TRIVULZIO,LOM,20-29,3,7,0,8,2,0,0,10,0,10,Lombardia,ITC4
2021-01-05,PF/BT,558,RSA PIO ALBERGO TRIVULZIO,LOM,30-39,6,17,0,17,6,0,0,23,0,23,Lombardia,ITC4
2021-01-05,PF/BT,558,RSA PIO ALBERGO TRIVULZIO,LOM,40-49,9,18,0,19,7,1,0,27,0,27,Lombardia,ITC4
2021-01-05,PF/BT,558,RSA PIO ALBERGO TRIVULZIO,LOM,50-59,15,27,0,30,11,1,0,42,0,42,Lombardia,ITC4
2021-01-05,PF/BT,558,RSA PIO ALBERGO TRIVULZIO,LOM,60-69,9,13,0,12,2,8,0,22,0,22,Lombardia,ITC4
2021-01-05,PF/BT,558,RSA PIO ALBERGO TRIVULZIO,LOM,70-79,2,13,0,0,0,15,0,15,0,15,Lombardia,ITC4
2021-01-05,PF/BT,558,RSA PIO ALBERGO TRIVULZIO,LOM,80-89,13,49,0,0,0,62,0,62,0,62,Lombardia,ITC4
2021-01-05,PF/BT,558,RSA PIO ALBERGO TRIVULZIO,LOM,90+,12,63,0,0,0,75,0,75,0,75,Lombardia,ITC4
2021-01-05,PF/BT,947,I.R.C.C.S. POLICLINICO SAN DONATO,LOM,20-29,5,1,0,5,1,0,0,6,0,6,Lombardia,ITC4
2021-01-05,PF/BT,947,I.R.C.C.S. POLICLINICO SAN DONATO,LOM,30-39,9,11,0,16,4,0,0,20,0,20,Lombardia,ITC4
2021-01-05,PF/BT,947,I.R.C.C.S. POLICLINICO SAN DONATO,LOM,40-49,14,16,0,23,6,0,1,30,0,30,Lombardia,ITC4
2021-01-05,PF/BT,947,I.R.C.C.S. POLICLINICO SAN DONATO,LOM,50-59,17,15,0,28,4,0,0,32,0,32,Lombardia,ITC4
2021-01-05,PF/BT,947,I.R.C.C.S. POLICLINICO SAN DONATO,LOM,60-69,4,7,0,11,0,0,0,11,0,11,Lombardia,ITC4
2021-01-05,PF/BT,HPS11/11bis,ASST SPEDALI CIVILI AMBULATORIO COVID BRESCIA,LOM,20-29,10,46,0,54,2,0,0,56,0,56,Lombardia,ITC4
2021-01-05,PF/BT,HPS11/11bis,ASST SPEDALI CIVILI AMBULATORIO COVID BRESCIA,LOM,30-39,18,72,0,87,3,0,0,90,0,90,Lombardia,ITC4
2021-01-05,PF/BT,HPS11/11bis,ASST SPEDALI CIVILI AMBULATORIO COVID BRESCIA,LOM,40-49,34,87,0,113,8,0,0,121,0,121,Lombardia,ITC4
2021-01-05,PF/BT,HPS11/11bis,ASST SPEDALI CIVILI AMBULATORIO COVID BRESCIA,LOM,50-59,38,92,0,116,14,0,0,130,0,130,Lombardia,ITC4
2021-01-05,PF/BT,HPS11/11bis,ASST SPEDALI CIVILI AMBULATORIO COVID BRESCIA,LOM,60-69,10,31,0,35,6,0,0,41,0,41,Lombardia,ITC4
2021-01-05,PF/BT,HSP11-11bis,32170224  HUB COVID OSP. SAN CARLO,LOM,20-29,3,10,0,13,0,0,0,13,0,13,Lombardia,ITC4
2021-01-05,PF/BT,HSP11-11bis,32170224  HUB COVID OSP. SAN CARLO,LOM,30-39,17,11,0,25,3,0,0,28,0,28,Lombardia,ITC4
2021-01-05,PF/BT,HSP11-11bis,32170224  HUB COVID OSP. SAN CARLO,LOM,40-49,12,34,0,42,4,0,0,46,0,46,Lombardia,ITC4
2021-01-05,PF/BT,HSP11-11bis,32170224  HUB COVID OSP. SAN CARLO,LOM,50-59,12,28,0,33,7,0,0,40,0,40,Lombardia,ITC4
2021-01-05,PF/BT,HSP11-11bis,32170224  HUB COVID OSP. SAN CARLO,LOM,60-69,5,10,0,14,1,0,0,15,0,15,Lombardia,ITC4
2021-01-05,PF/BT,HSP11-11bis,Ambulatorio COVID PO Casalpusterlengo,LOM,20-29,1,5,0,6,0,0,0,6,0,6,Lombardia,ITC4
2021-01-05,PF/BT,HSP11-11bis,Ambulatorio COVID PO Casalpusterlengo,LOM,30-39,4,13,0,16,1,0,0,17,0,17,Lombardia,ITC4
2021-01-05,PF/BT,HSP11-11bis,Ambulatorio COVID PO Casalpusterlengo,LOM,40-49,4,19,0,22,1,0,0,23,0,23,Lombardia,ITC4
2021-01-05,PF/BT,HSP11-11bis,Ambulatorio COVID PO Casalpusterlengo,LOM,50-59,5,30,0,34,1,0,0,35,0,35,Lombardia,ITC4
2021-01-05,PF/BT,HSP11-11bis,Ambulatorio COVID PO Casalpusterlengo,LOM,60-69,3,5,0,8,0,0,0,8,0,8,Lombardia,ITC4
2021-01-05,PF/BT,HSP11-11bis,Ambulatorio COVID PO Casalpusterlengo,LOM,70-79,1,0,0,1,0,0,0,1,0,1,Lombardia,ITC4
2021-01-05,PF/BT,HSP11-11bis,Ambulatorio COVID PO Codogno,LOM,20-29,2,7,0,5,4,0,0,9,0,9,Lombardia,ITC4
2021-01-05,PF/BT,HSP11-11bis,Ambulatorio COVID PO Codogno,LOM,30-39,7,5,0,8,4,0,0,12,0,12,Lombardia,ITC4
2021-01-05,PF/BT,HSP11-11bis,Ambulatorio COVID PO Codogno,LOM,40-49,7,22,0,25,4,0,0,29,0,29,Lombardia,ITC4
2021-01-05,PF/BT,HSP11-11bis,Ambulatorio COVID PO Codogno,LOM,50-59,9,28,0,32,5,0,0,37,0,37,Lombardia,ITC4
2021-01-05,PF/BT,HSP11-11bis,Ambulatorio COVID PO Codogno,LOM,60-69,2,7,0,6,3,0,0,9,0,9,Lombardia,ITC4
2021-01-05,PF/BT,HSP11-11bis,Ambulatorio COVID PO LODI,LOM,20-29,5,7,0,12,0,0,0,12,0,12,Lombardia,ITC4
2021-01-05,PF/BT,HSP11-11bis,Ambulatorio COVID PO LODI,LOM,30-39,13,21,0,30,4,0,0,34,0,34,Lombardia,ITC4
2021-01-05,PF/BT,HSP11-11bis,Ambulatorio COVID PO LODI,LOM,40-49,10,30,0,30,10,0,0,40,0,40,Lombardia,ITC4
2021-01-05,PF/BT,HSP11-11bis,Ambulatorio COVID PO LODI,LOM,50-59,10,43,0,39,14,0,0,53,0,53,Lombardia,ITC4
2021-01-05,PF/BT,HSP11-11bis,Ambulatorio COVID PO LODI,LOM,60-69,5,15,0,14,6,0,0,20,0,20,Lombardia,ITC4
2021-01-05,PF/BT,HSP11-11bis,Ambulatorio COVID PO LODI,LOM,70-79,2,1,0,1,2,0,0,3,0,3,Lombardia,ITC4
2021-01-05,PF/BT,HSP11-11bis,Ambulatorio COVID PO S.Angelo Lod.,LOM,20-29,2,5,0,7,0,0,0,7,0,7,Lombardia,ITC4
2021-01-05,PF/BT,HSP11-11bis,Ambulatorio COVID PO S.Angelo Lod.,LOM,30-39,6,4,0,10,0,0,0,10,0,10,Lombardia,ITC4
2021-01-05,PF/BT,HSP11-11bis,Ambulatorio COVID PO S.Angelo Lod.,LOM,40-49,5,19,0,23,1,0,0,24,0,24,Lombardia,ITC4
2021-01-05,PF/BT,HSP11-11bis,Ambulatorio COVID PO S.Angelo Lod.,LOM,50-59,8,14,0,17,5,0,0,22,0,22,Lombardia,ITC4
2021-01-05,PF/BT,HSP11-11bis,Ambulatorio COVID PO S.Angelo Lod.,LOM,60-69,2,1,0,2,1,0,0,3,0,3,Lombardia,ITC4
2021-01-05,PF/BT,HSP11-11bis,ASST BERGAMO OVEST - OSPEDALE ROMANO DI L.DIA,LOM,20-29,5,5,0,10,0,0,0,10,0,10,Lombardia,ITC4
2021-01-05,PF/BT,HSP11-11bis,ASST BERGAMO OVEST - OSPEDALE ROMANO DI L.DIA,LOM,30-39,2,6,0,5,1,0,2,8,0,8,Lombardia,ITC4
2021-01-05,PF/BT,HSP11-11bis,ASST BERGAMO OVEST - OSPEDALE ROMANO DI L.DIA,LOM,40-49,6,19,0,21,2,0,2,25,0,25,Lombardia,ITC4
2021-01-05,PF/BT,HSP11-11bis,ASST BERGAMO OVEST - OSPEDALE ROMANO DI L.DIA,LOM,50-59,8,21,0,23,3,0,3,29,0,29,Lombardia,ITC4
2021-01-05,PF/BT,HSP11-11bis,ASST BERGAMO OVEST - OSPEDALE ROMANO DI L.DIA,LOM,60-69,6,4,0,6,1,0,3,10,0,10,Lombardia,ITC4
2021-01-05,PF/BT,HSP11-11bis,ASST BERGAMO OVEST - OSPEDALE ROMANO DI L.DIA,LOM,70-79,2,0,0,0,0,0,2,2,0,2,Lombardia,ITC4
2021-01-05,PF/BT,HSP11-11bis,ASST BERGAMO OVEST - OSPEDALE TREVIGLIO,LOM,20-29,2,6,0,8,0,0,0,8,0,8,Lombardia,ITC4
2021-01-05,PF/BT,HSP11-11bis,ASST BERGAMO OVEST - OSPEDALE TREVIGLIO,LOM,30-39,8,11,0,18,0,0,1,19,0,19,Lombardia,ITC4
2021-01-05,PF/BT,HSP11-11bis,ASST BERGAMO OVEST - OSPEDALE TREVIGLIO,LOM,40-49,8,22,0,26,4,0,0,30,0,30,Lombardia,ITC4
2021-01-05,PF/BT,HSP11-11bis,ASST BERGAMO OVEST - OSPEDALE TREVIGLIO,LOM,50-59,6,25,0,29,2,0,0,31,0,31,Lombardia,ITC4
2021-01-05,PF/BT,HSP11-11bis,ASST BERGAMO OVEST - OSPEDALE TREVIGLIO,LOM,60-69,3,5,0,7,1,0,0,8,0,8,Lombardia,ITC4
2021-01-05,PF/BT,HSP11-11bis - 703,AMBULATORIO OSPEDALE SACCO,LOM,20-29,8,25,0,33,0,0,0,33,0,33,Lombardia,ITC4
2021-01-05,PF/BT,HSP11-11bis - 703,AMBULATORIO OSPEDALE SACCO,LOM,30-39,24,33,0,57,0,0,0,57,0,57,Lombardia,ITC4
2021-01-05,PF/BT,HSP11-11bis - 703,AMBULATORIO OSPEDALE SACCO,LOM,40-49,15,44,0,59,0,0,0,59,0,59,Lombardia,ITC4
2021-01-05,PF/BT,HSP11-11bis - 703,AMBULATORIO OSPEDALE SACCO,LOM,50-59,15,50,0,65,0,0,0,65,0,65,Lombardia,ITC4
2021-01-05,PF/BT,HSP11-11bis - 703,AMBULATORIO OSPEDALE SACCO,LOM,60-69,16,10,0,26,0,0,0,26,0,26,Lombardia,ITC4
2021-01-06,PF/BT,.030042,ASST VAL - PRESIDIO OSPEDALIERO DI SONDRIO,LOM,20-29,1,7,0,7,1,0,0,8,0,8,Lombardia,ITC4
2021-01-06,PF/BT,.030042,ASST VAL - PRESIDIO OSPEDALIERO DI SONDRIO,LOM,30-39,4,10,0,14,0,0,0,14,0,14,Lombardia,ITC4
2021-01-06,PF/BT,.030042,ASST VAL - PRESIDIO OSPEDALIERO DI SONDRIO,LOM,40-49,7,15,0,21,1,0,0,22,0,22,Lombardia,ITC4
2021-01-06,PF/BT,.030042,ASST VAL - PRESIDIO OSPEDALIERO DI SONDRIO,LOM,50-59,10,42,0,46,6,0,0,52,0,52,Lombardia,ITC4
2021-01-06,PF/BT,.030042,ASST VAL - PRESIDIO OSPEDALIERO DI SONDRIO,LOM,60-69,2,10,0,11,1,0,0,12,0,12,Lombardia,ITC4
2021-01-06,PF/BT,002987,POLIAMBULATORIO OSPEDALE ESINE,LOM,20-29,2,13,0,6,9,0,0,15,0,15,Lombardia,ITC4
2021-01-06,PF/BT,002987,POLIAMBULATORIO OSPEDALE ESINE,LOM,30-39,3,14,0,8,9,0,0,17,0,17,Lombardia,ITC4
2021-01-06,PF/BT,002987,POLIAMBULATORIO OSPEDALE ESINE,LOM,40-49,3,19,0,14,8,0,0,22,0,22,Lombardia,ITC4
2021-01-06,PF/BT,002987,POLIAMBULATORIO OSPEDALE ESINE,LOM,50-59,5,24,0,14,15,0,0,29,0,29,Lombardia,ITC4
2021-01-06,PF/BT,002987,POLIAMBULATORIO OSPEDALE ESINE,LOM,60-69,15,9,0,18,6,0,0,24,0,24,Lombardia,ITC4
2021-01-06,PF/BT,002987,POLIAMBULATORIO OSPEDALE ESINE,LOM,70-79,0,1,0,0,1,0,0,1,0,1,Lombardia,ITC4
2021-01-06,PF/BT,003335,HUB COV CHIARI - P.O. CHIARI ASST FRANCIACORTA,LOM,20-29,4,4,0,4,4,0,0,8,0,8,Lombardia,ITC4
2021-01-06,PF/BT,003335,HUB COV CHIARI - P.O. CHIARI ASST FRANCIACORTA,LOM,30-39,6,6,0,8,4,0,0,12,0,12,Lombardia,ITC4
2021-01-06,PF/BT,003335,HUB COV CHIARI - P.O. CHIARI ASST FRANCIACORTA,LOM,40-49,10,11,0,15,6,0,0,21,0,21,Lombardia,ITC4
2021-01-06,PF/BT,003335,HUB COV CHIARI - P.O. CHIARI ASST FRANCIACORTA,LOM,50-59,12,11,0,14,9,0,0,23,0,23,Lombardia,ITC4
2021-01-06,PF/BT,003335,HUB COV CHIARI - P.O. CHIARI ASST FRANCIACORTA,LOM,60-69,7,11,0,13,5,0,0,18,0,18,Lombardia,ITC4
2021-01-06,PF/BT,003335,HUB COV CHIARI - P.O. CHIARI ASST FRANCIACORTA,LOM,70-79,1,1,0,1,1,0,0,2,0,2,Lombardia,ITC4
2021-01-06,PF/BT,030066,CV Garbagnate,LOM,20-29,6,11,0,17,0,0,0,17,0,17,Lombardia,ITC4
2021-01-06,PF/BT,030066,CV Garbagnate,LOM,30-39,14,17,0,30,1,0,0,31,0,31,Lombardia,ITC4
2021-01-06,PF/BT,030066,CV Garbagnate,LOM,40-49,12,28,0,35,5,0,0,40,0,40,Lombardia,ITC4
2021-01-06,PF/BT,030066,CV Garbagnate,LOM,50-59,14,67,0,63,18,0,0,81,0,81,Lombardia,ITC4
2021-01-06,PF/BT,030066,CV Garbagnate,LOM,60-69,7,16,0,13,10,0,0,23,0,23,Lombardia,ITC4
2021-01-06,PF/BT,030068,PUNTO VACCINALE OSPEDALIERO DESIO,LOM,20-29,1,3,0,4,0,0,0,4,0,4,Lombardia,ITC4
2021-01-06,PF/BT,030068,PUNTO VACCINALE OSPEDALIERO DESIO,LOM,30-39,4,12,0,16,0,0,0,16,0,16,Lombardia,ITC4
2021-01-06,PF/BT,030068,PUNTO VACCINALE OSPEDALIERO DESIO,LOM,40-49,5,10,0,15,0,0,0,15,0,15,Lombardia,ITC4
2021-01-06,PF/BT,030068,PUNTO VACCINALE OSPEDALIERO DESIO,LOM,50-59,3,21,0,22,2,0,0,24,0,24,Lombardia,ITC4
2021-01-06,PF/BT,030068,PUNTO VACCINALE OSPEDALIERO DESIO,LOM,60-69,3,2,0,3,2,0,0,5,0,5,Lombardia,ITC4
2021-01-06,PF/BT,030068,PUNTO VACCINALE OSPEDALIERO DESIO,LOM,70-79,1,0,0,1,0,0,0,1,0,1,Lombardia,ITC4
2021-01-06,PF/BT,030070,PUNTO VACCINALE OSPEDALIERO CARATE BRIANZA,LOM,20-29,0,1,0,1,0,0,0,1,0,1,Lombardia,ITC4
2021-01-06,PF/BT,030070,PUNTO VACCINALE OSPEDALIERO CARATE BRIANZA,LOM,30-39,0,8,0,8,0,0,0,8,0,8,Lombardia,ITC4
2021-01-06,PF/BT,030070,PUNTO VACCINALE OSPEDALIERO CARATE BRIANZA,LOM,40-49,2,6,0,8,0,0,0,8,0,8,Lombardia,ITC4
2021-01-06,PF/BT,030070,PUNTO VACCINALE OSPEDALIERO CARATE BRIANZA,LOM,50-59,4,8,0,11,1,0,0,12,0,12,Lombardia,ITC4
2021-01-06,PF/BT,030070,PUNTO VACCINALE OSPEDALIERO CARATE BRIANZA,LOM,60-69,4,5,0,5,4,0,0,9,0,9,Lombardia,ITC4
2021-01-06,PF/BT,030070,PUNTO VACCINALE OSPEDALIERO CARATE BRIANZA,LOM,70-79,1,0,0,1,0,0,0,1,0,1,Lombardia,ITC4
2021-01-06,PF/BT,030078,PUNTO VACCINALE OSPEDALIERO VIMERCATE,LOM,20-29,6,6,0,9,3,0,0,12,0,12,Lombardia,ITC4
2021-01-06,PF/BT,030078,PUNTO VACCINALE OSPEDALIERO VIMERCATE,LOM,30-39,7,11,0,16,2,0,0,18,0,18,Lombardia,ITC4
2021-01-06,PF/BT,030078,PUNTO VACCINALE OSPEDALIERO VIMERCATE,LOM,40-49,5,22,0,19,8,0,0,27,0,27,Lombardia,ITC4
2021-01-06,PF/BT,030078,PUNTO VACCINALE OSPEDALIERO VIMERCATE,LOM,50-59,8,28,0,28,8,0,0,36,0,36,Lombardia,ITC4
2021-01-06,PF/BT,030078,PUNTO VACCINALE OSPEDALIERO VIMERCATE,LOM,60-69,6,0,0,5,1,0,0,6,0,6,Lombardia,ITC4
2021-01-06,PF/BT,030078,PUNTO VACCINALE OSPEDALIERO VIMERCATE,LOM,70-79,1,0,0,1,0,0,0,1,0,1,Lombardia,ITC4
2021-01-06,PF/BT,030903,AMB COVID LECCO,LOM,20-29,4,6,0,9,1,0,0,10,0,10,Lombardia,ITC4
2021-01-06,PF/BT,030903,AMB COVID LECCO,LOM,30-39,17,23,0,37,3,0,0,40,0,40,Lombardia,ITC4
2021-01-06,PF/BT,030903,AMB COVID LECCO,LOM,40-49,14,50,0,56,8,0,0,64,0,64,Lombardia,ITC4
2021-01-06,PF/BT,030903,AMB COVID LECCO,LOM,50-59,19,77,0,66,30,0,0,96,0,96,Lombardia,ITC4
2021-01-06,PF/BT,030903,AMB COVID LECCO,LOM,60-69,10,14,0,22,2,0,0,24,0,24,Lombardia,ITC4
2021-01-06,PF/BT,030922,"FOND.IRCCS ""ISTIT.NAZ.LE TUMORI""MILANO",LOM,20-29,3,9,0,12,0,0,0,12,0,12,Lombardia,ITC4
2021-01-06,PF/BT,030922,"FOND.IRCCS ""ISTIT.NAZ.LE TUMORI""MILANO",LOM,30-39,8,10,0,18,0,0,0,18,0,18,Lombardia,ITC4
2021-01-06,PF/BT,030922,"FOND.IRCCS ""ISTIT.NAZ.LE TUMORI""MILANO",LOM,40-49,1,7,0,8,0,0,0,8,0,8,Lombardia,ITC4
2021-01-06,PF/BT,030922,"FOND.IRCCS ""ISTIT.NAZ.LE TUMORI""MILANO",LOM,50-59,6,5,0,10,1,0,0,11,0,11,Lombardia,ITC4
2021-01-06,PF/BT,030922,"FOND.IRCCS ""ISTIT.NAZ.LE TUMORI""MILANO",LOM,60-69,2,2,0,3,1,0,0,4,0,4,Lombardia,ITC4
2021-01-06,PF/BT,030922,"FOND.IRCCS ""ISTIT.NAZ.LE TUMORI""MILANO",LOM,70-79,1,0,0,1,0,0,0,1,0,1,Lombardia,ITC4
2021-01-06,PF/BT,030924,IRCCS POLICLINICO S. MATTEO - PAVIA,LOM,20-29,25,32,0,57,0,0,0,57,0,57,Lombardia,ITC4
2021-01-06,PF/BT,030924,IRCCS POLICLINICO S. MATTEO - PAVIA,LOM,30-39,26,32,0,58,0,0,0,58,0,58,Lombardia,ITC4
2021-01-06,PF/BT,030924,IRCCS POLICLINICO S. MATTEO - PAVIA,LOM,40-49,13,15,0,28,0,0,0,28,0,28,Lombardia,ITC4
2021-01-06,PF/BT,030924,IRCCS POLICLINICO S. MATTEO - PAVIA,LOM,50-59,2,2,0,4,0,0,0,4,0,4,Lombardia,ITC4
2021-01-06,PF/BT,030924,IRCCS POLICLINICO S. MATTEO - PAVIA,LOM,60-69,1,2,0,3,0,0,0,3,0,3,Lombardia,ITC4
2021-01-06,PF/BT,030935,IRCCS    S. RAFFAELE - MILANO,LOM,20-29,47,55,0,102,0,0,0,102,0,102,Lombardia,ITC4
2021-01-06,PF/BT,030935,IRCCS    S. RAFFAELE - MILANO,LOM,30-39,65,68,0,133,0,0,0,133,0,133,Lombardia,ITC4
2021-01-06,PF/BT,030935,IRCCS    S. RAFFAELE - MILANO,LOM,40-49,28,41,0,69,0,0,0,69,0,69,Lombardia,ITC4
2021-01-06,PF/BT,030935,IRCCS    S. RAFFAELE - MILANO,LOM,50-59,23,44,0,67,0,0,0,67,0,67,Lombardia,ITC4
2021-01-06,PF/BT,030935,IRCCS    S. RAFFAELE - MILANO,LOM,60-69,4,3,0,7,0,0,0,7,0,7,Lombardia,ITC4
2021-01-06,PF/BT,030935,IRCCS    S. RAFFAELE - MILANO,LOM,70-79,0,1,0,1,0,0,0,1,0,1,Lombardia,ITC4
2021-01-06,PF/BT,030943,Istituto Clinico Humanitas,LOM,20-29,12,22,0,29,5,0,0,34,0,34,Lombardia,ITC4
2021-01-06,PF/BT,030943,Istituto Clinico Humanitas,LOM,30-39,24,25,0,37,12,0,0,49,0,49,Lombardia,ITC4
2021-01-06,PF/BT,030943,Istituto Clinico Humanitas,LOM,40-49,16,41,0,47,10,0,0,57,0,57,Lombardia,ITC4
2021-01-06,PF/BT,030943,Istituto Clinico Humanitas,LOM,50-59,10,25,0,27,8,0,0,35,0,35,Lombardia,ITC4
2021-01-06,PF/BT,030943,Istituto Clinico Humanitas,LOM,60-69,3,1,0,4,0,0,0,4,0,4,Lombardia,ITC4
2021-01-06,PF/BT,030943,Istituto Clinico Humanitas,LOM,70-79,1,0,0,1,0,0,0,1,0,1,Lombardia,ITC4
2021-01-06,PF/BT,30072,Centro Vaccinale Covid Vizzolo - ASST Melegnano Martesana,LOM,20-29,2,4,0,6,0,0,0,6,0,6,Lombardia,ITC4
2021-01-06,PF/BT,30072,Centro Vaccinale Covid Vizzolo - ASST Melegnano Martesana,LOM,30-39,10,6,0,9,7,0,0,16,0,16,Lombardia,ITC4
2021-01-06,PF/BT,30072,Centro Vaccinale Covid Vizzolo - ASST Melegnano Martesana,LOM,40-49,12,21,0,25,8,0,0,33,0,33,Lombardia,ITC4
2021-01-06,PF/BT,30072,Centro Vaccinale Covid Vizzolo - ASST Melegnano Martesana,LOM,50-59,19,49,0,48,20,0,0,68,0,68,Lombardia,ITC4
2021-01-06,PF/BT,30072,Centro Vaccinale Covid Vizzolo - ASST Melegnano Martesana,LOM,60-69,9,18,0,18,9,0,0,27,0,27,Lombardia,ITC4
2021-01-06,PF/BT,30073,cv rho,LOM,20-29,3,10,0,13,0,0,0,13,0,13,Lombardia,ITC4
2021-01-06,PF/BT,30073,cv rho,LOM,30-39,8,14,0,22,0,0,0,22,0,22,Lombardia,ITC4
2021-01-06,PF/BT,30073,cv rho,LOM,40-49,6,26,0,31,1,0,0,32,0,32,Lombardia,ITC4
2021-01-06,PF/BT,30073,cv rho,LOM,50-59,20,44,0,62,2,0,0,64,0,64,Lombardia,ITC4
2021-01-06,PF/BT,30073,cv rho,LOM,60-69,8,11,0,17,2,0,0,19,0,19,Lombardia,ITC4
2021-01-06,PF/BT,30074,HUB COVID MAGENTA,LOM,20-29,2,6,0,8,0,0,0,8,0,8,Lombardia,ITC4
2021-01-06,PF/BT,30074,HUB COVID MAGENTA,LOM,30-39,2,15,0,17,0,0,0,17,0,17,Lombardia,ITC4
2021-01-06,PF/BT,30074,HUB COVID MAGENTA,LOM,40-49,11,25,0,34,2,0,0,36,0,36,Lombardia,ITC4
2021-01-06,PF/BT,30074,HUB COVID MAGENTA,LOM,50-59,3,35,0,37,1,0,0,38,0,38,Lombardia,ITC4
2021-01-06,PF/BT,30074,HUB COVID MAGENTA,LOM,60-69,3,6,0,8,1,0,0,9,0,9,Lombardia,ITC4
2021-01-06,PF/BT,30156,Centro Vaccinale Covid Desenzano,LOM,16-19,0,1,0,1,0,0,0,1,0,1,Lombardia,ITC4
2021-01-06,PF/BT,30156,Centro Vaccinale Covid Desenzano,LOM,20-29,5,7,0,10,2,0,0,12,0,12,Lombardia,ITC4
2021-01-06,PF/BT,30156,Centro Vaccinale Covid Desenzano,LOM,30-39,7,8,0,13,2,0,0,15,0,15,Lombardia,ITC4
2021-01-06,PF/BT,30156,Centro Vaccinale Covid Desenzano,LOM,40-49,5,13,0,15,2,0,1,18,0,18,Lombardia,ITC4
2021-01-06,PF/BT,30156,Centro Vaccinale Covid Desenzano,LOM,50-59,8,31,0,29,7,0,3,39,0,39,Lombardia,ITC4
2021-01-06,PF/BT,30156,Centro Vaccinale Covid Desenzano,LOM,60-69,23,11,0,30,2,0,2,34,0,34,Lombardia,ITC4
2021-01-06,PF/BT,30156,Centro Vaccinale Covid Desenzano,LOM,70-79,1,0,0,1,0,0,0,1,0,1,Lombardia,ITC4
2021-01-06,PF/BT,30157,Centro Vaccinale Covid Gavardo,LOM,20-29,5,5,0,4,6,0,0,10,0,10,Lombardia,ITC4
2021-01-06,PF/BT,30157,Centro Vaccinale Covid Gavardo,LOM,30-39,9,8,0,12,5,0,0,17,0,17,Lombardia,ITC4
2021-01-06,PF/BT,30157,Centro Vaccinale Covid Gavardo,LOM,40-49,6,16,0,16,6,0,0,22,0,22,Lombardia,ITC4
2021-01-06,PF/BT,30157,Centro Vaccinale Covid Gavardo,LOM,50-59,10,36,0,28,18,0,0,46,0,46,Lombardia,ITC4
2021-01-06,PF/BT,30157,Centro Vaccinale Covid Gavardo,LOM,60-69,18,11,0,22,7,0,0,29,0,29,Lombardia,ITC4
2021-01-06,PF/BT,30157,Centro Vaccinale Covid Gavardo,LOM,70-79,2,0,0,1,1,0,0,2,0,2,Lombardia,ITC4
2021-01-06,PF/BT,30184,Centro Vaccinale Covid Manerbio,LOM,20-29,1,0,0,0,1,0,0,1,0,1,Lombardia,ITC4
2021-01-06,PF/BT,30184,Centro Vaccinale Covid Manerbio,LOM,30-39,2,3,0,4,0,0,1,5,0,5,Lombardia,ITC4
2021-01-06,PF/BT,30184,Centro Vaccinale Covid Manerbio,LOM,40-49,3,11,0,14,0,0,0,14,0,14,Lombardia,ITC4
2021-01-06,PF/BT,30184,Centro Vaccinale Covid Manerbio,LOM,50-59,4,27,0,25,4,0,2,31,0,31,Lombardia,ITC4
2021-01-06,PF/BT,30184,Centro Vaccinale Covid Manerbio,LOM,60-69,22,25,0,30,12,0,5,47,0,47,Lombardia,ITC4
2021-01-06,PF/BT,30184,Centro Vaccinale Covid Manerbio,LOM,70-79,1,9,0,3,6,0,1,10,0,10,Lombardia,ITC4
2021-01-06,PF/BT,30193,Ambulatorio HUB Vigevano,LOM,20-29,1,1,0,2,0,0,0,2,0,2,Lombardia,ITC4
2021-01-06,PF/BT,30193,Ambulatorio HUB Vigevano,LOM,30-39,6,8,0,14,0,0,0,14,0,14,Lombardia,ITC4
2021-01-06,PF/BT,30193,Ambulatorio HUB Vigevano,LOM,40-49,1,12,0,13,0,0,0,13,0,13,Lombardia,ITC4
2021-01-06,PF/BT,30193,Ambulatorio HUB Vigevano,LOM,50-59,1,20,0,20,1,0,0,21,0,21,Lombardia,ITC4
2021-01-06,PF/BT,30193,Ambulatorio HUB Vigevano,LOM,60-69,1,3,0,4,0,0,0,4,0,4,Lombardia,ITC4
2021-01-06,PF/BT,30209,OSPEDALE MAGGIORE DI CREMA,LOM,20-29,8,6,0,14,0,0,0,14,0,14,Lombardia,ITC4
2021-01-06,PF/BT,30209,OSPEDALE MAGGIORE DI CREMA,LOM,30-39,5,3,0,8,0,0,0,8,0,8,Lombardia,ITC4
2021-01-06,PF/BT,30209,OSPEDALE MAGGIORE DI CREMA,LOM,40-49,2,4,0,6,0,0,0,6,0,6,Lombardia,ITC4
2021-01-06,PF/BT,30209,OSPEDALE MAGGIORE DI CREMA,LOM,50-59,12,9,0,21,0,0,0,21,0,21,Lombardia,ITC4
2021-01-06,PF/BT,30209,OSPEDALE MAGGIORE DI CREMA,LOM,60-69,22,11,0,33,0,0,0,33,0,33,Lombardia,ITC4
2021-01-06,PF/BT,30209,OSPEDALE MAGGIORE DI CREMA,LOM,70-79,0,1,0,1,0,0,0,1,0,1,Lombardia,ITC4
2021-01-06,PF/BT,30209,OSPEDALE MAGGIORE DI CREMA,LOM,80-89,1,0,0,1,0,0,0,1,0,1,Lombardia,ITC4
2021-01-06,PF/BT,30281,HUB COVID LEGNANO,LOM,20-29,5,9,0,14,0,0,0,14,0,14,Lombardia,ITC4
2021-01-06,PF/BT,30281,HUB COVID LEGNANO,LOM,30-39,8,22,0,30,0,0,0,30,0,30,Lombardia,ITC4
2021-01-06,PF/BT,30281,HUB COVID LEGNANO,LOM,40-49,10,33,0,43,0,0,0,43,0,43,Lombardia,ITC4
2021-01-06,PF/BT,30281,HUB COVID LEGNANO,LOM,50-59,8,52,0,60,0,0,0,60,0,60,Lombardia,ITC4
2021-01-06,PF/BT,30281,HUB COVID LEGNANO,LOM,60-69,4,22,0,25,1,0,0,26,0,26,Lombardia,ITC4
2021-01-06,PF/BT,30281,HUB COVID LEGNANO,LOM,70-79,0,1,0,1,0,0,0,1,0,1,Lombardia,ITC4
2021-01-06,PF/BT,30701,ASST GRANDE OSPEDALE METROPOLITANO NIGUARDA,LOM,20-29,33,71,0,78,11,0,15,104,0,104,Lombardia,ITC4
2021-01-06,PF/BT,30701,ASST GRANDE OSPEDALE METROPOLITANO NIGUARDA,LOM,30-39,50,63,0,67,16,0,30,113,0,113,Lombardia,ITC4
2021-01-06,PF/BT,30701,ASST GRANDE OSPEDALE METROPOLITANO NIGUARDA,LOM,40-49,34,88,0,80,15,0,27,122,0,122,Lombardia,ITC4
2021-01-06,PF/BT,30701,ASST GRANDE OSPEDALE METROPOLITANO NIGUARDA,LOM,50-59,49,85,0,66,40,0,28,134,0,134,Lombardia,ITC4
2021-01-06,PF/BT,30701,ASST GRANDE OSPEDALE METROPOLITANO NIGUARDA,LOM,60-69,18,17,0,19,5,0,11,35,0,35,Lombardia,ITC4
2021-01-06,PF/BT,30701,ASST GRANDE OSPEDALE METROPOLITANO NIGUARDA,LOM,70-79,1,0,0,1,0,0,0,1,0,1,Lombardia,ITC4
2021-01-06,PF/BT,30701,ASST GRANDE OSPEDALE METROPOLITANO NIGUARDA,LOM,80-89,0,1,0,1,0,0,0,1,0,1,Lombardia,ITC4
2021-01-06,PF/BT,30718,ASST PAPA GIOVANNI XXIII,LOM,20-29,6,15,0,21,0,0,0,21,0,21,Lombardia,ITC4
2021-01-06,PF/BT,30718,ASST PAPA GIOVANNI XXIII,LOM,30-39,14,23,0,37,0,0,0,37,0,37,Lombardia,ITC4
2021-01-06,PF/BT,30718,ASST PAPA GIOVANNI XXIII,LOM,40-49,14,27,0,39,2,0,0,41,0,41,Lombardia,ITC4
2021-01-06,PF/BT,30718,ASST PAPA GIOVANNI XXIII,LOM,50-59,12,29,0,36,5,0,0,41,0,41,Lombardia,ITC4
2021-01-06,PF/BT,30718,ASST PAPA GIOVANNI XXIII,LOM,60-69,5,5,0,10,0,0,0,10,0,10,Lombardia,ITC4
2021-01-06,PF/BT,30902,Ospedale S.Anna - Como,LOM,20-29,8,22,0,28,2,0,0,30,0,30,Lombardia,ITC4
2021-01-06,PF/BT,30902,Ospedale S.Anna - Como,LOM,30-39,16,38,0,52,2,0,0,54,0,54,Lombardia,ITC4
2021-01-06,PF/BT,30902,Ospedale S.Anna - Como,LOM,40-49,15,45,0,54,6,0,0,60,0,60,Lombardia,ITC4
2021-01-06,PF/BT,30902,Ospedale S.Anna - Como,LOM,50-59,25,48,0,56,17,0,0,73,0,73,Lombardia,ITC4
2021-01-06,PF/BT,30902,Ospedale S.Anna - Como,LOM,60-69,7,16,0,18,5,0,0,23,0,23,Lombardia,ITC4
2021-01-06,PF/BT,30909,amb covid monza,LOM,20-29,10,17,0,23,3,0,1,27,0,27,Lombardia,ITC4
2021-01-06,PF/BT,30909,amb covid monza,LOM,30-39,17,11,0,25,1,0,2,28,0,28,Lombardia,ITC4
2021-01-06,PF/BT,30909,amb covid monza,LOM,40-49,6,32,0,28,8,0,2,38,0,38,Lombardia,ITC4
2021-01-06,PF/BT,30909,amb covid monza,LOM,50-59,20,52,0,57,15,0,0,72,0,72,Lombardia,ITC4
2021-01-06,PF/BT,30909,amb covid monza,LOM,60-69,32,14,0,44,2,0,0,46,0,46,Lombardia,ITC4
2021-01-06,PF/BT,30909,amb covid monza,LOM,70-79,4,0,0,2,1,0,1,4,0,4,Lombardia,ITC4
2021-01-06,PF/BT,30925,Fondazione IRCCS Ca' Granda Ospedale Maggiore Policlinico,LOM,20-29,18,48,0,64,2,0,0,66,0,66,Lombardia,ITC4
2021-01-06,PF/BT,30925,Fondazione IRCCS Ca' Granda Ospedale Maggiore Policlinico,LOM,30-39,32,45,0,76,1,0,0,77,0,77,Lombardia,ITC4
2021-01-06,PF/BT,30925,Fondazione IRCCS Ca' Granda Ospedale Maggiore Policlinico,LOM,40-49,15,23,0,36,2,0,0,38,0,38,Lombardia,ITC4
2021-01-06,PF/BT,30925,Fondazione IRCCS Ca' Granda Ospedale Maggiore Policlinico,LOM,50-59,17,33,0,47,3,0,0,50,0,50,Lombardia,ITC4
2021-01-06,PF/BT,30925,Fondazione IRCCS Ca' Granda Ospedale Maggiore Policlinico,LOM,60-69,15,10,0,22,3,0,0,25,0,25,Lombardia,ITC4
2021-01-06,PF/BT,30925,Fondazione IRCCS Ca' Granda Ospedale Maggiore Policlinico,LOM,70-79,3,0,0,3,0,0,0,3,0,3,Lombardia,ITC4
2021-01-06,PF/BT,32170712,ambulatorio covid SESTO SAN GIOVANNI,LOM,20-29,3,11,0,14,0,0,0,14,0,14,Lombardia,ITC4
2021-01-06,PF/BT,32170712,ambulatorio covid SESTO SAN GIOVANNI,LOM,30-39,11,19,0,30,0,0,0,30,0,30,Lombardia,ITC4
2021-01-06,PF/BT,32170712,ambulatorio covid SESTO SAN GIOVANNI,LOM,40-49,8,27,0,34,1,0,0,35,0,35,Lombardia,ITC4
2021-01-06,PF/BT,32170712,ambulatorio covid SESTO SAN GIOVANNI,LOM,50-59,13,31,0,44,0,0,0,44,0,44,Lombardia,ITC4
2021-01-06,PF/BT,32170712,ambulatorio covid SESTO SAN GIOVANNI,LOM,60-69,17,16,0,33,0,0,0,33,0,33,Lombardia,ITC4
2021-01-06,PF/BT,32271022,"ambulatorio covid Varese , ambulatorio covid Tradate , ambulatorio covid Angera",LOM,20-29,16,48,0,64,0,0,0,64,0,64,Lombardia,ITC4
2021-01-06,PF/BT,32271022,"ambulatorio covid Varese , ambulatorio covid Tradate , ambulatorio covid Angera",LOM,30-39,24,43,0,67,0,0,0,67,0,67,Lombardia,ITC4
2021-01-06,PF/BT,32271022,"ambulatorio covid Varese , ambulatorio covid Tradate , ambulatorio covid Angera",LOM,40-49,9,52,0,61,0,0,0,61,0,61,Lombardia,ITC4
2021-01-06,PF/BT,32271022,"ambulatorio covid Varese , ambulatorio covid Tradate , ambulatorio covid Angera",LOM,50-59,8,79,0,87,0,0,0,87,0,87,Lombardia,ITC4
2021-01-06,PF/BT,32271022,"ambulatorio covid Varese , ambulatorio covid Tradate , ambulatorio covid Angera",LOM,60-69,34,50,0,84,0,0,0,84,0,84,Lombardia,ITC4
2021-01-06,PF/BT,32271022,"ambulatorio covid Varese , ambulatorio covid Tradate , ambulatorio covid Angera",LOM,70-79,1,0,0,1,0,0,0,1,0,1,Lombardia,ITC4
2021-01-06,PF/BT,32271116,ambulatorio covid Gallarate,LOM,20-29,4,4,0,8,0,0,0,8,0,8,Lombardia,ITC4
2021-01-06,PF/BT,32271116,ambulatorio covid Gallarate,LOM,30-39,3,6,0,9,0,0,0,9,0,9,Lombardia,ITC4
2021-01-06,PF/BT,32271116,ambulatorio covid Gallarate,LOM,40-49,5,12,0,17,0,0,0,17,0,17,Lombardia,ITC4
2021-01-06,PF/BT,32271116,ambulatorio covid Gallarate,LOM,50-59,7,35,0,42,0,0,0,42,0,42,Lombardia,ITC4
2021-01-06,PF/BT,32271116,ambulatorio covid Gallarate,LOM,60-69,0,2,0,2,0,0,0,2,0,2,Lombardia,ITC4
2021-01-06,PF/BT,32271117,ambulatorio covid Saronno,LOM,20-29,0,1,0,1,0,0,0,1,0,1,Lombardia,ITC4
2021-01-06,PF/BT,32271117,ambulatorio covid Saronno,LOM,30-39,1,2,0,3,0,0,0,3,0,3,Lombardia,ITC4
2021-01-06,PF/BT,32271117,ambulatorio covid Saronno,LOM,40-49,0,7,0,7,0,0,0,7,0,7,Lombardia,ITC4
2021-01-06,PF/BT,32271117,ambulatorio covid Saronno,LOM,50-59,4,9,0,13,0,0,0,13,0,13,Lombardia,ITC4
2021-01-06,PF/BT,32271118,ambulatorio covid Busto A.,LOM,20-29,1,1,0,2,0,0,0,2,0,2,Lombardia,ITC4
2021-01-06,PF/BT,32271118,ambulatorio covid Busto A.,LOM,30-39,9,15,0,24,0,0,0,24,0,24,Lombardia,ITC4
2021-01-06,PF/BT,32271118,ambulatorio covid Busto A.,LOM,40-49,5,14,0,19,0,0,0,19,0,19,Lombardia,ITC4
2021-01-06,PF/BT,32271118,ambulatorio covid Busto A.,LOM,50-59,6,11,0,17,0,0,0,17,0,17,Lombardia,ITC4
2021-01-06,PF/BT,32271118,ambulatorio covid Busto A.,LOM,60-69,3,1,0,4,0,0,0,4,0,4,Lombardia,ITC4
2021-01-06,PF/BT,32572021,Ambulatorio COVID PO Alzano Lombardo,LOM,20-29,9,3,0,12,0,0,0,12,0,12,Lombardia,ITC4
2021-01-06,PF/BT,32572021,Ambulatorio COVID PO Alzano Lombardo,LOM,30-39,8,5,0,13,0,0,0,13,0,13,Lombardia,ITC4
2021-01-06,PF/BT,32572021,Ambulatorio COVID PO Alzano Lombardo,LOM,40-49,6,9,0,15,0,0,0,15,0,15,Lombardia,ITC4
2021-01-06,PF/BT,32572021,Ambulatorio COVID PO Alzano Lombardo,LOM,50-59,16,14,0,30,0,0,0,30,0,30,Lombardia,ITC4
2021-01-06,PF/BT,32572021,Ambulatorio COVID PO Alzano Lombardo,LOM,60-69,11,4,0,15,0,0,0,15,0,15,Lombardia,ITC4
2021-01-06,PF/BT,32572021,Ambulatorio COVID PO Alzano Lombardo,LOM,70-79,1,1,0,2,0,0,0,2,0,2,Lombardia,ITC4
2021-01-06,PF/BT,32572027,Ambulatorio COVID SERIATE,LOM,20-29,3,6,0,8,1,0,0,9,0,9,Lombardia,ITC4
2021-01-06,PF/BT,32572027,Ambulatorio COVID SERIATE,LOM,30-39,5,18,0,23,0,0,0,23,0,23,Lombardia,ITC4
2021-01-06,PF/BT,32572027,Ambulatorio COVID SERIATE,LOM,40-49,9,23,0,31,0,0,1,32,0,32,Lombardia,ITC4
2021-01-06,PF/BT,32572027,Ambulatorio COVID SERIATE,LOM,50-59,13,27,0,37,1,0,2,40,0,40,Lombardia,ITC4
2021-01-06,PF/BT,32572027,Ambulatorio COVID SERIATE,LOM,60-69,5,5,0,9,0,0,1,10,0,10,Lombardia,ITC4
2021-01-06,PF/BT,32772407,CD COVID CREMONA,LOM,20-29,4,5,0,9,0,0,0,9,0,9,Lombardia,ITC4
2021-01-06,PF/BT,32772407,CD COVID CREMONA,LOM,30-39,10,15,0,25,0,0,0,25,0,25,Lombardia,ITC4
2021-01-06,PF/BT,32772407,CD COVID CREMONA,LOM,40-49,6,15,0,17,4,0,0,21,0,21,Lombardia,ITC4
2021-01-06,PF/BT,32772407,CD COVID CREMONA,LOM,50-59,19,38,0,41,16,0,0,57,0,57,Lombardia,ITC4
2021-01-06,PF/BT,32772407,CD COVID CREMONA,LOM,60-69,22,11,0,29,4,0,0,33,0,33,Lombardia,ITC4
2021-01-06,PF/BT,32772407,CD COVID CREMONA,LOM,70-79,3,3,0,2,4,0,0,6,0,6,Lombardia,ITC4
2021-01-06,PF/BT,32772513,ASST DI MANTOVA - POMA,LOM,20-29,2,4,0,4,2,0,0,6,0,6,Lombardia,ITC4
2021-01-06,PF/BT,32772513,ASST DI MANTOVA - POMA,LOM,30-39,8,28,0,35,1,0,0,36,0,36,Lombardia,ITC4
2021-01-06,PF/BT,32772513,ASST DI MANTOVA - POMA,LOM,40-49,19,25,0,37,7,0,0,44,0,44,Lombardia,ITC4
2021-01-06,PF/BT,32772513,ASST DI MANTOVA - POMA,LOM,50-59,13,44,0,37,20,0,0,57,0,57,Lombardia,ITC4
2021-01-06,PF/BT,32772513,ASST DI MANTOVA - POMA,LOM,60-69,37,35,0,58,14,0,0,72,0,72,Lombardia,ITC4
2021-01-06,PF/BT,558,RSA PIO ALBERGO TRIVULZIO,LOM,20-29,4,3,0,5,1,1,0,7,0,7,Lombardia,ITC4
2021-01-06,PF/BT,558,RSA PIO ALBERGO TRIVULZIO,LOM,30-39,7,12,0,12,7,0,0,19,0,19,Lombardia,ITC4
2021-01-06,PF/BT,558,RSA PIO ALBERGO TRIVULZIO,LOM,40-49,6,25,0,19,6,6,0,31,0,31,Lombardia,ITC4
2021-01-06,PF/BT,558,RSA PIO ALBERGO TRIVULZIO,LOM,50-59,15,24,0,26,10,3,0,39,0,39,Lombardia,ITC4
2021-01-06,PF/BT,558,RSA PIO ALBERGO TRIVULZIO,LOM,60-69,3,8,0,7,3,1,0,11,0,11,Lombardia,ITC4
2021-01-06,PF/BT,558,RSA PIO ALBERGO TRIVULZIO,LOM,70-79,4,1,0,0,0,5,0,5,0,5,Lombardia,ITC4
2021-01-06,PF/BT,558,RSA PIO ALBERGO TRIVULZIO,LOM,80-89,3,9,0,0,0,12,0,12,0,12,Lombardia,ITC4
2021-01-06,PF/BT,558,RSA PIO ALBERGO TRIVULZIO,LOM,90+,0,8,0,0,0,8,0,8,0,8,Lombardia,ITC4
2021-01-06,PF/BT,HPS11/11bis,ASST SPEDALI CIVILI AMBULATORIO COVID BRESCIA,LOM,20-29,24,59,0,76,5,0,2,83,0,83,Lombardia,ITC4
2021-01-06,PF/BT,HPS11/11bis,ASST SPEDALI CIVILI AMBULATORIO COVID BRESCIA,LOM,30-39,45,66,0,99,12,0,0,111,0,111,Lombardia,ITC4
2021-01-06,PF/BT,HPS11/11bis,ASST SPEDALI CIVILI AMBULATORIO COVID BRESCIA,LOM,40-49,29,99,0,109,19,0,0,128,0,128,Lombardia,ITC4
2021-01-06,PF/BT,HPS11/11bis,ASST SPEDALI CIVILI AMBULATORIO COVID BRESCIA,LOM,50-59,30,124,0,109,45,0,0,154,0,154,Lombardia,ITC4
2021-01-06,PF/BT,HPS11/11bis,ASST SPEDALI CIVILI AMBULATORIO COVID BRESCIA,LOM,60-69,24,19,0,29,14,0,0,43,0,43,Lombardia,ITC4
2021-01-06,PF/BT,HPS11/11bis,ASST SPEDALI CIVILI AMBULATORIO COVID BRESCIA,LOM,70-79,1,0,0,1,0,0,0,1,0,1,Lombardia,ITC4
2021-01-06,PF/BT,HSP11,ASST MANTOVA - POMA,LOM,20-29,2,4,0,4,2,0,0,6,0,6,Lombardia,ITC4
2021-01-06,PF/BT,HSP11,ASST MANTOVA - POMA,LOM,30-39,8,28,0,35,1,0,0,36,0,36,Lombardia,ITC4
2021-01-06,PF/BT,HSP11,ASST MANTOVA - POMA,LOM,40-49,19,25,0,37,7,0,0,44,0,44,Lombardia,ITC4
2021-01-06,PF/BT,HSP11,ASST MANTOVA - POMA,LOM,50-59,13,44,0,37,20,0,0,57,0,57,Lombardia,ITC4
2021-01-06,PF/BT,HSP11,ASST MANTOVA - POMA,LOM,60-69,37,35,0,58,14,0,0,72,0,72,Lombardia,ITC4
2021-01-06,PF/BT,HSP11-11bis,32170223 HUB COVID SANTI PAOLO E CARLO,LOM,20-29,12,15,0,26,1,0,0,27,0,27,Lombardia,ITC4
2021-01-06,PF/BT,HSP11-11bis,32170223 HUB COVID SANTI PAOLO E CARLO,LOM,30-39,14,23,0,37,0,0,0,37,0,37,Lombardia,ITC4
2021-01-06,PF/BT,HSP11-11bis,32170223 HUB COVID SANTI PAOLO E CARLO,LOM,40-49,11,24,0,32,0,0,3,35,0,35,Lombardia,ITC4
2021-01-06,PF/BT,HSP11-11bis,32170223 HUB COVID SANTI PAOLO E CARLO,LOM,50-59,10,20,0,30,0,0,0,30,0,30,Lombardia,ITC4
2021-01-06,PF/BT,HSP11-11bis,32170223 HUB COVID SANTI PAOLO E CARLO,LOM,60-69,7,7,0,14,0,0,0,14,0,14,Lombardia,ITC4
2021-01-06,PF/BT,HSP11-11bis,32170223 HUB COVID SANTI PAOLO E CARLO,LOM,70-79,1,0,0,1,0,0,0,1,0,1,Lombardia,ITC4
2021-01-06,PF/BT,HSP11-11bis,32170224 HUB COVID OSP. SAN CARLO,LOM,20-29,10,11,0,20,1,0,0,21,0,21,Lombardia,ITC4
2021-01-06,PF/BT,HSP11-11bis,32170224 HUB COVID OSP. SAN CARLO,LOM,30-39,19,14,0,31,2,0,0,33,0,33,Lombardia,ITC4
2021-01-06,PF/BT,HSP11-11bis,32170224 HUB COVID OSP. SAN CARLO,LOM,40-49,13,10,0,22,1,0,0,23,0,23,Lombardia,ITC4
2021-01-06,PF/BT,HSP11-11bis,32170224 HUB COVID OSP. SAN CARLO,LOM,50-59,30,18,0,42,6,0,0,48,0,48,Lombardia,ITC4
2021-01-06,PF/BT,HSP11-11bis,32170224 HUB COVID OSP. SAN CARLO,LOM,60-69,7,10,0,13,4,0,0,17,0,17,Lombardia,ITC4
2021-01-06,PF/BT,HSP11-11bis,32170224 HUB COVID OSP. SAN CARLO,LOM,70-79,1,1,0,2,0,0,0,2,0,2,Lombardia,ITC4
2021-01-06,PF/BT,HSP11-11bis,Ambulatorio COVID PO Casalpusterlengo,LOM,16-19,0,1,0,1,0,0,0,1,0,1,Lombardia,ITC4
2021-01-06,PF/BT,HSP11-11bis,Ambulatorio COVID PO Casalpusterlengo,LOM,20-29,1,8,0,9,0,0,0,9,0,9,Lombardia,ITC4
2021-01-06,PF/BT,HSP11-11bis,Ambulatorio COVID PO Casalpusterlengo,LOM,30-39,7,6,0,13,0,0,0,13,0,13,Lombardia,ITC4
2021-01-06,PF/BT,HSP11-11bis,Ambulatorio COVID PO Casalpusterlengo,LOM,40-49,12,10,0,21,1,0,0,22,0,22,Lombardia,ITC4
2021-01-06,PF/BT,HSP11-11bis,Ambulatorio COVID PO Casalpusterlengo,LOM,50-59,5,9,0,12,2,0,0,14,0,14,Lombardia,ITC4
2021-01-06,PF/BT,HSP11-11bis,Ambulatorio COVID PO Casalpusterlengo,LOM,60-69,12,8,0,20,0,0,0,20,0,20,Lombardia,ITC4
2021-01-06,PF/BT,HSP11-11bis,Ambulatorio COVID PO Casalpusterlengo,LOM,70-79,5,0,0,5,0,0,0,5,0,5,Lombardia,ITC4
2021-01-06,PF/BT,HSP11-11bis,Ambulatorio COVID PO Codogno,LOM,20-29,5,13,0,10,8,0,0,18,0,18,Lombardia,ITC4
2021-01-06,PF/BT,HSP11-11bis,Ambulatorio COVID PO Codogno,LOM,30-39,3,8,0,7,4,0,0,11,0,11,Lombardia,ITC4
2021-01-06,PF/BT,HSP11-11bis,Ambulatorio COVID PO Codogno,LOM,40-49,11,19,0,20,10,0,0,30,0,30,Lombardia,ITC4
2021-01-06,PF/BT,HSP11-11bis,Ambulatorio COVID PO Codogno,LOM,50-59,13,14,0,18,9,0,0,27,0,27,Lombardia,ITC4
2021-01-06,PF/BT,HSP11-11bis,Ambulatorio COVID PO Codogno,LOM,60-69,12,14,0,22,4,0,0,26,0,26,Lombardia,ITC4
2021-01-06,PF/BT,HSP11-11bis,Ambulatorio COVID PO Codogno,LOM,70-79,2,0,0,1,1,0,0,2,0,2,Lombardia,ITC4
2021-01-06,PF/BT,HSP11-11bis,Ambulatorio COVID PO LODI,LOM,20-29,22,24,0,25,21,0,0,46,0,46,Lombardia,ITC4
2021-01-06,PF/BT,HSP11-11bis,Ambulatorio COVID PO LODI,LOM,30-39,30,22,0,36,16,0,0,52,0,52,Lombardia,ITC4
2021-01-06,PF/BT,HSP11-11bis,Ambulatorio COVID PO LODI,LOM,40-49,20,42,0,40,22,0,0,62,0,62,Lombardia,ITC4
2021-01-06,PF/BT,HSP11-11bis,Ambulatorio COVID PO LODI,LOM,50-59,27,28,0,25,30,0,0,55,0,55,Lombardia,ITC4
2021-01-06,PF/BT,HSP11-11bis,Ambulatorio COVID PO LODI,LOM,60-69,14,4,0,8,10,0,0,18,0,18,Lombardia,ITC4
2021-01-06,PF/BT,HSP11-11bis,Ambulatorio COVID PO LODI,LOM,70-79,3,0,0,0,3,0,0,3,0,3,Lombardia,ITC4
2021-01-06,PF/BT,HSP11-11bis,Ambulatorio COVID PO LODI,LOM,80-89,0,1,0,0,1,0,0,1,0,1,Lombardia,ITC4
2021-01-06,PF/BT,HSP11-11bis,Ambulatorio COVID PO S.Angelo Lod.,LOM,16-19,0,1,0,1,0,0,0,1,0,1,Lombardia,ITC4
2021-01-06,PF/BT,HSP11-11bis,Ambulatorio COVID PO S.Angelo Lod.,LOM,20-29,2,10,0,11,1,0,0,12,0,12,Lombardia,ITC4
2021-01-06,PF/BT,HSP11-11bis,Ambulatorio COVID PO S.Angelo Lod.,LOM,30-39,4,10,0,11,3,0,0,14,0,14,Lombardia,ITC4
2021-01-06,PF/BT,HSP11-11bis,Ambulatorio COVID PO S.Angelo Lod.,LOM,40-49,5,8,0,12,1,0,0,13,0,13,Lombardia,ITC4
2021-01-06,PF/BT,HSP11-11bis,Ambulatorio COVID PO S.Angelo Lod.,LOM,50-59,7,12,0,16,3,0,0,19,0,19,Lombardia,ITC4
2021-01-06,PF/BT,HSP11-11bis,Ambulatorio COVID PO S.Angelo Lod.,LOM,60-69,11,4,0,15,0,0,0,15,0,15,Lombardia,ITC4
2021-01-06,PF/BT,HSP11-11bis,Ambulatorio COVID PO S.Angelo Lod.,LOM,70-79,4,0,0,4,0,0,0,4,0,4,Lombardia,ITC4
2021-01-06,PF/BT,HSP11-11bis,ASST BERGAMO OVEST - OSPEDALE TREVIGLIO,LOM,20-29,5,6,0,3,1,0,7,11,0,11,Lombardia,ITC4
2021-01-06,PF/BT,HSP11-11bis,ASST BERGAMO OVEST - OSPEDALE TREVIGLIO,LOM,30-39,4,10,0,6,1,0,7,14,0,14,Lombardia,ITC4
2021-01-06,PF/BT,HSP11-11bis,ASST BERGAMO OVEST - OSPEDALE TREVIGLIO,LOM,40-49,6,13,0,10,0,0,9,19,0,19,Lombardia,ITC4
2021-01-06,PF/BT,HSP11-11bis,ASST BERGAMO OVEST - OSPEDALE TREVIGLIO,LOM,50-59,11,9,0,5,0,0,15,20,0,20,Lombardia,ITC4
2021-01-06,PF/BT,HSP11-11bis,ASST BERGAMO OVEST - OSPEDALE TREVIGLIO,LOM,60-69,3,3,0,0,0,0,6,6,0,6,Lombardia,ITC4
2021-01-06,PF/BT,HSP11-11bis,ASST BERGAMO OVEST - OSPEDALE TREVIGLIO,LOM,70-79,1,1,0,0,0,0,2,2,0,2,Lombardia,ITC4
2021-01-06,PF/BT,HSP11-11bis - 703,AMBULATORIO OSPEDALE SACCO,LOM,20-29,4,23,0,26,1,0,0,27,0,27,Lombardia,ITC4
2021-01-06,PF/BT,HSP11-11bis - 703,AMBULATORIO OSPEDALE SACCO,LOM,30-39,18,39,0,57,0,0,0,57,0,57,Lombardia,ITC4
2021-01-06,PF/BT,HSP11-11bis - 703,AMBULATORIO OSPEDALE SACCO,LOM,40-49,25,51,0,75,1,0,0,76,0,76,Lombardia,ITC4
2021-01-06,PF/BT,HSP11-11bis - 703,AMBULATORIO OSPEDALE SACCO,LOM,50-59,14,44,0,58,0,0,0,58,0,58,Lombardia,ITC4
2021-01-06,PF/BT,HSP11-11bis - 703,AMBULATORIO OSPEDALE SACCO,LOM,60-69,10,11,0,20,1,0,0,21,0,21,Lombardia,ITC4
2021-01-06,PF/BT,HSP11-11bis - 703,AMBULATORIO OSPEDALE SACCO,LOM,70-79,0,1,0,1,0,0,0,1,0,1,Lombardia,ITC4
2021-01-06,PF/BT,STS11,RSA  FONDAZIONE ANNI SERENI TREVIGLIO CARAVAGGI E FARA GA ONLUS,LOM,20-29,0,2,0,1,1,0,0,2,0,2,Lombardia,ITC4
2021-01-06,PF/BT,STS11,RSA  FONDAZIONE ANNI SERENI TREVIGLIO CARAVAGGI E FARA GA ONLUS,LOM,30-39,0,3,0,3,0,0,0,3,0,3,Lombardia,ITC4
2021-01-06,PF/BT,STS11,RSA  FONDAZIONE ANNI SERENI TREVIGLIO CARAVAGGI E FARA GA ONLUS,LOM,40-49,1,6,0,7,0,0,0,7,0,7,Lombardia,ITC4
2021-01-06,PF/BT,STS11,RSA  FONDAZIONE ANNI SERENI TREVIGLIO CARAVAGGI E FARA GA ONLUS,LOM,50-59,3,9,0,10,2,0,0,12,0,12,Lombardia,ITC4
2021-01-06,PF/BT,STS11,RSA  FONDAZIONE ANNI SERENI TREVIGLIO CARAVAGGI E FARA GA ONLUS,LOM,60-69,2,1,0,1,1,1,0,3,0,3,Lombardia,ITC4
2021-01-06,PF/BT,STS11,RSA  FONDAZIONE ANNI SERENI TREVIGLIO CARAVAGGI E FARA GA ONLUS,LOM,70-79,3,3,0,0,0,6,0,6,0,6,Lombardia,ITC4
2021-01-06,PF/BT,STS11,RSA  FONDAZIONE ANNI SERENI TREVIGLIO CARAVAGGI E FARA GA ONLUS,LOM,80-89,0,9,0,0,0,9,0,9,0,9,Lombardia,ITC4
2021-01-06,PF/BT,STS11,RSA  FONDAZIONE ANNI SERENI TREVIGLIO CARAVAGGI E FARA GA ONLUS,LOM,90+,1,5,0,0,0,6,0,6,0,6,Lombardia,ITC4
2021-01-07,PF/BT,(03027500/001752),PVO Istituto Clinico San Rocco (Spoke),LOM,20-29,0,4,0,4,0,0,0,4,0,4,Lombardia,ITC4
2021-01-07,PF/BT,(03027500/001752),PVO Istituto Clinico San Rocco (Spoke),LOM,30-39,1,6,0,7,0,0,0,7,0,7,Lombardia,ITC4
2021-01-07,PF/BT,(03027500/001752),PVO Istituto Clinico San Rocco (Spoke),LOM,40-49,2,11,0,13,0,0,0,13,0,13,Lombardia,ITC4
2021-01-07,PF/BT,(03027500/001752),PVO Istituto Clinico San Rocco (Spoke),LOM,50-59,3,8,0,8,3,0,0,11,0,11,Lombardia,ITC4
2021-01-07,PF/BT,(03027500/001752),PVO Istituto Clinico San Rocco (Spoke),LOM,60-69,3,2,0,5,0,0,0,5,0,5,Lombardia,ITC4
2021-01-07,PF/BT,(03027500/001752),PVO Istituto Clinico San Rocco (Spoke),LOM,70-79,1,0,0,1,0,0,0,1,0,1,Lombardia,ITC4
2021-01-07,PF/BT,.030042,ASST VALTELLINA ALTO LARIO - PRESIDIO OSPEDALIERO DI SONDRIO,LOM,20-29,2,2,0,4,0,0,0,4,0,4,Lombardia,ITC4
2021-01-07,PF/BT,.030042,ASST VALTELLINA ALTO LARIO - PRESIDIO OSPEDALIERO DI SONDRIO,LOM,30-39,5,7,0,10,2,0,0,12,0,12,Lombardia,ITC4
2021-01-07,PF/BT,.030042,ASST VALTELLINA ALTO LARIO - PRESIDIO OSPEDALIERO DI SONDRIO,LOM,40-49,5,20,0,24,1,0,0,25,0,25,Lombardia,ITC4
2021-01-07,PF/BT,.030042,ASST VALTELLINA ALTO LARIO - PRESIDIO OSPEDALIERO DI SONDRIO,LOM,50-59,11,50,0,59,2,0,0,61,0,61,Lombardia,ITC4
2021-01-07,PF/BT,.030042,ASST VALTELLINA ALTO LARIO - PRESIDIO OSPEDALIERO DI SONDRIO,LOM,60-69,4,14,0,16,2,0,0,18,0,18,Lombardia,ITC4
2021-01-07,PF/BT,000050,Poliambulatorio IRCSS OSPEDALE SAN LUCA,LOM,30-39,2,2,0,4,0,0,0,4,0,4,Lombardia,ITC4
2021-01-07,PF/BT,000050,Poliambulatorio IRCSS OSPEDALE SAN LUCA,LOM,40-49,1,4,0,5,0,0,0,5,0,5,Lombardia,ITC4
2021-01-07,PF/BT,000050,Poliambulatorio IRCSS OSPEDALE SAN LUCA,LOM,50-59,2,6,0,8,0,0,0,8,0,8,Lombardia,ITC4
2021-01-07,PF/BT,000050,Poliambulatorio IRCSS OSPEDALE SAN LUCA,LOM,60-69,2,2,0,4,0,0,0,4,0,4,Lombardia,ITC4
2021-01-07,PF/BT,000050,Poliambulatorio IRCSS OSPEDALE SAN LUCA,LOM,70-79,0,1,0,1,0,0,0,1,0,1,Lombardia,ITC4
2021-01-07,PF/BT,000417,POLIAMBULATORIO IRCCS OSPEDALE CAPITANIO,LOM,20-29,2,0,0,2,0,0,0,2,0,2,Lombardia,ITC4
2021-01-07,PF/BT,000417,POLIAMBULATORIO IRCCS OSPEDALE CAPITANIO,LOM,30-39,4,5,0,9,0,0,0,9,0,9,Lombardia,ITC4
2021-01-07,PF/BT,000417,POLIAMBULATORIO IRCCS OSPEDALE CAPITANIO,LOM,40-49,4,3,0,7,0,0,0,7,0,7,Lombardia,ITC4
2021-01-07,PF/BT,000417,POLIAMBULATORIO IRCCS OSPEDALE CAPITANIO,LOM,50-59,1,1,0,2,0,0,0,2,0,2,Lombardia,ITC4
2021-01-07,PF/BT,000417,POLIAMBULATORIO IRCCS OSPEDALE CAPITANIO,LOM,60-69,0,3,0,3,0,0,0,3,0,3,Lombardia,ITC4
2021-01-07,PF/BT,000417,POLIAMBULATORIO IRCCS OSPEDALE CAPITANIO,LOM,70-79,0,1,0,1,0,0,0,1,0,1,Lombardia,ITC4
2021-01-07,PF/BT,000492 E 000493,RSA KORIAN IPPOCRATE,LOM,20-29,4,11,0,12,3,0,0,15,0,15,Lombardia,ITC4
2021-01-07,PF/BT,000492 E 000493,RSA KORIAN IPPOCRATE,LOM,30-39,5,20,0,14,11,0,0,25,0,25,Lombardia,ITC4
2021-01-07,PF/BT,000492 E 000493,RSA KORIAN IPPOCRATE,LOM,40-49,4,22,0,23,3,0,0,26,0,26,Lombardia,ITC4
2021-01-07,PF/BT,000492 E 000493,RSA KORIAN IPPOCRATE,LOM,50-59,6,32,0,24,12,2,0,38,0,38,Lombardia,ITC4
2021-01-07,PF/BT,000492 E 000493,RSA KORIAN IPPOCRATE,LOM,60-69,8,20,0,9,6,13,0,28,0,28,Lombardia,ITC4
2021-01-07,PF/BT,000492 E 000493,RSA KORIAN IPPOCRATE,LOM,70-79,18,23,0,0,0,41,0,41,0,41,Lombardia,ITC4
2021-01-07,PF/BT,000492 E 000493,RSA KORIAN IPPOCRATE,LOM,80-89,21,75,0,0,0,96,0,96,0,96,Lombardia,ITC4
2021-01-07,PF/BT,000492 E 000493,RSA KORIAN IPPOCRATE,LOM,90+,14,59,0,0,0,73,0,73,0,73,Lombardia,ITC4
2021-01-07,PF/BT,002982,POLIAMBULATORI OSP. DI EDOLO,LOM,20-29,0,1,0,1,0,0,0,1,0,1,Lombardia,ITC4
2021-01-07,PF/BT,002982,POLIAMBULATORI OSP. DI EDOLO,LOM,30-39,2,5,0,7,0,0,0,7,0,7,Lombardia,ITC4
2021-01-07,PF/BT,002982,POLIAMBULATORI OSP. DI EDOLO,LOM,40-49,2,13,0,12,3,0,0,15,0,15,Lombardia,ITC4
2021-01-07,PF/BT,002982,POLIAMBULATORI OSP. DI EDOLO,LOM,50-59,3,18,0,18,3,0,0,21,0,21,Lombardia,ITC4
2021-01-07,PF/BT,002982,POLIAMBULATORI OSP. DI EDOLO,LOM,60-69,3,1,0,3,1,0,0,4,0,4,Lombardia,ITC4
2021-01-07,PF/BT,002987,POLIAMBULATORIO OSPEDALE ESINE,LOM,20-29,0,11,0,11,0,0,0,11,0,11,Lombardia,ITC4
2021-01-07,PF/BT,002987,POLIAMBULATORIO OSPEDALE ESINE,LOM,30-39,9,18,0,25,2,0,0,27,0,27,Lombardia,ITC4
2021-01-07,PF/BT,002987,POLIAMBULATORIO OSPEDALE ESINE,LOM,40-49,10,38,0,41,7,0,0,48,0,48,Lombardia,ITC4
2021-01-07,PF/BT,002987,POLIAMBULATORIO OSPEDALE ESINE,LOM,50-59,8,38,0,40,6,0,0,46,0,46,Lombardia,ITC4
2021-01-07,PF/BT,002987,POLIAMBULATORIO OSPEDALE ESINE,LOM,60-69,6,6,0,12,0,0,0,12,0,12,Lombardia,ITC4
2021-01-07,PF/BT,003328,HUB COV CHIARI - P.O. ISEO -  ASST FRANCIACORTA,LOM,16-19,0,3,0,2,1,0,0,3,0,3,Lombardia,ITC4
2021-01-07,PF/BT,003328,HUB COV CHIARI - P.O. ISEO -  ASST FRANCIACORTA,LOM,20-29,6,10,0,13,3,0,0,16,0,16,Lombardia,ITC4
2021-01-07,PF/BT,003328,HUB COV CHIARI - P.O. ISEO -  ASST FRANCIACORTA,LOM,30-39,9,16,0,21,4,0,0,25,0,25,Lombardia,ITC4
2021-01-07,PF/BT,003328,HUB COV CHIARI - P.O. ISEO -  ASST FRANCIACORTA,LOM,40-49,8,39,0,44,3,0,0,47,0,47,Lombardia,ITC4
2021-01-07,PF/BT,003328,HUB COV CHIARI - P.O. ISEO -  ASST FRANCIACORTA,LOM,50-59,10,29,0,35,4,0,0,39,0,39,Lombardia,ITC4
2021-01-07,PF/BT,003328,HUB COV CHIARI - P.O. ISEO -  ASST FRANCIACORTA,LOM,60-69,9,4,0,11,2,0,0,13,0,13,Lombardia,ITC4
2021-01-07,PF/BT,003328,HUB COV CHIARI - P.O. ISEO -  ASST FRANCIACORTA,LOM,70-79,1,0,0,1,0,0,0,1,0,1,Lombardia,ITC4
2021-01-07,PF/BT,003335,HUB COV CHIARI - P.O. CHIARI ASST FRANCIACORTA,LOM,20-29,5,19,0,21,3,0,0,24,0,24,Lombardia,ITC4
2021-01-07,PF/BT,003335,HUB COV CHIARI - P.O. CHIARI ASST FRANCIACORTA,LOM,30-39,8,18,0,21,5,0,0,26,0,26,Lombardia,ITC4
2021-01-07,PF/BT,003335,HUB COV CHIARI - P.O. CHIARI ASST FRANCIACORTA,LOM,40-49,14,42,0,48,8,0,0,56,0,56,Lombardia,ITC4
2021-01-07,PF/BT,003335,HUB COV CHIARI - P.O. CHIARI ASST FRANCIACORTA,LOM,50-59,22,29,0,39,12,0,0,51,0,51,Lombardia,ITC4
2021-01-07,PF/BT,003335,HUB COV CHIARI - P.O. CHIARI ASST FRANCIACORTA,LOM,60-69,4,7,0,7,4,0,0,11,0,11,Lombardia,ITC4
2021-01-07,PF/BT,030 202,ISTITUTO DI CURA CITTA' DI PAVIA,LOM,40-49,1,7,0,8,0,0,0,8,0,8,Lombardia,ITC4
2021-01-07,PF/BT,030 202,ISTITUTO DI CURA CITTA' DI PAVIA,LOM,50-59,0,3,0,3,0,0,0,3,0,3,Lombardia,ITC4
2021-01-07,PF/BT,030066,CV Garbagnate,LOM,20-29,3,9,0,12,0,0,0,12,0,12,Lombardia,ITC4
2021-01-07,PF/BT,030066,CV Garbagnate,LOM,30-39,7,19,0,23,3,0,0,26,0,26,Lombardia,ITC4
2021-01-07,PF/BT,030066,CV Garbagnate,LOM,40-49,13,28,0,36,5,0,0,41,0,41,Lombardia,ITC4
2021-01-07,PF/BT,030066,CV Garbagnate,LOM,50-59,20,64,0,73,11,0,0,84,0,84,Lombardia,ITC4
2021-01-07,PF/BT,030066,CV Garbagnate,LOM,60-69,12,17,0,25,4,0,0,29,0,29,Lombardia,ITC4
2021-01-07,PF/BT,030068,PUNTO VACCINALE OSPEDALIERO DESIO,LOM,20-29,1,2,0,3,0,0,0,3,0,3,Lombardia,ITC4
2021-01-07,PF/BT,030068,PUNTO VACCINALE OSPEDALIERO DESIO,LOM,30-39,5,10,0,14,1,0,0,15,0,15,Lombardia,ITC4
2021-01-07,PF/BT,030068,PUNTO VACCINALE OSPEDALIERO DESIO,LOM,40-49,13,23,0,33,3,0,0,36,0,36,Lombardia,ITC4
2021-01-07,PF/BT,030068,PUNTO VACCINALE OSPEDALIERO DESIO,LOM,50-59,10,37,0,36,11,0,0,47,0,47,Lombardia,ITC4
2021-01-07,PF/BT,030068,PUNTO VACCINALE OSPEDALIERO DESIO,LOM,60-69,7,10,0,14,3,0,0,17,0,17,Lombardia,ITC4
2021-01-07,PF/BT,030070,PUNTO VACCINALE OSPEDALIERO CARATE BRIANZA,LOM,20-29,1,8,0,7,2,0,0,9,0,9,Lombardia,ITC4
2021-01-07,PF/BT,030070,PUNTO VACCINALE OSPEDALIERO CARATE BRIANZA,LOM,30-39,11,17,0,24,4,0,0,28,0,28,Lombardia,ITC4
2021-01-07,PF/BT,030070,PUNTO VACCINALE OSPEDALIERO CARATE BRIANZA,LOM,40-49,4,17,0,16,5,0,0,21,0,21,Lombardia,ITC4
2021-01-07,PF/BT,030070,PUNTO VACCINALE OSPEDALIERO CARATE BRIANZA,LOM,50-59,17,42,0,43,16,0,0,59,0,59,Lombardia,ITC4
2021-01-07,PF/BT,030070,PUNTO VACCINALE OSPEDALIERO CARATE BRIANZA,LOM,60-69,7,10,0,15,2,0,0,17,0,17,Lombardia,ITC4
2021-01-07,PF/BT,030078,PUNTO VACCINALE OSPEDALIERO VIMERCATE,LOM,20-29,6,15,0,19,2,0,0,21,0,21,Lombardia,ITC4
2021-01-07,PF/BT,030078,PUNTO VACCINALE OSPEDALIERO VIMERCATE,LOM,30-39,11,20,0,26,5,0,0,31,0,31,Lombardia,ITC4
2021-01-07,PF/BT,030078,PUNTO VACCINALE OSPEDALIERO VIMERCATE,LOM,40-49,12,37,0,45,4,0,0,49,0,49,Lombardia,ITC4
2021-01-07,PF/BT,030078,PUNTO VACCINALE OSPEDALIERO VIMERCATE,LOM,50-59,12,43,0,44,11,0,0,55,0,55,Lombardia,ITC4
2021-01-07,PF/BT,030078,PUNTO VACCINALE OSPEDALIERO VIMERCATE,LOM,60-69,10,11,0,14,7,0,0,21,0,21,Lombardia,ITC4
2021-01-07,PF/BT,030078,PUNTO VACCINALE OSPEDALIERO VIMERCATE,LOM,70-79,1,2,0,3,0,0,0,3,0,3,Lombardia,ITC4
2021-01-07,PF/BT,030107,ISTITUTI CLINICI ZUCCHI - PRESIDIO DI MONZA,LOM,20-29,0,3,0,3,0,0,0,3,0,3,Lombardia,ITC4
2021-01-07,PF/BT,030107,ISTITUTI CLINICI ZUCCHI - PRESIDIO DI MONZA,LOM,30-39,2,5,0,7,0,0,0,7,0,7,Lombardia,ITC4
2021-01-07,PF/BT,030107,ISTITUTI CLINICI ZUCCHI - PRESIDIO DI MONZA,LOM,40-49,1,0,0,1,0,0,0,1,0,1,Lombardia,ITC4
2021-01-07,PF/BT,030107,ISTITUTI CLINICI ZUCCHI - PRESIDIO DI MONZA,LOM,50-59,1,0,0,1,0,0,0,1,0,1,Lombardia,ITC4
2021-01-07,PF/BT,030176,ISTITUTO CLINICO S. ANNA di ISTITUTI OSPEDALIERI BRESCIANI S.p.A,LOM,20-29,1,5,0,6,0,0,0,6,0,6,Lombardia,ITC4
2021-01-07,PF/BT,030176,ISTITUTO CLINICO S. ANNA di ISTITUTI OSPEDALIERI BRESCIANI S.p.A,LOM,30-39,3,8,0,11,0,0,0,11,0,11,Lombardia,ITC4
2021-01-07,PF/BT,030176,ISTITUTO CLINICO S. ANNA di ISTITUTI OSPEDALIERI BRESCIANI S.p.A,LOM,40-49,5,14,0,19,0,0,0,19,0,19,Lombardia,ITC4
2021-01-07,PF/BT,030176,ISTITUTO CLINICO S. ANNA di ISTITUTI OSPEDALIERI BRESCIANI S.p.A,LOM,50-59,5,9,0,14,0,0,0,14,0,14,Lombardia,ITC4
2021-01-07,PF/BT,030176,ISTITUTO CLINICO S. ANNA di ISTITUTI OSPEDALIERI BRESCIANI S.p.A,LOM,60-69,1,0,0,1,0,0,0,1,0,1,Lombardia,ITC4
2021-01-07,PF/BT,030176,ISTITUTO CLINICO S. ANNA di ISTITUTI OSPEDALIERI BRESCIANI S.p.A,LOM,70-79,1,0,0,1,0,0,0,1,0,1,Lombardia,ITC4
2021-01-07,PF/BT,030176,ISTITUTO CLINICO S. ANNA di ISTITUTI OSPEDALIERI BRESCIANI S.p.A,LOM,80-89,1,0,0,1,0,0,0,1,0,1,Lombardia,ITC4
2021-01-07,PF/BT,030178,ISTITUTO CLINICO CITTA' DI BRESCIA DI ISTITUTI OSPEDALIERI BRESCIANI,LOM,20-29,3,4,0,7,0,0,0,7,0,7,Lombardia,ITC4
2021-01-07,PF/BT,030178,ISTITUTO CLINICO CITTA' DI BRESCIA DI ISTITUTI OSPEDALIERI BRESCIANI,LOM,30-39,4,3,0,7,0,0,0,7,0,7,Lombardia,ITC4
2021-01-07,PF/BT,030178,ISTITUTO CLINICO CITTA' DI BRESCIA DI ISTITUTI OSPEDALIERI BRESCIANI,LOM,40-49,2,17,0,19,0,0,0,19,0,19,Lombardia,ITC4
2021-01-07,PF/BT,030178,ISTITUTO CLINICO CITTA' DI BRESCIA DI ISTITUTI OSPEDALIERI BRESCIANI,LOM,50-59,3,11,0,13,1,0,0,14,0,14,Lombardia,ITC4
2021-01-07,PF/BT,030178,ISTITUTO CLINICO CITTA' DI BRESCIA DI ISTITUTI OSPEDALIERI BRESCIANI,LOM,60-69,1,3,0,4,0,0,0,4,0,4,Lombardia,ITC4
2021-01-07,PF/BT,030295,Fondazione Poliambulanza - Brescia,LOM,20-29,9,16,0,25,0,0,0,25,0,25,Lombardia,ITC4
2021-01-07,PF/BT,030295,Fondazione Poliambulanza - Brescia,LOM,30-39,10,20,0,30,0,0,0,30,0,30,Lombardia,ITC4
2021-01-07,PF/BT,030295,Fondazione Poliambulanza - Brescia,LOM,40-49,13,37,0,50,0,0,0,50,0,50,Lombardia,ITC4
2021-01-07,PF/BT,030295,Fondazione Poliambulanza - Brescia,LOM,50-59,13,26,0,39,0,0,0,39,0,39,Lombardia,ITC4
2021-01-07,PF/BT,030295,Fondazione Poliambulanza - Brescia,LOM,60-69,16,6,0,22,0,0,0,22,0,22,Lombardia,ITC4
2021-01-07,PF/BT,030295,Fondazione Poliambulanza - Brescia,LOM,70-79,2,0,0,1,1,0,0,2,0,2,Lombardia,ITC4
2021-01-07,PF/BT,030-322-002821,FONDAZIONE CA' D'INDUSTRIA ONLUS,LOM,70-79,1,0,0,0,0,1,0,1,0,1,Lombardia,ITC4
2021-01-07,PF/BT,030-322-002821,FONDAZIONE CA' D'INDUSTRIA ONLUS,LOM,80-89,5,11,0,0,0,16,0,16,0,16,Lombardia,ITC4
2021-01-07,PF/BT,030-322-002821,FONDAZIONE CA' D'INDUSTRIA ONLUS,LOM,90+,2,5,0,0,0,7,0,7,0,7,Lombardia,ITC4
2021-01-07,PF/BT,030324001093 -  030324001116,ISTIT.RIUNITI AIROLDI E MUZZI,LOM,20-29,1,3,0,4,0,0,0,4,0,4,Lombardia,ITC4
2021-01-07,PF/BT,030324001093 -  030324001116,ISTIT.RIUNITI AIROLDI E MUZZI,LOM,30-39,0,1,0,1,0,0,0,1,0,1,Lombardia,ITC4
2021-01-07,PF/BT,030324001093 -  030324001116,ISTIT.RIUNITI AIROLDI E MUZZI,LOM,40-49,1,5,0,6,0,0,0,6,0,6,Lombardia,ITC4
2021-01-07,PF/BT,030324001093 -  030324001116,ISTIT.RIUNITI AIROLDI E MUZZI,LOM,50-59,2,7,0,8,1,0,0,9,0,9,Lombardia,ITC4
2021-01-07,PF/BT,030324001093 -  030324001116,ISTIT.RIUNITI AIROLDI E MUZZI,LOM,60-69,0,3,0,2,0,0,1,3,0,3,Lombardia,ITC4
2021-01-07,PF/BT,030324001093 -  030324001116,ISTIT.RIUNITI AIROLDI E MUZZI,LOM,70-79,1,0,0,0,0,0,1,1,0,1,Lombardia,ITC4
2021-01-07,PF/BT,030704,Polo Riabilitativo FFO,LOM,20-29,0,2,0,2,0,0,0,2,0,2,Lombardia,ITC4
2021-01-07,PF/BT,030704,Polo Riabilitativo FFO,LOM,30-39,2,2,0,4,0,0,0,4,0,4,Lombardia,ITC4
2021-01-07,PF/BT,030704,Polo Riabilitativo FFO,LOM,40-49,1,3,0,4,0,0,0,4,0,4,Lombardia,ITC4
2021-01-07,PF/BT,030704,Polo Riabilitativo FFO,LOM,50-59,0,1,0,1,0,0,0,1,0,1,Lombardia,ITC4
2021-01-07,PF/BT,030704,Polo Riabilitativo FFO,LOM,60-69,0,1,0,1,0,0,0,1,0,1,Lombardia,ITC4
2021-01-07,PF/BT,030704,Presidio Ospedaliero CTO,LOM,20-29,2,0,0,2,0,0,0,2,0,2,Lombardia,ITC4
2021-01-07,PF/BT,030704,Presidio Ospedaliero CTO,LOM,30-39,1,2,0,3,0,0,0,3,0,3,Lombardia,ITC4
2021-01-07,PF/BT,030704,Presidio Ospedaliero CTO,LOM,40-49,6,3,0,9,0,0,0,9,0,9,Lombardia,ITC4
2021-01-07,PF/BT,030704,Presidio Ospedaliero CTO,LOM,50-59,8,4,0,12,0,0,0,12,0,12,Lombardia,ITC4
2021-01-07,PF/BT,030704,Presidio Ospedaliero CTO,LOM,60-69,0,4,0,4,0,0,0,4,0,4,Lombardia,ITC4
2021-01-07,PF/BT,030704,Presidio Ospedaliero G. Pini,LOM,20-29,4,5,0,6,3,0,0,9,0,9,Lombardia,ITC4
2021-01-07,PF/BT,030704,Presidio Ospedaliero G. Pini,LOM,30-39,7,4,0,10,1,0,0,11,0,11,Lombardia,ITC4
2021-01-07,PF/BT,030704,Presidio Ospedaliero G. Pini,LOM,40-49,1,0,0,0,1,0,0,1,0,1,Lombardia,ITC4
2021-01-07,PF/BT,030704,Presidio Ospedaliero G. Pini,LOM,50-59,11,9,0,14,6,0,0,20,0,20,Lombardia,ITC4
2021-01-07,PF/BT,030704,Presidio Ospedaliero G. Pini,LOM,60-69,4,9,0,9,4,0,0,13,0,13,Lombardia,ITC4
2021-01-07,PF/BT,030704,Presidio Ospedaliero G. Pini,LOM,70-79,6,0,0,6,0,0,0,6,0,6,Lombardia,ITC4
2021-01-07,PF/BT,030903,AMB COVID LECCO,LOM,16-19,0,1,0,0,1,0,0,1,0,1,Lombardia,ITC4
2021-01-07,PF/BT,030903,AMB COVID LECCO,LOM,20-29,8,25,0,24,9,0,0,33,0,33,Lombardia,ITC4
2021-01-07,PF/BT,030903,AMB COVID LECCO,LOM,30-39,15,30,0,43,2,0,0,45,0,45,Lombardia,ITC4
2021-01-07,PF/BT,030903,AMB COVID LECCO,LOM,40-49,9,65,0,66,8,0,0,74,0,74,Lombardia,ITC4
2021-01-07,PF/BT,030903,AMB COVID LECCO,LOM,50-59,21,73,0,76,18,0,0,94,0,94,Lombardia,ITC4
2021-01-07,PF/BT,030903,AMB COVID LECCO,LOM,60-69,38,21,0,56,3,0,0,59,0,59,Lombardia,ITC4
2021-01-07,PF/BT,030922,"FOND.IRCCS ""ISTIT.NAZ.LE TUMORI""MILANO",LOM,20-29,7,11,0,15,3,0,0,18,0,18,Lombardia,ITC4
2021-01-07,PF/BT,030922,"FOND.IRCCS ""ISTIT.NAZ.LE TUMORI""MILANO",LOM,30-39,21,35,0,52,4,0,0,56,0,56,Lombardia,ITC4
2021-01-07,PF/BT,030922,"FOND.IRCCS ""ISTIT.NAZ.LE TUMORI""MILANO",LOM,40-49,8,24,0,28,4,0,0,32,0,32,Lombardia,ITC4
2021-01-07,PF/BT,030922,"FOND.IRCCS ""ISTIT.NAZ.LE TUMORI""MILANO",LOM,50-59,14,38,0,40,12,0,0,52,0,52,Lombardia,ITC4
2021-01-07,PF/BT,030922,"FOND.IRCCS ""ISTIT.NAZ.LE TUMORI""MILANO",LOM,60-69,11,11,0,18,4,0,0,22,0,22,Lombardia,ITC4
2021-01-07,PF/BT,030923,FOND.IRCCS IST.NAZ.NEUROLOGICO C.BESTA-M,LOM,20-29,2,5,0,6,1,0,0,7,0,7,Lombardia,ITC4
2021-01-07,PF/BT,030923,FOND.IRCCS IST.NAZ.NEUROLOGICO C.BESTA-M,LOM,30-39,11,10,0,19,1,0,1,21,0,21,Lombardia,ITC4
2021-01-07,PF/BT,030923,FOND.IRCCS IST.NAZ.NEUROLOGICO C.BESTA-M,LOM,40-49,6,15,0,18,2,0,1,21,0,21,Lombardia,ITC4
2021-01-07,PF/BT,030923,FOND.IRCCS IST.NAZ.NEUROLOGICO C.BESTA-M,LOM,50-59,5,21,0,16,10,0,0,26,0,26,Lombardia,ITC4
2021-01-07,PF/BT,030923,FOND.IRCCS IST.NAZ.NEUROLOGICO C.BESTA-M,LOM,60-69,4,3,0,7,0,0,0,7,0,7,Lombardia,ITC4
2021-01-07,PF/BT,030924,IRCCS POLICLINICO S. MATTEO - PAVIA,LOM,20-29,11,24,0,35,0,0,0,35,0,35,Lombardia,ITC4
2021-01-07,PF/BT,030924,IRCCS POLICLINICO S. MATTEO - PAVIA,LOM,30-39,16,29,0,45,0,0,0,45,0,45,Lombardia,ITC4
2021-01-07,PF/BT,030924,IRCCS POLICLINICO S. MATTEO - PAVIA,LOM,40-49,13,31,0,43,1,0,0,44,0,44,Lombardia,ITC4
2021-01-07,PF/BT,030924,IRCCS POLICLINICO S. MATTEO - PAVIA,LOM,50-59,21,48,0,67,2,0,0,69,0,69,Lombardia,ITC4
2021-01-07,PF/BT,030924,IRCCS POLICLINICO S. MATTEO - PAVIA,LOM,60-69,4,6,0,10,0,0,0,10,0,10,Lombardia,ITC4
2021-01-07,PF/BT,030935,IRCCS    S. RAFFAELE - MILANO,LOM,20-29,9,14,0,23,0,0,0,23,0,23,Lombardia,ITC4
2021-01-07,PF/BT,030935,IRCCS    S. RAFFAELE - MILANO,LOM,30-39,15,17,0,32,0,0,0,32,0,32,Lombardia,ITC4
2021-01-07,PF/BT,030935,IRCCS    S. RAFFAELE - MILANO,LOM,40-49,10,7,0,17,0,0,0,17,0,17,Lombardia,ITC4
2021-01-07,PF/BT,030935,IRCCS    S. RAFFAELE - MILANO,LOM,50-59,56,54,0,110,0,0,0,110,0,110,Lombardia,ITC4
2021-01-07,PF/BT,030935,IRCCS    S. RAFFAELE - MILANO,LOM,60-69,13,16,0,29,0,0,0,29,0,29,Lombardia,ITC4
2021-01-07,PF/BT,030935,IRCCS    S. RAFFAELE - MILANO,LOM,70-79,1,3,0,4,0,0,0,4,0,4,Lombardia,ITC4
2021-01-07,PF/BT,030937,PRO JOVENTUDE DON C. GNOCCHI - MI IRCCS PRIVATO,LOM,30-39,0,1,0,1,0,0,0,1,0,1,Lombardia,ITC4
2021-01-07,PF/BT,030937,PRO JOVENTUDE DON C. GNOCCHI - MI IRCCS PRIVATO,LOM,40-49,0,1,0,1,0,0,0,1,0,1,Lombardia,ITC4
2021-01-07,PF/BT,030937,PRO JOVENTUDE DON C. GNOCCHI - MI IRCCS PRIVATO,LOM,50-59,5,9,0,14,0,0,0,14,0,14,Lombardia,ITC4
2021-01-07,PF/BT,030937,PRO JOVENTUDE DON C. GNOCCHI - MI IRCCS PRIVATO,LOM,60-69,5,9,0,14,0,0,0,14,0,14,Lombardia,ITC4
2021-01-07,PF/BT,030943,Istituto Clinico Humanitas,LOM,20-29,54,83,0,122,15,0,0,137,0,137,Lombardia,ITC4
2021-01-07,PF/BT,030943,Istituto Clinico Humanitas,LOM,30-39,72,80,0,117,35,0,0,152,0,152,Lombardia,ITC4
2021-01-07,PF/BT,030943,Istituto Clinico Humanitas,LOM,40-49,41,82,0,99,24,0,0,123,0,123,Lombardia,ITC4
2021-01-07,PF/BT,030943,Istituto Clinico Humanitas,LOM,50-59,21,55,0,53,23,0,0,76,0,76,Lombardia,ITC4
2021-01-07,PF/BT,030943,Istituto Clinico Humanitas,LOM,60-69,14,5,0,14,5,0,0,19,0,19,Lombardia,ITC4
2021-01-07,PF/BT,030943,Istituto Clinico Humanitas,LOM,70-79,3,0,0,2,1,0,0,3,0,3,Lombardia,ITC4
2021-01-07,PF/BT,030950,IRCCS   S. RAFFAELE TURRO - MILANO,LOM,40-49,1,1,0,2,0,0,0,2,0,2,Lombardia,ITC4
2021-01-07,PF/BT,030950,IRCCS   S. RAFFAELE TURRO - MILANO,LOM,50-59,11,19,0,30,0,0,0,30,0,30,Lombardia,ITC4
2021-01-07,PF/BT,030950,IRCCS   S. RAFFAELE TURRO - MILANO,LOM,60-69,9,4,0,13,0,0,0,13,0,13,Lombardia,ITC4
2021-01-07,PF/BT,030950,IRCCS   S. RAFFAELE TURRO - MILANO,LOM,70-79,1,1,0,2,0,0,0,2,0,2,Lombardia,ITC4
2021-01-07,PF/BT,1798,FONDAZIONE GIUSEPPINA BRUNENGHI,LOM,40-49,1,0,0,0,0,1,0,1,0,1,Lombardia,ITC4
2021-01-07,PF/BT,1798,FONDAZIONE GIUSEPPINA BRUNENGHI,LOM,50-59,0,1,0,0,0,1,0,1,0,1,Lombardia,ITC4
2021-01-07,PF/BT,1798,FONDAZIONE GIUSEPPINA BRUNENGHI,LOM,60-69,1,2,0,0,0,3,0,3,0,3,Lombardia,ITC4
2021-01-07,PF/BT,1798,FONDAZIONE GIUSEPPINA BRUNENGHI,LOM,70-79,4,3,0,0,0,7,0,7,0,7,Lombardia,ITC4
2021-01-07,PF/BT,1798,FONDAZIONE GIUSEPPINA BRUNENGHI,LOM,80-89,4,12,0,0,0,16,0,16,0,16,Lombardia,ITC4
2021-01-07,PF/BT,1798,FONDAZIONE GIUSEPPINA BRUNENGHI,LOM,90+,1,31,0,0,0,32,0,32,0,32,Lombardia,ITC4
2021-01-07,PF/BT,1842,RSA VILLA AZZURRA,LOM,30-39,1,5,0,5,1,0,0,6,0,6,Lombardia,ITC4
2021-01-07,PF/BT,1842,RSA VILLA AZZURRA,LOM,40-49,1,4,0,5,0,0,0,5,0,5,Lombardia,ITC4
2021-01-07,PF/BT,1842,RSA VILLA AZZURRA,LOM,50-59,0,5,0,5,0,0,0,5,0,5,Lombardia,ITC4
2021-01-07,PF/BT,1842,RSA VILLA AZZURRA,LOM,60-69,0,2,0,2,0,0,0,2,0,2,Lombardia,ITC4
2021-01-07,PF/BT,1842,RSA VILLA AZZURRA,LOM,80-89,1,1,0,0,0,2,0,2,0,2,Lombardia,ITC4
2021-01-07,PF/BT,1842,RSA VILLA AZZURRA,LOM,90+,1,3,0,0,0,4,0,4,0,4,Lombardia,ITC4
2021-01-07,PF/BT,1953,RSA BEATA PAOLA,LOM,20-29,0,1,0,1,0,0,0,1,0,1,Lombardia,ITC4
2021-01-07,PF/BT,1953,RSA BEATA PAOLA,LOM,40-49,2,5,0,5,2,0,0,7,0,7,Lombardia,ITC4
2021-01-07,PF/BT,1953,RSA BEATA PAOLA,LOM,50-59,1,5,0,6,0,0,0,6,0,6,Lombardia,ITC4
2021-01-07,PF/BT,1953,RSA BEATA PAOLA,LOM,60-69,1,0,0,0,0,1,0,1,0,1,Lombardia,ITC4
2021-01-07,PF/BT,1953,RSA BEATA PAOLA,LOM,70-79,1,1,0,0,0,2,0,2,0,2,Lombardia,ITC4
2021-01-07,PF/BT,1953,RSA BEATA PAOLA,LOM,80-89,3,7,0,0,0,10,0,10,0,10,Lombardia,ITC4
2021-01-07,PF/BT,1953,RSA BEATA PAOLA,LOM,90+,0,3,0,0,0,3,0,3,0,3,Lombardia,ITC4
2021-01-07,PF/BT,2761,FONDAZIONE CA'D'INDUSTRIA LE CAMELIE,LOM,50-59,0,1,0,0,0,1,0,1,0,1,Lombardia,ITC4
2021-01-07,PF/BT,2761,FONDAZIONE CA'D'INDUSTRIA LE CAMELIE,LOM,70-79,0,1,0,0,0,1,0,1,0,1,Lombardia,ITC4
2021-01-07,PF/BT,2761,FONDAZIONE CA'D'INDUSTRIA LE CAMELIE,LOM,80-89,0,5,0,0,0,5,0,5,0,5,Lombardia,ITC4
2021-01-07,PF/BT,2761,FONDAZIONE CA'D'INDUSTRIA LE CAMELIE,LOM,90+,2,3,0,0,0,5,0,5,0,5,Lombardia,ITC4
2021-01-07,PF/BT,2821,FONDAZIONE CA' D'INDUSTRIA ONLUS,LOM,70-79,1,0,0,0,0,1,0,1,0,1,Lombardia,ITC4
2021-01-07,PF/BT,2821,FONDAZIONE CA' D'INDUSTRIA ONLUS,LOM,80-89,5,11,0,0,0,16,0,16,0,16,Lombardia,ITC4
2021-01-07,PF/BT,2821,FONDAZIONE CA' D'INDUSTRIA ONLUS,LOM,90+,2,5,0,0,0,7,0,7,0,7,Lombardia,ITC4
2021-01-07,PF/BT,2859,RSA FONDAZIONE BELLARIA ONLUS,LOM,40-49,0,2,0,2,0,0,0,2,0,2,Lombardia,ITC4
2021-01-07,PF/BT,2859,RSA FONDAZIONE BELLARIA ONLUS,LOM,50-59,0,4,0,4,0,0,0,4,0,4,Lombardia,ITC4
2021-01-07,PF/BT,30071,Centro Vaccinale Covid Melzo - ASST Melegnano Martesana,LOM,20-29,0,6,0,6,0,0,0,6,0,6,Lombardia,ITC4
2021-01-07,PF/BT,30071,Centro Vaccinale Covid Melzo - ASST Melegnano Martesana,LOM,30-39,9,4,0,13,0,0,0,13,0,13,Lombardia,ITC4
2021-01-07,PF/BT,30071,Centro Vaccinale Covid Melzo - ASST Melegnano Martesana,LOM,40-49,4,20,0,24,0,0,0,24,0,24,Lombardia,ITC4
2021-01-07,PF/BT,30071,Centro Vaccinale Covid Melzo - ASST Melegnano Martesana,LOM,50-59,7,37,0,44,0,0,0,44,0,44,Lombardia,ITC4
2021-01-07,PF/BT,30071,Centro Vaccinale Covid Melzo - ASST Melegnano Martesana,LOM,60-69,7,7,0,14,0,0,0,14,0,14,Lombardia,ITC4
2021-01-07,PF/BT,30072,Centro Vaccinale Covid Vizzolo - ASST Melegnano Martesana,LOM,20-29,2,8,0,9,1,0,0,10,0,10,Lombardia,ITC4
2021-01-07,PF/BT,30072,Centro Vaccinale Covid Vizzolo - ASST Melegnano Martesana,LOM,30-39,8,14,0,14,8,0,0,22,0,22,Lombardia,ITC4
2021-01-07,PF/BT,30072,Centro Vaccinale Covid Vizzolo - ASST Melegnano Martesana,LOM,40-49,10,15,0,19,6,0,0,25,0,25,Lombardia,ITC4
2021-01-07,PF/BT,30072,Centro Vaccinale Covid Vizzolo - ASST Melegnano Martesana,LOM,50-59,9,38,0,32,15,0,0,47,0,47,Lombardia,ITC4
2021-01-07,PF/BT,30072,Centro Vaccinale Covid Vizzolo - ASST Melegnano Martesana,LOM,60-69,6,9,0,15,0,0,0,15,0,15,Lombardia,ITC4
2021-01-07,PF/BT,30073,cv rho,LOM,20-29,3,4,0,7,0,0,0,7,0,7,Lombardia,ITC4
2021-01-07,PF/BT,30073,cv rho,LOM,30-39,5,19,0,24,0,0,0,24,0,24,Lombardia,ITC4
2021-01-07,PF/BT,30073,cv rho,LOM,40-49,3,24,0,25,2,0,0,27,0,27,Lombardia,ITC4
2021-01-07,PF/BT,30073,cv rho,LOM,50-59,16,49,0,61,4,0,0,65,0,65,Lombardia,ITC4
2021-01-07,PF/BT,30073,cv rho,LOM,60-69,9,17,0,24,2,0,0,26,0,26,Lombardia,ITC4
2021-01-07,PF/BT,30074,HUB COVID MAGENTA,LOM,16-19,0,1,0,0,1,0,0,1,0,1,Lombardia,ITC4
2021-01-07,PF/BT,30074,HUB COVID MAGENTA,LOM,20-29,2,6,0,8,0,0,0,8,0,8,Lombardia,ITC4
2021-01-07,PF/BT,30074,HUB COVID MAGENTA,LOM,30-39,4,17,0,20,1,0,0,21,0,21,Lombardia,ITC4
2021-01-07,PF/BT,30074,HUB COVID MAGENTA,LOM,40-49,6,34,0,36,4,0,0,40,0,40,Lombardia,ITC4
2021-01-07,PF/BT,30074,HUB COVID MAGENTA,LOM,50-59,15,58,0,58,15,0,0,73,0,73,Lombardia,ITC4
2021-01-07,PF/BT,30074,HUB COVID MAGENTA,LOM,60-69,3,15,0,11,7,0,0,18,0,18,Lombardia,ITC4
2021-01-07,PF/BT,30156,Centro Vaccinale Covid Desenzano,LOM,20-29,5,10,0,15,0,0,0,15,0,15,Lombardia,ITC4
2021-01-07,PF/BT,30156,Centro Vaccinale Covid Desenzano,LOM,30-39,8,10,0,15,3,0,0,18,0,18,Lombardia,ITC4
2021-01-07,PF/BT,30156,Centro Vaccinale Covid Desenzano,LOM,40-49,8,15,0,17,5,0,1,23,0,23,Lombardia,ITC4
2021-01-07,PF/BT,30156,Centro Vaccinale Covid Desenzano,LOM,50-59,9,38,0,39,8,0,0,47,0,47,Lombardia,ITC4
2021-01-07,PF/BT,30156,Centro Vaccinale Covid Desenzano,LOM,60-69,9,8,0,9,7,0,1,17,0,17,Lombardia,ITC4
2021-01-07,PF/BT,30157,Centro Vaccinale Covid Gavardo,LOM,20-29,0,5,0,4,1,0,0,5,0,5,Lombardia,ITC4
2021-01-07,PF/BT,30157,Centro Vaccinale Covid Gavardo,LOM,30-39,5,10,0,15,0,0,0,15,0,15,Lombardia,ITC4
2021-01-07,PF/BT,30157,Centro Vaccinale Covid Gavardo,LOM,40-49,6,25,0,23,8,0,0,31,0,31,Lombardia,ITC4
2021-01-07,PF/BT,30157,Centro Vaccinale Covid Gavardo,LOM,50-59,7,35,0,29,13,0,0,42,0,42,Lombardia,ITC4
2021-01-07,PF/BT,30157,Centro Vaccinale Covid Gavardo,LOM,60-69,2,6,0,6,2,0,0,8,0,8,Lombardia,ITC4
2021-01-07,PF/BT,30157,Centro Vaccinale Covid Gavardo,LOM,70-79,1,0,0,1,0,0,0,1,0,1,Lombardia,ITC4
2021-01-07,PF/BT,30184,Centro Vaccinale Covid Manerbio,LOM,20-29,1,5,0,5,1,0,0,6,0,6,Lombardia,ITC4
2021-01-07,PF/BT,30184,Centro Vaccinale Covid Manerbio,LOM,30-39,3,15,0,15,3,0,0,18,0,18,Lombardia,ITC4
2021-01-07,PF/BT,30184,Centro Vaccinale Covid Manerbio,LOM,40-49,7,19,0,21,5,0,0,26,0,26,Lombardia,ITC4
2021-01-07,PF/BT,30184,Centro Vaccinale Covid Manerbio,LOM,50-59,12,37,0,40,9,0,0,49,0,49,Lombardia,ITC4
2021-01-07,PF/BT,30184,Centro Vaccinale Covid Manerbio,LOM,60-69,8,7,0,12,3,0,0,15,0,15,Lombardia,ITC4
2021-01-07,PF/BT,30193,Ambulatorio HUB Vigevano,LOM,20-29,2,9,0,10,1,0,0,11,0,11,Lombardia,ITC4
2021-01-07,PF/BT,30193,Ambulatorio HUB Vigevano,LOM,30-39,8,14,0,20,2,0,0,22,0,22,Lombardia,ITC4
2021-01-07,PF/BT,30193,Ambulatorio HUB Vigevano,LOM,40-49,5,25,0,27,3,0,0,30,0,30,Lombardia,ITC4
2021-01-07,PF/BT,30193,Ambulatorio HUB Vigevano,LOM,50-59,16,65,0,70,11,0,0,81,0,81,Lombardia,ITC4
2021-01-07,PF/BT,30193,Ambulatorio HUB Vigevano,LOM,60-69,9,15,0,22,2,0,0,24,0,24,Lombardia,ITC4
2021-01-07,PF/BT,30194,AMBULATORIO HUB VOGHERA,LOM,20-29,2,6,0,8,0,0,0,8,0,8,Lombardia,ITC4
2021-01-07,PF/BT,30194,AMBULATORIO HUB VOGHERA,LOM,30-39,13,18,0,31,0,0,0,31,0,31,Lombardia,ITC4
2021-01-07,PF/BT,30194,AMBULATORIO HUB VOGHERA,LOM,40-49,10,34,0,42,2,0,0,44,0,44,Lombardia,ITC4
2021-01-07,PF/BT,30194,AMBULATORIO HUB VOGHERA,LOM,50-59,31,35,0,63,3,0,0,66,0,66,Lombardia,ITC4
2021-01-07,PF/BT,30194,AMBULATORIO HUB VOGHERA,LOM,60-69,9,4,0,13,0,0,0,13,0,13,Lombardia,ITC4
2021-01-07,PF/BT,30209,OSPEDALE MAGGIORE DI CREMA,LOM,20-29,1,10,0,9,2,0,0,11,0,11,Lombardia,ITC4
2021-01-07,PF/BT,30209,OSPEDALE MAGGIORE DI CREMA,LOM,30-39,12,11,0,20,3,0,0,23,0,23,Lombardia,ITC4
2021-01-07,PF/BT,30209,OSPEDALE MAGGIORE DI CREMA,LOM,40-49,10,17,0,20,7,0,0,27,0,27,Lombardia,ITC4
2021-01-07,PF/BT,30209,OSPEDALE MAGGIORE DI CREMA,LOM,50-59,14,32,0,32,14,0,0,46,0,46,Lombardia,ITC4
2021-01-07,PF/BT,30209,OSPEDALE MAGGIORE DI CREMA,LOM,60-69,3,10,0,6,7,0,0,13,0,13,Lombardia,ITC4
2021-01-07,PF/BT,30281,HUB COVID LEGNANO,LOM,20-29,10,15,0,20,5,0,0,25,0,25,Lombardia,ITC4
2021-01-07,PF/BT,30281,HUB COVID LEGNANO,LOM,30-39,10,23,0,30,3,0,0,33,0,33,Lombardia,ITC4
2021-01-07,PF/BT,30281,HUB COVID LEGNANO,LOM,40-49,14,33,0,43,4,0,0,47,0,47,Lombardia,ITC4
2021-01-07,PF/BT,30281,HUB COVID LEGNANO,LOM,50-59,10,58,0,48,20,0,0,68,0,68,Lombardia,ITC4
2021-01-07,PF/BT,30281,HUB COVID LEGNANO,LOM,60-69,4,21,0,15,10,0,0,25,0,25,Lombardia,ITC4
2021-01-07,PF/BT,30322002778,RSA ISTITUTO GIUSEPPINE,LOM,20-29,0,1,0,1,0,0,0,1,0,1,Lombardia,ITC4
2021-01-07,PF/BT,30322002778,RSA ISTITUTO GIUSEPPINE,LOM,30-39,3,8,0,10,1,0,0,11,0,11,Lombardia,ITC4
2021-01-07,PF/BT,30322002778,RSA ISTITUTO GIUSEPPINE,LOM,40-49,0,10,0,8,2,0,0,10,0,10,Lombardia,ITC4
2021-01-07,PF/BT,30322002778,RSA ISTITUTO GIUSEPPINE,LOM,50-59,2,4,0,2,4,0,0,6,0,6,Lombardia,ITC4
2021-01-07,PF/BT,30322002778,RSA ISTITUTO GIUSEPPINE,LOM,60-69,0,4,0,1,0,3,0,4,0,4,Lombardia,ITC4
2021-01-07,PF/BT,30322002778,RSA ISTITUTO GIUSEPPINE,LOM,70-79,0,6,0,0,1,5,0,6,0,6,Lombardia,ITC4
2021-01-07,PF/BT,30322002778,RSA ISTITUTO GIUSEPPINE,LOM,80-89,0,21,0,0,2,19,0,21,0,21,Lombardia,ITC4
2021-01-07,PF/BT,30322002778,RSA ISTITUTO GIUSEPPINE,LOM,90+,0,25,0,0,0,25,0,25,0,25,Lombardia,ITC4
2021-01-07,PF/BT,30701,ASST GRANDE OSPEDALE METROPOLITANO NIGUARDA,LOM,20-29,17,44,0,49,6,0,6,61,0,61,Lombardia,ITC4
2021-01-07,PF/BT,30701,ASST GRANDE OSPEDALE METROPOLITANO NIGUARDA,LOM,30-39,43,69,0,93,9,0,10,112,0,112,Lombardia,ITC4
2021-01-07,PF/BT,30701,ASST GRANDE OSPEDALE METROPOLITANO NIGUARDA,LOM,40-49,42,83,0,100,22,0,3,125,0,125,Lombardia,ITC4
2021-01-07,PF/BT,30701,ASST GRANDE OSPEDALE METROPOLITANO NIGUARDA,LOM,50-59,52,101,0,97,48,0,8,153,0,153,Lombardia,ITC4
2021-01-07,PF/BT,30701,ASST GRANDE OSPEDALE METROPOLITANO NIGUARDA,LOM,60-69,29,23,0,43,6,0,3,52,0,52,Lombardia,ITC4
2021-01-07,PF/BT,30701,ASST GRANDE OSPEDALE METROPOLITANO NIGUARDA,LOM,70-79,0,1,0,1,0,0,0,1,0,1,Lombardia,ITC4
2021-01-07,PF/BT,30712,Ospedale Sant'Anna - Via Napoleona - Como,LOM,20-29,0,3,0,3,0,0,0,3,0,3,Lombardia,ITC4
2021-01-07,PF/BT,30712,Ospedale Sant'Anna - Via Napoleona - Como,LOM,30-39,4,2,0,6,0,0,0,6,0,6,Lombardia,ITC4
2021-01-07,PF/BT,30712,Ospedale Sant'Anna - Via Napoleona - Como,LOM,40-49,2,5,0,7,0,0,0,7,0,7,Lombardia,ITC4
2021-01-07,PF/BT,30712,Ospedale Sant'Anna - Via Napoleona - Como,LOM,50-59,6,14,0,20,0,0,0,20,0,20,Lombardia,ITC4
2021-01-07,PF/BT,30712,Ospedale Sant'Anna - Via Napoleona - Como,LOM,60-69,5,13,0,18,0,0,0,18,0,18,Lombardia,ITC4
2021-01-07,PF/BT,30718,ASST Papa Giovanni XXIII - Bergamo,LOM,20-29,9,24,0,33,0,0,0,33,0,33,Lombardia,ITC4
2021-01-07,PF/BT,30718,ASST Papa Giovanni XXIII - Bergamo,LOM,30-39,17,34,0,50,1,0,0,51,0,51,Lombardia,ITC4
2021-01-07,PF/BT,30718,ASST Papa Giovanni XXIII - Bergamo,LOM,40-49,21,44,0,62,3,0,0,65,0,65,Lombardia,ITC4
2021-01-07,PF/BT,30718,ASST Papa Giovanni XXIII - Bergamo,LOM,50-59,18,48,0,62,4,0,0,66,0,66,Lombardia,ITC4
2021-01-07,PF/BT,30718,ASST Papa Giovanni XXIII - Bergamo,LOM,60-69,11,7,0,17,1,0,0,18,0,18,Lombardia,ITC4
2021-01-07,PF/BT,30902,Ospedale S.Anna - Como,LOM,20-29,3,10,0,11,2,0,0,13,0,13,Lombardia,ITC4
2021-01-07,PF/BT,30902,Ospedale S.Anna - Como,LOM,30-39,19,25,0,35,9,0,0,44,0,44,Lombardia,ITC4
2021-01-07,PF/BT,30902,Ospedale S.Anna - Como,LOM,40-49,15,32,0,38,9,0,0,47,0,47,Lombardia,ITC4
2021-01-07,PF/BT,30902,Ospedale S.Anna - Como,LOM,50-59,13,45,0,48,10,0,0,58,0,58,Lombardia,ITC4
2021-01-07,PF/BT,30902,Ospedale S.Anna - Como,LOM,60-69,4,13,0,12,5,0,0,17,0,17,Lombardia,ITC4
2021-01-07,PF/BT,30902,Ospedale S.Anna - Como,LOM,70-79,0,1,0,1,0,0,0,1,0,1,Lombardia,ITC4
2021-01-07,PF/BT,30904,ASST VALTELLINA E ALTO LARIO PRESIDIO OSPEDALIERO MORELLI  DI SONDALO,LOM,20-29,1,4,0,5,0,0,0,5,0,5,Lombardia,ITC4
2021-01-07,PF/BT,30904,ASST VALTELLINA E ALTO LARIO PRESIDIO OSPEDALIERO MORELLI  DI SONDALO,LOM,30-39,1,4,0,5,0,0,0,5,0,5,Lombardia,ITC4
2021-01-07,PF/BT,30904,ASST VALTELLINA E ALTO LARIO PRESIDIO OSPEDALIERO MORELLI  DI SONDALO,LOM,40-49,5,15,0,20,0,0,0,20,0,20,Lombardia,ITC4
2021-01-07,PF/BT,30904,ASST VALTELLINA E ALTO LARIO PRESIDIO OSPEDALIERO MORELLI  DI SONDALO,LOM,50-59,6,36,0,40,2,0,0,42,0,42,Lombardia,ITC4
2021-01-07,PF/BT,30904,ASST VALTELLINA E ALTO LARIO PRESIDIO OSPEDALIERO MORELLI  DI SONDALO,LOM,60-69,2,4,0,6,0,0,0,6,0,6,Lombardia,ITC4
2021-01-07,PF/BT,30909,amb covid monza,LOM,20-29,23,31,0,53,1,0,0,54,0,54,Lombardia,ITC4
2021-01-07,PF/BT,30909,amb covid monza,LOM,30-39,22,45,0,64,3,0,0,67,0,67,Lombardia,ITC4
2021-01-07,PF/BT,30909,amb covid monza,LOM,40-49,15,45,0,59,1,0,0,60,0,60,Lombardia,ITC4
2021-01-07,PF/BT,30909,amb covid monza,LOM,50-59,19,51,0,66,4,0,0,70,0,70,Lombardia,ITC4
2021-01-07,PF/BT,30909,amb covid monza,LOM,60-69,14,14,0,23,3,0,2,28,0,28,Lombardia,ITC4
2021-01-07,PF/BT,30909,amb covid monza,LOM,70-79,1,2,0,2,1,0,0,3,0,3,Lombardia,ITC4
2021-01-07,PF/BT,30925,Fondazione IRCCS Ca' Granda Ospedale Maggiore Policlinico,LOM,20-29,7,31,0,37,1,0,0,38,0,38,Lombardia,ITC4
2021-01-07,PF/BT,30925,Fondazione IRCCS Ca' Granda Ospedale Maggiore Policlinico,LOM,30-39,21,54,0,63,12,0,0,75,0,75,Lombardia,ITC4
2021-01-07,PF/BT,30925,Fondazione IRCCS Ca' Granda Ospedale Maggiore Policlinico,LOM,40-49,17,47,0,54,10,0,0,64,0,64,Lombardia,ITC4
2021-01-07,PF/BT,30925,Fondazione IRCCS Ca' Granda Ospedale Maggiore Policlinico,LOM,50-59,19,47,0,46,20,0,0,66,0,66,Lombardia,ITC4
2021-01-07,PF/BT,30925,Fondazione IRCCS Ca' Granda Ospedale Maggiore Policlinico,LOM,60-69,13,18,0,30,1,0,0,31,0,31,Lombardia,ITC4
2021-01-07,PF/BT,30925,Fondazione IRCCS Ca' Granda Ospedale Maggiore Policlinico,LOM,70-79,1,1,0,1,1,0,0,2,0,2,Lombardia,ITC4
2021-01-07,PF/BT,30925,Fondazione IRCCS Ca' Granda Ospedale Maggiore Policlinico,LOM,80-89,1,0,0,0,1,0,0,1,0,1,Lombardia,ITC4
2021-01-07,PF/BT,30941,ISTITUTO EUROPEO DI ONCOLOGIA,LOM,50-59,1,0,0,1,0,0,0,1,0,1,Lombardia,ITC4
2021-01-07,PF/BT,30941,ISTITUTO EUROPEO DI ONCOLOGIA,LOM,60-69,18,15,0,33,0,0,0,33,0,33,Lombardia,ITC4
2021-01-07,PF/BT,30941,ISTITUTO EUROPEO DI ONCOLOGIA,LOM,70-79,7,0,0,7,0,0,0,7,0,7,Lombardia,ITC4
2021-01-07,PF/BT,32271022,ambulatorio covid tradate ; ambulatorio covid cittiglio ; ambulatorio covid varese,LOM,16-19,1,2,0,3,0,0,0,3,0,3,Lombardia,ITC4
2021-01-07,PF/BT,32271022,ambulatorio covid tradate ; ambulatorio covid cittiglio ; ambulatorio covid varese,LOM,20-29,19,24,0,43,0,0,0,43,0,43,Lombardia,ITC4
2021-01-07,PF/BT,32271022,ambulatorio covid tradate ; ambulatorio covid cittiglio ; ambulatorio covid varese,LOM,30-39,23,33,0,56,0,0,0,56,0,56,Lombardia,ITC4
2021-01-07,PF/BT,32271022,ambulatorio covid tradate ; ambulatorio covid cittiglio ; ambulatorio covid varese,LOM,40-49,26,73,0,99,0,0,0,99,0,99,Lombardia,ITC4
2021-01-07,PF/BT,32271022,ambulatorio covid tradate ; ambulatorio covid cittiglio ; ambulatorio covid varese,LOM,50-59,30,72,0,102,0,0,0,102,0,102,Lombardia,ITC4
2021-01-07,PF/BT,32271022,ambulatorio covid tradate ; ambulatorio covid cittiglio ; ambulatorio covid varese,LOM,60-69,16,21,0,37,0,0,0,37,0,37,Lombardia,ITC4
2021-01-07,PF/BT,32271022,ambulatorio covid tradate ; ambulatorio covid cittiglio ; ambulatorio covid varese,LOM,70-79,1,0,0,1,0,0,0,1,0,1,Lombardia,ITC4
2021-01-07,PF/BT,32572021,Ambulatorio COVID PO Alzano Lombardo,LOM,16-19,1,0,0,1,0,0,0,1,0,1,Lombardia,ITC4
2021-01-07,PF/BT,32572021,Ambulatorio COVID PO Alzano Lombardo,LOM,20-29,4,12,0,16,0,0,0,16,0,16,Lombardia,ITC4
2021-01-07,PF/BT,32572021,Ambulatorio COVID PO Alzano Lombardo,LOM,30-39,3,1,0,4,0,0,0,4,0,4,Lombardia,ITC4
2021-01-07,PF/BT,32572021,Ambulatorio COVID PO Alzano Lombardo,LOM,40-49,9,8,0,17,0,0,0,17,0,17,Lombardia,ITC4
2021-01-07,PF/BT,32572021,Ambulatorio COVID PO Alzano Lombardo,LOM,50-59,15,11,0,26,0,0,0,26,0,26,Lombardia,ITC4
2021-01-07,PF/BT,32572021,Ambulatorio COVID PO Alzano Lombardo,LOM,60-69,9,7,0,16,0,0,0,16,0,16,Lombardia,ITC4
2021-01-07,PF/BT,32572021,Ambulatorio COVID PO Alzano Lombardo,LOM,70-79,3,1,0,4,0,0,0,4,0,4,Lombardia,ITC4
2021-01-07,PF/BT,32572027,Ambulatorio COVID SERIATE,LOM,20-29,3,9,0,12,0,0,0,12,0,12,Lombardia,ITC4
2021-01-07,PF/BT,32572027,Ambulatorio COVID SERIATE,LOM,30-39,7,15,0,22,0,0,0,22,0,22,Lombardia,ITC4
2021-01-07,PF/BT,32572027,Ambulatorio COVID SERIATE,LOM,40-49,5,31,0,32,0,0,4,36,0,36,Lombardia,ITC4
2021-01-07,PF/BT,32572027,Ambulatorio COVID SERIATE,LOM,50-59,7,38,0,42,1,0,2,45,0,45,Lombardia,ITC4
2021-01-07,PF/BT,32572027,Ambulatorio COVID SERIATE,LOM,60-69,4,7,0,11,0,0,0,11,0,11,Lombardia,ITC4
2021-01-07,PF/BT,32772401,cv casalmaggiore,LOM,20-29,2,6,0,7,0,0,1,8,0,8,Lombardia,ITC4
2021-01-07,PF/BT,32772401,cv casalmaggiore,LOM,30-39,5,15,0,20,0,0,0,20,0,20,Lombardia,ITC4
2021-01-07,PF/BT,32772401,cv casalmaggiore,LOM,40-49,9,26,0,34,0,0,1,35,0,35,Lombardia,ITC4
2021-01-07,PF/BT,32772401,cv casalmaggiore,LOM,50-59,14,38,0,48,4,0,0,52,0,52,Lombardia,ITC4
2021-01-07,PF/BT,32772401,cv casalmaggiore,LOM,60-69,5,10,0,15,0,0,0,15,0,15,Lombardia,ITC4
2021-01-07,PF/BT,32772407,CV COVID CREMONA,LOM,20-29,5,10,0,14,1,0,0,15,0,15,Lombardia,ITC4
2021-01-07,PF/BT,32772407,CV COVID CREMONA,LOM,30-39,9,33,0,41,1,0,0,42,0,42,Lombardia,ITC4
2021-01-07,PF/BT,32772407,CV COVID CREMONA,LOM,40-49,8,34,0,36,6,0,0,42,0,42,Lombardia,ITC4
2021-01-07,PF/BT,32772407,CV COVID CREMONA,LOM,50-59,24,88,0,101,11,0,0,112,0,112,Lombardia,ITC4
2021-01-07,PF/BT,32772407,CV COVID CREMONA,LOM,60-69,16,13,0,28,1,0,0,29,0,29,Lombardia,ITC4
2021-01-07,PF/BT,32772513,ASST DI MANTOVA - POMA,LOM,20-29,8,8,0,12,4,0,0,16,0,16,Lombardia,ITC4
2021-01-07,PF/BT,32772513,ASST DI MANTOVA - POMA,LOM,30-39,8,13,0,18,3,0,0,21,0,21,Lombardia,ITC4
2021-01-07,PF/BT,32772513,ASST DI MANTOVA - POMA,LOM,40-49,25,31,0,46,10,0,0,56,0,56,Lombardia,ITC4
2021-01-07,PF/BT,32772513,ASST DI MANTOVA - POMA,LOM,50-59,40,80,0,107,13,0,0,120,0,120,Lombardia,ITC4
2021-01-07,PF/BT,32772513,ASST DI MANTOVA - POMA,LOM,60-69,30,34,0,50,14,0,0,64,0,64,Lombardia,ITC4
2021-01-07,PF/BT,558,RSA PIO ALBERGO TRIVULZIO,LOM,20-29,5,9,0,14,0,0,0,14,0,14,Lombardia,ITC4
2021-01-07,PF/BT,558,RSA PIO ALBERGO TRIVULZIO,LOM,30-39,7,10,0,14,3,0,0,17,0,17,Lombardia,ITC4
2021-01-07,PF/BT,558,RSA PIO ALBERGO TRIVULZIO,LOM,40-49,11,15,0,20,6,0,0,26,0,26,Lombardia,ITC4
2021-01-07,PF/BT,558,RSA PIO ALBERGO TRIVULZIO,LOM,50-59,14,42,0,46,9,1,0,56,0,56,Lombardia,ITC4
2021-01-07,PF/BT,558,RSA PIO ALBERGO TRIVULZIO,LOM,60-69,2,13,0,8,4,3,0,15,0,15,Lombardia,ITC4
2021-01-07,PF/BT,558,RSA PIO ALBERGO TRIVULZIO,LOM,70-79,5,7,0,0,0,12,0,12,0,12,Lombardia,ITC4
2021-01-07,PF/BT,558,RSA PIO ALBERGO TRIVULZIO,LOM,80-89,11,59,0,0,0,70,0,70,0,70,Lombardia,ITC4
2021-01-07,PF/BT,558,RSA PIO ALBERGO TRIVULZIO,LOM,90+,6,54,0,0,0,60,0,60,0,60,Lombardia,ITC4
2021-01-07,PF/BT,697,CASA RIPOSO F.LLI MOLINA P.E.T,LOM,20-29,0,1,0,1,0,0,0,1,0,1,Lombardia,ITC4
2021-01-07,PF/BT,697,CASA RIPOSO F.LLI MOLINA P.E.T,LOM,30-39,1,1,0,2,0,0,0,2,0,2,Lombardia,ITC4
2021-01-07,PF/BT,697,CASA RIPOSO F.LLI MOLINA P.E.T,LOM,40-49,1,6,0,7,0,0,0,7,0,7,Lombardia,ITC4
2021-01-07,PF/BT,697,CASA RIPOSO F.LLI MOLINA P.E.T,LOM,50-59,2,8,0,10,0,0,0,10,0,10,Lombardia,ITC4
2021-01-07,PF/BT,697,CASA RIPOSO F.LLI MOLINA P.E.T,LOM,60-69,0,1,0,1,0,0,0,1,0,1,Lombardia,ITC4
2021-01-07,PF/BT,697,CASA RIPOSO F.LLI MOLINA P.E.T,LOM,70-79,1,2,0,0,0,3,0,3,0,3,Lombardia,ITC4
2021-01-07,PF/BT,697,CASA RIPOSO F.LLI MOLINA P.E.T,LOM,80-89,3,2,0,0,0,5,0,5,0,5,Lombardia,ITC4
2021-01-07,PF/BT,697,CASA RIPOSO F.LLI MOLINA P.E.T,LOM,90+,1,6,0,0,0,7,0,7,0,7,Lombardia,ITC4
2021-01-07,PF/BT,924,RSA FONDAZIONE FRATELLI BONA ONLUS,LOM,30-39,0,4,0,3,1,0,0,4,0,4,Lombardia,ITC4
2021-01-07,PF/BT,924,RSA FONDAZIONE FRATELLI BONA ONLUS,LOM,40-49,2,8,0,7,3,0,0,10,0,10,Lombardia,ITC4
2021-01-07,PF/BT,924,RSA FONDAZIONE FRATELLI BONA ONLUS,LOM,50-59,0,6,0,5,1,0,0,6,0,6,Lombardia,ITC4
2021-01-07,PF/BT,924,RSA FONDAZIONE FRATELLI BONA ONLUS,LOM,60-69,1,1,0,1,1,0,0,2,0,2,Lombardia,ITC4
2021-01-07,PF/BT,924,RSA FONDAZIONE FRATELLI BONA ONLUS,LOM,70-79,2,0,0,0,2,0,0,2,0,2,Lombardia,ITC4
2021-01-07,PF/BT,943,R.S.A RESIDENZA FONDAZIONE ANGELO MAJ FONDAZIONE ONLUS,LOM,20-29,0,3,0,3,0,0,0,3,0,3,Lombardia,ITC4
2021-01-07,PF/BT,943,R.S.A RESIDENZA FONDAZIONE ANGELO MAJ FONDAZIONE ONLUS,LOM,30-39,1,9,0,6,4,0,0,10,0,10,Lombardia,ITC4
2021-01-07,PF/BT,943,R.S.A RESIDENZA FONDAZIONE ANGELO MAJ FONDAZIONE ONLUS,LOM,40-49,3,15,0,13,5,0,0,18,0,18,Lombardia,ITC4
2021-01-07,PF/BT,943,R.S.A RESIDENZA FONDAZIONE ANGELO MAJ FONDAZIONE ONLUS,LOM,50-59,2,11,0,9,4,0,0,13,0,13,Lombardia,ITC4
2021-01-07,PF/BT,943,R.S.A RESIDENZA FONDAZIONE ANGELO MAJ FONDAZIONE ONLUS,LOM,60-69,0,4,0,2,2,0,0,4,0,4,Lombardia,ITC4
2021-01-07,PF/BT,947,I.R.C.C.S. POLICLINICO SAN DONATO,LOM,20-29,4,11,0,11,4,0,0,15,0,15,Lombardia,ITC4
2021-01-07,PF/BT,947,I.R.C.C.S. POLICLINICO SAN DONATO,LOM,30-39,19,22,0,40,1,0,0,41,0,41,Lombardia,ITC4
2021-01-07,PF/BT,947,I.R.C.C.S. POLICLINICO SAN DONATO,LOM,40-49,25,25,0,45,5,0,0,50,0,50,Lombardia,ITC4
2021-01-07,PF/BT,947,I.R.C.C.S. POLICLINICO SAN DONATO,LOM,50-59,10,22,0,27,5,0,0,32,0,32,Lombardia,ITC4
2021-01-07,PF/BT,947,I.R.C.C.S. POLICLINICO SAN DONATO,LOM,60-69,11,6,0,17,0,0,0,17,0,17,Lombardia,ITC4
2021-01-07,PF/BT,HPS11/11bis,ASST SPEDALI CIVILI AMBULATORIO COVID BRESCIA,LOM,20-29,24,47,0,71,0,0,0,71,0,71,Lombardia,ITC4
2021-01-07,PF/BT,HPS11/11bis,ASST SPEDALI CIVILI AMBULATORIO COVID BRESCIA,LOM,30-39,52,70,0,112,10,0,0,122,0,122,Lombardia,ITC4
2021-01-07,PF/BT,HPS11/11bis,ASST SPEDALI CIVILI AMBULATORIO COVID BRESCIA,LOM,40-49,40,78,0,102,16,0,0,118,0,118,Lombardia,ITC4
2021-01-07,PF/BT,HPS11/11bis,ASST SPEDALI CIVILI AMBULATORIO COVID BRESCIA,LOM,50-59,37,108,0,116,29,0,0,145,0,145,Lombardia,ITC4
2021-01-07,PF/BT,HPS11/11bis,ASST SPEDALI CIVILI AMBULATORIO COVID BRESCIA,LOM,60-69,24,24,0,31,17,0,0,48,0,48,Lombardia,ITC4
2021-01-07,PF/BT,HSP11,ASST MANTOVA-POMA,LOM,20-29,8,8,0,12,4,0,0,16,0,16,Lombardia,ITC4
2021-01-07,PF/BT,HSP11,ASST MANTOVA-POMA,LOM,30-39,8,13,0,18,3,0,0,21,0,21,Lombardia,ITC4
2021-01-07,PF/BT,HSP11,ASST MANTOVA-POMA,LOM,40-49,25,31,0,46,10,0,0,56,0,56,Lombardia,ITC4
2021-01-07,PF/BT,HSP11,ASST MANTOVA-POMA,LOM,50-59,40,80,0,107,13,0,0,120,0,120,Lombardia,ITC4
2021-01-07,PF/BT,HSP11,ASST MANTOVA-POMA,LOM,60-69,30,34,0,50,14,0,0,64,0,64,Lombardia,ITC4
2021-01-07,PF/BT,HSP11-11 bis,Policlinico San Pietro,LOM,20-29,2,8,0,6,4,0,0,10,0,10,Lombardia,ITC4
2021-01-07,PF/BT,HSP11-11 bis,Policlinico San Pietro,LOM,30-39,2,8,0,9,1,0,0,10,0,10,Lombardia,ITC4
2021-01-07,PF/BT,HSP11-11 bis,Policlinico San Pietro,LOM,40-49,3,7,0,7,3,0,0,10,0,10,Lombardia,ITC4
2021-01-07,PF/BT,HSP11-11 bis,Policlinico San Pietro,LOM,50-59,2,5,0,6,1,0,0,7,0,7,Lombardia,ITC4
2021-01-07,PF/BT,HSP11-11 bis,Policlinico San Pietro,LOM,60-69,2,2,0,2,2,0,0,4,0,4,Lombardia,ITC4
2021-01-07,PF/BT,HSP11-11 bis,Policlinico San Pietro,LOM,70-79,0,3,0,3,0,0,0,3,0,3,Lombardia,ITC4
2021-01-07,PF/BT,HSP11-11bis,32170223   HUB COVID SS PAOLO E CARLO - PVO Ospedale San Paolo,LOM,20-29,6,18,0,23,1,0,0,24,0,24,Lombardia,ITC4
2021-01-07,PF/BT,HSP11-11bis,32170223   HUB COVID SS PAOLO E CARLO - PVO Ospedale San Paolo,LOM,30-39,8,29,0,36,0,0,1,37,0,37,Lombardia,ITC4
2021-01-07,PF/BT,HSP11-11bis,32170223   HUB COVID SS PAOLO E CARLO - PVO Ospedale San Paolo,LOM,40-49,14,29,0,40,0,0,3,43,0,43,Lombardia,ITC4
2021-01-07,PF/BT,HSP11-11bis,32170223   HUB COVID SS PAOLO E CARLO - PVO Ospedale San Paolo,LOM,50-59,13,14,0,25,1,0,1,27,0,27,Lombardia,ITC4
2021-01-07,PF/BT,HSP11-11bis,32170223   HUB COVID SS PAOLO E CARLO - PVO Ospedale San Paolo,LOM,60-69,7,6,0,11,2,0,0,13,0,13,Lombardia,ITC4
2021-01-07,PF/BT,HSP11-11bis,32170224 HUB COVID OSP. SAN CARLO,LOM,20-29,10,13,0,21,2,0,0,23,0,23,Lombardia,ITC4
2021-01-07,PF/BT,HSP11-11bis,32170224 HUB COVID OSP. SAN CARLO,LOM,30-39,11,18,0,27,0,0,2,29,0,29,Lombardia,ITC4
2021-01-07,PF/BT,HSP11-11bis,32170224 HUB COVID OSP. SAN CARLO,LOM,40-49,5,29,0,28,4,0,2,34,0,34,Lombardia,ITC4
2021-01-07,PF/BT,HSP11-11bis,32170224 HUB COVID OSP. SAN CARLO,LOM,50-59,18,25,0,35,8,0,0,43,0,43,Lombardia,ITC4
2021-01-07,PF/BT,HSP11-11bis,32170224 HUB COVID OSP. SAN CARLO,LOM,60-69,7,7,0,11,2,0,1,14,0,14,Lombardia,ITC4
2021-01-07,PF/BT,HSP11-11bis,32170224 HUB COVID OSP. SAN CARLO,LOM,70-79,0,1,0,0,0,0,1,1,0,1,Lombardia,ITC4
2021-01-07,PF/BT,HSP11-11bis,Ambulatorio COVID PO Casalpusterlengo,LOM,20-29,1,10,0,5,6,0,0,11,0,11,Lombardia,ITC4
2021-01-07,PF/BT,HSP11-11bis,Ambulatorio COVID PO Casalpusterlengo,LOM,30-39,2,7,0,9,0,0,0,9,0,9,Lombardia,ITC4
2021-01-07,PF/BT,HSP11-11bis,Ambulatorio COVID PO Casalpusterlengo,LOM,40-49,5,10,0,13,2,0,0,15,0,15,Lombardia,ITC4
2021-01-07,PF/BT,HSP11-11bis,Ambulatorio COVID PO Casalpusterlengo,LOM,50-59,1,22,0,17,6,0,0,23,0,23,Lombardia,ITC4
2021-01-07,PF/BT,HSP11-11bis,Ambulatorio COVID PO Casalpusterlengo,LOM,60-69,4,6,0,8,2,0,0,10,0,10,Lombardia,ITC4
2021-01-07,PF/BT,HSP11-11bis,Ambulatorio COVID PO Casalpusterlengo,LOM,70-79,1,0,0,1,0,0,0,1,0,1,Lombardia,ITC4
2021-01-07,PF/BT,HSP11-11bis,Ambulatorio COVID PO Codogno,LOM,20-29,4,3,0,5,2,0,0,7,0,7,Lombardia,ITC4
2021-01-07,PF/BT,HSP11-11bis,Ambulatorio COVID PO Codogno,LOM,30-39,6,4,0,6,4,0,0,10,0,10,Lombardia,ITC4
2021-01-07,PF/BT,HSP11-11bis,Ambulatorio COVID PO Codogno,LOM,40-49,7,14,0,12,9,0,0,21,0,21,Lombardia,ITC4
2021-01-07,PF/BT,HSP11-11bis,Ambulatorio COVID PO Codogno,LOM,50-59,16,15,0,13,18,0,0,31,0,31,Lombardia,ITC4
2021-01-07,PF/BT,HSP11-11bis,Ambulatorio COVID PO Codogno,LOM,60-69,14,10,0,9,15,0,0,24,0,24,Lombardia,ITC4
2021-01-07,PF/BT,HSP11-11bis,Ambulatorio COVID PO Codogno,LOM,70-79,3,0,0,0,3,0,0,3,0,3,Lombardia,ITC4
2021-01-07,PF/BT,HSP11-11bis,Ambulatorio COVID PO LODI,LOM,20-29,10,10,0,19,1,0,0,20,0,20,Lombardia,ITC4
2021-01-07,PF/BT,HSP11-11bis,Ambulatorio COVID PO LODI,LOM,30-39,8,21,0,28,1,0,0,29,0,29,Lombardia,ITC4
2021-01-07,PF/BT,HSP11-11bis,Ambulatorio COVID PO LODI,LOM,40-49,10,20,0,27,3,0,0,30,0,30,Lombardia,ITC4
2021-01-07,PF/BT,HSP11-11bis,Ambulatorio COVID PO LODI,LOM,50-59,17,31,0,43,5,0,0,48,0,48,Lombardia,ITC4
2021-01-07,PF/BT,HSP11-11bis,Ambulatorio COVID PO LODI,LOM,60-69,4,5,0,9,0,0,0,9,0,9,Lombardia,ITC4
2021-01-07,PF/BT,HSP11-11bis,Ambulatorio COVID PO LODI,LOM,70-79,1,1,0,2,0,0,0,2,0,2,Lombardia,ITC4
2021-01-07,PF/BT,HSP11-11bis,Ambulatorio COVID PO S.Angelo Lod.,LOM,16-19,1,0,0,1,0,0,0,1,0,1,Lombardia,ITC4
2021-01-07,PF/BT,HSP11-11bis,Ambulatorio COVID PO S.Angelo Lod.,LOM,20-29,3,5,0,8,0,0,0,8,0,8,Lombardia,ITC4
2021-01-07,PF/BT,HSP11-11bis,Ambulatorio COVID PO S.Angelo Lod.,LOM,30-39,4,5,0,9,0,0,0,9,0,9,Lombardia,ITC4
2021-01-07,PF/BT,HSP11-11bis,Ambulatorio COVID PO S.Angelo Lod.,LOM,40-49,3,13,0,15,1,0,0,16,0,16,Lombardia,ITC4
2021-01-07,PF/BT,HSP11-11bis,Ambulatorio COVID PO S.Angelo Lod.,LOM,50-59,8,15,0,18,5,0,0,23,0,23,Lombardia,ITC4
2021-01-07,PF/BT,HSP11-11bis,Ambulatorio COVID PO S.Angelo Lod.,LOM,60-69,9,2,0,9,2,0,0,11,0,11,Lombardia,ITC4
2021-01-07,PF/BT,HSP11-11bis,Ambulatorio COVID PO S.Angelo Lod.,LOM,70-79,3,1,0,4,0,0,0,4,0,4,Lombardia,ITC4
2021-01-07,PF/BT,HSP11-11bis,AMBULATORIO COVID PO SACCO,LOM,20-29,10,33,0,43,0,0,0,43,0,43,Lombardia,ITC4
2021-01-07,PF/BT,HSP11-11bis,AMBULATORIO COVID PO SACCO,LOM,30-39,27,71,0,98,0,0,0,98,0,98,Lombardia,ITC4
2021-01-07,PF/BT,HSP11-11bis,AMBULATORIO COVID PO SACCO,LOM,40-49,21,63,0,84,0,0,0,84,0,84,Lombardia,ITC4
2021-01-07,PF/BT,HSP11-11bis,AMBULATORIO COVID PO SACCO,LOM,50-59,32,72,0,104,0,0,0,104,0,104,Lombardia,ITC4
2021-01-07,PF/BT,HSP11-11bis,AMBULATORIO COVID PO SACCO,LOM,60-69,36,42,0,78,0,0,0,78,0,78,Lombardia,ITC4
2021-01-07,PF/BT,HSP11-11bis,ASST BERGAMO OVEST - OSPEDALE ROMANO DI L.DIA,LOM,20-29,2,9,0,9,0,0,2,11,0,11,Lombardia,ITC4
2021-01-07,PF/BT,HSP11-11bis,ASST BERGAMO OVEST - OSPEDALE ROMANO DI L.DIA,LOM,30-39,4,10,0,6,2,0,6,14,0,14,Lombardia,ITC4
2021-01-07,PF/BT,HSP11-11bis,ASST BERGAMO OVEST - OSPEDALE ROMANO DI L.DIA,LOM,40-49,6,23,0,22,1,0,6,29,0,29,Lombardia,ITC4
2021-01-07,PF/BT,HSP11-11bis,ASST BERGAMO OVEST - OSPEDALE ROMANO DI L.DIA,LOM,50-59,12,28,0,31,2,0,7,40,0,40,Lombardia,ITC4
2021-01-07,PF/BT,HSP11-11bis,ASST BERGAMO OVEST - OSPEDALE ROMANO DI L.DIA,LOM,60-69,5,3,0,8,0,0,0,8,0,8,Lombardia,ITC4
2021-01-07,PF/BT,HSP11-11bis,ASST BERGAMO OVEST - OSPEDALE TREVIGLIO,LOM,20-29,2,7,0,8,1,0,0,9,0,9,Lombardia,ITC4
2021-01-07,PF/BT,HSP11-11bis,ASST BERGAMO OVEST - OSPEDALE TREVIGLIO,LOM,30-39,2,17,0,19,0,0,0,19,0,19,Lombardia,ITC4
2021-01-07,PF/BT,HSP11-11bis,ASST BERGAMO OVEST - OSPEDALE TREVIGLIO,LOM,40-49,7,16,0,21,2,0,0,23,0,23,Lombardia,ITC4
2021-01-07,PF/BT,HSP11-11bis,ASST BERGAMO OVEST - OSPEDALE TREVIGLIO,LOM,50-59,9,34,0,37,6,0,0,43,0,43,Lombardia,ITC4
2021-01-07,PF/BT,HSP11-11bis,ASST BERGAMO OVEST - OSPEDALE TREVIGLIO,LOM,60-69,5,3,0,8,0,0,0,8,0,8,Lombardia,ITC4
2021-01-07,PF/BT,HSP11-11bis,"Policlinico San Marco, Osio Sotto (BG)",LOM,20-29,1,3,0,4,0,0,0,4,0,4,Lombardia,ITC4
2021-01-07,PF/BT,HSP11-11bis,"Policlinico San Marco, Osio Sotto (BG)",LOM,30-39,1,4,0,5,0,0,0,5,0,5,Lombardia,ITC4
2021-01-07,PF/BT,HSP11-11bis,"Policlinico San Marco, Osio Sotto (BG)",LOM,40-49,3,12,0,14,1,0,0,15,0,15,Lombardia,ITC4
2021-01-07,PF/BT,HSP11-11bis,"Policlinico San Marco, Osio Sotto (BG)",LOM,50-59,3,2,0,5,0,0,0,5,0,5,Lombardia,ITC4
2021-01-07,PF/BT,HSP11-11bis,"Policlinico San Marco, Osio Sotto (BG)",LOM,60-69,4,1,0,4,1,0,0,5,0,5,Lombardia,ITC4
2021-01-07,PF/BT,HSP11-11bis,"Policlinico San Marco, Osio Sotto (BG)",LOM,70-79,1,0,0,1,0,0,0,1,0,1,Lombardia,ITC4
2021-01-07,PF/BT,HSP11-11bis,"Policlinico San Marco, Osio Sotto (BG)",LOM,80-89,1,0,0,1,0,0,0,1,0,1,Lombardia,ITC4
2021-01-07,PF/BT,STS11,RSA DON GIOVANNI FERRAGLIO MALONNO ONLUS,LOM,30-39,2,1,0,3,0,0,0,3,0,3,Lombardia,ITC4
2021-01-07,PF/BT,STS11,RSA DON GIOVANNI FERRAGLIO MALONNO ONLUS,LOM,40-49,0,2,0,2,0,0,0,2,0,2,Lombardia,ITC4
2021-01-07,PF/BT,STS11,RSA DON GIOVANNI FERRAGLIO MALONNO ONLUS,LOM,50-59,1,2,0,2,1,0,0,3,0,3,Lombardia,ITC4
2021-01-07,PF/BT,STS11,RSA DON GIOVANNI FERRAGLIO MALONNO ONLUS,LOM,60-69,0,2,0,1,1,0,0,2,0,2,Lombardia,ITC4
2021-01-07,PF/BT,STS11,RSA DON GIOVANNI FERRAGLIO MALONNO ONLUS,LOM,70-79,3,1,0,0,0,4,0,4,0,4,Lombardia,ITC4
2021-01-07,PF/BT,STS11,RSA DON GIOVANNI FERRAGLIO MALONNO ONLUS,LOM,80-89,1,5,0,0,0,6,0,6,0,6,Lombardia,ITC4
2021-01-07,PF/BT,STS11,RSA DON GIOVANNI FERRAGLIO MALONNO ONLUS,LOM,90+,4,6,0,0,0,10,0,10,0,10,Lombardia,ITC4
2021-01-08,PF/BT,"""000916""",CASA RIPOSO CITTA' DI SONDRIO,LOM,20-29,0,3,0,3,0,0,0,3,0,3,Lombardia,ITC4
2021-01-08,PF/BT,"""000916""",CASA RIPOSO CITTA' DI SONDRIO,LOM,30-39,3,3,0,6,0,0,0,6,0,6,Lombardia,ITC4
2021-01-08,PF/BT,"""000916""",CASA RIPOSO CITTA' DI SONDRIO,LOM,40-49,1,3,0,2,2,0,0,4,0,4,Lombardia,ITC4
2021-01-08,PF/BT,"""000916""",CASA RIPOSO CITTA' DI SONDRIO,LOM,50-59,2,5,0,4,2,1,0,7,0,7,Lombardia,ITC4
2021-01-08,PF/BT,"""000916""",CASA RIPOSO CITTA' DI SONDRIO,LOM,60-69,1,1,0,0,0,2,0,2,0,2,Lombardia,ITC4
2021-01-08,PF/BT,"""000916""",CASA RIPOSO CITTA' DI SONDRIO,LOM,70-79,5,4,0,0,0,9,0,9,0,9,Lombardia,ITC4
2021-01-08,PF/BT,"""000916""",CASA RIPOSO CITTA' DI SONDRIO,LOM,80-89,5,6,0,0,0,11,0,11,0,11,Lombardia,ITC4
2021-01-08,PF/BT,"""000916""",CASA RIPOSO CITTA' DI SONDRIO,LOM,90+,0,6,0,0,0,6,0,6,0,6,Lombardia,ITC4
2021-01-08,PF/BT,(03027500/001752),PVO Istituto Clinico San Rocco (Spoke),LOM,20-29,0,2,0,2,0,0,0,2,0,2,Lombardia,ITC4
2021-01-08,PF/BT,(03027500/001752),PVO Istituto Clinico San Rocco (Spoke),LOM,30-39,2,3,0,5,0,0,0,5,0,5,Lombardia,ITC4
2021-01-08,PF/BT,(03027500/001752),PVO Istituto Clinico San Rocco (Spoke),LOM,40-49,5,11,0,15,1,0,0,16,0,16,Lombardia,ITC4
2021-01-08,PF/BT,(03027500/001752),PVO Istituto Clinico San Rocco (Spoke),LOM,50-59,7,7,0,12,2,0,0,14,0,14,Lombardia,ITC4
2021-01-08,PF/BT,(03027500/001752),PVO Istituto Clinico San Rocco (Spoke),LOM,60-69,1,2,0,2,1,0,0,3,0,3,Lombardia,ITC4
2021-01-08,PF/BT,(03027500/001752),PVO Istituto Clinico San Rocco (Spoke),LOM,70-79,2,0,0,2,0,0,0,2,0,2,Lombardia,ITC4
2021-01-08,PF/BT,.030042,ASST VALTELLINA ALTO LARIO - PRESIDIO OSPEDALIERO DI SONDRIO,LOM,20-29,3,5,0,7,1,0,0,8,0,8,Lombardia,ITC4
2021-01-08,PF/BT,.030042,ASST VALTELLINA ALTO LARIO - PRESIDIO OSPEDALIERO DI SONDRIO,LOM,30-39,6,12,0,15,3,0,0,18,0,18,Lombardia,ITC4
2021-01-08,PF/BT,.030042,ASST VALTELLINA ALTO LARIO - PRESIDIO OSPEDALIERO DI SONDRIO,LOM,40-49,5,16,0,19,2,0,0,21,0,21,Lombardia,ITC4
2021-01-08,PF/BT,.030042,ASST VALTELLINA ALTO LARIO - PRESIDIO OSPEDALIERO DI SONDRIO,LOM,50-59,16,47,0,51,12,0,0,63,0,63,Lombardia,ITC4
2021-01-08,PF/BT,.030042,ASST VALTELLINA ALTO LARIO - PRESIDIO OSPEDALIERO DI SONDRIO,LOM,60-69,7,9,0,14,2,0,0,16,0,16,Lombardia,ITC4
2021-01-08,PF/BT,0,ASST VALTELLINA E ALTO LARIO PRESIDIO OSPEDALIERO DI SONDALO,LOM,20-29,4,8,0,12,0,0,0,12,0,12,Lombardia,ITC4
2021-01-08,PF/BT,0,ASST VALTELLINA E ALTO LARIO PRESIDIO OSPEDALIERO DI SONDALO,LOM,30-39,4,11,0,15,0,0,0,15,0,15,Lombardia,ITC4
2021-01-08,PF/BT,0,ASST VALTELLINA E ALTO LARIO PRESIDIO OSPEDALIERO DI SONDALO,LOM,40-49,8,19,0,26,1,0,0,27,0,27,Lombardia,ITC4
2021-01-08,PF/BT,0,ASST VALTELLINA E ALTO LARIO PRESIDIO OSPEDALIERO DI SONDALO,LOM,50-59,13,45,0,56,2,0,0,58,0,58,Lombardia,ITC4
2021-01-08,PF/BT,0,ASST VALTELLINA E ALTO LARIO PRESIDIO OSPEDALIERO DI SONDALO,LOM,60-69,9,11,0,19,1,0,0,20,0,20,Lombardia,ITC4
2021-01-08,PF/BT,0,Istituto Redaelli Milano,LOM,20-29,2,4,0,6,0,0,0,6,0,6,Lombardia,ITC4
2021-01-08,PF/BT,0,Istituto Redaelli Milano,LOM,30-39,5,9,0,14,0,0,0,14,0,14,Lombardia,ITC4
2021-01-08,PF/BT,0,Istituto Redaelli Milano,LOM,40-49,3,13,0,16,0,0,0,16,0,16,Lombardia,ITC4
2021-01-08,PF/BT,0,Istituto Redaelli Milano,LOM,50-59,3,12,0,15,0,0,0,15,0,15,Lombardia,ITC4
2021-01-08,PF/BT,0,Istituto Redaelli Milano,LOM,60-69,6,3,0,9,0,0,0,9,0,9,Lombardia,ITC4
2021-01-08,PF/BT,000050,Poliambulatorio IRCSS OSPEDALE SAN LUCA,LOM,30-39,3,2,0,5,0,0,0,5,0,5,Lombardia,ITC4
2021-01-08,PF/BT,000050,Poliambulatorio IRCSS OSPEDALE SAN LUCA,LOM,40-49,0,9,0,9,0,0,0,9,0,9,Lombardia,ITC4
2021-01-08,PF/BT,000050,Poliambulatorio IRCSS OSPEDALE SAN LUCA,LOM,50-59,1,5,0,6,0,0,0,6,0,6,Lombardia,ITC4
2021-01-08,PF/BT,000050,Poliambulatorio IRCSS OSPEDALE SAN LUCA,LOM,60-69,1,1,0,2,0,0,0,2,0,2,Lombardia,ITC4
2021-01-08,PF/BT,000050,Poliambulatorio IRCSS OSPEDALE SAN LUCA,LOM,70-79,2,0,0,2,0,0,0,2,0,2,Lombardia,ITC4
2021-01-08,PF/BT,000417,POLIAMBULATORIO IRCCS OSPEDALE CAPITANIO,LOM,20-29,2,2,0,4,0,0,0,4,0,4,Lombardia,ITC4
2021-01-08,PF/BT,000417,POLIAMBULATORIO IRCCS OSPEDALE CAPITANIO,LOM,30-39,0,2,0,2,0,0,0,2,0,2,Lombardia,ITC4
2021-01-08,PF/BT,000417,POLIAMBULATORIO IRCCS OSPEDALE CAPITANIO,LOM,40-49,2,6,0,8,0,0,0,8,0,8,Lombardia,ITC4
2021-01-08,PF/BT,000417,POLIAMBULATORIO IRCCS OSPEDALE CAPITANIO,LOM,50-59,3,3,0,6,0,0,0,6,0,6,Lombardia,ITC4
2021-01-08,PF/BT,000417,POLIAMBULATORIO IRCCS OSPEDALE CAPITANIO,LOM,60-69,3,1,0,4,0,0,0,4,0,4,Lombardia,ITC4
2021-01-08,PF/BT,000492 E 000493,RSA KORIAN IPPOCRATE,LOM,20-29,1,3,0,2,2,0,0,4,0,4,Lombardia,ITC4
2021-01-08,PF/BT,000492 E 000493,RSA KORIAN IPPOCRATE,LOM,30-39,4,2,0,4,2,0,0,6,0,6,Lombardia,ITC4
2021-01-08,PF/BT,000492 E 000493,RSA KORIAN IPPOCRATE,LOM,40-49,1,13,0,14,0,0,0,14,0,14,Lombardia,ITC4
2021-01-08,PF/BT,000492 E 000493,RSA KORIAN IPPOCRATE,LOM,50-59,2,10,0,10,2,0,0,12,0,12,Lombardia,ITC4
2021-01-08,PF/BT,000492 E 000493,RSA KORIAN IPPOCRATE,LOM,60-69,0,3,0,3,0,0,0,3,0,3,Lombardia,ITC4
2021-01-08,PF/BT,000492 E 000493,RSA KORIAN IPPOCRATE,LOM,70-79,1,0,0,0,1,0,0,1,0,1,Lombardia,ITC4
2021-01-08,PF/BT,000492 E 000493,RSA KORIAN IPPOCRATE,LOM,90+,0,2,0,0,0,2,0,2,0,2,Lombardia,ITC4
2021-01-08,PF/BT,000500,RSA MONSIGNOR BICCHIERAI 2,LOM,80-89,3,6,0,0,0,9,0,9,0,9,Lombardia,ITC4
2021-01-08,PF/BT,000500,RSA MONSIGNOR BICCHIERAI 2,LOM,90+,1,4,0,0,0,5,0,5,0,5,Lombardia,ITC4
2021-01-08,PF/BT,000542,RSA MONSIGNOR BICCHIERAI 1,LOM,80-89,1,1,0,0,0,2,0,2,0,2,Lombardia,ITC4
2021-01-08,PF/BT,000542,RSA MONSIGNOR BICCHIERAI 1,LOM,90+,0,2,0,0,0,2,0,2,0,2,Lombardia,ITC4
2021-01-08,PF/BT,002987,POLIAMBULATORIO OSPEDALE ESINE,LOM,20-29,1,6,0,6,1,0,0,7,0,7,Lombardia,ITC4
2021-01-08,PF/BT,002987,POLIAMBULATORIO OSPEDALE ESINE,LOM,30-39,7,17,0,22,2,0,0,24,0,24,Lombardia,ITC4
2021-01-08,PF/BT,002987,POLIAMBULATORIO OSPEDALE ESINE,LOM,40-49,9,33,0,38,4,0,0,42,0,42,Lombardia,ITC4
2021-01-08,PF/BT,002987,POLIAMBULATORIO OSPEDALE ESINE,LOM,50-59,7,51,0,55,3,0,0,58,0,58,Lombardia,ITC4
2021-01-08,PF/BT,002987,POLIAMBULATORIO OSPEDALE ESINE,LOM,60-69,5,12,0,15,2,0,0,17,0,17,Lombardia,ITC4
2021-01-08,PF/BT,002987,POLIAMBULATORIO OSPEDALE ESINE,LOM,70-79,0,2,0,0,2,0,0,2,0,2,Lombardia,ITC4
2021-01-08,PF/BT,003328,HUB COV CHIARI - P.O. ISEO -  ASST FRANCIACORTA,LOM,16-19,1,0,0,1,0,0,0,1,0,1,Lombardia,ITC4
2021-01-08,PF/BT,003328,HUB COV CHIARI - P.O. ISEO -  ASST FRANCIACORTA,LOM,20-29,5,9,0,13,1,0,0,14,0,14,Lombardia,ITC4
2021-01-08,PF/BT,003328,HUB COV CHIARI - P.O. ISEO -  ASST FRANCIACORTA,LOM,30-39,5,12,0,16,1,0,0,17,0,17,Lombardia,ITC4
2021-01-08,PF/BT,003328,HUB COV CHIARI - P.O. ISEO -  ASST FRANCIACORTA,LOM,40-49,19,20,0,37,2,0,0,39,0,39,Lombardia,ITC4
2021-01-08,PF/BT,003328,HUB COV CHIARI - P.O. ISEO -  ASST FRANCIACORTA,LOM,50-59,17,24,0,36,5,0,0,41,0,41,Lombardia,ITC4
2021-01-08,PF/BT,003328,HUB COV CHIARI - P.O. ISEO -  ASST FRANCIACORTA,LOM,60-69,19,9,0,26,2,0,0,28,0,28,Lombardia,ITC4
2021-01-08,PF/BT,003328,HUB COV CHIARI - P.O. ISEO -  ASST FRANCIACORTA,LOM,70-79,4,0,0,4,0,0,0,4,0,4,Lombardia,ITC4
2021-01-08,PF/BT,003335,HUB COV CHIARI - P.O. CHIARI ASST FRANCIACORTA,LOM,20-29,6,17,0,19,4,0,0,23,0,23,Lombardia,ITC4
2021-01-08,PF/BT,003335,HUB COV CHIARI - P.O. CHIARI ASST FRANCIACORTA,LOM,30-39,14,19,0,26,7,0,0,33,0,33,Lombardia,ITC4
2021-01-08,PF/BT,003335,HUB COV CHIARI - P.O. CHIARI ASST FRANCIACORTA,LOM,40-49,10,33,0,37,6,0,0,43,0,43,Lombardia,ITC4
2021-01-08,PF/BT,003335,HUB COV CHIARI - P.O. CHIARI ASST FRANCIACORTA,LOM,50-59,16,40,0,44,12,0,0,56,0,56,Lombardia,ITC4
2021-01-08,PF/BT,003335,HUB COV CHIARI - P.O. CHIARI ASST FRANCIACORTA,LOM,60-69,9,4,0,10,3,0,0,13,0,13,Lombardia,ITC4
2021-01-08,PF/BT,030 - 322 - 002821,RSA Via Brambilla,LOM,30-39,0,2,0,2,0,0,0,2,0,2,Lombardia,ITC4
2021-01-08,PF/BT,030 - 322 - 002821,RSA Via Brambilla,LOM,40-49,0,3,0,3,0,0,0,3,0,3,Lombardia,ITC4
2021-01-08,PF/BT,030 - 322 - 002821,RSA Via Brambilla,LOM,50-59,0,5,0,5,0,0,0,5,0,5,Lombardia,ITC4
2021-01-08,PF/BT,030068,PUNTO VACCINALE OSPEDALIERO DESIO,LOM,20-29,1,4,0,5,0,0,0,5,0,5,Lombardia,ITC4
2021-01-08,PF/BT,030068,PUNTO VACCINALE OSPEDALIERO DESIO,LOM,30-39,6,24,0,29,1,0,0,30,0,30,Lombardia,ITC4
2021-01-08,PF/BT,030068,PUNTO VACCINALE OSPEDALIERO DESIO,LOM,40-49,11,34,0,43,2,0,0,45,0,45,Lombardia,ITC4
2021-01-08,PF/BT,030068,PUNTO VACCINALE OSPEDALIERO DESIO,LOM,50-59,12,45,0,45,12,0,0,57,0,57,Lombardia,ITC4
2021-01-08,PF/BT,030068,PUNTO VACCINALE OSPEDALIERO DESIO,LOM,60-69,2,7,0,7,2,0,0,9,0,9,Lombardia,ITC4
2021-01-08,PF/BT,030070,PUNTO VACCINALE OSPEDALIERO CARATE BRIANZA,LOM,20-29,1,6,0,7,0,0,0,7,0,7,Lombardia,ITC4
2021-01-08,PF/BT,030070,PUNTO VACCINALE OSPEDALIERO CARATE BRIANZA,LOM,30-39,5,10,0,14,1,0,0,15,0,15,Lombardia,ITC4
2021-01-08,PF/BT,030070,PUNTO VACCINALE OSPEDALIERO CARATE BRIANZA,LOM,40-49,6,20,0,23,2,0,1,26,0,26,Lombardia,ITC4
2021-01-08,PF/BT,030070,PUNTO VACCINALE OSPEDALIERO CARATE BRIANZA,LOM,50-59,8,45,0,40,13,0,0,53,0,53,Lombardia,ITC4
2021-01-08,PF/BT,030070,PUNTO VACCINALE OSPEDALIERO CARATE BRIANZA,LOM,60-69,3,12,0,10,5,0,0,15,0,15,Lombardia,ITC4
2021-01-08,PF/BT,030078,PUNTO VACCINALE OSPEDALIERO VIMERCATE,LOM,20-29,1,4,0,4,1,0,0,5,0,5,Lombardia,ITC4
2021-01-08,PF/BT,030078,PUNTO VACCINALE OSPEDALIERO VIMERCATE,LOM,30-39,12,18,0,27,3,0,0,30,0,30,Lombardia,ITC4
2021-01-08,PF/BT,030078,PUNTO VACCINALE OSPEDALIERO VIMERCATE,LOM,40-49,5,13,0,12,6,0,0,18,0,18,Lombardia,ITC4
2021-01-08,PF/BT,030078,PUNTO VACCINALE OSPEDALIERO VIMERCATE,LOM,50-59,11,34,0,32,13,0,0,45,0,45,Lombardia,ITC4
2021-01-08,PF/BT,030078,PUNTO VACCINALE OSPEDALIERO VIMERCATE,LOM,60-69,9,10,0,16,3,0,0,19,0,19,Lombardia,ITC4
2021-01-08,PF/BT,030107,ISTITUTI CLINICI ZUCCHI - PRESIDIO DI MONZA,LOM,20-29,4,15,0,19,0,0,0,19,0,19,Lombardia,ITC4
2021-01-08,PF/BT,030107,ISTITUTI CLINICI ZUCCHI - PRESIDIO DI MONZA,LOM,30-39,6,5,0,11,0,0,0,11,0,11,Lombardia,ITC4
2021-01-08,PF/BT,030107,ISTITUTI CLINICI ZUCCHI - PRESIDIO DI MONZA,LOM,40-49,5,16,0,21,0,0,0,21,0,21,Lombardia,ITC4
2021-01-08,PF/BT,030107,ISTITUTI CLINICI ZUCCHI - PRESIDIO DI MONZA,LOM,50-59,7,23,0,30,0,0,0,30,0,30,Lombardia,ITC4
2021-01-08,PF/BT,030107,ISTITUTI CLINICI ZUCCHI - PRESIDIO DI MONZA,LOM,60-69,9,7,0,16,0,0,0,16,0,16,Lombardia,ITC4
2021-01-08,PF/BT,030107,ISTITUTI CLINICI ZUCCHI - PRESIDIO DI MONZA,LOM,70-79,8,3,0,11,0,0,0,11,0,11,Lombardia,ITC4
2021-01-08,PF/BT,030108,ISTITUTI CLINICI ZUCCHI - PRESIDIO DI CARATE BRIANZA,LOM,20-29,0,7,0,7,0,0,0,7,0,7,Lombardia,ITC4
2021-01-08,PF/BT,030108,ISTITUTI CLINICI ZUCCHI - PRESIDIO DI CARATE BRIANZA,LOM,30-39,4,5,0,9,0,0,0,9,0,9,Lombardia,ITC4
2021-01-08,PF/BT,030108,ISTITUTI CLINICI ZUCCHI - PRESIDIO DI CARATE BRIANZA,LOM,40-49,3,8,0,11,0,0,0,11,0,11,Lombardia,ITC4
2021-01-08,PF/BT,030108,ISTITUTI CLINICI ZUCCHI - PRESIDIO DI CARATE BRIANZA,LOM,50-59,1,11,0,12,0,0,0,12,0,12,Lombardia,ITC4
2021-01-08,PF/BT,030108,ISTITUTI CLINICI ZUCCHI - PRESIDIO DI CARATE BRIANZA,LOM,60-69,5,9,0,14,0,0,0,14,0,14,Lombardia,ITC4
2021-01-08,PF/BT,030176,ISTITUTO CLINICO S. ANNA di ISTITUTI OSPEDALIERI BRESCIANI S.p.A,LOM,30-39,3,6,0,9,0,0,0,9,0,9,Lombardia,ITC4
2021-01-08,PF/BT,030176,ISTITUTO CLINICO S. ANNA di ISTITUTI OSPEDALIERI BRESCIANI S.p.A,LOM,40-49,3,14,0,17,0,0,0,17,0,17,Lombardia,ITC4
2021-01-08,PF/BT,030176,ISTITUTO CLINICO S. ANNA di ISTITUTI OSPEDALIERI BRESCIANI S.p.A,LOM,50-59,7,11,0,18,0,0,0,18,0,18,Lombardia,ITC4
2021-01-08,PF/BT,030176,ISTITUTO CLINICO S. ANNA di ISTITUTI OSPEDALIERI BRESCIANI S.p.A,LOM,60-69,3,7,0,10,0,0,0,10,0,10,Lombardia,ITC4
2021-01-08,PF/BT,030178,ISTITUTO CLINICO CITTA' DI BRESCIA DI ISTITUTI OSPEDALIERI BRESCIANI,LOM,20-29,3,8,0,11,0,0,0,11,0,11,Lombardia,ITC4
2021-01-08,PF/BT,030178,ISTITUTO CLINICO CITTA' DI BRESCIA DI ISTITUTI OSPEDALIERI BRESCIANI,LOM,30-39,5,4,0,9,0,0,0,9,0,9,Lombardia,ITC4
2021-01-08,PF/BT,030178,ISTITUTO CLINICO CITTA' DI BRESCIA DI ISTITUTI OSPEDALIERI BRESCIANI,LOM,40-49,1,19,0,17,3,0,0,20,0,20,Lombardia,ITC4
2021-01-08,PF/BT,030178,ISTITUTO CLINICO CITTA' DI BRESCIA DI ISTITUTI OSPEDALIERI BRESCIANI,LOM,50-59,6,8,0,13,1,0,0,14,0,14,Lombardia,ITC4
2021-01-08,PF/BT,030295,Fondazione Poliambulanza - Brescia,LOM,20-29,7,19,0,24,2,0,0,26,0,26,Lombardia,ITC4
2021-01-08,PF/BT,030295,Fondazione Poliambulanza - Brescia,LOM,30-39,10,18,0,28,0,0,0,28,0,28,Lombardia,ITC4
2021-01-08,PF/BT,030295,Fondazione Poliambulanza - Brescia,LOM,40-49,11,41,0,50,2,0,0,52,0,52,Lombardia,ITC4
2021-01-08,PF/BT,030295,Fondazione Poliambulanza - Brescia,LOM,50-59,16,30,0,43,3,0,0,46,0,46,Lombardia,ITC4
2021-01-08,PF/BT,030295,Fondazione Poliambulanza - Brescia,LOM,60-69,12,2,0,14,0,0,0,14,0,14,Lombardia,ITC4
2021-01-08,PF/BT,030295,Fondazione Poliambulanza - Brescia,LOM,70-79,1,1,0,0,2,0,0,2,0,2,Lombardia,ITC4
2021-01-08,PF/BT,030322002778,RSA ISTITUTO GIUSEPPINE,LOM,20-29,1,0,0,0,1,0,0,1,0,1,Lombardia,ITC4
2021-01-08,PF/BT,030322002778,RSA ISTITUTO GIUSEPPINE,LOM,30-39,1,8,0,7,2,0,0,9,0,9,Lombardia,ITC4
2021-01-08,PF/BT,030322002778,RSA ISTITUTO GIUSEPPINE,LOM,40-49,2,8,0,4,6,0,0,10,0,10,Lombardia,ITC4
2021-01-08,PF/BT,030322002778,RSA ISTITUTO GIUSEPPINE,LOM,50-59,1,11,0,7,4,1,0,12,0,12,Lombardia,ITC4
2021-01-08,PF/BT,030322002778,RSA ISTITUTO GIUSEPPINE,LOM,60-69,3,2,0,1,2,2,0,5,0,5,Lombardia,ITC4
2021-01-08,PF/BT,030322002778,RSA ISTITUTO GIUSEPPINE,LOM,70-79,6,3,0,0,2,7,0,9,0,9,Lombardia,ITC4
2021-01-08,PF/BT,030322002778,RSA ISTITUTO GIUSEPPINE,LOM,80-89,2,7,0,0,0,9,0,9,0,9,Lombardia,ITC4
2021-01-08,PF/BT,030322002778,RSA ISTITUTO GIUSEPPINE,LOM,90+,0,5,0,0,0,5,0,5,0,5,Lombardia,ITC4
2021-01-08,PF/BT,030-322-002821,FONDAZIONE CA' D'INDUSTRIA ONLUS,LOM,60-69,1,1,0,0,0,2,0,2,0,2,Lombardia,ITC4
2021-01-08,PF/BT,030-322-002821,FONDAZIONE CA' D'INDUSTRIA ONLUS,LOM,70-79,1,0,0,0,0,1,0,1,0,1,Lombardia,ITC4
2021-01-08,PF/BT,030-322-002821,FONDAZIONE CA' D'INDUSTRIA ONLUS,LOM,80-89,1,4,0,0,0,5,0,5,0,5,Lombardia,ITC4
2021-01-08,PF/BT,030-322-002821,FONDAZIONE CA' D'INDUSTRIA ONLUS,LOM,90+,1,5,0,0,0,6,0,6,0,6,Lombardia,ITC4
2021-01-08,PF/BT,030324001093 -  030324001116,ISTIT.RIUNITI AIROLDI E MUZZI,LOM,20-29,1,5,0,6,0,0,0,6,0,6,Lombardia,ITC4
2021-01-08,PF/BT,030324001093 -  030324001116,ISTIT.RIUNITI AIROLDI E MUZZI,LOM,30-39,3,8,0,11,0,0,0,11,0,11,Lombardia,ITC4
2021-01-08,PF/BT,030324001093 -  030324001116,ISTIT.RIUNITI AIROLDI E MUZZI,LOM,40-49,3,14,0,17,0,0,0,17,0,17,Lombardia,ITC4
2021-01-08,PF/BT,030324001093 -  030324001116,ISTIT.RIUNITI AIROLDI E MUZZI,LOM,50-59,5,17,0,20,2,0,0,22,0,22,Lombardia,ITC4
2021-01-08,PF/BT,030324001093 -  030324001116,ISTIT.RIUNITI AIROLDI E MUZZI,LOM,60-69,2,2,0,3,1,0,0,4,0,4,Lombardia,ITC4
2021-01-08,PF/BT,030704,Polo Riabilitativo FFO,LOM,20-29,3,2,0,5,0,0,0,5,0,5,Lombardia,ITC4
2021-01-08,PF/BT,030704,Polo Riabilitativo FFO,LOM,30-39,1,1,0,2,0,0,0,2,0,2,Lombardia,ITC4
2021-01-08,PF/BT,030704,Polo Riabilitativo FFO,LOM,40-49,2,2,0,4,0,0,0,4,0,4,Lombardia,ITC4
2021-01-08,PF/BT,030704,Polo Riabilitativo FFO,LOM,50-59,0,1,0,1,0,0,0,1,0,1,Lombardia,ITC4
2021-01-08,PF/BT,030704,Presidio Ospedaliero CTO,LOM,20-29,3,1,0,4,0,0,0,4,0,4,Lombardia,ITC4
2021-01-08,PF/BT,030704,Presidio Ospedaliero CTO,LOM,30-39,3,6,0,9,0,0,0,9,0,9,Lombardia,ITC4
2021-01-08,PF/BT,030704,Presidio Ospedaliero CTO,LOM,40-49,8,11,0,19,0,0,0,19,0,19,Lombardia,ITC4
2021-01-08,PF/BT,030704,Presidio Ospedaliero CTO,LOM,50-59,7,16,0,23,0,0,0,23,0,23,Lombardia,ITC4
2021-01-08,PF/BT,030704,Presidio Ospedaliero CTO,LOM,60-69,4,0,0,4,0,0,0,4,0,4,Lombardia,ITC4
2021-01-08,PF/BT,030704,Presidio Ospedaliero G. Pini,LOM,20-29,0,8,0,8,0,0,0,8,0,8,Lombardia,ITC4
2021-01-08,PF/BT,030704,Presidio Ospedaliero G. Pini,LOM,30-39,10,3,0,12,1,0,0,13,0,13,Lombardia,ITC4
2021-01-08,PF/BT,030704,Presidio Ospedaliero G. Pini,LOM,40-49,10,6,0,14,2,0,0,16,0,16,Lombardia,ITC4
2021-01-08,PF/BT,030704,Presidio Ospedaliero G. Pini,LOM,50-59,8,9,0,13,4,0,0,17,0,17,Lombardia,ITC4
2021-01-08,PF/BT,030704,Presidio Ospedaliero G. Pini,LOM,60-69,15,3,0,16,2,0,0,18,0,18,Lombardia,ITC4
2021-01-08,PF/BT,030903,AMB COVID LECCO,LOM,16-19,1,0,0,0,1,0,0,1,0,1,Lombardia,ITC4
2021-01-08,PF/BT,030903,AMB COVID LECCO,LOM,20-29,8,22,0,20,10,0,0,30,0,30,Lombardia,ITC4
2021-01-08,PF/BT,030903,AMB COVID LECCO,LOM,30-39,17,34,0,37,14,0,0,51,0,51,Lombardia,ITC4
2021-01-08,PF/BT,030903,AMB COVID LECCO,LOM,40-49,18,63,0,57,24,0,0,81,0,81,Lombardia,ITC4
2021-01-08,PF/BT,030903,AMB COVID LECCO,LOM,50-59,28,81,0,85,24,0,0,109,0,109,Lombardia,ITC4
2021-01-08,PF/BT,030903,AMB COVID LECCO,LOM,60-69,29,20,0,44,5,0,0,49,0,49,Lombardia,ITC4
2021-01-08,PF/BT,030922,"FOND.IRCCS ""ISTIT.NAZ.LE TUMORI""MILANO",LOM,16-19,0,1,0,0,1,0,0,1,0,1,Lombardia,ITC4
2021-01-08,PF/BT,030922,"FOND.IRCCS ""ISTIT.NAZ.LE TUMORI""MILANO",LOM,20-29,7,20,0,22,5,0,0,27,0,27,Lombardia,ITC4
2021-01-08,PF/BT,030922,"FOND.IRCCS ""ISTIT.NAZ.LE TUMORI""MILANO",LOM,30-39,15,22,0,33,4,0,0,37,0,37,Lombardia,ITC4
2021-01-08,PF/BT,030922,"FOND.IRCCS ""ISTIT.NAZ.LE TUMORI""MILANO",LOM,40-49,11,26,0,27,10,0,0,37,0,37,Lombardia,ITC4
2021-01-08,PF/BT,030922,"FOND.IRCCS ""ISTIT.NAZ.LE TUMORI""MILANO",LOM,50-59,8,47,0,33,22,0,0,55,0,55,Lombardia,ITC4
2021-01-08,PF/BT,030922,"FOND.IRCCS ""ISTIT.NAZ.LE TUMORI""MILANO",LOM,60-69,10,13,0,11,12,0,0,23,0,23,Lombardia,ITC4
2021-01-08,PF/BT,030923,FOND.IRCCS IST.NAZ.NEUROLOGICO C.BESTA-M,LOM,20-29,8,15,0,22,1,0,0,23,0,23,Lombardia,ITC4
2021-01-08,PF/BT,030923,FOND.IRCCS IST.NAZ.NEUROLOGICO C.BESTA-M,LOM,30-39,7,16,0,21,1,0,1,23,0,23,Lombardia,ITC4
2021-01-08,PF/BT,030923,FOND.IRCCS IST.NAZ.NEUROLOGICO C.BESTA-M,LOM,40-49,5,16,0,18,3,0,0,21,0,21,Lombardia,ITC4
2021-01-08,PF/BT,030923,FOND.IRCCS IST.NAZ.NEUROLOGICO C.BESTA-M,LOM,50-59,9,22,0,27,3,0,1,31,0,31,Lombardia,ITC4
2021-01-08,PF/BT,030923,FOND.IRCCS IST.NAZ.NEUROLOGICO C.BESTA-M,LOM,60-69,3,5,0,8,0,0,0,8,0,8,Lombardia,ITC4
2021-01-08,PF/BT,030923,FOND.IRCCS IST.NAZ.NEUROLOGICO C.BESTA-M,LOM,70-79,1,0,0,0,0,0,1,1,0,1,Lombardia,ITC4
2021-01-08,PF/BT,030924,IRCCS POLICLINICO S. MATTEO - PAVIA,LOM,20-29,5,21,0,26,0,0,0,26,0,26,Lombardia,ITC4
2021-01-08,PF/BT,030924,IRCCS POLICLINICO S. MATTEO - PAVIA,LOM,30-39,11,24,0,35,0,0,0,35,0,35,Lombardia,ITC4
2021-01-08,PF/BT,030924,IRCCS POLICLINICO S. MATTEO - PAVIA,LOM,40-49,13,53,0,64,2,0,0,66,0,66,Lombardia,ITC4
2021-01-08,PF/BT,030924,IRCCS POLICLINICO S. MATTEO - PAVIA,LOM,50-59,13,38,0,48,3,0,0,51,0,51,Lombardia,ITC4
2021-01-08,PF/BT,030924,IRCCS POLICLINICO S. MATTEO - PAVIA,LOM,60-69,13,12,0,22,3,0,0,25,0,25,Lombardia,ITC4
2021-01-08,PF/BT,030924,IRCCS POLICLINICO S. MATTEO - PAVIA,LOM,70-79,1,0,0,1,0,0,0,1,0,1,Lombardia,ITC4
2021-01-08,PF/BT,030925,Fondazione IRCCS Ca' Granda Ospedale Maggiore Policlinico,LOM,20-29,10,31,0,41,0,0,0,41,0,41,Lombardia,ITC4
2021-01-08,PF/BT,030925,Fondazione IRCCS Ca' Granda Ospedale Maggiore Policlinico,LOM,30-39,23,59,0,81,1,0,0,82,0,82,Lombardia,ITC4
2021-01-08,PF/BT,030925,Fondazione IRCCS Ca' Granda Ospedale Maggiore Policlinico,LOM,40-49,16,39,0,51,4,0,0,55,0,55,Lombardia,ITC4
2021-01-08,PF/BT,030925,Fondazione IRCCS Ca' Granda Ospedale Maggiore Policlinico,LOM,50-59,17,38,0,47,8,0,0,55,0,55,Lombardia,ITC4
2021-01-08,PF/BT,030925,Fondazione IRCCS Ca' Granda Ospedale Maggiore Policlinico,LOM,60-69,19,15,0,32,2,0,0,34,0,34,Lombardia,ITC4
2021-01-08,PF/BT,030925,Fondazione IRCCS Ca' Granda Ospedale Maggiore Policlinico,LOM,70-79,0,1,0,1,0,0,0,1,0,1,Lombardia,ITC4
2021-01-08,PF/BT,030935,IRCCS    S. RAFFAELE - MILANO,LOM,20-29,2,7,0,9,0,0,0,9,0,9,Lombardia,ITC4
2021-01-08,PF/BT,030935,IRCCS    S. RAFFAELE - MILANO,LOM,30-39,9,5,0,14,0,0,0,14,0,14,Lombardia,ITC4
2021-01-08,PF/BT,030935,IRCCS    S. RAFFAELE - MILANO,LOM,40-49,5,8,0,13,0,0,0,13,0,13,Lombardia,ITC4
2021-01-08,PF/BT,030935,IRCCS    S. RAFFAELE - MILANO,LOM,50-59,33,84,0,117,0,0,0,117,0,117,Lombardia,ITC4
2021-01-08,PF/BT,030935,IRCCS    S. RAFFAELE - MILANO,LOM,60-69,20,16,0,36,0,0,0,36,0,36,Lombardia,ITC4
2021-01-08,PF/BT,030935,IRCCS    S. RAFFAELE - MILANO,LOM,70-79,6,1,0,7,0,0,0,7,0,7,Lombardia,ITC4
2021-01-08,PF/BT,030937,PRO JOVENTUDE DON C. GNOCCHI - MI IRCCS PRIVATO,LOM,20-29,2,0,0,2,0,0,0,2,0,2,Lombardia,ITC4
2021-01-08,PF/BT,030937,PRO JOVENTUDE DON C. GNOCCHI - MI IRCCS PRIVATO,LOM,30-39,2,4,0,6,0,0,0,6,0,6,Lombardia,ITC4
2021-01-08,PF/BT,030937,PRO JOVENTUDE DON C. GNOCCHI - MI IRCCS PRIVATO,LOM,40-49,0,1,0,1,0,0,0,1,0,1,Lombardia,ITC4
2021-01-08,PF/BT,030937,PRO JOVENTUDE DON C. GNOCCHI - MI IRCCS PRIVATO,LOM,50-59,2,3,0,5,0,0,0,5,0,5,Lombardia,ITC4
2021-01-08,PF/BT,030937,PRO JOVENTUDE DON C. GNOCCHI - MI IRCCS PRIVATO,LOM,60-69,7,6,0,12,0,0,1,13,0,13,Lombardia,ITC4
2021-01-08,PF/BT,030937,PRO JOVENTUDE DON C. GNOCCHI - MI IRCCS PRIVATO,LOM,70-79,0,2,0,0,0,0,2,2,0,2,Lombardia,ITC4
2021-01-08,PF/BT,030937,PRO JOVENTUDE DON C. GNOCCHI - MI IRCCS PRIVATO,LOM,90+,0,1,0,0,0,0,1,1,0,1,Lombardia,ITC4
2021-01-08,PF/BT,030943,Istituto Clinico Humanitas,LOM,20-29,50,96,0,95,51,0,0,146,0,146,Lombardia,ITC4
2021-01-08,PF/BT,030943,Istituto Clinico Humanitas,LOM,30-39,49,91,0,87,53,0,0,140,0,140,Lombardia,ITC4
2021-01-08,PF/BT,030943,Istituto Clinico Humanitas,LOM,40-49,45,83,0,86,42,0,0,128,0,128,Lombardia,ITC4
2021-01-08,PF/BT,030943,Istituto Clinico Humanitas,LOM,50-59,27,44,0,53,18,0,0,71,0,71,Lombardia,ITC4
2021-01-08,PF/BT,030943,Istituto Clinico Humanitas,LOM,60-69,7,8,0,11,4,0,0,15,0,15,Lombardia,ITC4
2021-01-08,PF/BT,030943,Istituto Clinico Humanitas,LOM,70-79,3,0,0,1,2,0,0,3,0,3,Lombardia,ITC4
2021-01-08,PF/BT,030950,IRCCS   S. RAFFAELE TURRO - MILANO,LOM,40-49,5,21,0,26,0,0,0,26,0,26,Lombardia,ITC4
2021-01-08,PF/BT,030950,IRCCS   S. RAFFAELE TURRO - MILANO,LOM,50-59,11,17,0,28,0,0,0,28,0,28,Lombardia,ITC4
2021-01-08,PF/BT,030950,IRCCS   S. RAFFAELE TURRO - MILANO,LOM,60-69,3,2,0,5,0,0,0,5,0,5,Lombardia,ITC4
2021-01-08,PF/BT,1206,RSA ANNA E GUIDO  FOSSATI - MONZA,LOM,70-79,2,5,0,0,0,7,0,7,0,7,Lombardia,ITC4
2021-01-08,PF/BT,1206,RSA ANNA E GUIDO  FOSSATI - MONZA,LOM,80-89,9,32,0,0,0,41,0,41,0,41,Lombardia,ITC4
2021-01-08,PF/BT,1206,RSA ANNA E GUIDO  FOSSATI - MONZA,LOM,90+,2,16,0,0,0,18,0,18,0,18,Lombardia,ITC4
2021-01-08,PF/BT,167,ASST SPEDALI CIVILI AMBULATORIO COVID BRESCIA,LOM,20-29,33,60,0,85,8,0,0,93,0,93,Lombardia,ITC4
2021-01-08,PF/BT,167,ASST SPEDALI CIVILI AMBULATORIO COVID BRESCIA,LOM,30-39,37,79,0,102,14,0,0,116,0,116,Lombardia,ITC4
2021-01-08,PF/BT,167,ASST SPEDALI CIVILI AMBULATORIO COVID BRESCIA,LOM,40-49,24,71,0,72,23,0,0,95,0,95,Lombardia,ITC4
2021-01-08,PF/BT,167,ASST SPEDALI CIVILI AMBULATORIO COVID BRESCIA,LOM,50-59,33,82,0,94,21,0,0,115,0,115,Lombardia,ITC4
2021-01-08,PF/BT,167,ASST SPEDALI CIVILI AMBULATORIO COVID BRESCIA,LOM,60-69,27,21,0,40,8,0,0,48,0,48,Lombardia,ITC4
2021-01-08,PF/BT,1842,RSA VILLA AZZURRA,LOM,20-29,0,2,0,1,1,0,0,2,0,2,Lombardia,ITC4
2021-01-08,PF/BT,1842,RSA VILLA AZZURRA,LOM,30-39,0,3,0,3,0,0,0,3,0,3,Lombardia,ITC4
2021-01-08,PF/BT,1842,RSA VILLA AZZURRA,LOM,40-49,0,6,0,2,4,0,0,6,0,6,Lombardia,ITC4
2021-01-08,PF/BT,1842,RSA VILLA AZZURRA,LOM,50-59,0,7,0,5,2,0,0,7,0,7,Lombardia,ITC4
2021-01-08,PF/BT,1842,RSA VILLA AZZURRA,LOM,60-69,0,2,0,0,0,2,0,2,0,2,Lombardia,ITC4
2021-01-08,PF/BT,1842,RSA VILLA AZZURRA,LOM,70-79,0,3,0,0,0,3,0,3,0,3,Lombardia,ITC4
2021-01-08,PF/BT,1842,RSA VILLA AZZURRA,LOM,80-89,0,3,0,0,0,3,0,3,0,3,Lombardia,ITC4
2021-01-08,PF/BT,1842,RSA VILLA AZZURRA,LOM,90+,0,10,0,0,0,10,0,10,0,10,Lombardia,ITC4
2021-01-08,PF/BT,194,AMBULATORIO HUB VOGHERA,LOM,20-29,3,6,0,7,2,0,0,9,0,9,Lombardia,ITC4
2021-01-08,PF/BT,194,AMBULATORIO HUB VOGHERA,LOM,30-39,13,18,0,25,6,0,0,31,0,31,Lombardia,ITC4
2021-01-08,PF/BT,194,AMBULATORIO HUB VOGHERA,LOM,40-49,15,11,0,22,4,0,0,26,0,26,Lombardia,ITC4
2021-01-08,PF/BT,194,AMBULATORIO HUB VOGHERA,LOM,50-59,17,33,0,46,4,0,0,50,0,50,Lombardia,ITC4
2021-01-08,PF/BT,194,AMBULATORIO HUB VOGHERA,LOM,60-69,15,13,0,21,7,0,0,28,0,28,Lombardia,ITC4
2021-01-08,PF/BT,1953,RSA BEATA PAOLA,LOM,30-39,1,1,0,2,0,0,0,2,0,2,Lombardia,ITC4
2021-01-08,PF/BT,1953,RSA BEATA PAOLA,LOM,40-49,0,5,0,4,1,0,0,5,0,5,Lombardia,ITC4
2021-01-08,PF/BT,1953,RSA BEATA PAOLA,LOM,50-59,0,4,0,4,0,0,0,4,0,4,Lombardia,ITC4
2021-01-08,PF/BT,1953,RSA BEATA PAOLA,LOM,60-69,0,2,0,1,0,1,0,2,0,2,Lombardia,ITC4
2021-01-08,PF/BT,1953,RSA BEATA PAOLA,LOM,70-79,2,2,0,0,0,4,0,4,0,4,Lombardia,ITC4
2021-01-08,PF/BT,1953,RSA BEATA PAOLA,LOM,80-89,2,2,0,0,0,4,0,4,0,4,Lombardia,ITC4
2021-01-08,PF/BT,1953,RSA BEATA PAOLA,LOM,90+,0,3,0,0,0,3,0,3,0,3,Lombardia,ITC4
2021-01-08,PF/BT,2148,RSA DE RODOLFI VIGEVANO,LOM,20-29,0,1,0,1,0,0,0,1,0,1,Lombardia,ITC4
2021-01-08,PF/BT,2148,RSA DE RODOLFI VIGEVANO,LOM,30-39,1,1,0,1,1,0,0,2,0,2,Lombardia,ITC4
2021-01-08,PF/BT,2148,RSA DE RODOLFI VIGEVANO,LOM,40-49,2,5,0,7,0,0,0,7,0,7,Lombardia,ITC4
2021-01-08,PF/BT,2148,RSA DE RODOLFI VIGEVANO,LOM,50-59,4,9,0,8,5,0,0,13,0,13,Lombardia,ITC4
2021-01-08,PF/BT,2148,RSA DE RODOLFI VIGEVANO,LOM,60-69,2,4,0,3,3,0,0,6,0,6,Lombardia,ITC4
2021-01-08,PF/BT,2148,RSA DE RODOLFI VIGEVANO,LOM,70-79,1,0,0,0,1,0,0,1,0,1,Lombardia,ITC4
2021-01-08,PF/BT,2761,FONDAZIONE CA'D'INDUSTRIA LE CAMELIE,LOM,60-69,1,3,0,0,0,4,0,4,0,4,Lombardia,ITC4
2021-01-08,PF/BT,2761,FONDAZIONE CA'D'INDUSTRIA LE CAMELIE,LOM,70-79,3,4,0,0,0,7,0,7,0,7,Lombardia,ITC4
2021-01-08,PF/BT,2761,FONDAZIONE CA'D'INDUSTRIA LE CAMELIE,LOM,80-89,4,10,0,0,0,14,0,14,0,14,Lombardia,ITC4
2021-01-08,PF/BT,2761,FONDAZIONE CA'D'INDUSTRIA LE CAMELIE,LOM,90+,0,11,0,0,0,11,0,11,0,11,Lombardia,ITC4
2021-01-08,PF/BT,2821,FONDAZIONE CA' D'INDUSTRIA ONLUS,LOM,60-69,1,1,0,0,0,2,0,2,0,2,Lombardia,ITC4
2021-01-08,PF/BT,2821,FONDAZIONE CA' D'INDUSTRIA ONLUS,LOM,70-79,1,0,0,0,0,1,0,1,0,1,Lombardia,ITC4
2021-01-08,PF/BT,2821,FONDAZIONE CA' D'INDUSTRIA ONLUS,LOM,80-89,1,4,0,0,0,5,0,5,0,5,Lombardia,ITC4
2021-01-08,PF/BT,2821,FONDAZIONE CA' D'INDUSTRIA ONLUS,LOM,90+,1,5,0,0,0,6,0,6,0,6,Lombardia,ITC4
2021-01-08,PF/BT,2859,RSA FONDAZIONE BELLARIA ONLUS,LOM,20-29,1,2,0,2,1,0,0,3,0,3,Lombardia,ITC4
2021-01-08,PF/BT,2859,RSA FONDAZIONE BELLARIA ONLUS,LOM,30-39,1,3,0,2,2,0,0,4,0,4,Lombardia,ITC4
2021-01-08,PF/BT,2859,RSA FONDAZIONE BELLARIA ONLUS,LOM,40-49,1,10,0,6,5,0,0,11,0,11,Lombardia,ITC4
2021-01-08,PF/BT,2859,RSA FONDAZIONE BELLARIA ONLUS,LOM,50-59,2,9,0,8,3,0,0,11,0,11,Lombardia,ITC4
2021-01-08,PF/BT,2859,RSA FONDAZIONE BELLARIA ONLUS,LOM,60-69,0,4,0,3,0,0,1,4,0,4,Lombardia,ITC4
2021-01-08,PF/BT,2859,RSA FONDAZIONE BELLARIA ONLUS,LOM,70-79,2,0,0,0,0,0,2,2,0,2,Lombardia,ITC4
2021-01-08,PF/BT,2859,RSA FONDAZIONE BELLARIA ONLUS,LOM,80-89,1,0,0,0,0,0,1,1,0,1,Lombardia,ITC4
2021-01-08,PF/BT,30072,Centro Vaccinale Covid Vizzolo - ASST Melegnano Martesana,LOM,20-29,2,3,0,4,1,0,0,5,0,5,Lombardia,ITC4
2021-01-08,PF/BT,30072,Centro Vaccinale Covid Vizzolo - ASST Melegnano Martesana,LOM,30-39,8,14,0,18,4,0,0,22,0,22,Lombardia,ITC4
2021-01-08,PF/BT,30072,Centro Vaccinale Covid Vizzolo - ASST Melegnano Martesana,LOM,40-49,11,25,0,29,7,0,0,36,0,36,Lombardia,ITC4
2021-01-08,PF/BT,30072,Centro Vaccinale Covid Vizzolo - ASST Melegnano Martesana,LOM,50-59,9,33,0,32,10,0,0,42,0,42,Lombardia,ITC4
2021-01-08,PF/BT,30072,Centro Vaccinale Covid Vizzolo - ASST Melegnano Martesana,LOM,60-69,6,15,0,15,6,0,0,21,0,21,Lombardia,ITC4
2021-01-08,PF/BT,30074,HUB COVID MAGENTA,LOM,20-29,1,7,0,7,1,0,0,8,0,8,Lombardia,ITC4
2021-01-08,PF/BT,30074,HUB COVID MAGENTA,LOM,30-39,2,14,0,15,1,0,0,16,0,16,Lombardia,ITC4
2021-01-08,PF/BT,30074,HUB COVID MAGENTA,LOM,40-49,10,36,0,43,3,0,0,46,0,46,Lombardia,ITC4
2021-01-08,PF/BT,30074,HUB COVID MAGENTA,LOM,50-59,8,48,0,50,6,0,0,56,0,56,Lombardia,ITC4
2021-01-08,PF/BT,30074,HUB COVID MAGENTA,LOM,60-69,5,6,0,6,5,0,0,11,0,11,Lombardia,ITC4
2021-01-08,PF/BT,30085,Centro Vaccinale Covid Cernusco - ASST Melegnano Martesana,LOM,20-29,0,7,0,7,0,0,0,7,0,7,Lombardia,ITC4
2021-01-08,PF/BT,30085,Centro Vaccinale Covid Cernusco - ASST Melegnano Martesana,LOM,30-39,4,5,0,9,0,0,0,9,0,9,Lombardia,ITC4
2021-01-08,PF/BT,30085,Centro Vaccinale Covid Cernusco - ASST Melegnano Martesana,LOM,40-49,5,17,0,22,0,0,0,22,0,22,Lombardia,ITC4
2021-01-08,PF/BT,30085,Centro Vaccinale Covid Cernusco - ASST Melegnano Martesana,LOM,50-59,6,43,0,49,0,0,0,49,0,49,Lombardia,ITC4
2021-01-08,PF/BT,30085,Centro Vaccinale Covid Cernusco - ASST Melegnano Martesana,LOM,60-69,4,10,0,13,1,0,0,14,0,14,Lombardia,ITC4
2021-01-08,PF/BT,30156,Centro Vaccinale Covid Desenzano,LOM,20-29,3,14,0,16,1,0,0,17,0,17,Lombardia,ITC4
2021-01-08,PF/BT,30156,Centro Vaccinale Covid Desenzano,LOM,30-39,6,6,0,11,1,0,0,12,0,12,Lombardia,ITC4
2021-01-08,PF/BT,30156,Centro Vaccinale Covid Desenzano,LOM,40-49,5,17,0,16,6,0,0,22,0,22,Lombardia,ITC4
2021-01-08,PF/BT,30156,Centro Vaccinale Covid Desenzano,LOM,50-59,6,31,0,31,3,0,3,37,0,37,Lombardia,ITC4
2021-01-08,PF/BT,30156,Centro Vaccinale Covid Desenzano,LOM,60-69,10,16,0,21,5,0,0,26,0,26,Lombardia,ITC4
2021-01-08,PF/BT,30157,Centro Vaccinale Covid Gavardo,LOM,20-29,1,9,0,10,0,0,0,10,0,10,Lombardia,ITC4
2021-01-08,PF/BT,30157,Centro Vaccinale Covid Gavardo,LOM,30-39,4,5,0,8,1,0,0,9,0,9,Lombardia,ITC4
2021-01-08,PF/BT,30157,Centro Vaccinale Covid Gavardo,LOM,40-49,1,18,0,16,3,0,0,19,0,19,Lombardia,ITC4
2021-01-08,PF/BT,30157,Centro Vaccinale Covid Gavardo,LOM,50-59,12,36,0,41,7,0,0,48,0,48,Lombardia,ITC4
2021-01-08,PF/BT,30157,Centro Vaccinale Covid Gavardo,LOM,60-69,3,13,0,15,1,0,0,16,0,16,Lombardia,ITC4
2021-01-08,PF/BT,30184,Centro Vaccinale Covid Manerbio,LOM,20-29,0,4,0,4,0,0,0,4,0,4,Lombardia,ITC4
2021-01-08,PF/BT,30184,Centro Vaccinale Covid Manerbio,LOM,30-39,4,9,0,11,2,0,0,13,0,13,Lombardia,ITC4
2021-01-08,PF/BT,30184,Centro Vaccinale Covid Manerbio,LOM,40-49,4,24,0,24,3,0,1,28,0,28,Lombardia,ITC4
2021-01-08,PF/BT,30184,Centro Vaccinale Covid Manerbio,LOM,50-59,13,37,0,42,7,0,1,50,0,50,Lombardia,ITC4
2021-01-08,PF/BT,30184,Centro Vaccinale Covid Manerbio,LOM,60-69,4,9,0,11,1,0,1,13,0,13,Lombardia,ITC4
2021-01-08,PF/BT,30193,Ambulatorio HUB Vigevano,LOM,20-29,4,8,0,11,1,0,0,12,0,12,Lombardia,ITC4
2021-01-08,PF/BT,30193,Ambulatorio HUB Vigevano,LOM,30-39,12,19,0,29,2,0,0,31,0,31,Lombardia,ITC4
2021-01-08,PF/BT,30193,Ambulatorio HUB Vigevano,LOM,40-49,9,26,0,33,2,0,0,35,0,35,Lombardia,ITC4
2021-01-08,PF/BT,30193,Ambulatorio HUB Vigevano,LOM,50-59,17,60,0,72,5,0,0,77,0,77,Lombardia,ITC4
2021-01-08,PF/BT,30193,Ambulatorio HUB Vigevano,LOM,60-69,6,11,0,14,3,0,0,17,0,17,Lombardia,ITC4
2021-01-08,PF/BT,30209,OSPEDALE MAGGIORE DI CREMA,LOM,16-19,0,1,0,0,1,0,0,1,0,1,Lombardia,ITC4
2021-01-08,PF/BT,30209,OSPEDALE MAGGIORE DI CREMA,LOM,20-29,4,6,0,7,3,0,0,10,0,10,Lombardia,ITC4
2021-01-08,PF/BT,30209,OSPEDALE MAGGIORE DI CREMA,LOM,30-39,5,12,0,15,2,0,0,17,0,17,Lombardia,ITC4
2021-01-08,PF/BT,30209,OSPEDALE MAGGIORE DI CREMA,LOM,40-49,6,28,0,29,5,0,0,34,0,34,Lombardia,ITC4
2021-01-08,PF/BT,30209,OSPEDALE MAGGIORE DI CREMA,LOM,50-59,6,31,0,21,16,0,0,37,0,37,Lombardia,ITC4
2021-01-08,PF/BT,30209,OSPEDALE MAGGIORE DI CREMA,LOM,60-69,2,7,0,4,5,0,0,9,0,9,Lombardia,ITC4
2021-01-08,PF/BT,30281,HUB COVID LEGNANO,LOM,20-29,3,9,0,8,4,0,0,12,0,12,Lombardia,ITC4
2021-01-08,PF/BT,30281,HUB COVID LEGNANO,LOM,30-39,9,30,0,32,7,0,0,39,0,39,Lombardia,ITC4
2021-01-08,PF/BT,30281,HUB COVID LEGNANO,LOM,40-49,20,37,0,40,17,0,0,57,0,57,Lombardia,ITC4
2021-01-08,PF/BT,30281,HUB COVID LEGNANO,LOM,50-59,12,62,0,56,18,0,0,74,0,74,Lombardia,ITC4
2021-01-08,PF/BT,30281,HUB COVID LEGNANO,LOM,60-69,4,9,0,12,1,0,0,13,0,13,Lombardia,ITC4
2021-01-08,PF/BT,30701,ASST GRANDE OSPEDALE METROPOLITANO NIGUARDA,LOM,20-29,12,53,0,53,7,0,5,65,0,65,Lombardia,ITC4
2021-01-08,PF/BT,30701,ASST GRANDE OSPEDALE METROPOLITANO NIGUARDA,LOM,30-39,49,72,0,98,13,0,10,121,0,121,Lombardia,ITC4
2021-01-08,PF/BT,30701,ASST GRANDE OSPEDALE METROPOLITANO NIGUARDA,LOM,40-49,31,66,0,82,13,0,2,97,0,97,Lombardia,ITC4
2021-01-08,PF/BT,30701,ASST GRANDE OSPEDALE METROPOLITANO NIGUARDA,LOM,50-59,42,126,0,115,43,0,10,168,0,168,Lombardia,ITC4
2021-01-08,PF/BT,30701,ASST GRANDE OSPEDALE METROPOLITANO NIGUARDA,LOM,60-69,21,32,0,35,13,0,5,53,0,53,Lombardia,ITC4
2021-01-08,PF/BT,30712,Ospedale Sant'Anna - Via Napoleona - Como,LOM,20-29,1,2,0,0,3,0,0,3,0,3,Lombardia,ITC4
2021-01-08,PF/BT,30712,Ospedale Sant'Anna - Via Napoleona - Como,LOM,30-39,2,5,0,0,6,1,0,7,0,7,Lombardia,ITC4
2021-01-08,PF/BT,30712,Ospedale Sant'Anna - Via Napoleona - Como,LOM,40-49,4,12,0,0,16,0,0,16,0,16,Lombardia,ITC4
2021-01-08,PF/BT,30712,Ospedale Sant'Anna - Via Napoleona - Como,LOM,50-59,6,13,0,0,17,2,0,19,0,19,Lombardia,ITC4
2021-01-08,PF/BT,30712,Ospedale Sant'Anna - Via Napoleona - Como,LOM,60-69,2,7,0,0,9,0,0,9,0,9,Lombardia,ITC4
2021-01-08,PF/BT,30718,ASST PAPA GIOVANNI XXIII,LOM,20-29,7,16,0,20,3,0,0,23,0,23,Lombardia,ITC4
2021-01-08,PF/BT,30718,ASST PAPA GIOVANNI XXIII,LOM,30-39,19,40,0,52,7,0,0,59,0,59,Lombardia,ITC4
2021-01-08,PF/BT,30718,ASST PAPA GIOVANNI XXIII,LOM,40-49,20,34,0,54,0,0,0,54,0,54,Lombardia,ITC4
2021-01-08,PF/BT,30718,ASST PAPA GIOVANNI XXIII,LOM,50-59,16,53,0,60,9,0,0,69,0,69,Lombardia,ITC4
2021-01-08,PF/BT,30718,ASST PAPA GIOVANNI XXIII,LOM,60-69,9,14,0,19,4,0,0,23,0,23,Lombardia,ITC4
2021-01-08,PF/BT,30909,amb covid monza,LOM,20-29,9,31,0,37,2,0,1,40,0,40,Lombardia,ITC4
2021-01-08,PF/BT,30909,amb covid monza,LOM,30-39,22,42,0,61,2,0,1,64,0,64,Lombardia,ITC4
2021-01-08,PF/BT,30909,amb covid monza,LOM,40-49,20,49,0,65,3,0,1,69,0,69,Lombardia,ITC4
2021-01-08,PF/BT,30909,amb covid monza,LOM,50-59,16,65,0,80,1,0,0,81,0,81,Lombardia,ITC4
2021-01-08,PF/BT,30909,amb covid monza,LOM,60-69,13,14,0,25,2,0,0,27,0,27,Lombardia,ITC4
2021-01-08,PF/BT,30909,amb covid monza,LOM,70-79,0,1,0,1,0,0,0,1,0,1,Lombardia,ITC4
2021-01-08,PF/BT,30934,CENTRO CARDIOLOGICO MONZINO,LOM,20-29,10,9,0,14,5,0,0,19,0,19,Lombardia,ITC4
2021-01-08,PF/BT,30934,CENTRO CARDIOLOGICO MONZINO,LOM,30-39,7,12,0,14,4,0,1,19,0,19,Lombardia,ITC4
2021-01-08,PF/BT,30934,CENTRO CARDIOLOGICO MONZINO,LOM,40-49,12,20,0,26,6,0,0,32,0,32,Lombardia,ITC4
2021-01-08,PF/BT,30934,CENTRO CARDIOLOGICO MONZINO,LOM,50-59,15,15,0,22,8,0,0,30,0,30,Lombardia,ITC4
2021-01-08,PF/BT,30934,CENTRO CARDIOLOGICO MONZINO,LOM,60-69,7,7,0,13,1,0,0,14,0,14,Lombardia,ITC4
2021-01-08,PF/BT,30934,CENTRO CARDIOLOGICO MONZINO,LOM,70-79,2,1,0,3,0,0,0,3,0,3,Lombardia,ITC4
2021-01-08,PF/BT,30941,ISTITUTO EUROPEO DI ONCOLOGIA,LOM,20-29,2,3,0,5,0,0,0,5,0,5,Lombardia,ITC4
2021-01-08,PF/BT,30941,ISTITUTO EUROPEO DI ONCOLOGIA,LOM,30-39,9,4,0,13,0,0,0,13,0,13,Lombardia,ITC4
2021-01-08,PF/BT,30941,ISTITUTO EUROPEO DI ONCOLOGIA,LOM,40-49,6,4,0,10,0,0,0,10,0,10,Lombardia,ITC4
2021-01-08,PF/BT,30941,ISTITUTO EUROPEO DI ONCOLOGIA,LOM,50-59,44,56,0,100,0,0,0,100,0,100,Lombardia,ITC4
2021-01-08,PF/BT,30941,ISTITUTO EUROPEO DI ONCOLOGIA,LOM,60-69,10,12,0,21,1,0,0,22,0,22,Lombardia,ITC4
2021-01-08,PF/BT,3094602,IST.CLINICO S.SIRO SPA-MILANO,LOM,40-49,1,2,0,2,1,0,0,3,0,3,Lombardia,ITC4
2021-01-08,PF/BT,3094602,IST.CLINICO S.SIRO SPA-MILANO,LOM,50-59,2,4,0,5,1,0,0,6,0,6,Lombardia,ITC4
2021-01-08,PF/BT,3094602,IST.CLINICO S.SIRO SPA-MILANO,LOM,60-69,1,0,0,1,0,0,0,1,0,1,Lombardia,ITC4
2021-01-08,PF/BT,3094602,IST.CLINICO S.SIRO SPA-MILANO,LOM,70-79,2,0,0,2,0,0,0,2,0,2,Lombardia,ITC4
2021-01-08,PF/BT,321000483,RSA SAN FRANCESCO D'ASSISI,LOM,20-29,0,2,0,2,0,0,0,2,0,2,Lombardia,ITC4
2021-01-08,PF/BT,321000483,RSA SAN FRANCESCO D'ASSISI,LOM,30-39,0,3,0,3,0,0,0,3,0,3,Lombardia,ITC4
2021-01-08,PF/BT,321000483,RSA SAN FRANCESCO D'ASSISI,LOM,40-49,2,10,0,11,1,0,0,12,0,12,Lombardia,ITC4
2021-01-08,PF/BT,321000483,RSA SAN FRANCESCO D'ASSISI,LOM,50-59,2,7,0,7,2,0,0,9,0,9,Lombardia,ITC4
2021-01-08,PF/BT,321000483,RSA SAN FRANCESCO D'ASSISI,LOM,60-69,2,2,0,3,0,1,0,4,0,4,Lombardia,ITC4
2021-01-08,PF/BT,321000483,RSA SAN FRANCESCO D'ASSISI,LOM,70-79,0,2,0,0,0,2,0,2,0,2,Lombardia,ITC4
2021-01-08,PF/BT,321000483,RSA SAN FRANCESCO D'ASSISI,LOM,80-89,4,16,0,0,0,20,0,20,0,20,Lombardia,ITC4
2021-01-08,PF/BT,321000483,RSA SAN FRANCESCO D'ASSISI,LOM,90+,6,19,0,0,0,25,0,25,0,25,Lombardia,ITC4
2021-01-08,PF/BT,321000682,RSA CENTRO PADRE AMBROSOLI GIUSEPPE,LOM,30-39,2,3,0,5,0,0,0,5,0,5,Lombardia,ITC4
2021-01-08,PF/BT,321000682,RSA CENTRO PADRE AMBROSOLI GIUSEPPE,LOM,40-49,0,2,0,1,1,0,0,2,0,2,Lombardia,ITC4
2021-01-08,PF/BT,321000682,RSA CENTRO PADRE AMBROSOLI GIUSEPPE,LOM,50-59,0,2,0,0,2,0,0,2,0,2,Lombardia,ITC4
2021-01-08,PF/BT,321000682,RSA CENTRO PADRE AMBROSOLI GIUSEPPE,LOM,60-69,1,1,0,1,1,0,0,2,0,2,Lombardia,ITC4
2021-01-08,PF/BT,321000682,RSA CENTRO PADRE AMBROSOLI GIUSEPPE,LOM,80-89,1,0,0,0,0,1,0,1,0,1,Lombardia,ITC4
2021-01-08,PF/BT,32170712,ambulatorio covid SESTO SAN GIOVANNI,LOM,20-29,7,15,0,20,2,0,0,22,0,22,Lombardia,ITC4
2021-01-08,PF/BT,32170712,ambulatorio covid SESTO SAN GIOVANNI,LOM,30-39,12,20,0,31,1,0,0,32,0,32,Lombardia,ITC4
2021-01-08,PF/BT,32170712,ambulatorio covid SESTO SAN GIOVANNI,LOM,40-49,14,45,0,53,6,0,0,59,0,59,Lombardia,ITC4
2021-01-08,PF/BT,32170712,ambulatorio covid SESTO SAN GIOVANNI,LOM,50-59,24,65,0,75,14,0,0,89,0,89,Lombardia,ITC4
2021-01-08,PF/BT,32170712,ambulatorio covid SESTO SAN GIOVANNI,LOM,60-69,15,17,0,30,2,0,0,32,0,32,Lombardia,ITC4
2021-01-08,PF/BT,322000728,RSA CAMELOT,LOM,20-29,1,1,0,2,0,0,0,2,0,2,Lombardia,ITC4
2021-01-08,PF/BT,322000728,RSA CAMELOT,LOM,30-39,0,1,0,1,0,0,0,1,0,1,Lombardia,ITC4
2021-01-08,PF/BT,322000728,RSA CAMELOT,LOM,40-49,1,8,0,8,1,0,0,9,0,9,Lombardia,ITC4
2021-01-08,PF/BT,322000728,RSA CAMELOT,LOM,50-59,1,4,0,4,1,0,0,5,0,5,Lombardia,ITC4
2021-01-08,PF/BT,322000728,RSA CAMELOT,LOM,60-69,1,4,0,4,1,0,0,5,0,5,Lombardia,ITC4
2021-01-08,PF/BT,322000728,RSA CAMELOT,LOM,70-79,2,0,0,2,0,0,0,2,0,2,Lombardia,ITC4
2021-01-08,PF/BT,322000844 - 322000712,Istituto La Provvidenza - UG1 /UG3,LOM,20-29,3,3,0,6,0,0,0,6,0,6,Lombardia,ITC4
2021-01-08,PF/BT,322000844 - 322000712,Istituto La Provvidenza - UG1 /UG3,LOM,30-39,1,7,0,8,0,0,0,8,0,8,Lombardia,ITC4
2021-01-08,PF/BT,322000844 - 322000712,Istituto La Provvidenza - UG1 /UG3,LOM,40-49,0,6,0,6,0,0,0,6,0,6,Lombardia,ITC4
2021-01-08,PF/BT,322000844 - 322000712,Istituto La Provvidenza - UG1 /UG3,LOM,50-59,0,3,0,3,0,0,0,3,0,3,Lombardia,ITC4
2021-01-08,PF/BT,322000844 - 322000712,Istituto La Provvidenza - UG1 /UG3,LOM,90+,1,0,0,1,0,0,0,1,0,1,Lombardia,ITC4
2021-01-08,PF/BT,32271022,ambulatorio covid Circolo,LOM,20-29,9,21,0,30,0,0,0,30,0,30,Lombardia,ITC4
2021-01-08,PF/BT,32271022,ambulatorio covid Circolo,LOM,30-39,14,26,0,40,0,0,0,40,0,40,Lombardia,ITC4
2021-01-08,PF/BT,32271022,ambulatorio covid Circolo,LOM,40-49,16,21,0,37,0,0,0,37,0,37,Lombardia,ITC4
2021-01-08,PF/BT,32271022,ambulatorio covid Circolo,LOM,50-59,14,48,0,62,0,0,0,62,0,62,Lombardia,ITC4
2021-01-08,PF/BT,32271022,ambulatorio covid Circolo,LOM,60-69,17,17,0,34,0,0,0,34,0,34,Lombardia,ITC4
2021-01-08,PF/BT,32271022,ambulatorio covid Circolo,LOM,70-79,8,4,0,12,0,0,0,12,0,12,Lombardia,ITC4
2021-01-08,PF/BT,32271022,ambulatorio covid Circolo,LOM,80-89,1,0,0,1,0,0,0,1,0,1,Lombardia,ITC4
2021-01-08,PF/BT,32271022,ambulatorio covid Luino,LOM,20-29,1,10,0,11,0,0,0,11,0,11,Lombardia,ITC4
2021-01-08,PF/BT,32271022,ambulatorio covid Luino,LOM,30-39,8,9,0,17,0,0,0,17,0,17,Lombardia,ITC4
2021-01-08,PF/BT,32271022,ambulatorio covid Luino,LOM,40-49,10,10,0,20,0,0,0,20,0,20,Lombardia,ITC4
2021-01-08,PF/BT,32271022,ambulatorio covid Luino,LOM,50-59,8,22,0,30,0,0,0,30,0,30,Lombardia,ITC4
2021-01-08,PF/BT,32271022,ambulatorio covid Luino,LOM,60-69,7,10,0,17,0,0,0,17,0,17,Lombardia,ITC4
2021-01-08,PF/BT,32271022,ambulatorio covid Luino,LOM,70-79,5,1,0,6,0,0,0,6,0,6,Lombardia,ITC4
2021-01-08,PF/BT,32271022,ambulatorio covid Luino,LOM,80-89,1,0,0,1,0,0,0,1,0,1,Lombardia,ITC4
2021-01-08,PF/BT,32271022,ambulatorio covid Tradate,LOM,20-29,8,5,0,13,0,0,0,13,0,13,Lombardia,ITC4
2021-01-08,PF/BT,32271022,ambulatorio covid Tradate,LOM,30-39,3,14,0,17,0,0,0,17,0,17,Lombardia,ITC4
2021-01-08,PF/BT,32271022,ambulatorio covid Tradate,LOM,40-49,6,11,0,17,0,0,0,17,0,17,Lombardia,ITC4
2021-01-08,PF/BT,32271022,ambulatorio covid Tradate,LOM,50-59,6,26,0,32,0,0,0,32,0,32,Lombardia,ITC4
2021-01-08,PF/BT,32271022,ambulatorio covid Tradate,LOM,60-69,10,10,0,20,0,0,0,20,0,20,Lombardia,ITC4
2021-01-08,PF/BT,32271022,ambulatorio covid Tradate,LOM,70-79,3,0,0,3,0,0,0,3,0,3,Lombardia,ITC4
2021-01-08,PF/BT,32271022,ambulatorio covid Varese,LOM,20-29,8,33,0,41,0,0,0,41,0,41,Lombardia,ITC4
2021-01-08,PF/BT,32271022,ambulatorio covid Varese,LOM,30-39,11,36,0,47,0,0,0,47,0,47,Lombardia,ITC4
2021-01-08,PF/BT,32271022,ambulatorio covid Varese,LOM,40-49,4,30,0,34,0,0,0,34,0,34,Lombardia,ITC4
2021-01-08,PF/BT,32271022,ambulatorio covid Varese,LOM,50-59,5,10,0,15,0,0,0,15,0,15,Lombardia,ITC4
2021-01-08,PF/BT,32271022,ambulatorio covid Varese,LOM,60-69,1,10,0,11,0,0,0,11,0,11,Lombardia,ITC4
2021-01-08,PF/BT,32271116,ambulatorio covid Gallarate,LOM,20-29,1,4,0,5,0,0,0,5,0,5,Lombardia,ITC4
2021-01-08,PF/BT,32271116,ambulatorio covid Gallarate,LOM,30-39,5,22,0,27,0,0,0,27,0,27,Lombardia,ITC4
2021-01-08,PF/BT,32271116,ambulatorio covid Gallarate,LOM,40-49,15,55,0,70,0,0,0,70,0,70,Lombardia,ITC4
2021-01-08,PF/BT,32271116,ambulatorio covid Gallarate,LOM,50-59,11,66,0,77,0,0,0,77,0,77,Lombardia,ITC4
2021-01-08,PF/BT,32271116,ambulatorio covid Gallarate,LOM,60-69,8,4,0,12,0,0,0,12,0,12,Lombardia,ITC4
2021-01-08,PF/BT,32271116,ambulatorio covid Gallarate,LOM,70-79,0,1,0,1,0,0,0,1,0,1,Lombardia,ITC4
2021-01-08,PF/BT,32271117,ambulatorio covid Saronno,LOM,20-29,1,1,0,2,0,0,0,2,0,2,Lombardia,ITC4
2021-01-08,PF/BT,32271117,ambulatorio covid Saronno,LOM,30-39,4,3,0,7,0,0,0,7,0,7,Lombardia,ITC4
2021-01-08,PF/BT,32271117,ambulatorio covid Saronno,LOM,40-49,8,15,0,23,0,0,0,23,0,23,Lombardia,ITC4
2021-01-08,PF/BT,32271117,ambulatorio covid Saronno,LOM,50-59,2,16,0,18,0,0,0,18,0,18,Lombardia,ITC4
2021-01-08,PF/BT,32271117,ambulatorio covid Saronno,LOM,60-69,2,2,0,4,0,0,0,4,0,4,Lombardia,ITC4
2021-01-08,PF/BT,32271118,ambulatorio covid Busto A.,LOM,20-29,4,7,0,11,0,0,0,11,0,11,Lombardia,ITC4
2021-01-08,PF/BT,32271118,ambulatorio covid Busto A.,LOM,30-39,9,19,0,28,0,0,0,28,0,28,Lombardia,ITC4
2021-01-08,PF/BT,32271118,ambulatorio covid Busto A.,LOM,40-49,8,41,0,49,0,0,0,49,0,49,Lombardia,ITC4
2021-01-08,PF/BT,32271118,ambulatorio covid Busto A.,LOM,50-59,8,57,0,65,0,0,0,65,0,65,Lombardia,ITC4
2021-01-08,PF/BT,32271118,ambulatorio covid Busto A.,LOM,60-69,3,5,0,8,0,0,0,8,0,8,Lombardia,ITC4
2021-01-08,PF/BT,325001342,CLINICHE GAVAZZENI SPA,LOM,20-29,0,18,0,18,0,0,0,18,0,18,Lombardia,ITC4
2021-01-08,PF/BT,325001342,CLINICHE GAVAZZENI SPA,LOM,30-39,5,7,0,12,0,0,0,12,0,12,Lombardia,ITC4
2021-01-08,PF/BT,325001342,CLINICHE GAVAZZENI SPA,LOM,40-49,6,12,0,18,0,0,0,18,0,18,Lombardia,ITC4
2021-01-08,PF/BT,325001342,CLINICHE GAVAZZENI SPA,LOM,50-59,4,7,0,11,0,0,0,11,0,11,Lombardia,ITC4
2021-01-08,PF/BT,32572021,AMBULATORIO COVID P.O. ALZANO,LOM,20-29,5,6,0,11,0,0,0,11,0,11,Lombardia,ITC4
2021-01-08,PF/BT,32572021,AMBULATORIO COVID P.O. ALZANO,LOM,30-39,7,5,0,12,0,0,0,12,0,12,Lombardia,ITC4
2021-01-08,PF/BT,32572021,AMBULATORIO COVID P.O. ALZANO,LOM,40-49,7,9,0,16,0,0,0,16,0,16,Lombardia,ITC4
2021-01-08,PF/BT,32572021,AMBULATORIO COVID P.O. ALZANO,LOM,50-59,9,13,0,22,0,0,0,22,0,22,Lombardia,ITC4
2021-01-08,PF/BT,32572021,AMBULATORIO COVID P.O. ALZANO,LOM,60-69,13,5,0,18,0,0,0,18,0,18,Lombardia,ITC4
2021-01-08,PF/BT,32572021,AMBULATORIO COVID P.O. ALZANO,LOM,70-79,3,2,0,5,0,0,0,5,0,5,Lombardia,ITC4
2021-01-08,PF/BT,32572027,Ambulatorio COVID SERIATE,LOM,20-29,1,10,0,10,1,0,0,11,0,11,Lombardia,ITC4
2021-01-08,PF/BT,32572027,Ambulatorio COVID SERIATE,LOM,30-39,3,21,0,24,0,0,0,24,0,24,Lombardia,ITC4
2021-01-08,PF/BT,32572027,Ambulatorio COVID SERIATE,LOM,40-49,8,35,0,39,4,0,0,43,0,43,Lombardia,ITC4
2021-01-08,PF/BT,32572027,Ambulatorio COVID SERIATE,LOM,50-59,13,38,0,47,1,0,3,51,0,51,Lombardia,ITC4
2021-01-08,PF/BT,32572027,Ambulatorio COVID SERIATE,LOM,60-69,10,10,0,18,0,0,2,20,0,20,Lombardia,ITC4
2021-01-08,PF/BT,32572027,Ambulatorio COVID SERIATE,LOM,70-79,1,0,0,1,0,0,0,1,0,1,Lombardia,ITC4
2021-01-08,PF/BT,32772401,cv casalmaggiore,LOM,20-29,6,5,0,11,0,0,0,11,0,11,Lombardia,ITC4
2021-01-08,PF/BT,32772401,cv casalmaggiore,LOM,30-39,11,8,0,19,0,0,0,19,0,19,Lombardia,ITC4
2021-01-08,PF/BT,32772401,cv casalmaggiore,LOM,40-49,5,20,0,24,1,0,0,25,0,25,Lombardia,ITC4
2021-01-08,PF/BT,32772401,cv casalmaggiore,LOM,50-59,15,60,0,69,5,0,1,75,0,75,Lombardia,ITC4
2021-01-08,PF/BT,32772401,cv casalmaggiore,LOM,60-69,6,7,0,12,0,0,1,13,0,13,Lombardia,ITC4
2021-01-08,PF/BT,32772401,cv casalmaggiore,LOM,70-79,0,1,0,1,0,0,0,1,0,1,Lombardia,ITC4
2021-01-08,PF/BT,32772407,CV COVID CREMONA,LOM,20-29,3,14,0,15,2,0,0,17,0,17,Lombardia,ITC4
2021-01-08,PF/BT,32772407,CV COVID CREMONA,LOM,30-39,15,21,0,34,1,0,1,36,0,36,Lombardia,ITC4
2021-01-08,PF/BT,32772407,CV COVID CREMONA,LOM,40-49,17,42,0,53,6,0,0,59,0,59,Lombardia,ITC4
2021-01-08,PF/BT,32772407,CV COVID CREMONA,LOM,50-59,20,59,0,66,12,0,1,79,0,79,Lombardia,ITC4
2021-01-08,PF/BT,32772407,CV COVID CREMONA,LOM,60-69,6,13,0,17,2,0,0,19,0,19,Lombardia,ITC4
2021-01-08,PF/BT,32772513,ASST DI MANTOVA - POMA,LOM,20-29,5,15,0,20,0,0,0,20,0,20,Lombardia,ITC4
2021-01-08,PF/BT,32772513,ASST DI MANTOVA - POMA,LOM,30-39,12,28,0,38,2,0,0,40,0,40,Lombardia,ITC4
2021-01-08,PF/BT,32772513,ASST DI MANTOVA - POMA,LOM,40-49,21,42,0,60,3,0,0,63,0,63,Lombardia,ITC4
2021-01-08,PF/BT,32772513,ASST DI MANTOVA - POMA,LOM,50-59,26,80,0,93,13,0,0,106,0,106,Lombardia,ITC4
2021-01-08,PF/BT,32772513,ASST DI MANTOVA - POMA,LOM,60-69,27,8,0,35,0,0,0,35,0,35,Lombardia,ITC4
2021-01-08,PF/BT,558,RSA PIO ALBERGO TRIVULZIO,LOM,20-29,5,6,0,8,3,0,0,11,0,11,Lombardia,ITC4
2021-01-08,PF/BT,558,RSA PIO ALBERGO TRIVULZIO,LOM,30-39,2,11,0,8,5,0,0,13,0,13,Lombardia,ITC4
2021-01-08,PF/BT,558,RSA PIO ALBERGO TRIVULZIO,LOM,40-49,10,16,0,15,11,0,0,26,0,26,Lombardia,ITC4
2021-01-08,PF/BT,558,RSA PIO ALBERGO TRIVULZIO,LOM,50-59,9,32,0,33,8,0,0,41,0,41,Lombardia,ITC4
2021-01-08,PF/BT,558,RSA PIO ALBERGO TRIVULZIO,LOM,60-69,6,11,0,11,6,0,0,17,0,17,Lombardia,ITC4
2021-01-08,PF/BT,924,RSA FONDAZIONE FRATELLI BONA ONLUS,LOM,20-29,0,4,0,3,1,0,0,4,0,4,Lombardia,ITC4
2021-01-08,PF/BT,924,RSA FONDAZIONE FRATELLI BONA ONLUS,LOM,30-39,0,2,0,2,0,0,0,2,0,2,Lombardia,ITC4
2021-01-08,PF/BT,924,RSA FONDAZIONE FRATELLI BONA ONLUS,LOM,40-49,0,7,0,5,1,1,0,7,0,7,Lombardia,ITC4
2021-01-08,PF/BT,924,RSA FONDAZIONE FRATELLI BONA ONLUS,LOM,50-59,0,6,0,4,1,1,0,6,0,6,Lombardia,ITC4
2021-01-08,PF/BT,924,RSA FONDAZIONE FRATELLI BONA ONLUS,LOM,60-69,2,2,0,2,0,2,0,4,0,4,Lombardia,ITC4
2021-01-08,PF/BT,924,RSA FONDAZIONE FRATELLI BONA ONLUS,LOM,70-79,5,6,0,0,0,10,1,11,0,11,Lombardia,ITC4
2021-01-08,PF/BT,924,RSA FONDAZIONE FRATELLI BONA ONLUS,LOM,80-89,4,16,0,0,0,20,0,20,0,20,Lombardia,ITC4
2021-01-08,PF/BT,924,RSA FONDAZIONE FRATELLI BONA ONLUS,LOM,90+,0,6,0,0,0,6,0,6,0,6,Lombardia,ITC4
2021-01-08,PF/BT,943,R.S.A. RESIDENZA ANGELO MAJ FONDAZIONE ONLUS,LOM,20-29,1,8,0,9,0,0,0,9,0,9,Lombardia,ITC4
2021-01-08,PF/BT,943,R.S.A. RESIDENZA ANGELO MAJ FONDAZIONE ONLUS,LOM,30-39,0,6,0,6,0,0,0,6,0,6,Lombardia,ITC4
2021-01-08,PF/BT,943,R.S.A. RESIDENZA ANGELO MAJ FONDAZIONE ONLUS,LOM,40-49,2,16,0,17,1,0,0,18,0,18,Lombardia,ITC4
2021-01-08,PF/BT,943,R.S.A. RESIDENZA ANGELO MAJ FONDAZIONE ONLUS,LOM,50-59,1,12,0,12,1,0,0,13,0,13,Lombardia,ITC4
2021-01-08,PF/BT,943,R.S.A. RESIDENZA ANGELO MAJ FONDAZIONE ONLUS,LOM,60-69,0,2,0,2,0,0,0,2,0,2,Lombardia,ITC4
2021-01-08,PF/BT,947,I.R.C.C.S. POLICLINICO SAN DONATO,LOM,20-29,18,8,0,23,3,0,0,26,0,26,Lombardia,ITC4
2021-01-08,PF/BT,947,I.R.C.C.S. POLICLINICO SAN DONATO,LOM,30-39,15,19,0,32,2,0,0,34,0,34,Lombardia,ITC4
2021-01-08,PF/BT,947,I.R.C.C.S. POLICLINICO SAN DONATO,LOM,40-49,15,30,0,40,5,0,0,45,0,45,Lombardia,ITC4
2021-01-08,PF/BT,947,I.R.C.C.S. POLICLINICO SAN DONATO,LOM,50-59,13,26,0,36,3,0,0,39,0,39,Lombardia,ITC4
2021-01-08,PF/BT,947,I.R.C.C.S. POLICLINICO SAN DONATO,LOM,60-69,3,8,0,11,0,0,0,11,0,11,Lombardia,ITC4
2021-01-08,PF/BT,947,I.R.C.C.S. POLICLINICO SAN DONATO,LOM,70-79,2,0,0,2,0,0,0,2,0,2,Lombardia,ITC4
2021-01-08,PF/BT,958,RSA VILLA W.A. MOZART,LOM,20-29,1,4,0,3,2,0,0,5,0,5,Lombardia,ITC4
2021-01-08,PF/BT,958,RSA VILLA W.A. MOZART,LOM,30-39,1,5,0,3,3,0,0,6,0,6,Lombardia,ITC4
2021-01-08,PF/BT,958,RSA VILLA W.A. MOZART,LOM,40-49,1,9,0,7,2,0,1,10,0,10,Lombardia,ITC4
2021-01-08,PF/BT,958,RSA VILLA W.A. MOZART,LOM,50-59,3,7,0,4,4,2,0,10,0,10,Lombardia,ITC4
2021-01-08,PF/BT,958,RSA VILLA W.A. MOZART,LOM,60-69,2,1,0,1,0,2,0,3,0,3,Lombardia,ITC4
2021-01-08,PF/BT,958,RSA VILLA W.A. MOZART,LOM,70-79,2,1,0,0,0,3,0,3,0,3,Lombardia,ITC4
2021-01-08,PF/BT,958,RSA VILLA W.A. MOZART,LOM,80-89,2,18,0,0,0,20,0,20,0,20,Lombardia,ITC4
2021-01-08,PF/BT,958,RSA VILLA W.A. MOZART,LOM,90+,1,8,0,0,0,9,0,9,0,9,Lombardia,ITC4
2021-01-08,PF/BT,CUDES 321000261,FONDAZIONE CASTELLINI ONLUS MELEGNANO,LOM,30-39,0,3,0,3,0,0,0,3,0,3,Lombardia,ITC4
2021-01-08,PF/BT,CUDES 321000261,FONDAZIONE CASTELLINI ONLUS MELEGNANO,LOM,40-49,1,3,0,4,0,0,0,4,0,4,Lombardia,ITC4
2021-01-08,PF/BT,CUDES 321000261,FONDAZIONE CASTELLINI ONLUS MELEGNANO,LOM,50-59,2,5,0,6,1,0,0,7,0,7,Lombardia,ITC4
2021-01-08,PF/BT,CUDES 321000261,FONDAZIONE CASTELLINI ONLUS MELEGNANO,LOM,60-69,0,3,0,3,0,0,0,3,0,3,Lombardia,ITC4
2021-01-08,PF/BT,CUDES 321000261,FONDAZIONE CASTELLINI ONLUS MELEGNANO,LOM,70-79,1,0,0,0,1,0,0,1,0,1,Lombardia,ITC4
2021-01-08,PF/BT,HSP11-11 bis,Policlinico San Pietro,LOM,20-29,2,6,0,4,4,0,0,8,0,8,Lombardia,ITC4
2021-01-08,PF/BT,HSP11-11 bis,Policlinico San Pietro,LOM,30-39,2,4,0,6,0,0,0,6,0,6,Lombardia,ITC4
2021-01-08,PF/BT,HSP11-11 bis,Policlinico San Pietro,LOM,40-49,1,5,0,5,1,0,0,6,0,6,Lombardia,ITC4
2021-01-08,PF/BT,HSP11-11 bis,Policlinico San Pietro,LOM,50-59,0,4,0,3,1,0,0,4,0,4,Lombardia,ITC4
2021-01-08,PF/BT,HSP11-11 bis,Policlinico San Pietro,LOM,60-69,0,4,0,4,0,0,0,4,0,4,Lombardia,ITC4
2021-01-08,PF/BT,HSP11-11 bis,Policlinico San Pietro,LOM,70-79,1,0,0,1,0,0,0,1,0,1,Lombardia,ITC4
2021-01-08,PF/BT,HSP11-11bis,32170223   HUB COVID SS PAOLO E CARLO - PVO Ospedale San Paolo32170223   HUB COVID SS PAOLO E CARLO - PVO Ospedale San Paolo32170223   HUB COVID SS PAOLO E CARLO - PVO Ospedale San Paolo,LOM,20-29,9,19,0,26,2,0,0,28,0,28,Lombardia,ITC4
2021-01-08,PF/BT,HSP11-11bis,32170223   HUB COVID SS PAOLO E CARLO - PVO Ospedale San Paolo32170223   HUB COVID SS PAOLO E CARLO - PVO Ospedale San Paolo32170223   HUB COVID SS PAOLO E CARLO - PVO Ospedale San Paolo,LOM,30-39,22,32,0,47,5,0,2,54,0,54,Lombardia,ITC4
2021-01-08,PF/BT,HSP11-11bis,32170223   HUB COVID SS PAOLO E CARLO - PVO Ospedale San Paolo32170223   HUB COVID SS PAOLO E CARLO - PVO Ospedale San Paolo32170223   HUB COVID SS PAOLO E CARLO - PVO Ospedale San Paolo,LOM,40-49,23,39,0,52,8,0,2,62,0,62,Lombardia,ITC4
2021-01-08,PF/BT,HSP11-11bis,32170223   HUB COVID SS PAOLO E CARLO - PVO Ospedale San Paolo32170223   HUB COVID SS PAOLO E CARLO - PVO Ospedale San Paolo32170223   HUB COVID SS PAOLO E CARLO - PVO Ospedale San Paolo,LOM,50-59,23,51,0,65,3,0,6,74,0,74,Lombardia,ITC4
2021-01-08,PF/BT,HSP11-11bis,32170223   HUB COVID SS PAOLO E CARLO - PVO Ospedale San Paolo32170223   HUB COVID SS PAOLO E CARLO - PVO Ospedale San Paolo32170223   HUB COVID SS PAOLO E CARLO - PVO Ospedale San Paolo,LOM,60-69,19,14,0,30,2,0,1,33,0,33,Lombardia,ITC4
2021-01-08,PF/BT,HSP11-11bis,32170224 HUB COVID OSP. SAN CARLO,LOM,16-19,1,0,0,0,1,0,0,1,0,1,Lombardia,ITC4
2021-01-08,PF/BT,HSP11-11bis,32170224 HUB COVID OSP. SAN CARLO,LOM,20-29,5,14,0,16,3,0,0,19,0,19,Lombardia,ITC4
2021-01-08,PF/BT,HSP11-11bis,32170224 HUB COVID OSP. SAN CARLO,LOM,30-39,13,31,0,42,2,0,0,44,0,44,Lombardia,ITC4
2021-01-08,PF/BT,HSP11-11bis,32170224 HUB COVID OSP. SAN CARLO,LOM,40-49,12,25,0,30,6,1,0,37,0,37,Lombardia,ITC4
2021-01-08,PF/BT,HSP11-11bis,32170224 HUB COVID OSP. SAN CARLO,LOM,50-59,19,86,0,86,19,0,0,105,0,105,Lombardia,ITC4
2021-01-08,PF/BT,HSP11-11bis,32170224 HUB COVID OSP. SAN CARLO,LOM,60-69,23,17,0,38,1,1,0,40,0,40,Lombardia,ITC4
2021-01-08,PF/BT,HSP11-11bis,32170224 HUB COVID OSP. SAN CARLO,LOM,70-79,0,1,0,1,0,0,0,1,0,1,Lombardia,ITC4
2021-01-08,PF/BT,HSP11-11bis,Ambulatorio COVID PO Casalpusterlengo,LOM,20-29,1,3,0,4,0,0,0,4,0,4,Lombardia,ITC4
2021-01-08,PF/BT,HSP11-11bis,Ambulatorio COVID PO Casalpusterlengo,LOM,30-39,2,1,0,3,0,0,0,3,0,3,Lombardia,ITC4
2021-01-08,PF/BT,HSP11-11bis,Ambulatorio COVID PO Casalpusterlengo,LOM,40-49,1,5,0,6,0,0,0,6,0,6,Lombardia,ITC4
2021-01-08,PF/BT,HSP11-11bis,Ambulatorio COVID PO Casalpusterlengo,LOM,50-59,7,12,0,12,7,0,0,19,0,19,Lombardia,ITC4
2021-01-08,PF/BT,HSP11-11bis,Ambulatorio COVID PO Casalpusterlengo,LOM,60-69,9,5,0,13,1,0,0,14,0,14,Lombardia,ITC4
2021-01-08,PF/BT,HSP11-11bis,Ambulatorio COVID PO Casalpusterlengo,LOM,70-79,4,2,0,6,0,0,0,6,0,6,Lombardia,ITC4
2021-01-08,PF/BT,HSP11-11bis,Ambulatorio COVID PO Codogno,LOM,20-29,2,8,0,8,2,0,0,10,0,10,Lombardia,ITC4
2021-01-08,PF/BT,HSP11-11bis,Ambulatorio COVID PO Codogno,LOM,30-39,7,16,0,20,3,0,0,23,0,23,Lombardia,ITC4
2021-01-08,PF/BT,HSP11-11bis,Ambulatorio COVID PO Codogno,LOM,40-49,2,21,0,18,5,0,0,23,0,23,Lombardia,ITC4
2021-01-08,PF/BT,HSP11-11bis,Ambulatorio COVID PO Codogno,LOM,50-59,10,32,0,32,10,0,0,42,0,42,Lombardia,ITC4
2021-01-08,PF/BT,HSP11-11bis,Ambulatorio COVID PO Codogno,LOM,60-69,6,8,0,13,1,0,0,14,0,14,Lombardia,ITC4
2021-01-08,PF/BT,HSP11-11bis,Ambulatorio COVID PO Codogno,LOM,70-79,3,1,0,3,1,0,0,4,0,4,Lombardia,ITC4
2021-01-08,PF/BT,HSP11-11bis,Ambulatorio COVID PO LODI,LOM,20-29,7,7,0,14,0,0,0,14,0,14,Lombardia,ITC4
2021-01-08,PF/BT,HSP11-11bis,Ambulatorio COVID PO LODI,LOM,30-39,7,20,0,26,1,0,0,27,0,27,Lombardia,ITC4
2021-01-08,PF/BT,HSP11-11bis,Ambulatorio COVID PO LODI,LOM,40-49,9,21,0,27,3,0,0,30,0,30,Lombardia,ITC4
2021-01-08,PF/BT,HSP11-11bis,Ambulatorio COVID PO LODI,LOM,50-59,11,39,0,44,6,0,0,50,0,50,Lombardia,ITC4
2021-01-08,PF/BT,HSP11-11bis,Ambulatorio COVID PO LODI,LOM,60-69,6,10,0,15,1,0,0,16,0,16,Lombardia,ITC4
2021-01-08,PF/BT,HSP11-11bis,Ambulatorio COVID PO LODI,LOM,70-79,1,0,0,1,0,0,0,1,0,1,Lombardia,ITC4
2021-01-08,PF/BT,HSP11-11bis,Ambulatorio COVID PO S.Angelo Lod.,LOM,16-19,0,1,0,1,0,0,0,1,0,1,Lombardia,ITC4
2021-01-08,PF/BT,HSP11-11bis,Ambulatorio COVID PO S.Angelo Lod.,LOM,20-29,1,1,0,1,1,0,0,2,0,2,Lombardia,ITC4
2021-01-08,PF/BT,HSP11-11bis,Ambulatorio COVID PO S.Angelo Lod.,LOM,30-39,5,7,0,11,1,0,0,12,0,12,Lombardia,ITC4
2021-01-08,PF/BT,HSP11-11bis,Ambulatorio COVID PO S.Angelo Lod.,LOM,40-49,3,3,0,5,1,0,0,6,0,6,Lombardia,ITC4
2021-01-08,PF/BT,HSP11-11bis,Ambulatorio COVID PO S.Angelo Lod.,LOM,50-59,1,5,0,5,1,0,0,6,0,6,Lombardia,ITC4
2021-01-08,PF/BT,HSP11-11bis,Ambulatorio COVID PO S.Angelo Lod.,LOM,60-69,5,2,0,6,1,0,0,7,0,7,Lombardia,ITC4
2021-01-08,PF/BT,HSP11-11bis,Ambulatorio COVID PO S.Angelo Lod.,LOM,70-79,1,0,0,1,0,0,0,1,0,1,Lombardia,ITC4
2021-01-08,PF/BT,HSP11-11bis,Ambulatorio COVID PO S.Angelo Lod.,LOM,80-89,1,0,0,1,0,0,0,1,0,1,Lombardia,ITC4
2021-01-08,PF/BT,HSP11-11bis,ASST BERGAMO OVEST - OSPEDALE ROMANO DI L.DIA,LOM,16-19,1,0,0,0,0,0,1,1,0,1,Lombardia,ITC4
2021-01-08,PF/BT,HSP11-11bis,ASST BERGAMO OVEST - OSPEDALE ROMANO DI L.DIA,LOM,20-29,2,7,0,3,0,0,6,9,0,9,Lombardia,ITC4
2021-01-08,PF/BT,HSP11-11bis,ASST BERGAMO OVEST - OSPEDALE ROMANO DI L.DIA,LOM,30-39,2,8,0,4,0,0,6,10,0,10,Lombardia,ITC4
2021-01-08,PF/BT,HSP11-11bis,ASST BERGAMO OVEST - OSPEDALE ROMANO DI L.DIA,LOM,40-49,5,14,0,11,2,0,6,19,0,19,Lombardia,ITC4
2021-01-08,PF/BT,HSP11-11bis,ASST BERGAMO OVEST - OSPEDALE ROMANO DI L.DIA,LOM,50-59,13,14,0,10,0,0,17,27,0,27,Lombardia,ITC4
2021-01-08,PF/BT,HSP11-11bis,ASST BERGAMO OVEST - OSPEDALE ROMANO DI L.DIA,LOM,60-69,12,9,0,2,1,0,18,21,0,21,Lombardia,ITC4
2021-01-08,PF/BT,HSP11-11bis,ASST BERGAMO OVEST - OSPEDALE ROMANO DI L.DIA,LOM,70-79,6,2,0,0,0,0,8,8,0,8,Lombardia,ITC4
2021-01-08,PF/BT,HSP11-11bis,ASST BERGAMO OVEST - OSPEDALE TREVIGLIO,LOM,20-29,0,10,0,9,1,0,0,10,0,10,Lombardia,ITC4
2021-01-08,PF/BT,HSP11-11bis,ASST BERGAMO OVEST - OSPEDALE TREVIGLIO,LOM,30-39,7,16,0,16,7,0,0,23,0,23,Lombardia,ITC4
2021-01-08,PF/BT,HSP11-11bis,ASST BERGAMO OVEST - OSPEDALE TREVIGLIO,LOM,40-49,9,17,0,20,5,0,1,26,0,26,Lombardia,ITC4
2021-01-08,PF/BT,HSP11-11bis,ASST BERGAMO OVEST - OSPEDALE TREVIGLIO,LOM,50-59,13,35,0,34,12,0,2,48,0,48,Lombardia,ITC4
2021-01-08,PF/BT,HSP11-11bis,ASST BERGAMO OVEST - OSPEDALE TREVIGLIO,LOM,60-69,4,3,0,6,1,0,0,7,0,7,Lombardia,ITC4
2021-01-08,PF/BT,HSP11-11bis,"Policlinico San Marco, Osio Sotto (BG)",LOM,20-29,1,5,0,6,0,0,0,6,0,6,Lombardia,ITC4
2021-01-08,PF/BT,HSP11-11bis,"Policlinico San Marco, Osio Sotto (BG)",LOM,30-39,6,4,0,10,0,0,0,10,0,10,Lombardia,ITC4
2021-01-08,PF/BT,HSP11-11bis,"Policlinico San Marco, Osio Sotto (BG)",LOM,40-49,6,8,0,14,0,0,0,14,0,14,Lombardia,ITC4
2021-01-08,PF/BT,HSP11-11bis,"Policlinico San Marco, Osio Sotto (BG)",LOM,50-59,3,6,0,9,0,0,0,9,0,9,Lombardia,ITC4
2021-01-08,PF/BT,HSP11-11bis,"Policlinico San Marco, Osio Sotto (BG)",LOM,60-69,2,1,0,3,0,0,0,3,0,3,Lombardia,ITC4
2021-01-08,PF/BT,HSP11-11bis - 703,AMBULATORIO OSPEDALE SACCO,LOM,20-29,30,49,0,79,0,0,0,79,0,79,Lombardia,ITC4
2021-01-08,PF/BT,HSP11-11bis - 703,AMBULATORIO OSPEDALE SACCO,LOM,30-39,19,55,0,74,0,0,0,74,0,74,Lombardia,ITC4
2021-01-08,PF/BT,HSP11-11bis - 703,AMBULATORIO OSPEDALE SACCO,LOM,40-49,21,70,0,91,0,0,0,91,0,91,Lombardia,ITC4
2021-01-08,PF/BT,HSP11-11bis - 703,AMBULATORIO OSPEDALE SACCO,LOM,50-59,30,57,0,84,3,0,0,87,0,87,Lombardia,ITC4
2021-01-08,PF/BT,HSP11-11bis - 703,AMBULATORIO OSPEDALE SACCO,LOM,60-69,20,20,0,38,2,0,0,40,0,40,Lombardia,ITC4
2021-01-08,PF/BT,HSP11-11bis - 703,AMBULATORIO OSPEDALE SACCO,LOM,80-89,1,0,0,0,1,0,0,1,0,1,Lombardia,ITC4
2021-01-08,PF/BT,HSP11-11BIS-03010600,CASA DI CURA POLICLINICO DI MONZA-MONZA-,LOM,20-29,4,7,0,10,1,0,0,11,0,11,Lombardia,ITC4
2021-01-08,PF/BT,HSP11-11BIS-03010600,CASA DI CURA POLICLINICO DI MONZA-MONZA-,LOM,30-39,10,12,0,19,3,0,0,22,0,22,Lombardia,ITC4
2021-01-08,PF/BT,HSP11-11BIS-03010600,CASA DI CURA POLICLINICO DI MONZA-MONZA-,LOM,40-49,17,36,0,44,9,0,0,53,0,53,Lombardia,ITC4
2021-01-08,PF/BT,HSP11-11BIS-03010600,CASA DI CURA POLICLINICO DI MONZA-MONZA-,LOM,50-59,16,24,0,30,9,0,1,40,0,40,Lombardia,ITC4
2021-01-08,PF/BT,HSP11-11BIS-03010600,CASA DI CURA POLICLINICO DI MONZA-MONZA-,LOM,60-69,9,5,0,12,2,0,0,14,0,14,Lombardia,ITC4
2021-01-08,PF/BT,HSP11-11BIS-03010600,CASA DI CURA POLICLINICO DI MONZA-MONZA-,LOM,70-79,2,0,0,2,0,0,0,2,0,2,Lombardia,ITC4
2021-01-08,PF/BT,HSP11-11BIS-03010600,CASA DI CURA POLICLINICO DI MONZA-MONZA-,LOM,80-89,2,0,0,2,0,0,0,2,0,2,Lombardia,ITC4
2021-01-09,PF/BT,(03027500/001752),PVO Istituto Clinico San Rocco (Spoke),LOM,20-29,0,5,0,4,0,0,1,5,0,5,Lombardia,ITC4
2021-01-09,PF/BT,(03027500/001752),PVO Istituto Clinico San Rocco (Spoke),LOM,30-39,2,10,0,11,1,0,0,12,0,12,Lombardia,ITC4
2021-01-09,PF/BT,(03027500/001752),PVO Istituto Clinico San Rocco (Spoke),LOM,40-49,4,18,0,18,4,0,0,22,0,22,Lombardia,ITC4
2021-01-09,PF/BT,(03027500/001752),PVO Istituto Clinico San Rocco (Spoke),LOM,50-59,2,8,0,8,2,0,0,10,0,10,Lombardia,ITC4
2021-01-09,PF/BT,(03027500/001752),PVO Istituto Clinico San Rocco (Spoke),LOM,60-69,6,3,0,9,0,0,0,9,0,9,Lombardia,ITC4
2021-01-09,PF/BT,(03027500/001752),PVO Istituto Clinico San Rocco (Spoke),LOM,70-79,2,0,0,2,0,0,0,2,0,2,Lombardia,ITC4
2021-01-09,PF/BT,****,AMBULATORIO COVID P.O. ALZANO L.DO,LOM,20-29,6,16,0,22,0,0,0,22,0,22,Lombardia,ITC4
2021-01-09,PF/BT,****,AMBULATORIO COVID P.O. ALZANO L.DO,LOM,30-39,7,5,0,12,0,0,0,12,0,12,Lombardia,ITC4
2021-01-09,PF/BT,****,AMBULATORIO COVID P.O. ALZANO L.DO,LOM,40-49,8,9,0,17,0,0,0,17,0,17,Lombardia,ITC4
2021-01-09,PF/BT,****,AMBULATORIO COVID P.O. ALZANO L.DO,LOM,50-59,8,8,0,16,0,0,0,16,0,16,Lombardia,ITC4
2021-01-09,PF/BT,****,AMBULATORIO COVID P.O. ALZANO L.DO,LOM,60-69,10,4,0,14,0,0,0,14,0,14,Lombardia,ITC4
2021-01-09,PF/BT,****,AMBULATORIO COVID P.O. ALZANO L.DO,LOM,70-79,2,1,0,3,0,0,0,3,0,3,Lombardia,ITC4
2021-01-09,PF/BT,.030042,ASST VALTELLINA ALTO LARIO - PRESIDIO OSPEDALIERO DI SONDRIO,LOM,20-29,1,7,0,8,0,0,0,8,0,8,Lombardia,ITC4
2021-01-09,PF/BT,.030042,ASST VALTELLINA ALTO LARIO - PRESIDIO OSPEDALIERO DI SONDRIO,LOM,30-39,9,5,0,12,2,0,0,14,0,14,Lombardia,ITC4
2021-01-09,PF/BT,.030042,ASST VALTELLINA ALTO LARIO - PRESIDIO OSPEDALIERO DI SONDRIO,LOM,40-49,1,18,0,19,0,0,0,19,0,19,Lombardia,ITC4
2021-01-09,PF/BT,.030042,ASST VALTELLINA ALTO LARIO - PRESIDIO OSPEDALIERO DI SONDRIO,LOM,50-59,16,30,0,34,12,0,0,46,0,46,Lombardia,ITC4
2021-01-09,PF/BT,.030042,ASST VALTELLINA ALTO LARIO - PRESIDIO OSPEDALIERO DI SONDRIO,LOM,60-69,14,13,0,22,5,0,0,27,0,27,Lombardia,ITC4
2021-01-09,PF/BT,0,Istituto Redaelli Milano,LOM,20-29,4,6,0,10,0,0,0,10,0,10,Lombardia,ITC4
2021-01-09,PF/BT,0,Istituto Redaelli Milano,LOM,30-39,4,0,0,4,0,0,0,4,0,4,Lombardia,ITC4
2021-01-09,PF/BT,0,Istituto Redaelli Milano,LOM,40-49,3,12,0,15,0,0,0,15,0,15,Lombardia,ITC4
2021-01-09,PF/BT,0,Istituto Redaelli Milano,LOM,50-59,5,16,0,21,0,0,0,21,0,21,Lombardia,ITC4
2021-01-09,PF/BT,0,Istituto Redaelli Milano,LOM,60-69,1,3,0,4,0,0,0,4,0,4,Lombardia,ITC4
2021-01-09,PF/BT,000293,IRCCS MultiMedica,LOM,16-19,2,0,0,1,1,0,0,2,0,2,Lombardia,ITC4
2021-01-09,PF/BT,000293,IRCCS MultiMedica,LOM,20-29,32,45,0,76,1,0,0,77,0,77,Lombardia,ITC4
2021-01-09,PF/BT,000293,IRCCS MultiMedica,LOM,30-39,63,81,0,144,0,0,0,144,0,144,Lombardia,ITC4
2021-01-09,PF/BT,000293,IRCCS MultiMedica,LOM,40-49,79,155,0,220,14,0,0,234,0,234,Lombardia,ITC4
2021-01-09,PF/BT,000293,IRCCS MultiMedica,LOM,50-59,56,129,0,164,21,0,0,185,0,185,Lombardia,ITC4
2021-01-09,PF/BT,000293,IRCCS MultiMedica,LOM,60-69,36,31,0,64,3,0,0,67,0,67,Lombardia,ITC4
2021-01-09,PF/BT,000293,IRCCS MultiMedica,LOM,70-79,14,3,0,17,0,0,0,17,0,17,Lombardia,ITC4
2021-01-09,PF/BT,001153,SPOKE RSA CASA FAMIGLIA SAN GIUSEPPE - HUB ASST BRIANZA,LOM,50-59,1,0,0,0,0,1,0,1,0,1,Lombardia,ITC4
2021-01-09,PF/BT,001153,SPOKE RSA CASA FAMIGLIA SAN GIUSEPPE - HUB ASST BRIANZA,LOM,70-79,1,4,0,0,0,5,0,5,0,5,Lombardia,ITC4
2021-01-09,PF/BT,001153,SPOKE RSA CASA FAMIGLIA SAN GIUSEPPE - HUB ASST BRIANZA,LOM,80-89,3,31,0,0,0,34,0,34,0,34,Lombardia,ITC4
2021-01-09,PF/BT,001153,SPOKE RSA CASA FAMIGLIA SAN GIUSEPPE - HUB ASST BRIANZA,LOM,90+,4,20,0,0,0,24,0,24,0,24,Lombardia,ITC4
2021-01-09,PF/BT,002987,POLIAMBULATORIO OSPEDALE ESINE,LOM,16-19,1,2,0,0,3,0,0,3,0,3,Lombardia,ITC4
2021-01-09,PF/BT,002987,POLIAMBULATORIO OSPEDALE ESINE,LOM,20-29,12,20,0,9,23,0,0,32,0,32,Lombardia,ITC4
2021-01-09,PF/BT,002987,POLIAMBULATORIO OSPEDALE ESINE,LOM,30-39,22,39,0,23,38,0,0,61,0,61,Lombardia,ITC4
2021-01-09,PF/BT,002987,POLIAMBULATORIO OSPEDALE ESINE,LOM,40-49,24,39,0,22,41,0,0,63,0,63,Lombardia,ITC4
2021-01-09,PF/BT,002987,POLIAMBULATORIO OSPEDALE ESINE,LOM,50-59,26,33,0,17,42,0,0,59,0,59,Lombardia,ITC4
2021-01-09,PF/BT,002987,POLIAMBULATORIO OSPEDALE ESINE,LOM,60-69,52,16,0,29,39,0,0,68,0,68,Lombardia,ITC4
2021-01-09,PF/BT,002987,POLIAMBULATORIO OSPEDALE ESINE,LOM,70-79,12,1,0,3,10,0,0,13,0,13,Lombardia,ITC4
2021-01-09,PF/BT,002987,POLIAMBULATORIO OSPEDALE ESINE,LOM,80-89,0,1,0,0,1,0,0,1,0,1,Lombardia,ITC4
2021-01-09,PF/BT,003328,HUB COV CHIARI - P.O. ISEO -  ASST FRANCIACORTA,LOM,20-29,5,6,0,11,0,0,0,11,0,11,Lombardia,ITC4
2021-01-09,PF/BT,003328,HUB COV CHIARI - P.O. ISEO -  ASST FRANCIACORTA,LOM,30-39,7,19,0,26,0,0,0,26,0,26,Lombardia,ITC4
2021-01-09,PF/BT,003328,HUB COV CHIARI - P.O. ISEO -  ASST FRANCIACORTA,LOM,40-49,9,12,0,21,0,0,0,21,0,21,Lombardia,ITC4
2021-01-09,PF/BT,003328,HUB COV CHIARI - P.O. ISEO -  ASST FRANCIACORTA,LOM,50-59,14,28,0,42,0,0,0,42,0,42,Lombardia,ITC4
2021-01-09,PF/BT,003328,HUB COV CHIARI - P.O. ISEO -  ASST FRANCIACORTA,LOM,60-69,29,15,0,43,1,0,0,44,0,44,Lombardia,ITC4
2021-01-09,PF/BT,030066,CV Garbagnate,LOM,20-29,8,8,0,14,2,0,0,16,0,16,Lombardia,ITC4
2021-01-09,PF/BT,030066,CV Garbagnate,LOM,30-39,7,15,0,20,2,0,0,22,0,22,Lombardia,ITC4
2021-01-09,PF/BT,030066,CV Garbagnate,LOM,40-49,5,37,0,41,1,0,0,42,0,42,Lombardia,ITC4
2021-01-09,PF/BT,030066,CV Garbagnate,LOM,50-59,19,77,0,80,16,0,0,96,0,96,Lombardia,ITC4
2021-01-09,PF/BT,030066,CV Garbagnate,LOM,60-69,10,30,0,32,8,0,0,40,0,40,Lombardia,ITC4
2021-01-09,PF/BT,030068,PUNTO VACCINALE OSPEDALIERO DESIO,LOM,16-19,0,4,0,4,0,0,0,4,0,4,Lombardia,ITC4
2021-01-09,PF/BT,030068,PUNTO VACCINALE OSPEDALIERO DESIO,LOM,20-29,16,23,0,39,0,0,0,39,0,39,Lombardia,ITC4
2021-01-09,PF/BT,030068,PUNTO VACCINALE OSPEDALIERO DESIO,LOM,30-39,21,19,0,38,1,0,1,40,0,40,Lombardia,ITC4
2021-01-09,PF/BT,030068,PUNTO VACCINALE OSPEDALIERO DESIO,LOM,40-49,22,28,0,45,5,0,0,50,0,50,Lombardia,ITC4
2021-01-09,PF/BT,030068,PUNTO VACCINALE OSPEDALIERO DESIO,LOM,50-59,23,43,0,57,8,0,1,66,0,66,Lombardia,ITC4
2021-01-09,PF/BT,030068,PUNTO VACCINALE OSPEDALIERO DESIO,LOM,60-69,26,11,0,36,1,0,0,37,0,37,Lombardia,ITC4
2021-01-09,PF/BT,030068,PUNTO VACCINALE OSPEDALIERO DESIO,LOM,70-79,3,0,0,3,0,0,0,3,0,3,Lombardia,ITC4
2021-01-09,PF/BT,030070,PUNTO VACCINALE OSPEDALIERO CARATE BRIANZA,LOM,20-29,9,14,0,23,0,0,0,23,0,23,Lombardia,ITC4
2021-01-09,PF/BT,030070,PUNTO VACCINALE OSPEDALIERO CARATE BRIANZA,LOM,30-39,22,12,0,33,1,0,0,34,0,34,Lombardia,ITC4
2021-01-09,PF/BT,030070,PUNTO VACCINALE OSPEDALIERO CARATE BRIANZA,LOM,40-49,17,16,0,30,3,0,0,33,0,33,Lombardia,ITC4
2021-01-09,PF/BT,030070,PUNTO VACCINALE OSPEDALIERO CARATE BRIANZA,LOM,50-59,18,23,0,32,9,0,0,41,0,41,Lombardia,ITC4
2021-01-09,PF/BT,030070,PUNTO VACCINALE OSPEDALIERO CARATE BRIANZA,LOM,60-69,16,6,0,21,1,0,0,22,0,22,Lombardia,ITC4
2021-01-09,PF/BT,030070,PUNTO VACCINALE OSPEDALIERO CARATE BRIANZA,LOM,70-79,5,0,0,5,0,0,0,5,0,5,Lombardia,ITC4
2021-01-09,PF/BT,030078,PUNTO VACCINALE OSPEDALIERO VIMERCATE,LOM,16-19,1,1,0,2,0,0,0,2,0,2,Lombardia,ITC4
2021-01-09,PF/BT,030078,PUNTO VACCINALE OSPEDALIERO VIMERCATE,LOM,20-29,16,22,0,35,2,0,1,38,0,38,Lombardia,ITC4
2021-01-09,PF/BT,030078,PUNTO VACCINALE OSPEDALIERO VIMERCATE,LOM,30-39,18,29,0,36,10,0,1,47,0,47,Lombardia,ITC4
2021-01-09,PF/BT,030078,PUNTO VACCINALE OSPEDALIERO VIMERCATE,LOM,40-49,22,27,0,33,11,0,5,49,0,49,Lombardia,ITC4
2021-01-09,PF/BT,030078,PUNTO VACCINALE OSPEDALIERO VIMERCATE,LOM,50-59,17,36,0,40,12,0,1,53,0,53,Lombardia,ITC4
2021-01-09,PF/BT,030078,PUNTO VACCINALE OSPEDALIERO VIMERCATE,LOM,60-69,17,20,0,35,2,0,0,37,0,37,Lombardia,ITC4
2021-01-09,PF/BT,030078,PUNTO VACCINALE OSPEDALIERO VIMERCATE,LOM,70-79,2,0,0,2,0,0,0,2,0,2,Lombardia,ITC4
2021-01-09,PF/BT,030078,PUNTO VACCINALE OSPEDALIERO VIMERCATE,LOM,80-89,1,0,0,1,0,0,0,1,0,1,Lombardia,ITC4
2021-01-09,PF/BT,030107,ISTITUTI CLINICI ZUCCHI - PRESIDIO DI MONZA,LOM,20-29,4,7,0,11,0,0,0,11,0,11,Lombardia,ITC4
2021-01-09,PF/BT,030107,ISTITUTI CLINICI ZUCCHI - PRESIDIO DI MONZA,LOM,30-39,5,13,0,18,0,0,0,18,0,18,Lombardia,ITC4
2021-01-09,PF/BT,030107,ISTITUTI CLINICI ZUCCHI - PRESIDIO DI MONZA,LOM,40-49,10,15,0,25,0,0,0,25,0,25,Lombardia,ITC4
2021-01-09,PF/BT,030107,ISTITUTI CLINICI ZUCCHI - PRESIDIO DI MONZA,LOM,50-59,11,20,0,31,0,0,0,31,0,31,Lombardia,ITC4
2021-01-09,PF/BT,030107,ISTITUTI CLINICI ZUCCHI - PRESIDIO DI MONZA,LOM,60-69,13,7,0,20,0,0,0,20,0,20,Lombardia,ITC4
2021-01-09,PF/BT,030107,ISTITUTI CLINICI ZUCCHI - PRESIDIO DI MONZA,LOM,70-79,2,1,0,3,0,0,0,3,0,3,Lombardia,ITC4
2021-01-09,PF/BT,030108,ISTITUTI CLINICI ZUCCHI - PRESIDIO DI CARATE BRIANZA,LOM,20-29,1,2,0,3,0,0,0,3,0,3,Lombardia,ITC4
2021-01-09,PF/BT,030108,ISTITUTI CLINICI ZUCCHI - PRESIDIO DI CARATE BRIANZA,LOM,30-39,1,2,0,3,0,0,0,3,0,3,Lombardia,ITC4
2021-01-09,PF/BT,030108,ISTITUTI CLINICI ZUCCHI - PRESIDIO DI CARATE BRIANZA,LOM,40-49,2,2,0,4,0,0,0,4,0,4,Lombardia,ITC4
2021-01-09,PF/BT,030108,ISTITUTI CLINICI ZUCCHI - PRESIDIO DI CARATE BRIANZA,LOM,50-59,2,5,0,7,0,0,0,7,0,7,Lombardia,ITC4
2021-01-09,PF/BT,030108,ISTITUTI CLINICI ZUCCHI - PRESIDIO DI CARATE BRIANZA,LOM,60-69,0,1,0,1,0,0,0,1,0,1,Lombardia,ITC4
2021-01-09,PF/BT,030176,ISTITUTO CLINICO S. ANNA di ISTITUTI OSPEDALIERI BRESCIANI S.p.A,LOM,20-29,3,4,0,6,1,0,0,7,0,7,Lombardia,ITC4
2021-01-09,PF/BT,030176,ISTITUTO CLINICO S. ANNA di ISTITUTI OSPEDALIERI BRESCIANI S.p.A,LOM,30-39,3,12,0,14,1,0,0,15,0,15,Lombardia,ITC4
2021-01-09,PF/BT,030176,ISTITUTO CLINICO S. ANNA di ISTITUTI OSPEDALIERI BRESCIANI S.p.A,LOM,40-49,2,17,0,16,3,0,0,19,0,19,Lombardia,ITC4
2021-01-09,PF/BT,030176,ISTITUTO CLINICO S. ANNA di ISTITUTI OSPEDALIERI BRESCIANI S.p.A,LOM,50-59,7,11,0,10,8,0,0,18,0,18,Lombardia,ITC4
2021-01-09,PF/BT,030176,ISTITUTO CLINICO S. ANNA di ISTITUTI OSPEDALIERI BRESCIANI S.p.A,LOM,60-69,0,1,0,1,0,0,0,1,0,1,Lombardia,ITC4
2021-01-09,PF/BT,030178,ISTITUTO CLINICO CITTA' DI BRESCIA DI ISTITUTI OSPEDALIERI BRESCIANI,LOM,20-29,3,5,0,8,0,0,0,8,0,8,Lombardia,ITC4
2021-01-09,PF/BT,030178,ISTITUTO CLINICO CITTA' DI BRESCIA DI ISTITUTI OSPEDALIERI BRESCIANI,LOM,30-39,3,5,0,8,0,0,0,8,0,8,Lombardia,ITC4
2021-01-09,PF/BT,030178,ISTITUTO CLINICO CITTA' DI BRESCIA DI ISTITUTI OSPEDALIERI BRESCIANI,LOM,40-49,7,9,0,16,0,0,0,16,0,16,Lombardia,ITC4
2021-01-09,PF/BT,030178,ISTITUTO CLINICO CITTA' DI BRESCIA DI ISTITUTI OSPEDALIERI BRESCIANI,LOM,50-59,5,9,0,13,1,0,0,14,0,14,Lombardia,ITC4
2021-01-09,PF/BT,030178,ISTITUTO CLINICO CITTA' DI BRESCIA DI ISTITUTI OSPEDALIERI BRESCIANI,LOM,60-69,6,2,0,8,0,0,0,8,0,8,Lombardia,ITC4
2021-01-09,PF/BT,030295,Fondazione Poliambulanza - Brescia,LOM,20-29,6,14,0,20,0,0,0,20,0,20,Lombardia,ITC4
2021-01-09,PF/BT,030295,Fondazione Poliambulanza - Brescia,LOM,30-39,10,26,0,34,2,0,0,36,0,36,Lombardia,ITC4
2021-01-09,PF/BT,030295,Fondazione Poliambulanza - Brescia,LOM,40-49,13,38,0,49,2,0,0,51,0,51,Lombardia,ITC4
2021-01-09,PF/BT,030295,Fondazione Poliambulanza - Brescia,LOM,50-59,7,28,0,35,0,0,0,35,0,35,Lombardia,ITC4
2021-01-09,PF/BT,030295,Fondazione Poliambulanza - Brescia,LOM,60-69,2,5,0,7,0,0,0,7,0,7,Lombardia,ITC4
2021-01-09,PF/BT,030295,Fondazione Poliambulanza - Brescia,LOM,70-79,0,1,0,1,0,0,0,1,0,1,Lombardia,ITC4
2021-01-09,PF/BT,030324001093 -  030324001116,ISTIT.RIUNITI AIROLDI E MUZZI,LOM,20-29,0,5,0,4,1,0,0,5,0,5,Lombardia,ITC4
2021-01-09,PF/BT,030324001093 -  030324001116,ISTIT.RIUNITI AIROLDI E MUZZI,LOM,30-39,0,3,0,3,0,0,0,3,0,3,Lombardia,ITC4
2021-01-09,PF/BT,030324001093 -  030324001116,ISTIT.RIUNITI AIROLDI E MUZZI,LOM,40-49,4,11,0,13,2,0,0,15,0,15,Lombardia,ITC4
2021-01-09,PF/BT,030324001093 -  030324001116,ISTIT.RIUNITI AIROLDI E MUZZI,LOM,50-59,1,15,0,15,1,0,0,16,0,16,Lombardia,ITC4
2021-01-09,PF/BT,030324001093 -  030324001116,ISTIT.RIUNITI AIROLDI E MUZZI,LOM,60-69,1,7,0,5,3,0,0,8,0,8,Lombardia,ITC4
2021-01-09,PF/BT,030324001093 -  030324001116,ISTIT.RIUNITI AIROLDI E MUZZI,LOM,70-79,1,0,0,1,0,0,0,1,0,1,Lombardia,ITC4
2021-01-09,PF/BT,030704,Presidio Ospedaliero G. Pini,LOM,20-29,3,5,0,8,0,0,0,8,0,8,Lombardia,ITC4
2021-01-09,PF/BT,030704,Presidio Ospedaliero G. Pini,LOM,30-39,5,6,0,7,4,0,0,11,0,11,Lombardia,ITC4
2021-01-09,PF/BT,030704,Presidio Ospedaliero G. Pini,LOM,40-49,2,13,0,7,8,0,0,15,0,15,Lombardia,ITC4
2021-01-09,PF/BT,030704,Presidio Ospedaliero G. Pini,LOM,50-59,7,7,0,10,4,0,0,14,0,14,Lombardia,ITC4
2021-01-09,PF/BT,030704,Presidio Ospedaliero G. Pini,LOM,60-69,2,4,0,6,0,0,0,6,0,6,Lombardia,ITC4
2021-01-09,PF/BT,030903,AMB COVID LECCO,LOM,16-19,3,15,0,0,18,0,0,18,0,18,Lombardia,ITC4
2021-01-09,PF/BT,030903,AMB COVID LECCO,LOM,20-29,32,73,0,25,80,0,0,105,0,105,Lombardia,ITC4
2021-01-09,PF/BT,030903,AMB COVID LECCO,LOM,30-39,20,36,0,34,22,0,0,56,0,56,Lombardia,ITC4
2021-01-09,PF/BT,030903,AMB COVID LECCO,LOM,40-49,19,52,0,50,21,0,0,71,0,71,Lombardia,ITC4
2021-01-09,PF/BT,030903,AMB COVID LECCO,LOM,50-59,26,69,0,71,24,0,0,95,0,95,Lombardia,ITC4
2021-01-09,PF/BT,030903,AMB COVID LECCO,LOM,60-69,31,27,0,39,19,0,0,58,0,58,Lombardia,ITC4
2021-01-09,PF/BT,030903,AMB COVID LECCO,LOM,70-79,2,2,0,1,3,0,0,4,0,4,Lombardia,ITC4
2021-01-09,PF/BT,030922,"FOND.IRCCS ""ISTIT.NAZ.LE TUMORI""MILANO",LOM,20-29,5,17,0,17,5,0,0,22,0,22,Lombardia,ITC4
2021-01-09,PF/BT,030922,"FOND.IRCCS ""ISTIT.NAZ.LE TUMORI""MILANO",LOM,30-39,18,36,0,24,30,0,0,54,0,54,Lombardia,ITC4
2021-01-09,PF/BT,030922,"FOND.IRCCS ""ISTIT.NAZ.LE TUMORI""MILANO",LOM,40-49,18,27,0,18,27,0,0,45,0,45,Lombardia,ITC4
2021-01-09,PF/BT,030922,"FOND.IRCCS ""ISTIT.NAZ.LE TUMORI""MILANO",LOM,50-59,8,31,0,17,22,0,0,39,0,39,Lombardia,ITC4
2021-01-09,PF/BT,030922,"FOND.IRCCS ""ISTIT.NAZ.LE TUMORI""MILANO",LOM,60-69,4,15,0,15,4,0,0,19,0,19,Lombardia,ITC4
2021-01-09,PF/BT,030922,"FOND.IRCCS ""ISTIT.NAZ.LE TUMORI""MILANO",LOM,70-79,0,1,0,1,0,0,0,1,0,1,Lombardia,ITC4
2021-01-09,PF/BT,030923,FOND.IRCCS IST.NAZ.NEUROLOGICO C.BESTA-M,LOM,20-29,3,8,0,6,2,0,3,11,0,11,Lombardia,ITC4
2021-01-09,PF/BT,030923,FOND.IRCCS IST.NAZ.NEUROLOGICO C.BESTA-M,LOM,30-39,11,24,0,21,6,0,8,35,0,35,Lombardia,ITC4
2021-01-09,PF/BT,030923,FOND.IRCCS IST.NAZ.NEUROLOGICO C.BESTA-M,LOM,40-49,10,15,0,8,1,0,16,25,0,25,Lombardia,ITC4
2021-01-09,PF/BT,030923,FOND.IRCCS IST.NAZ.NEUROLOGICO C.BESTA-M,LOM,50-59,10,15,0,8,2,0,15,25,0,25,Lombardia,ITC4
2021-01-09,PF/BT,030923,FOND.IRCCS IST.NAZ.NEUROLOGICO C.BESTA-M,LOM,60-69,2,7,0,2,0,0,7,9,0,9,Lombardia,ITC4
2021-01-09,PF/BT,030923,FOND.IRCCS IST.NAZ.NEUROLOGICO C.BESTA-M,LOM,70-79,1,0,0,0,0,0,1,1,0,1,Lombardia,ITC4
2021-01-09,PF/BT,030923,FOND.IRCCS IST.NAZ.NEUROLOGICO C.BESTA-M,LOM,80-89,1,1,0,0,0,0,2,2,0,2,Lombardia,ITC4
2021-01-09,PF/BT,030924,IRCCS POLICLINICO S. MATTEO - PAVIA,LOM,20-29,16,37,0,53,0,0,0,53,0,53,Lombardia,ITC4
2021-01-09,PF/BT,030924,IRCCS POLICLINICO S. MATTEO - PAVIA,LOM,30-39,26,47,0,73,0,0,0,73,0,73,Lombardia,ITC4
2021-01-09,PF/BT,030924,IRCCS POLICLINICO S. MATTEO - PAVIA,LOM,40-49,13,41,0,48,6,0,0,54,0,54,Lombardia,ITC4
2021-01-09,PF/BT,030924,IRCCS POLICLINICO S. MATTEO - PAVIA,LOM,50-59,26,54,0,61,16,0,3,80,0,80,Lombardia,ITC4
2021-01-09,PF/BT,030924,IRCCS POLICLINICO S. MATTEO - PAVIA,LOM,60-69,17,28,0,33,12,0,0,45,0,45,Lombardia,ITC4
2021-01-09,PF/BT,030924,IRCCS POLICLINICO S. MATTEO - PAVIA,LOM,70-79,1,0,0,0,0,0,1,1,0,1,Lombardia,ITC4
2021-01-09,PF/BT,030925,Fondazione IRCCS Ca' Granda Ospedale Maggiore Policlinico,LOM,20-29,26,54,0,77,3,0,0,80,0,80,Lombardia,ITC4
2021-01-09,PF/BT,030925,Fondazione IRCCS Ca' Granda Ospedale Maggiore Policlinico,LOM,30-39,22,39,0,61,0,0,0,61,0,61,Lombardia,ITC4
2021-01-09,PF/BT,030925,Fondazione IRCCS Ca' Granda Ospedale Maggiore Policlinico,LOM,40-49,8,28,0,34,2,0,0,36,0,36,Lombardia,ITC4
2021-01-09,PF/BT,030925,Fondazione IRCCS Ca' Granda Ospedale Maggiore Policlinico,LOM,50-59,25,40,0,58,7,0,0,65,0,65,Lombardia,ITC4
2021-01-09,PF/BT,030925,Fondazione IRCCS Ca' Granda Ospedale Maggiore Policlinico,LOM,60-69,16,11,0,27,0,0,0,27,0,27,Lombardia,ITC4
2021-01-09,PF/BT,030925,Fondazione IRCCS Ca' Granda Ospedale Maggiore Policlinico,LOM,70-79,1,2,0,3,0,0,0,3,0,3,Lombardia,ITC4
2021-01-09,PF/BT,030925,Fondazione IRCCS Ca' Granda Ospedale Maggiore Policlinico,LOM,90+,1,0,0,1,0,0,0,1,0,1,Lombardia,ITC4
2021-01-09,PF/BT,030935,IRCCS    S. RAFFAELE - MILANO,LOM,20-29,5,5,0,10,0,0,0,10,0,10,Lombardia,ITC4
2021-01-09,PF/BT,030935,IRCCS    S. RAFFAELE - MILANO,LOM,30-39,3,3,0,6,0,0,0,6,0,6,Lombardia,ITC4
2021-01-09,PF/BT,030935,IRCCS    S. RAFFAELE - MILANO,LOM,40-49,3,5,0,8,0,0,0,8,0,8,Lombardia,ITC4
2021-01-09,PF/BT,030935,IRCCS    S. RAFFAELE - MILANO,LOM,50-59,11,30,0,41,0,0,0,41,0,41,Lombardia,ITC4
2021-01-09,PF/BT,030935,IRCCS    S. RAFFAELE - MILANO,LOM,60-69,2,7,0,9,0,0,0,9,0,9,Lombardia,ITC4
2021-01-09,PF/BT,030935,IRCCS    S. RAFFAELE - MILANO,LOM,70-79,0,4,0,4,0,0,0,4,0,4,Lombardia,ITC4
2021-01-09,PF/BT,030943,Istituto Clinico Humanitas,LOM,20-29,15,24,0,21,18,0,0,39,0,39,Lombardia,ITC4
2021-01-09,PF/BT,030943,Istituto Clinico Humanitas,LOM,30-39,21,37,0,31,27,0,0,58,0,58,Lombardia,ITC4
2021-01-09,PF/BT,030943,Istituto Clinico Humanitas,LOM,40-49,17,39,0,37,19,0,0,56,0,56,Lombardia,ITC4
2021-01-09,PF/BT,030943,Istituto Clinico Humanitas,LOM,50-59,15,21,0,18,18,0,0,36,0,36,Lombardia,ITC4
2021-01-09,PF/BT,030943,Istituto Clinico Humanitas,LOM,60-69,6,6,0,9,3,0,0,12,0,12,Lombardia,ITC4
2021-01-09,PF/BT,030943,Istituto Clinico Humanitas,LOM,70-79,2,1,0,3,0,0,0,3,0,3,Lombardia,ITC4
2021-01-09,PF/BT,167,ASST SPEDALI CIVILI AMBULATORIO COVID BRESCIA,LOM,20-29,22,63,0,82,3,0,0,85,0,85,Lombardia,ITC4
2021-01-09,PF/BT,167,ASST SPEDALI CIVILI AMBULATORIO COVID BRESCIA,LOM,30-39,41,68,0,94,15,0,0,109,0,109,Lombardia,ITC4
2021-01-09,PF/BT,167,ASST SPEDALI CIVILI AMBULATORIO COVID BRESCIA,LOM,40-49,29,79,0,82,26,0,0,108,0,108,Lombardia,ITC4
2021-01-09,PF/BT,167,ASST SPEDALI CIVILI AMBULATORIO COVID BRESCIA,LOM,50-59,37,88,0,92,33,0,0,125,0,125,Lombardia,ITC4
2021-01-09,PF/BT,167,ASST SPEDALI CIVILI AMBULATORIO COVID BRESCIA,LOM,60-69,21,25,0,31,15,0,0,46,0,46,Lombardia,ITC4
2021-01-09,PF/BT,1842,RSA VILLA AZZURRA,LOM,30-39,0,1,0,1,0,0,0,1,0,1,Lombardia,ITC4
2021-01-09,PF/BT,1842,RSA VILLA AZZURRA,LOM,40-49,1,0,0,1,0,0,0,1,0,1,Lombardia,ITC4
2021-01-09,PF/BT,1842,RSA VILLA AZZURRA,LOM,50-59,1,1,0,2,0,0,0,2,0,2,Lombardia,ITC4
2021-01-09,PF/BT,1842,RSA VILLA AZZURRA,LOM,60-69,1,1,0,2,0,0,0,2,0,2,Lombardia,ITC4
2021-01-09,PF/BT,1842,RSA VILLA AZZURRA,LOM,80-89,0,3,0,0,0,3,0,3,0,3,Lombardia,ITC4
2021-01-09,PF/BT,1842,RSA VILLA AZZURRA,LOM,90+,0,3,0,0,0,3,0,3,0,3,Lombardia,ITC4
2021-01-09,PF/BT,1953,RSA BEATA PAOLA,LOM,30-39,1,1,0,1,1,0,0,2,0,2,Lombardia,ITC4
2021-01-09,PF/BT,1953,RSA BEATA PAOLA,LOM,40-49,2,2,0,2,2,0,0,4,0,4,Lombardia,ITC4
2021-01-09,PF/BT,1953,RSA BEATA PAOLA,LOM,50-59,0,2,0,1,1,0,0,2,0,2,Lombardia,ITC4
2021-01-09,PF/BT,1953,RSA BEATA PAOLA,LOM,60-69,0,1,0,0,1,0,0,1,0,1,Lombardia,ITC4
2021-01-09,PF/BT,1953,RSA BEATA PAOLA,LOM,70-79,1,1,0,0,0,2,0,2,0,2,Lombardia,ITC4
2021-01-09,PF/BT,1953,RSA BEATA PAOLA,LOM,80-89,0,15,0,0,0,15,0,15,0,15,Lombardia,ITC4
2021-01-09,PF/BT,1953,RSA BEATA PAOLA,LOM,90+,0,4,0,0,0,4,0,4,0,4,Lombardia,ITC4
2021-01-09,PF/BT,2859,RSA FONDAZIONE BELLARIA ONLUS,LOM,60-69,4,1,0,0,0,5,0,5,0,5,Lombardia,ITC4
2021-01-09,PF/BT,2859,RSA FONDAZIONE BELLARIA ONLUS,LOM,70-79,1,0,0,0,0,1,0,1,0,1,Lombardia,ITC4
2021-01-09,PF/BT,2859,RSA FONDAZIONE BELLARIA ONLUS,LOM,80-89,4,12,0,0,0,16,0,16,0,16,Lombardia,ITC4
2021-01-09,PF/BT,2859,RSA FONDAZIONE BELLARIA ONLUS,LOM,90+,3,5,0,0,0,8,0,8,0,8,Lombardia,ITC4
2021-01-09,PF/BT,30026,OSPEDALE ERBA-  RENALDI - MENAGGIO,LOM,20-29,5,4,0,8,1,0,0,9,0,9,Lombardia,ITC4
2021-01-09,PF/BT,30026,OSPEDALE ERBA-  RENALDI - MENAGGIO,LOM,30-39,8,14,0,21,1,0,0,22,0,22,Lombardia,ITC4
2021-01-09,PF/BT,30026,OSPEDALE ERBA-  RENALDI - MENAGGIO,LOM,40-49,10,30,0,39,1,0,0,40,0,40,Lombardia,ITC4
2021-01-09,PF/BT,30026,OSPEDALE ERBA-  RENALDI - MENAGGIO,LOM,50-59,32,74,0,90,16,0,0,106,0,106,Lombardia,ITC4
2021-01-09,PF/BT,30026,OSPEDALE ERBA-  RENALDI - MENAGGIO,LOM,60-69,31,18,0,40,9,0,0,49,0,49,Lombardia,ITC4
2021-01-09,PF/BT,30026,OSPEDALE ERBA-  RENALDI - MENAGGIO,LOM,70-79,1,1,0,2,0,0,0,2,0,2,Lombardia,ITC4
2021-01-09,PF/BT,30072,Centro Vaccinale Covid Vizzolo - ASST Melegnano Martesana,LOM,20-29,6,12,0,18,0,0,0,18,0,18,Lombardia,ITC4
2021-01-09,PF/BT,30072,Centro Vaccinale Covid Vizzolo - ASST Melegnano Martesana,LOM,30-39,5,8,0,10,3,0,0,13,0,13,Lombardia,ITC4
2021-01-09,PF/BT,30072,Centro Vaccinale Covid Vizzolo - ASST Melegnano Martesana,LOM,40-49,8,32,0,33,7,0,0,40,0,40,Lombardia,ITC4
2021-01-09,PF/BT,30072,Centro Vaccinale Covid Vizzolo - ASST Melegnano Martesana,LOM,50-59,19,40,0,44,15,0,0,59,0,59,Lombardia,ITC4
2021-01-09,PF/BT,30072,Centro Vaccinale Covid Vizzolo - ASST Melegnano Martesana,LOM,60-69,26,22,0,44,4,0,0,48,0,48,Lombardia,ITC4
2021-01-09,PF/BT,30072,Centro Vaccinale Covid Vizzolo - ASST Melegnano Martesana,LOM,70-79,2,0,0,2,0,0,0,2,0,2,Lombardia,ITC4
2021-01-09,PF/BT,30073,CV Bollate,LOM,20-29,2,6,0,1,0,0,7,8,0,8,Lombardia,ITC4
2021-01-09,PF/BT,30073,CV Bollate,LOM,30-39,3,1,0,2,0,0,2,4,0,4,Lombardia,ITC4
2021-01-09,PF/BT,30073,CV Bollate,LOM,40-49,3,4,0,1,0,0,6,7,0,7,Lombardia,ITC4
2021-01-09,PF/BT,30073,CV Bollate,LOM,50-59,3,3,0,0,0,0,6,6,0,6,Lombardia,ITC4
2021-01-09,PF/BT,30073,CV Bollate,LOM,60-69,9,4,0,2,0,0,11,13,0,13,Lombardia,ITC4
2021-01-09,PF/BT,30073,CV Bollate,LOM,70-79,3,0,0,0,0,0,3,3,0,3,Lombardia,ITC4
2021-01-09,PF/BT,30073,cv rho,LOM,20-29,2,6,0,8,0,0,0,8,0,8,Lombardia,ITC4
2021-01-09,PF/BT,30073,cv rho,LOM,30-39,10,15,0,25,0,0,0,25,0,25,Lombardia,ITC4
2021-01-09,PF/BT,30073,cv rho,LOM,40-49,6,35,0,39,2,0,0,41,0,41,Lombardia,ITC4
2021-01-09,PF/BT,30073,cv rho,LOM,50-59,15,40,0,48,7,0,0,55,0,55,Lombardia,ITC4
2021-01-09,PF/BT,30073,cv rho,LOM,60-69,13,13,0,21,5,0,0,26,0,26,Lombardia,ITC4
2021-01-09,PF/BT,30074,HUB COVID MAGENTA,LOM,20-29,0,3,0,3,0,0,0,3,0,3,Lombardia,ITC4
2021-01-09,PF/BT,30074,HUB COVID MAGENTA,LOM,30-39,3,7,0,7,3,0,0,10,0,10,Lombardia,ITC4
2021-01-09,PF/BT,30074,HUB COVID MAGENTA,LOM,40-49,8,22,0,18,12,0,0,30,0,30,Lombardia,ITC4
2021-01-09,PF/BT,30074,HUB COVID MAGENTA,LOM,50-59,18,61,0,47,32,0,0,79,0,79,Lombardia,ITC4
2021-01-09,PF/BT,30074,HUB COVID MAGENTA,LOM,60-69,9,12,0,15,6,0,0,21,0,21,Lombardia,ITC4
2021-01-09,PF/BT,30156,Centro Vaccinale Covid Desenzano,LOM,20-29,1,9,0,0,10,0,0,10,0,10,Lombardia,ITC4
2021-01-09,PF/BT,30156,Centro Vaccinale Covid Desenzano,LOM,30-39,6,12,0,2,16,0,0,18,0,18,Lombardia,ITC4
2021-01-09,PF/BT,30156,Centro Vaccinale Covid Desenzano,LOM,40-49,8,18,0,3,21,0,2,26,0,26,Lombardia,ITC4
2021-01-09,PF/BT,30156,Centro Vaccinale Covid Desenzano,LOM,50-59,12,29,0,8,33,0,0,41,0,41,Lombardia,ITC4
2021-01-09,PF/BT,30156,Centro Vaccinale Covid Desenzano,LOM,60-69,6,6,0,3,9,0,0,12,0,12,Lombardia,ITC4
2021-01-09,PF/BT,30156,Centro Vaccinale Covid Desenzano,LOM,70-79,0,1,0,0,1,0,0,1,0,1,Lombardia,ITC4
2021-01-09,PF/BT,30157,Centro Vaccinale Covid Gavardo,LOM,20-29,2,6,0,7,1,0,0,8,0,8,Lombardia,ITC4
2021-01-09,PF/BT,30157,Centro Vaccinale Covid Gavardo,LOM,30-39,6,9,0,15,0,0,0,15,0,15,Lombardia,ITC4
2021-01-09,PF/BT,30157,Centro Vaccinale Covid Gavardo,LOM,40-49,5,15,0,19,1,0,0,20,0,20,Lombardia,ITC4
2021-01-09,PF/BT,30157,Centro Vaccinale Covid Gavardo,LOM,50-59,10,31,0,39,2,0,0,41,0,41,Lombardia,ITC4
2021-01-09,PF/BT,30157,Centro Vaccinale Covid Gavardo,LOM,60-69,11,11,0,21,1,0,0,22,0,22,Lombardia,ITC4
2021-01-09,PF/BT,30184,Centro Vaccinale Covid Manerbio,LOM,20-29,3,7,0,6,0,0,4,10,0,10,Lombardia,ITC4
2021-01-09,PF/BT,30184,Centro Vaccinale Covid Manerbio,LOM,30-39,2,21,0,16,0,0,7,23,0,23,Lombardia,ITC4
2021-01-09,PF/BT,30184,Centro Vaccinale Covid Manerbio,LOM,40-49,6,16,0,15,2,0,5,22,0,22,Lombardia,ITC4
2021-01-09,PF/BT,30184,Centro Vaccinale Covid Manerbio,LOM,50-59,11,26,0,23,11,0,3,37,0,37,Lombardia,ITC4
2021-01-09,PF/BT,30184,Centro Vaccinale Covid Manerbio,LOM,60-69,12,10,0,17,3,0,2,22,0,22,Lombardia,ITC4
2021-01-09,PF/BT,30193,Ambulatorio HUB Vigevano,LOM,20-29,1,4,0,3,2,0,0,5,0,5,Lombardia,ITC4
2021-01-09,PF/BT,30193,Ambulatorio HUB Vigevano,LOM,30-39,2,11,0,12,1,0,0,13,0,13,Lombardia,ITC4
2021-01-09,PF/BT,30193,Ambulatorio HUB Vigevano,LOM,40-49,8,21,0,24,5,0,0,29,0,29,Lombardia,ITC4
2021-01-09,PF/BT,30193,Ambulatorio HUB Vigevano,LOM,50-59,8,44,0,46,6,0,0,52,0,52,Lombardia,ITC4
2021-01-09,PF/BT,30193,Ambulatorio HUB Vigevano,LOM,60-69,5,14,0,17,2,0,0,19,0,19,Lombardia,ITC4
2021-01-09,PF/BT,30194,AMBULATORIO HUB VOGHERA,LOM,20-29,4,5,0,9,0,0,0,9,0,9,Lombardia,ITC4
2021-01-09,PF/BT,30194,AMBULATORIO HUB VOGHERA,LOM,30-39,5,10,0,14,1,0,0,15,0,15,Lombardia,ITC4
2021-01-09,PF/BT,30194,AMBULATORIO HUB VOGHERA,LOM,40-49,6,24,0,28,2,0,0,30,0,30,Lombardia,ITC4
2021-01-09,PF/BT,30194,AMBULATORIO HUB VOGHERA,LOM,50-59,6,31,0,31,6,0,0,37,0,37,Lombardia,ITC4
2021-01-09,PF/BT,30194,AMBULATORIO HUB VOGHERA,LOM,60-69,3,7,0,9,1,0,0,10,0,10,Lombardia,ITC4
2021-01-09,PF/BT,30209,OSPEDALE MAGGIORE DI CREMA,LOM,20-29,9,3,0,10,1,0,1,12,0,12,Lombardia,ITC4
2021-01-09,PF/BT,30209,OSPEDALE MAGGIORE DI CREMA,LOM,30-39,4,10,0,10,3,0,1,14,0,14,Lombardia,ITC4
2021-01-09,PF/BT,30209,OSPEDALE MAGGIORE DI CREMA,LOM,40-49,4,12,0,14,1,0,1,16,0,16,Lombardia,ITC4
2021-01-09,PF/BT,30209,OSPEDALE MAGGIORE DI CREMA,LOM,50-59,9,18,0,21,6,0,0,27,0,27,Lombardia,ITC4
2021-01-09,PF/BT,30209,OSPEDALE MAGGIORE DI CREMA,LOM,60-69,10,10,0,17,2,0,1,20,0,20,Lombardia,ITC4
2021-01-09,PF/BT,30209,OSPEDALE MAGGIORE DI CREMA,LOM,70-79,1,0,0,1,0,0,0,1,0,1,Lombardia,ITC4
2021-01-09,PF/BT,30281,HUB COVID LEGNANO,LOM,20-29,0,8,0,8,0,0,0,8,0,8,Lombardia,ITC4
2021-01-09,PF/BT,30281,HUB COVID LEGNANO,LOM,30-39,5,7,0,12,0,0,0,12,0,12,Lombardia,ITC4
2021-01-09,PF/BT,30281,HUB COVID LEGNANO,LOM,40-49,1,14,0,13,2,0,0,15,0,15,Lombardia,ITC4
2021-01-09,PF/BT,30281,HUB COVID LEGNANO,LOM,50-59,20,58,0,64,14,0,0,78,0,78,Lombardia,ITC4
2021-01-09,PF/BT,30281,HUB COVID LEGNANO,LOM,60-69,5,7,0,8,4,0,0,12,0,12,Lombardia,ITC4
2021-01-09,PF/BT,3034800,CASA DI CURA VILLA GEMMA PRESSO CASA DI CURA VILLA BARBARANO,LOM,20-29,2,7,0,9,0,0,0,9,0,9,Lombardia,ITC4
2021-01-09,PF/BT,3034800,CASA DI CURA VILLA GEMMA PRESSO CASA DI CURA VILLA BARBARANO,LOM,30-39,5,20,0,22,3,0,0,25,0,25,Lombardia,ITC4
2021-01-09,PF/BT,3034800,CASA DI CURA VILLA GEMMA PRESSO CASA DI CURA VILLA BARBARANO,LOM,40-49,4,43,0,37,10,0,0,47,0,47,Lombardia,ITC4
2021-01-09,PF/BT,3034800,CASA DI CURA VILLA GEMMA PRESSO CASA DI CURA VILLA BARBARANO,LOM,50-59,12,30,0,28,14,0,0,42,0,42,Lombardia,ITC4
2021-01-09,PF/BT,3034800,CASA DI CURA VILLA GEMMA PRESSO CASA DI CURA VILLA BARBARANO,LOM,60-69,12,5,0,13,4,0,0,17,0,17,Lombardia,ITC4
2021-01-09,PF/BT,3034800,CASA DI CURA VILLA GEMMA PRESSO CASA DI CURA VILLA BARBARANO,LOM,70-79,7,1,0,7,1,0,0,8,0,8,Lombardia,ITC4
2021-01-09,PF/BT,30701,ASST GRANDE OSPEDALE METROPOLITANO NIGUARDA,LOM,20-29,7,25,0,24,0,0,8,32,0,32,Lombardia,ITC4
2021-01-09,PF/BT,30701,ASST GRANDE OSPEDALE METROPOLITANO NIGUARDA,LOM,30-39,26,31,0,45,5,0,7,57,0,57,Lombardia,ITC4
2021-01-09,PF/BT,30701,ASST GRANDE OSPEDALE METROPOLITANO NIGUARDA,LOM,40-49,20,27,0,32,9,0,6,47,0,47,Lombardia,ITC4
2021-01-09,PF/BT,30701,ASST GRANDE OSPEDALE METROPOLITANO NIGUARDA,LOM,50-59,27,47,0,55,13,0,6,74,0,74,Lombardia,ITC4
2021-01-09,PF/BT,30701,ASST GRANDE OSPEDALE METROPOLITANO NIGUARDA,LOM,60-69,29,27,0,48,2,0,6,56,0,56,Lombardia,ITC4
2021-01-09,PF/BT,30701,ASST GRANDE OSPEDALE METROPOLITANO NIGUARDA,LOM,70-79,2,2,0,2,0,0,2,4,0,4,Lombardia,ITC4
2021-01-09,PF/BT,30718,ASST PAPA GIOVANNI XXIII,LOM,20-29,16,22,0,27,11,0,0,38,0,38,Lombardia,ITC4
2021-01-09,PF/BT,30718,ASST PAPA GIOVANNI XXIII,LOM,30-39,15,15,0,18,12,0,0,30,0,30,Lombardia,ITC4
2021-01-09,PF/BT,30718,ASST PAPA GIOVANNI XXIII,LOM,40-49,14,22,0,12,24,0,0,36,0,36,Lombardia,ITC4
2021-01-09,PF/BT,30718,ASST PAPA GIOVANNI XXIII,LOM,50-59,25,29,0,34,20,0,0,54,0,54,Lombardia,ITC4
2021-01-09,PF/BT,30718,ASST PAPA GIOVANNI XXIII,LOM,60-69,48,16,0,48,16,0,0,64,0,64,Lombardia,ITC4
2021-01-09,PF/BT,30718,ASST PAPA GIOVANNI XXIII,LOM,70-79,4,2,0,0,6,0,0,6,0,6,Lombardia,ITC4
2021-01-09,PF/BT,30902,Ospedale S.Anna - Como,LOM,20-29,10,14,0,9,15,0,0,24,0,24,Lombardia,ITC4
2021-01-09,PF/BT,30902,Ospedale S.Anna - Como,LOM,30-39,32,21,0,20,33,0,0,53,0,53,Lombardia,ITC4
2021-01-09,PF/BT,30902,Ospedale S.Anna - Como,LOM,40-49,25,37,0,23,39,0,0,62,0,62,Lombardia,ITC4
2021-01-09,PF/BT,30902,Ospedale S.Anna - Como,LOM,50-59,32,34,0,26,40,0,0,66,0,66,Lombardia,ITC4
2021-01-09,PF/BT,30902,Ospedale S.Anna - Como,LOM,60-69,50,27,0,41,36,0,0,77,0,77,Lombardia,ITC4
2021-01-09,PF/BT,30902,Ospedale S.Anna - Como,LOM,70-79,15,3,0,3,15,0,0,18,0,18,Lombardia,ITC4
2021-01-09,PF/BT,30904,ASST VALTELLINA E ALTO LARIO PRESIDIO OSPEDALIERO DI SONDALO,LOM,20-29,2,6,0,7,1,0,0,8,0,8,Lombardia,ITC4
2021-01-09,PF/BT,30904,ASST VALTELLINA E ALTO LARIO PRESIDIO OSPEDALIERO DI SONDALO,LOM,30-39,4,5,0,9,0,0,0,9,0,9,Lombardia,ITC4
2021-01-09,PF/BT,30904,ASST VALTELLINA E ALTO LARIO PRESIDIO OSPEDALIERO DI SONDALO,LOM,40-49,9,19,0,25,3,0,0,28,0,28,Lombardia,ITC4
2021-01-09,PF/BT,30904,ASST VALTELLINA E ALTO LARIO PRESIDIO OSPEDALIERO DI SONDALO,LOM,50-59,22,40,0,34,28,0,0,62,0,62,Lombardia,ITC4
2021-01-09,PF/BT,30904,ASST VALTELLINA E ALTO LARIO PRESIDIO OSPEDALIERO DI SONDALO,LOM,60-69,12,13,0,17,8,0,0,25,0,25,Lombardia,ITC4
2021-01-09,PF/BT,30909,amb covid monza,LOM,20-29,13,43,0,50,4,0,2,56,0,56,Lombardia,ITC4
2021-01-09,PF/BT,30909,amb covid monza,LOM,30-39,19,46,0,61,3,0,1,65,0,65,Lombardia,ITC4
2021-01-09,PF/BT,30909,amb covid monza,LOM,40-49,13,50,0,57,4,0,2,63,0,63,Lombardia,ITC4
2021-01-09,PF/BT,30909,amb covid monza,LOM,50-59,29,69,0,82,13,0,3,98,0,98,Lombardia,ITC4
2021-01-09,PF/BT,30909,amb covid monza,LOM,60-69,21,23,0,38,6,0,0,44,0,44,Lombardia,ITC4
2021-01-09,PF/BT,30909,amb covid monza,LOM,70-79,2,2,0,3,0,0,1,4,0,4,Lombardia,ITC4
2021-01-09,PF/BT,30941,ISTITUTO EUROPEO DI ONCOLOGIA,LOM,20-29,1,5,0,5,1,0,0,6,0,6,Lombardia,ITC4
2021-01-09,PF/BT,30941,ISTITUTO EUROPEO DI ONCOLOGIA,LOM,30-39,3,2,0,5,0,0,0,5,0,5,Lombardia,ITC4
2021-01-09,PF/BT,30941,ISTITUTO EUROPEO DI ONCOLOGIA,LOM,40-49,4,6,0,10,0,0,0,10,0,10,Lombardia,ITC4
2021-01-09,PF/BT,30941,ISTITUTO EUROPEO DI ONCOLOGIA,LOM,50-59,16,23,0,39,0,0,0,39,0,39,Lombardia,ITC4
2021-01-09,PF/BT,321000483,RSA SAN FRANCESCO D'ASSISI,LOM,20-29,2,2,0,2,2,0,0,4,0,4,Lombardia,ITC4
2021-01-09,PF/BT,321000483,RSA SAN FRANCESCO D'ASSISI,LOM,30-39,3,4,0,6,1,0,0,7,0,7,Lombardia,ITC4
2021-01-09,PF/BT,321000483,RSA SAN FRANCESCO D'ASSISI,LOM,40-49,1,4,0,3,2,0,0,5,0,5,Lombardia,ITC4
2021-01-09,PF/BT,321000483,RSA SAN FRANCESCO D'ASSISI,LOM,50-59,1,5,0,4,2,0,0,6,0,6,Lombardia,ITC4
2021-01-09,PF/BT,321000483,RSA SAN FRANCESCO D'ASSISI,LOM,60-69,0,1,0,1,0,0,0,1,0,1,Lombardia,ITC4
2021-01-09,PF/BT,321000483,RSA SAN FRANCESCO D'ASSISI,LOM,70-79,0,2,0,0,0,2,0,2,0,2,Lombardia,ITC4
2021-01-09,PF/BT,321000483,RSA SAN FRANCESCO D'ASSISI,LOM,80-89,0,1,0,0,0,1,0,1,0,1,Lombardia,ITC4
2021-01-09,PF/BT,32170712,ambulatorio covid SESTO SAN GIOVANNI,LOM,20-29,4,6,0,10,0,0,0,10,0,10,Lombardia,ITC4
2021-01-09,PF/BT,32170712,ambulatorio covid SESTO SAN GIOVANNI,LOM,30-39,11,23,0,33,1,0,0,34,0,34,Lombardia,ITC4
2021-01-09,PF/BT,32170712,ambulatorio covid SESTO SAN GIOVANNI,LOM,40-49,13,23,0,36,0,0,0,36,0,36,Lombardia,ITC4
2021-01-09,PF/BT,32170712,ambulatorio covid SESTO SAN GIOVANNI,LOM,50-59,29,40,0,69,0,0,0,69,0,69,Lombardia,ITC4
2021-01-09,PF/BT,32170712,ambulatorio covid SESTO SAN GIOVANNI,LOM,60-69,50,46,0,95,1,0,0,96,0,96,Lombardia,ITC4
2021-01-09,PF/BT,32170712,ambulatorio covid SESTO SAN GIOVANNI,LOM,70-79,1,0,0,1,0,0,0,1,0,1,Lombardia,ITC4
2021-01-09,PF/BT,322000728,RSA CAMELOT,LOM,20-29,2,1,0,3,0,0,0,3,0,3,Lombardia,ITC4
2021-01-09,PF/BT,322000728,RSA CAMELOT,LOM,40-49,1,2,0,3,0,0,0,3,0,3,Lombardia,ITC4
2021-01-09,PF/BT,322000728,RSA CAMELOT,LOM,50-59,0,2,0,2,0,0,0,2,0,2,Lombardia,ITC4
2021-01-09,PF/BT,322000728,RSA CAMELOT,LOM,60-69,0,5,0,4,0,1,0,5,0,5,Lombardia,ITC4
2021-01-09,PF/BT,322000728,RSA CAMELOT,LOM,70-79,1,1,0,0,0,2,0,2,0,2,Lombardia,ITC4
2021-01-09,PF/BT,322000728,RSA CAMELOT,LOM,80-89,4,8,0,0,0,12,0,12,0,12,Lombardia,ITC4
2021-01-09,PF/BT,322000728,RSA CAMELOT,LOM,90+,0,9,0,0,0,9,0,9,0,9,Lombardia,ITC4
2021-01-09,PF/BT,32271022,ambulatorio covid Varese,LOM,20-29,3,6,0,9,0,0,0,9,0,9,Lombardia,ITC4
2021-01-09,PF/BT,32271022,ambulatorio covid Varese,LOM,30-39,6,11,0,17,0,0,0,17,0,17,Lombardia,ITC4
2021-01-09,PF/BT,32271022,ambulatorio covid Varese,LOM,40-49,1,10,0,11,0,0,0,11,0,11,Lombardia,ITC4
2021-01-09,PF/BT,32271022,ambulatorio covid Varese,LOM,50-59,3,7,0,10,0,0,0,10,0,10,Lombardia,ITC4
2021-01-09,PF/BT,32271022,ambulatorio covid Varese,LOM,60-69,2,5,0,7,0,0,0,7,0,7,Lombardia,ITC4
2021-01-09,PF/BT,32271026,AMBULATORIO COVID OSPEDALE ANGERA,LOM,20-29,0,4,0,4,0,0,0,4,0,4,Lombardia,ITC4
2021-01-09,PF/BT,32271026,AMBULATORIO COVID OSPEDALE ANGERA,LOM,30-39,6,0,0,6,0,0,0,6,0,6,Lombardia,ITC4
2021-01-09,PF/BT,32271026,AMBULATORIO COVID OSPEDALE ANGERA,LOM,40-49,5,13,0,18,0,0,0,18,0,18,Lombardia,ITC4
2021-01-09,PF/BT,32271026,AMBULATORIO COVID OSPEDALE ANGERA,LOM,50-59,4,24,0,28,0,0,0,28,0,28,Lombardia,ITC4
2021-01-09,PF/BT,32271026,AMBULATORIO COVID OSPEDALE ANGERA,LOM,60-69,5,2,0,7,0,0,0,7,0,7,Lombardia,ITC4
2021-01-09,PF/BT,32271026,AMBULATORIO COVID OSPEDALE ANGERA,LOM,70-79,2,1,0,3,0,0,0,3,0,3,Lombardia,ITC4
2021-01-09,PF/BT,32271028,AMBULATORIO COVID OSPEDALE CIRCOLO,LOM,16-19,1,0,0,1,0,0,0,1,0,1,Lombardia,ITC4
2021-01-09,PF/BT,32271028,AMBULATORIO COVID OSPEDALE CIRCOLO,LOM,20-29,17,48,0,65,0,0,0,65,0,65,Lombardia,ITC4
2021-01-09,PF/BT,32271028,AMBULATORIO COVID OSPEDALE CIRCOLO,LOM,30-39,46,79,0,125,0,0,0,125,0,125,Lombardia,ITC4
2021-01-09,PF/BT,32271028,AMBULATORIO COVID OSPEDALE CIRCOLO,LOM,40-49,26,96,0,122,0,0,0,122,0,122,Lombardia,ITC4
2021-01-09,PF/BT,32271028,AMBULATORIO COVID OSPEDALE CIRCOLO,LOM,50-59,48,110,0,158,0,0,0,158,0,158,Lombardia,ITC4
2021-01-09,PF/BT,32271028,AMBULATORIO COVID OSPEDALE CIRCOLO,LOM,60-69,20,33,0,53,0,0,0,53,0,53,Lombardia,ITC4
2021-01-09,PF/BT,32271028,AMBULATORIO COVID OSPEDALE CIRCOLO,LOM,70-79,2,2,0,4,0,0,0,4,0,4,Lombardia,ITC4
2021-01-09,PF/BT,32271116,ambulatorio covid Gallarate,LOM,20-29,4,8,0,12,0,0,0,12,0,12,Lombardia,ITC4
2021-01-09,PF/BT,32271116,ambulatorio covid Gallarate,LOM,30-39,4,7,0,11,0,0,0,11,0,11,Lombardia,ITC4
2021-01-09,PF/BT,32271116,ambulatorio covid Gallarate,LOM,40-49,4,6,0,10,0,0,0,10,0,10,Lombardia,ITC4
2021-01-09,PF/BT,32271116,ambulatorio covid Gallarate,LOM,50-59,8,16,0,24,0,0,0,24,0,24,Lombardia,ITC4
2021-01-09,PF/BT,32271116,ambulatorio covid Gallarate,LOM,60-69,31,14,0,45,0,0,0,45,0,45,Lombardia,ITC4
2021-01-09,PF/BT,32572027,Ambulatorio COVID SERIATE,LOM,20-29,8,4,0,12,0,0,0,12,0,12,Lombardia,ITC4
2021-01-09,PF/BT,32572027,Ambulatorio COVID SERIATE,LOM,30-39,12,7,0,19,0,0,0,19,0,19,Lombardia,ITC4
2021-01-09,PF/BT,32572027,Ambulatorio COVID SERIATE,LOM,40-49,4,19,0,23,0,0,0,23,0,23,Lombardia,ITC4
2021-01-09,PF/BT,32572027,Ambulatorio COVID SERIATE,LOM,50-59,6,20,0,26,0,0,0,26,0,26,Lombardia,ITC4
2021-01-09,PF/BT,32572027,Ambulatorio COVID SERIATE,LOM,60-69,19,9,0,28,0,0,0,28,0,28,Lombardia,ITC4
2021-01-09,PF/BT,327001997,"RSA ""RESIDENZA ALLA PACE"" COOP. SERV. E SOL. SOC.- ONLUS",LOM,30-39,0,3,0,3,0,0,0,3,0,3,Lombardia,ITC4
2021-01-09,PF/BT,327001997,"RSA ""RESIDENZA ALLA PACE"" COOP. SERV. E SOL. SOC.- ONLUS",LOM,40-49,0,8,0,4,4,0,0,8,0,8,Lombardia,ITC4
2021-01-09,PF/BT,327001997,"RSA ""RESIDENZA ALLA PACE"" COOP. SERV. E SOL. SOC.- ONLUS",LOM,50-59,2,8,0,7,3,0,0,10,0,10,Lombardia,ITC4
2021-01-09,PF/BT,327001997,"RSA ""RESIDENZA ALLA PACE"" COOP. SERV. E SOL. SOC.- ONLUS",LOM,60-69,3,3,0,2,2,2,0,6,0,6,Lombardia,ITC4
2021-01-09,PF/BT,327001997,"RSA ""RESIDENZA ALLA PACE"" COOP. SERV. E SOL. SOC.- ONLUS",LOM,70-79,3,4,0,0,1,6,0,7,0,7,Lombardia,ITC4
2021-01-09,PF/BT,327001997,"RSA ""RESIDENZA ALLA PACE"" COOP. SERV. E SOL. SOC.- ONLUS",LOM,80-89,3,12,0,0,0,15,0,15,0,15,Lombardia,ITC4
2021-01-09,PF/BT,327001997,"RSA ""RESIDENZA ALLA PACE"" COOP. SERV. E SOL. SOC.- ONLUS",LOM,90+,3,6,0,0,0,9,0,9,0,9,Lombardia,ITC4
2021-01-09,PF/BT,32772401,cv casalmaggiore,LOM,20-29,3,3,0,5,0,0,1,6,0,6,Lombardia,ITC4
2021-01-09,PF/BT,32772401,cv casalmaggiore,LOM,30-39,4,8,0,9,2,0,1,12,0,12,Lombardia,ITC4
2021-01-09,PF/BT,32772401,cv casalmaggiore,LOM,40-49,6,26,0,28,1,0,3,32,0,32,Lombardia,ITC4
2021-01-09,PF/BT,32772401,cv casalmaggiore,LOM,50-59,10,45,0,46,4,0,5,55,0,55,Lombardia,ITC4
2021-01-09,PF/BT,32772401,cv casalmaggiore,LOM,60-69,3,5,0,8,0,0,0,8,0,8,Lombardia,ITC4
2021-01-09,PF/BT,32772401,cv casalmaggiore,LOM,70-79,1,0,0,0,0,0,1,1,0,1,Lombardia,ITC4
2021-01-09,PF/BT,32772407,CV COVID CREMONA,LOM,20-29,1,1,0,2,0,0,0,2,0,2,Lombardia,ITC4
2021-01-09,PF/BT,32772407,CV COVID CREMONA,LOM,30-39,13,26,0,32,3,0,4,39,0,39,Lombardia,ITC4
2021-01-09,PF/BT,32772407,CV COVID CREMONA,LOM,40-49,14,22,0,27,4,0,5,36,0,36,Lombardia,ITC4
2021-01-09,PF/BT,32772407,CV COVID CREMONA,LOM,50-59,27,45,0,45,11,0,16,72,0,72,Lombardia,ITC4
2021-01-09,PF/BT,32772407,CV COVID CREMONA,LOM,60-69,20,48,0,40,15,0,13,68,0,68,Lombardia,ITC4
2021-01-09,PF/BT,32772407,CV COVID CREMONA,LOM,70-79,24,15,0,33,5,0,1,39,0,39,Lombardia,ITC4
2021-01-09,PF/BT,32772407,CV COVID CREMONA,LOM,80-89,1,1,0,2,0,0,0,2,0,2,Lombardia,ITC4
2021-01-09,PF/BT,32772513,ASST DI MANTOVA - POMA,LOM,16-19,1,0,0,1,0,0,0,1,0,1,Lombardia,ITC4
2021-01-09,PF/BT,32772513,ASST DI MANTOVA - POMA,LOM,20-29,14,24,0,34,4,0,0,38,0,38,Lombardia,ITC4
2021-01-09,PF/BT,32772513,ASST DI MANTOVA - POMA,LOM,30-39,6,19,0,23,2,0,0,25,0,25,Lombardia,ITC4
2021-01-09,PF/BT,32772513,ASST DI MANTOVA - POMA,LOM,40-49,11,17,0,21,7,0,0,28,0,28,Lombardia,ITC4
2021-01-09,PF/BT,32772513,ASST DI MANTOVA - POMA,LOM,50-59,43,42,0,70,15,0,0,85,0,85,Lombardia,ITC4
2021-01-09,PF/BT,32772513,ASST DI MANTOVA - POMA,LOM,60-69,41,17,0,55,3,0,0,58,0,58,Lombardia,ITC4
2021-01-09,PF/BT,32772513,ASST DI MANTOVA - POMA,LOM,70-79,1,3,0,3,1,0,0,4,0,4,Lombardia,ITC4
2021-01-09,PF/BT,32772513,ASST DI MANTOVA - POMA,LOM,90+,0,1,0,0,1,0,0,1,0,1,Lombardia,ITC4
2021-01-09,PF/BT,697,CASA RIPOSO F.LLI MOLINA P.E.T,LOM,20-29,1,4,0,5,0,0,0,5,0,5,Lombardia,ITC4
2021-01-09,PF/BT,697,CASA RIPOSO F.LLI MOLINA P.E.T,LOM,30-39,0,3,0,3,0,0,0,3,0,3,Lombardia,ITC4
2021-01-09,PF/BT,697,CASA RIPOSO F.LLI MOLINA P.E.T,LOM,40-49,0,3,0,3,0,0,0,3,0,3,Lombardia,ITC4
2021-01-09,PF/BT,697,CASA RIPOSO F.LLI MOLINA P.E.T,LOM,50-59,1,8,0,9,0,0,0,9,0,9,Lombardia,ITC4
2021-01-09,PF/BT,697,CASA RIPOSO F.LLI MOLINA P.E.T,LOM,60-69,0,5,0,4,1,0,0,5,0,5,Lombardia,ITC4
2021-01-09,PF/BT,697,CASA RIPOSO F.LLI MOLINA P.E.T,LOM,70-79,1,1,0,0,2,0,0,2,0,2,Lombardia,ITC4
2021-01-09,PF/BT,697,CASA RIPOSO F.LLI MOLINA P.E.T,LOM,80-89,0,6,0,0,6,0,0,6,0,6,Lombardia,ITC4
2021-01-09,PF/BT,697,CASA RIPOSO F.LLI MOLINA P.E.T,LOM,90+,0,3,0,0,3,0,0,3,0,3,Lombardia,ITC4
2021-01-09,PF/BT,HSP11-11bis,32170223 HUB COVID SS PAOLO E CARLO - PVO Ospedale San Paolo,LOM,20-29,11,24,0,34,1,0,0,35,0,35,Lombardia,ITC4
2021-01-09,PF/BT,HSP11-11bis,32170223 HUB COVID SS PAOLO E CARLO - PVO Ospedale San Paolo,LOM,30-39,22,39,0,59,2,0,0,61,0,61,Lombardia,ITC4
2021-01-09,PF/BT,HSP11-11bis,32170223 HUB COVID SS PAOLO E CARLO - PVO Ospedale San Paolo,LOM,40-49,13,41,0,49,5,0,0,54,0,54,Lombardia,ITC4
2021-01-09,PF/BT,HSP11-11bis,32170223 HUB COVID SS PAOLO E CARLO - PVO Ospedale San Paolo,LOM,50-59,27,60,0,68,19,0,0,87,0,87,Lombardia,ITC4
2021-01-09,PF/BT,HSP11-11bis,32170223 HUB COVID SS PAOLO E CARLO - PVO Ospedale San Paolo,LOM,60-69,17,24,0,39,2,0,0,41,0,41,Lombardia,ITC4
2021-01-09,PF/BT,HSP11-11bis,32170223 HUB COVID SS PAOLO E CARLO - PVO Ospedale San Paolo,LOM,70-79,2,1,0,2,1,0,0,3,0,3,Lombardia,ITC4
2021-01-09,PF/BT,HSP11-11bis,32170224 HUB COVID OSP. SAN CARLO,LOM,20-29,17,29,0,38,5,0,3,46,0,46,Lombardia,ITC4
2021-01-09,PF/BT,HSP11-11bis,32170224 HUB COVID OSP. SAN CARLO,LOM,30-39,11,23,0,30,2,0,2,34,0,34,Lombardia,ITC4
2021-01-09,PF/BT,HSP11-11bis,32170224 HUB COVID OSP. SAN CARLO,LOM,40-49,12,36,0,39,3,0,6,48,0,48,Lombardia,ITC4
2021-01-09,PF/BT,HSP11-11bis,32170224 HUB COVID OSP. SAN CARLO,LOM,50-59,20,49,0,60,1,0,8,69,0,69,Lombardia,ITC4
2021-01-09,PF/BT,HSP11-11bis,32170224 HUB COVID OSP. SAN CARLO,LOM,60-69,22,27,0,41,2,0,6,49,0,49,Lombardia,ITC4
2021-01-09,PF/BT,HSP11-11bis,32170224 HUB COVID OSP. SAN CARLO,LOM,70-79,2,3,0,4,1,0,0,5,0,5,Lombardia,ITC4
2021-01-09,PF/BT,HSP11-11bis,32170224 HUB COVID OSP. SAN CARLO,LOM,80-89,1,0,0,0,0,0,1,1,0,1,Lombardia,ITC4
2021-01-09,PF/BT,HSP11-11bis,Ambulatorio COVID PO Casalpusterlengo,LOM,20-29,1,3,0,3,1,0,0,4,0,4,Lombardia,ITC4
2021-01-09,PF/BT,HSP11-11bis,Ambulatorio COVID PO Casalpusterlengo,LOM,30-39,1,5,0,2,4,0,0,6,0,6,Lombardia,ITC4
2021-01-09,PF/BT,HSP11-11bis,Ambulatorio COVID PO Casalpusterlengo,LOM,40-49,2,25,0,23,4,0,0,27,0,27,Lombardia,ITC4
2021-01-09,PF/BT,HSP11-11bis,Ambulatorio COVID PO Casalpusterlengo,LOM,50-59,13,22,0,18,17,0,0,35,0,35,Lombardia,ITC4
2021-01-09,PF/BT,HSP11-11bis,Ambulatorio COVID PO Casalpusterlengo,LOM,60-69,2,4,0,4,2,0,0,6,0,6,Lombardia,ITC4
2021-01-09,PF/BT,HSP11-11bis,Ambulatorio COVID PO Casalpusterlengo,LOM,70-79,0,1,0,1,0,0,0,1,0,1,Lombardia,ITC4
2021-01-09,PF/BT,HSP11-11bis,Ambulatorio COVID PO Codogno,LOM,20-29,4,4,0,7,1,0,0,8,0,8,Lombardia,ITC4
2021-01-09,PF/BT,HSP11-11bis,Ambulatorio COVID PO Codogno,LOM,30-39,1,3,0,3,1,0,0,4,0,4,Lombardia,ITC4
2021-01-09,PF/BT,HSP11-11bis,Ambulatorio COVID PO Codogno,LOM,40-49,0,11,0,11,0,0,0,11,0,11,Lombardia,ITC4
2021-01-09,PF/BT,HSP11-11bis,Ambulatorio COVID PO Codogno,LOM,50-59,8,17,0,18,7,0,0,25,0,25,Lombardia,ITC4
2021-01-09,PF/BT,HSP11-11bis,Ambulatorio COVID PO Codogno,LOM,60-69,1,5,0,3,3,0,0,6,0,6,Lombardia,ITC4
2021-01-09,PF/BT,HSP11-11bis,Ambulatorio COVID PO LODI,LOM,16-19,0,1,0,1,0,0,0,1,0,1,Lombardia,ITC4
2021-01-09,PF/BT,HSP11-11bis,Ambulatorio COVID PO LODI,LOM,20-29,12,33,0,35,10,0,0,45,0,45,Lombardia,ITC4
2021-01-09,PF/BT,HSP11-11bis,Ambulatorio COVID PO LODI,LOM,30-39,21,46,0,48,19,0,0,67,0,67,Lombardia,ITC4
2021-01-09,PF/BT,HSP11-11bis,Ambulatorio COVID PO LODI,LOM,40-49,15,42,0,46,11,0,0,57,0,57,Lombardia,ITC4
2021-01-09,PF/BT,HSP11-11bis,Ambulatorio COVID PO LODI,LOM,50-59,25,94,0,89,30,0,0,119,0,119,Lombardia,ITC4
2021-01-09,PF/BT,HSP11-11bis,Ambulatorio COVID PO LODI,LOM,60-69,22,21,0,30,13,0,0,43,0,43,Lombardia,ITC4
2021-01-09,PF/BT,HSP11-11bis,Ambulatorio COVID PO LODI,LOM,70-79,2,1,0,1,2,0,0,3,0,3,Lombardia,ITC4
2021-01-09,PF/BT,HSP11-11bis,Ambulatorio COVID PO S.Angelo Lod.,LOM,20-29,5,6,0,7,4,0,0,11,0,11,Lombardia,ITC4
2021-01-09,PF/BT,HSP11-11bis,Ambulatorio COVID PO S.Angelo Lod.,LOM,30-39,5,2,0,4,3,0,0,7,0,7,Lombardia,ITC4
2021-01-09,PF/BT,HSP11-11bis,Ambulatorio COVID PO S.Angelo Lod.,LOM,40-49,2,9,0,9,2,0,0,11,0,11,Lombardia,ITC4
2021-01-09,PF/BT,HSP11-11bis,Ambulatorio COVID PO S.Angelo Lod.,LOM,50-59,12,26,0,30,8,0,0,38,0,38,Lombardia,ITC4
2021-01-09,PF/BT,HSP11-11bis,Ambulatorio COVID PO S.Angelo Lod.,LOM,60-69,3,6,0,8,1,0,0,9,0,9,Lombardia,ITC4
2021-01-09,PF/BT,HSP11-11bis,Ambulatorio COVID PO S.Angelo Lod.,LOM,70-79,1,1,0,2,0,0,0,2,0,2,Lombardia,ITC4
2021-01-09,PF/BT,HSP11-11bis,AMBULATORIO COVID PO SACCO,LOM,20-29,37,71,0,105,3,0,0,108,0,108,Lombardia,ITC4
2021-01-09,PF/BT,HSP11-11bis,AMBULATORIO COVID PO SACCO,LOM,30-39,34,66,0,94,6,0,0,100,0,100,Lombardia,ITC4
2021-01-09,PF/BT,HSP11-11bis,AMBULATORIO COVID PO SACCO,LOM,40-49,39,75,0,113,1,0,0,114,0,114,Lombardia,ITC4
2021-01-09,PF/BT,HSP11-11bis,AMBULATORIO COVID PO SACCO,LOM,50-59,67,97,0,154,10,0,0,164,0,164,Lombardia,ITC4
2021-01-09,PF/BT,HSP11-11bis,AMBULATORIO COVID PO SACCO,LOM,60-69,37,37,0,71,3,0,0,74,0,74,Lombardia,ITC4
2021-01-09,PF/BT,HSP11-11bis,AMBULATORIO COVID PO SACCO,LOM,70-79,9,1,0,10,0,0,0,10,0,10,Lombardia,ITC4
2021-01-09,PF/BT,HSP11-11bis,ASST BERGAMO OVEST - OSPEDALE ROMANO DI L.DIA,LOM,20-29,10,17,0,0,0,0,27,27,0,27,Lombardia,ITC4
2021-01-09,PF/BT,HSP11-11bis,ASST BERGAMO OVEST - OSPEDALE ROMANO DI L.DIA,LOM,30-39,6,4,0,1,0,0,9,10,0,10,Lombardia,ITC4
2021-01-09,PF/BT,HSP11-11bis,ASST BERGAMO OVEST - OSPEDALE ROMANO DI L.DIA,LOM,40-49,12,8,0,4,0,0,16,20,0,20,Lombardia,ITC4
2021-01-09,PF/BT,HSP11-11bis,ASST BERGAMO OVEST - OSPEDALE ROMANO DI L.DIA,LOM,50-59,18,19,0,4,1,0,32,37,0,37,Lombardia,ITC4
2021-01-09,PF/BT,HSP11-11bis,ASST BERGAMO OVEST - OSPEDALE ROMANO DI L.DIA,LOM,60-69,22,12,0,4,0,0,30,34,0,34,Lombardia,ITC4
2021-01-09,PF/BT,HSP11-11bis,ASST BERGAMO OVEST - OSPEDALE ROMANO DI L.DIA,LOM,70-79,8,2,0,0,0,0,10,10,0,10,Lombardia,ITC4
2021-01-09,PF/BT,HSP11-11bis,ASST BERGAMO OVEST - OSPEDALE TREVIGLIO,LOM,20-29,4,1,0,2,0,3,0,5,0,5,Lombardia,ITC4
2021-01-09,PF/BT,HSP11-11bis,ASST BERGAMO OVEST - OSPEDALE TREVIGLIO,LOM,30-39,6,5,0,4,0,7,0,11,0,11,Lombardia,ITC4
2021-01-09,PF/BT,HSP11-11bis,ASST BERGAMO OVEST - OSPEDALE TREVIGLIO,LOM,40-49,18,7,0,3,0,22,0,25,0,25,Lombardia,ITC4
2021-01-09,PF/BT,HSP11-11bis,ASST BERGAMO OVEST - OSPEDALE TREVIGLIO,LOM,50-59,15,14,0,13,0,16,0,29,0,29,Lombardia,ITC4
2021-01-09,PF/BT,HSP11-11bis,ASST BERGAMO OVEST - OSPEDALE TREVIGLIO,LOM,60-69,3,5,0,0,0,8,0,8,0,8,Lombardia,ITC4
2021-01-09,PF/BT,HSP11-11BIS-03010600,CASA DI CURA POLICLINICO DI MONZA-MONZA-,LOM,20-29,2,6,0,8,0,0,0,8,0,8,Lombardia,ITC4
2021-01-09,PF/BT,HSP11-11BIS-03010600,CASA DI CURA POLICLINICO DI MONZA-MONZA-,LOM,30-39,17,19,0,34,2,0,0,36,0,36,Lombardia,ITC4
2021-01-09,PF/BT,HSP11-11BIS-03010600,CASA DI CURA POLICLINICO DI MONZA-MONZA-,LOM,40-49,24,18,0,40,2,0,0,42,0,42,Lombardia,ITC4
2021-01-09,PF/BT,HSP11-11BIS-03010600,CASA DI CURA POLICLINICO DI MONZA-MONZA-,LOM,50-59,15,6,0,21,0,0,0,21,0,21,Lombardia,ITC4
2021-01-09,PF/BT,HSP11-11BIS-03010600,CASA DI CURA POLICLINICO DI MONZA-MONZA-,LOM,60-69,18,6,0,23,1,0,0,24,0,24,Lombardia,ITC4
2021-01-09,PF/BT,HSP11-11BIS-03010600,CASA DI CURA POLICLINICO DI MONZA-MONZA-,LOM,70-79,9,0,0,9,0,0,0,9,0,9,Lombardia,ITC4
2021-01-09,PF/BT,HSP11-11BIS-03010600,CASA DI CURA POLICLINICO DI MONZA-MONZA-,LOM,80-89,4,0,0,4,0,0,0,4,0,4,Lombardia,ITC4
2021-01-09,PF/BT,S09,RSA PII ISTITUTI UNIFICATI ONLUS,LOM,20-29,1,0,0,1,0,0,0,1,0,1,Lombardia,ITC4
2021-01-09,PF/BT,S09,RSA PII ISTITUTI UNIFICATI ONLUS,LOM,30-39,5,7,0,11,0,0,1,12,0,12,Lombardia,ITC4
2021-01-09,PF/BT,S09,RSA PII ISTITUTI UNIFICATI ONLUS,LOM,40-49,2,10,0,12,0,0,0,12,0,12,Lombardia,ITC4
2021-01-09,PF/BT,S09,RSA PII ISTITUTI UNIFICATI ONLUS,LOM,50-59,1,15,0,15,0,0,1,16,0,16,Lombardia,ITC4
2021-01-09,PF/BT,S09,RSA PII ISTITUTI UNIFICATI ONLUS,LOM,60-69,3,3,0,5,0,0,1,6,0,6,Lombardia,ITC4
2021-01-09,PF/BT,S09,RSA PII ISTITUTI UNIFICATI ONLUS,LOM,70-79,1,0,0,0,0,0,1,1,0,1,Lombardia,ITC4
2021-01-09,PF/BT,STS11,PVT COVID BRESCIA VIA ACERBI,LOM,20-29,7,17,0,5,2,0,17,24,0,24,Lombardia,ITC4
2021-01-09,PF/BT,STS11,PVT COVID BRESCIA VIA ACERBI,LOM,30-39,20,31,0,17,7,0,27,51,0,51,Lombardia,ITC4
2021-01-09,PF/BT,STS11,PVT COVID BRESCIA VIA ACERBI,LOM,40-49,33,44,0,33,8,0,36,77,0,77,Lombardia,ITC4
2021-01-09,PF/BT,STS11,PVT COVID BRESCIA VIA ACERBI,LOM,50-59,54,74,0,65,16,0,47,128,0,128,Lombardia,ITC4
2021-01-09,PF/BT,STS11,PVT COVID BRESCIA VIA ACERBI,LOM,60-69,37,37,0,33,8,0,33,74,0,74,Lombardia,ITC4
2021-01-09,PF/BT,STS11,PVT COVID BRESCIA VIA ACERBI,LOM,70-79,15,2,0,0,0,0,17,17,0,17,Lombardia,ITC4
2021-01-09,PF/BT,STS11,PVT COVID BRESCIA VIA ACERBI,LOM,80-89,1,0,0,0,1,0,0,1,0,1,Lombardia,ITC4
2021-01-10,PF/BT,(03027500/001752),PVO Istituto Clinico San Rocco (Spoke),LOM,20-29,1,3,0,4,0,0,0,4,0,4,Lombardia,ITC4
2021-01-10,PF/BT,(03027500/001752),PVO Istituto Clinico San Rocco (Spoke),LOM,30-39,5,6,0,11,0,0,0,11,0,11,Lombardia,ITC4
2021-01-10,PF/BT,(03027500/001752),PVO Istituto Clinico San Rocco (Spoke),LOM,40-49,3,20,0,20,3,0,0,23,0,23,Lombardia,ITC4
2021-01-10,PF/BT,(03027500/001752),PVO Istituto Clinico San Rocco (Spoke),LOM,50-59,5,11,0,12,4,0,0,16,0,16,Lombardia,ITC4
2021-01-10,PF/BT,(03027500/001752),PVO Istituto Clinico San Rocco (Spoke),LOM,60-69,2,4,0,5,1,0,0,6,0,6,Lombardia,ITC4
2021-01-10,PF/BT,.030042,ASST VAL - PRESIDIO OSPEDALIERO DI SONDRIO,LOM,20-29,4,2,0,4,2,0,0,6,0,6,Lombardia,ITC4
2021-01-10,PF/BT,.030042,ASST VAL - PRESIDIO OSPEDALIERO DI SONDRIO,LOM,30-39,2,5,0,3,4,0,0,7,0,7,Lombardia,ITC4
2021-01-10,PF/BT,.030042,ASST VAL - PRESIDIO OSPEDALIERO DI SONDRIO,LOM,40-49,2,10,0,8,4,0,0,12,0,12,Lombardia,ITC4
2021-01-10,PF/BT,.030042,ASST VAL - PRESIDIO OSPEDALIERO DI SONDRIO,LOM,50-59,7,14,0,10,11,0,0,21,0,21,Lombardia,ITC4
2021-01-10,PF/BT,.030042,ASST VAL - PRESIDIO OSPEDALIERO DI SONDRIO,LOM,60-69,9,5,0,11,3,0,0,14,0,14,Lombardia,ITC4
2021-01-10,PF/BT,0,Asst Lodi ambulatorio Covid Pres.Osp. Lodi,LOM,16-19,1,1,0,0,2,0,0,2,0,2,Lombardia,ITC4
2021-01-10,PF/BT,0,Asst Lodi ambulatorio Covid Pres.Osp. Lodi,LOM,20-29,3,14,0,8,9,0,0,17,0,17,Lombardia,ITC4
2021-01-10,PF/BT,0,Asst Lodi ambulatorio Covid Pres.Osp. Lodi,LOM,30-39,14,21,0,25,10,0,0,35,0,35,Lombardia,ITC4
2021-01-10,PF/BT,0,Asst Lodi ambulatorio Covid Pres.Osp. Lodi,LOM,40-49,12,35,0,33,14,0,0,47,0,47,Lombardia,ITC4
2021-01-10,PF/BT,0,Asst Lodi ambulatorio Covid Pres.Osp. Lodi,LOM,50-59,9,27,0,27,9,0,0,36,0,36,Lombardia,ITC4
2021-01-10,PF/BT,0,Asst Lodi ambulatorio Covid Pres.Osp. Lodi,LOM,60-69,14,9,0,12,11,0,0,23,0,23,Lombardia,ITC4
2021-01-10,PF/BT,0,Asst Lodi ambulatorio Covid Pres.Osp. Lodi,LOM,70-79,2,0,0,2,0,0,0,2,0,2,Lombardia,ITC4
2021-01-10,PF/BT,0,Istituto Redaelli Milano,LOM,20-29,4,2,0,6,0,0,0,6,0,6,Lombardia,ITC4
2021-01-10,PF/BT,0,Istituto Redaelli Milano,LOM,30-39,3,6,0,9,0,0,0,9,0,9,Lombardia,ITC4
2021-01-10,PF/BT,0,Istituto Redaelli Milano,LOM,40-49,4,12,0,16,0,0,0,16,0,16,Lombardia,ITC4
2021-01-10,PF/BT,0,Istituto Redaelli Milano,LOM,50-59,1,12,0,13,0,0,0,13,0,13,Lombardia,ITC4
2021-01-10,PF/BT,0,Istituto Redaelli Milano,LOM,60-69,0,4,0,4,0,0,0,4,0,4,Lombardia,ITC4
2021-01-10,PF/BT,003335,HUB COV CHIARI - P.O. CHIARI ASST FRANCIACORTA,LOM,16-19,2,2,0,4,0,0,0,4,0,4,Lombardia,ITC4
2021-01-10,PF/BT,003335,HUB COV CHIARI - P.O. CHIARI ASST FRANCIACORTA,LOM,20-29,12,16,0,26,2,0,0,28,0,28,Lombardia,ITC4
2021-01-10,PF/BT,003335,HUB COV CHIARI - P.O. CHIARI ASST FRANCIACORTA,LOM,30-39,8,11,0,19,0,0,0,19,0,19,Lombardia,ITC4
2021-01-10,PF/BT,003335,HUB COV CHIARI - P.O. CHIARI ASST FRANCIACORTA,LOM,40-49,13,16,0,27,2,0,0,29,0,29,Lombardia,ITC4
2021-01-10,PF/BT,003335,HUB COV CHIARI - P.O. CHIARI ASST FRANCIACORTA,LOM,50-59,45,37,0,73,9,0,0,82,0,82,Lombardia,ITC4
2021-01-10,PF/BT,003335,HUB COV CHIARI - P.O. CHIARI ASST FRANCIACORTA,LOM,60-69,5,1,0,6,0,0,0,6,0,6,Lombardia,ITC4
2021-01-10,PF/BT,030066,CV Garbagnate,LOM,20-29,30,35,0,63,0,0,2,65,0,65,Lombardia,ITC4
2021-01-10,PF/BT,030066,CV Garbagnate,LOM,30-39,14,19,0,27,0,0,6,33,0,33,Lombardia,ITC4
2021-01-10,PF/BT,030066,CV Garbagnate,LOM,40-49,21,18,0,29,1,0,9,39,0,39,Lombardia,ITC4
2021-01-10,PF/BT,030066,CV Garbagnate,LOM,50-59,19,33,0,36,5,0,11,52,0,52,Lombardia,ITC4
2021-01-10,PF/BT,030066,CV Garbagnate,LOM,60-69,9,19,0,26,1,0,1,28,0,28,Lombardia,ITC4
2021-01-10,PF/BT,030066,CV Garbagnate,LOM,70-79,4,1,0,5,0,0,0,5,0,5,Lombardia,ITC4
2021-01-10,PF/BT,030068,PUNTO VACCINALE OSPEDALIERO DESIO,LOM,16-19,3,1,0,4,0,0,0,4,0,4,Lombardia,ITC4
2021-01-10,PF/BT,030068,PUNTO VACCINALE OSPEDALIERO DESIO,LOM,20-29,15,20,0,34,1,0,0,35,0,35,Lombardia,ITC4
2021-01-10,PF/BT,030068,PUNTO VACCINALE OSPEDALIERO DESIO,LOM,30-39,14,17,0,27,4,0,0,31,0,31,Lombardia,ITC4
2021-01-10,PF/BT,030068,PUNTO VACCINALE OSPEDALIERO DESIO,LOM,40-49,23,20,0,39,4,0,0,43,0,43,Lombardia,ITC4
2021-01-10,PF/BT,030068,PUNTO VACCINALE OSPEDALIERO DESIO,LOM,50-59,24,32,0,47,9,0,0,56,0,56,Lombardia,ITC4
2021-01-10,PF/BT,030068,PUNTO VACCINALE OSPEDALIERO DESIO,LOM,60-69,27,15,0,40,2,0,0,42,0,42,Lombardia,ITC4
2021-01-10,PF/BT,030068,PUNTO VACCINALE OSPEDALIERO DESIO,LOM,70-79,6,0,0,6,0,0,0,6,0,6,Lombardia,ITC4
2021-01-10,PF/BT,030070,PUNTO VACCINALE OSPEDALIERO CARATE BRIANZA,LOM,20-29,7,10,0,16,1,0,0,17,0,17,Lombardia,ITC4
2021-01-10,PF/BT,030070,PUNTO VACCINALE OSPEDALIERO CARATE BRIANZA,LOM,30-39,16,17,0,32,1,0,0,33,0,33,Lombardia,ITC4
2021-01-10,PF/BT,030070,PUNTO VACCINALE OSPEDALIERO CARATE BRIANZA,LOM,40-49,27,10,0,34,3,0,0,37,0,37,Lombardia,ITC4
2021-01-10,PF/BT,030070,PUNTO VACCINALE OSPEDALIERO CARATE BRIANZA,LOM,50-59,18,13,0,28,3,0,0,31,0,31,Lombardia,ITC4
2021-01-10,PF/BT,030070,PUNTO VACCINALE OSPEDALIERO CARATE BRIANZA,LOM,60-69,11,8,0,19,0,0,0,19,0,19,Lombardia,ITC4
2021-01-10,PF/BT,030070,PUNTO VACCINALE OSPEDALIERO CARATE BRIANZA,LOM,70-79,2,2,0,4,0,0,0,4,0,4,Lombardia,ITC4
2021-01-10,PF/BT,030078,PUNTO VACCINALE OSPEDALIERO VIMERCATE,LOM,20-29,9,16,0,19,6,0,0,25,0,25,Lombardia,ITC4
2021-01-10,PF/BT,030078,PUNTO VACCINALE OSPEDALIERO VIMERCATE,LOM,30-39,5,13,0,18,0,0,0,18,0,18,Lombardia,ITC4
2021-01-10,PF/BT,030078,PUNTO VACCINALE OSPEDALIERO VIMERCATE,LOM,40-49,13,24,0,30,7,0,0,37,0,37,Lombardia,ITC4
2021-01-10,PF/BT,030078,PUNTO VACCINALE OSPEDALIERO VIMERCATE,LOM,50-59,18,21,0,31,8,0,0,39,0,39,Lombardia,ITC4
2021-01-10,PF/BT,030078,PUNTO VACCINALE OSPEDALIERO VIMERCATE,LOM,60-69,17,24,0,36,5,0,0,41,0,41,Lombardia,ITC4
2021-01-10,PF/BT,030078,PUNTO VACCINALE OSPEDALIERO VIMERCATE,LOM,70-79,10,6,0,16,0,0,0,16,0,16,Lombardia,ITC4
2021-01-10,PF/BT,030107,ISTITUTI CLINICI ZUCCHI - PRESIDIO DI MONZA,LOM,20-29,6,3,0,9,0,0,0,9,0,9,Lombardia,ITC4
2021-01-10,PF/BT,030107,ISTITUTI CLINICI ZUCCHI - PRESIDIO DI MONZA,LOM,30-39,15,13,0,28,0,0,0,28,0,28,Lombardia,ITC4
2021-01-10,PF/BT,030107,ISTITUTI CLINICI ZUCCHI - PRESIDIO DI MONZA,LOM,40-49,7,20,0,27,0,0,0,27,0,27,Lombardia,ITC4
2021-01-10,PF/BT,030107,ISTITUTI CLINICI ZUCCHI - PRESIDIO DI MONZA,LOM,50-59,10,25,0,35,0,0,0,35,0,35,Lombardia,ITC4
2021-01-10,PF/BT,030107,ISTITUTI CLINICI ZUCCHI - PRESIDIO DI MONZA,LOM,60-69,6,2,0,8,0,0,0,8,0,8,Lombardia,ITC4
2021-01-10,PF/BT,030107,ISTITUTI CLINICI ZUCCHI - PRESIDIO DI MONZA,LOM,70-79,1,0,0,1,0,0,0,1,0,1,Lombardia,ITC4
2021-01-10,PF/BT,030178,ISTITUTO CLINICO CITTA' DI BRESCIA DI ISTITUTI OSPEDALIERI BRESCIANI,LOM,20-29,3,4,0,7,0,0,0,7,0,7,Lombardia,ITC4
2021-01-10,PF/BT,030178,ISTITUTO CLINICO CITTA' DI BRESCIA DI ISTITUTI OSPEDALIERI BRESCIANI,LOM,30-39,3,5,0,8,0,0,0,8,0,8,Lombardia,ITC4
2021-01-10,PF/BT,030178,ISTITUTO CLINICO CITTA' DI BRESCIA DI ISTITUTI OSPEDALIERI BRESCIANI,LOM,40-49,4,11,0,15,0,0,0,15,0,15,Lombardia,ITC4
2021-01-10,PF/BT,030178,ISTITUTO CLINICO CITTA' DI BRESCIA DI ISTITUTI OSPEDALIERI BRESCIANI,LOM,50-59,2,8,0,10,0,0,0,10,0,10,Lombardia,ITC4
2021-01-10,PF/BT,030178,ISTITUTO CLINICO CITTA' DI BRESCIA DI ISTITUTI OSPEDALIERI BRESCIANI,LOM,60-69,4,2,0,6,0,0,0,6,0,6,Lombardia,ITC4
2021-01-10,PF/BT,030178,ISTITUTO CLINICO CITTA' DI BRESCIA DI ISTITUTI OSPEDALIERI BRESCIANI,LOM,70-79,2,0,0,2,0,0,0,2,0,2,Lombardia,ITC4
2021-01-10,PF/BT,030324001093 -  030324001116,ISTIT.RIUNITI AIROLDI E MUZZI,LOM,20-29,1,5,0,6,0,0,0,6,0,6,Lombardia,ITC4
2021-01-10,PF/BT,030324001093 -  030324001116,ISTIT.RIUNITI AIROLDI E MUZZI,LOM,30-39,0,1,0,1,0,0,0,1,0,1,Lombardia,ITC4
2021-01-10,PF/BT,030324001093 -  030324001116,ISTIT.RIUNITI AIROLDI E MUZZI,LOM,40-49,1,7,0,7,1,0,0,8,0,8,Lombardia,ITC4
2021-01-10,PF/BT,030324001093 -  030324001116,ISTIT.RIUNITI AIROLDI E MUZZI,LOM,50-59,3,12,0,10,5,0,0,15,0,15,Lombardia,ITC4
2021-01-10,PF/BT,030704,Presidio Ospedaliero G. Pini,LOM,20-29,3,4,0,7,0,0,0,7,0,7,Lombardia,ITC4
2021-01-10,PF/BT,030704,Presidio Ospedaliero G. Pini,LOM,30-39,3,1,0,3,1,0,0,4,0,4,Lombardia,ITC4
2021-01-10,PF/BT,030704,Presidio Ospedaliero G. Pini,LOM,40-49,4,4,0,7,1,0,0,8,0,8,Lombardia,ITC4
2021-01-10,PF/BT,030704,Presidio Ospedaliero G. Pini,LOM,50-59,5,3,0,7,1,0,0,8,0,8,Lombardia,ITC4
2021-01-10,PF/BT,030704,Presidio Ospedaliero G. Pini,LOM,60-69,1,0,0,1,0,0,0,1,0,1,Lombardia,ITC4
2021-01-10,PF/BT,030704,Presidio Ospedaliero G. Pini,LOM,70-79,1,1,0,2,0,0,0,2,0,2,Lombardia,ITC4
2021-01-10,PF/BT,030903,AMB COVID LECCO,LOM,16-19,1,3,0,1,3,0,0,4,0,4,Lombardia,ITC4
2021-01-10,PF/BT,030903,AMB COVID LECCO,LOM,20-29,21,54,0,49,26,0,0,75,0,75,Lombardia,ITC4
2021-01-10,PF/BT,030903,AMB COVID LECCO,LOM,30-39,20,50,0,46,24,0,0,70,0,70,Lombardia,ITC4
2021-01-10,PF/BT,030903,AMB COVID LECCO,LOM,40-49,20,46,0,42,24,0,0,66,0,66,Lombardia,ITC4
2021-01-10,PF/BT,030903,AMB COVID LECCO,LOM,50-59,27,75,0,57,45,0,0,102,0,102,Lombardia,ITC4
2021-01-10,PF/BT,030903,AMB COVID LECCO,LOM,60-69,25,15,0,11,29,0,0,40,0,40,Lombardia,ITC4
2021-01-10,PF/BT,030903,AMB COVID LECCO,LOM,70-79,7,1,0,0,8,0,0,8,0,8,Lombardia,ITC4
2021-01-10,PF/BT,030903,AMB COVID LECCO,LOM,80-89,0,1,0,0,1,0,0,1,0,1,Lombardia,ITC4
2021-01-10,PF/BT,030922,"FOND.IRCCS ""ISTIT.NAZ.LE TUMORI""MILANO",LOM,20-29,4,15,0,16,2,0,1,19,0,19,Lombardia,ITC4
2021-01-10,PF/BT,030922,"FOND.IRCCS ""ISTIT.NAZ.LE TUMORI""MILANO",LOM,30-39,11,14,0,8,15,0,2,25,0,25,Lombardia,ITC4
2021-01-10,PF/BT,030922,"FOND.IRCCS ""ISTIT.NAZ.LE TUMORI""MILANO",LOM,40-49,9,17,0,7,19,0,0,26,0,26,Lombardia,ITC4
2021-01-10,PF/BT,030922,"FOND.IRCCS ""ISTIT.NAZ.LE TUMORI""MILANO",LOM,50-59,8,25,0,17,15,0,1,33,0,33,Lombardia,ITC4
2021-01-10,PF/BT,030922,"FOND.IRCCS ""ISTIT.NAZ.LE TUMORI""MILANO",LOM,60-69,6,11,0,6,11,0,0,17,0,17,Lombardia,ITC4
2021-01-10,PF/BT,030923,FOND.IRCCS IST.NAZ.NEUROLOGICO C.BESTA-M,LOM,20-29,0,7,0,0,0,0,7,7,0,7,Lombardia,ITC4
2021-01-10,PF/BT,030923,FOND.IRCCS IST.NAZ.NEUROLOGICO C.BESTA-M,LOM,30-39,1,4,0,1,0,0,4,5,0,5,Lombardia,ITC4
2021-01-10,PF/BT,030923,FOND.IRCCS IST.NAZ.NEUROLOGICO C.BESTA-M,LOM,40-49,4,14,0,4,1,0,13,18,0,18,Lombardia,ITC4
2021-01-10,PF/BT,030923,FOND.IRCCS IST.NAZ.NEUROLOGICO C.BESTA-M,LOM,50-59,3,10,0,1,1,0,11,13,0,13,Lombardia,ITC4
2021-01-10,PF/BT,030923,FOND.IRCCS IST.NAZ.NEUROLOGICO C.BESTA-M,LOM,60-69,4,28,0,2,0,0,30,32,0,32,Lombardia,ITC4
2021-01-10,PF/BT,030923,FOND.IRCCS IST.NAZ.NEUROLOGICO C.BESTA-M,LOM,70-79,6,22,0,0,0,0,28,28,0,28,Lombardia,ITC4
2021-01-10,PF/BT,030923,FOND.IRCCS IST.NAZ.NEUROLOGICO C.BESTA-M,LOM,80-89,0,4,0,0,0,0,4,4,0,4,Lombardia,ITC4
2021-01-10,PF/BT,030924,IRCCS POLICLINICO S. MATTEO - PAVIA,LOM,20-29,8,19,0,26,1,0,0,27,0,27,Lombardia,ITC4
2021-01-10,PF/BT,030924,IRCCS POLICLINICO S. MATTEO - PAVIA,LOM,30-39,13,20,0,33,0,0,0,33,0,33,Lombardia,ITC4
2021-01-10,PF/BT,030924,IRCCS POLICLINICO S. MATTEO - PAVIA,LOM,40-49,16,45,0,51,9,0,1,61,0,61,Lombardia,ITC4
2021-01-10,PF/BT,030924,IRCCS POLICLINICO S. MATTEO - PAVIA,LOM,50-59,41,104,0,111,31,0,3,145,0,145,Lombardia,ITC4
2021-01-10,PF/BT,030924,IRCCS POLICLINICO S. MATTEO - PAVIA,LOM,60-69,13,26,0,33,6,0,0,39,0,39,Lombardia,ITC4
2021-01-10,PF/BT,030924,IRCCS POLICLINICO S. MATTEO - PAVIA,LOM,80-89,1,0,0,1,0,0,0,1,0,1,Lombardia,ITC4
2021-01-10,PF/BT,030925,Fondazione IRCCS Ca' Granda Ospedale Maggiore Policlinico,LOM,16-19,1,7,0,8,0,0,0,8,0,8,Lombardia,ITC4
2021-01-10,PF/BT,030925,Fondazione IRCCS Ca' Granda Ospedale Maggiore Policlinico,LOM,20-29,16,71,0,80,7,0,0,87,0,87,Lombardia,ITC4
2021-01-10,PF/BT,030925,Fondazione IRCCS Ca' Granda Ospedale Maggiore Policlinico,LOM,30-39,28,35,0,43,20,0,0,63,0,63,Lombardia,ITC4
2021-01-10,PF/BT,030925,Fondazione IRCCS Ca' Granda Ospedale Maggiore Policlinico,LOM,40-49,14,24,0,25,13,0,0,38,0,38,Lombardia,ITC4
2021-01-10,PF/BT,030925,Fondazione IRCCS Ca' Granda Ospedale Maggiore Policlinico,LOM,50-59,15,24,0,26,13,0,0,39,0,39,Lombardia,ITC4
2021-01-10,PF/BT,030925,Fondazione IRCCS Ca' Granda Ospedale Maggiore Policlinico,LOM,60-69,10,5,0,10,5,0,0,15,0,15,Lombardia,ITC4
2021-01-10,PF/BT,030935,IRCCS    S. RAFFAELE - MILANO,LOM,20-29,0,3,0,3,0,0,0,3,0,3,Lombardia,ITC4
2021-01-10,PF/BT,030935,IRCCS    S. RAFFAELE - MILANO,LOM,30-39,1,0,0,1,0,0,0,1,0,1,Lombardia,ITC4
2021-01-10,PF/BT,030935,IRCCS    S. RAFFAELE - MILANO,LOM,50-59,1,1,0,2,0,0,0,2,0,2,Lombardia,ITC4
2021-01-10,PF/BT,030943,Istituto Clinico Humanitas,LOM,20-29,12,27,0,25,14,0,0,39,0,39,Lombardia,ITC4
2021-01-10,PF/BT,030943,Istituto Clinico Humanitas,LOM,30-39,16,42,0,26,32,0,0,58,0,58,Lombardia,ITC4
2021-01-10,PF/BT,030943,Istituto Clinico Humanitas,LOM,40-49,20,47,0,34,33,0,0,67,0,67,Lombardia,ITC4
2021-01-10,PF/BT,030943,Istituto Clinico Humanitas,LOM,50-59,13,17,0,21,9,0,0,30,0,30,Lombardia,ITC4
2021-01-10,PF/BT,030943,Istituto Clinico Humanitas,LOM,60-69,4,5,0,5,4,0,0,9,0,9,Lombardia,ITC4
2021-01-10,PF/BT,030943,Istituto Clinico Humanitas,LOM,70-79,1,0,0,0,1,0,0,1,0,1,Lombardia,ITC4
2021-01-10,PF/BT,2859,RSA FONDAZIONE BELLARIA ONLUS,LOM,20-29,1,3,0,4,0,0,0,4,0,4,Lombardia,ITC4
2021-01-10,PF/BT,2859,RSA FONDAZIONE BELLARIA ONLUS,LOM,30-39,2,5,0,6,0,0,1,7,0,7,Lombardia,ITC4
2021-01-10,PF/BT,2859,RSA FONDAZIONE BELLARIA ONLUS,LOM,40-49,0,6,0,5,1,0,0,6,0,6,Lombardia,ITC4
2021-01-10,PF/BT,2859,RSA FONDAZIONE BELLARIA ONLUS,LOM,50-59,0,5,0,5,0,0,0,5,0,5,Lombardia,ITC4
2021-01-10,PF/BT,2859,RSA FONDAZIONE BELLARIA ONLUS,LOM,60-69,0,2,0,2,0,0,0,2,0,2,Lombardia,ITC4
2021-01-10,PF/BT,294,Casa di cura Domus Salutis - Brescia,LOM,20-29,9,34,0,43,0,0,0,43,0,43,Lombardia,ITC4
2021-01-10,PF/BT,294,Casa di cura Domus Salutis - Brescia,LOM,30-39,23,21,0,43,1,0,0,44,0,44,Lombardia,ITC4
2021-01-10,PF/BT,294,Casa di cura Domus Salutis - Brescia,LOM,40-49,13,45,0,57,1,0,0,58,0,58,Lombardia,ITC4
2021-01-10,PF/BT,294,Casa di cura Domus Salutis - Brescia,LOM,50-59,13,65,0,78,0,0,0,78,0,78,Lombardia,ITC4
2021-01-10,PF/BT,294,Casa di cura Domus Salutis - Brescia,LOM,60-69,6,7,0,13,0,0,0,13,0,13,Lombardia,ITC4
2021-01-10,PF/BT,294,Casa di cura Domus Salutis - Brescia,LOM,70-79,1,2,0,3,0,0,0,3,0,3,Lombardia,ITC4
2021-01-10,PF/BT,294,Casa di cura Domus Salutis - Brescia,LOM,90+,0,1,0,1,0,0,0,1,0,1,Lombardia,ITC4
2021-01-10,PF/BT,30022,Ospedale S.Antonio Abate - Cantu',LOM,20-29,13,15,0,21,7,0,0,28,0,28,Lombardia,ITC4
2021-01-10,PF/BT,30022,Ospedale S.Antonio Abate - Cantu',LOM,30-39,19,53,0,57,14,0,1,72,0,72,Lombardia,ITC4
2021-01-10,PF/BT,30022,Ospedale S.Antonio Abate - Cantu',LOM,40-49,21,95,0,92,24,0,0,116,0,116,Lombardia,ITC4
2021-01-10,PF/BT,30022,Ospedale S.Antonio Abate - Cantu',LOM,50-59,56,191,0,194,53,0,0,247,0,247,Lombardia,ITC4
2021-01-10,PF/BT,30022,Ospedale S.Antonio Abate - Cantu',LOM,60-69,59,52,0,98,13,0,0,111,0,111,Lombardia,ITC4
2021-01-10,PF/BT,30022,Ospedale S.Antonio Abate - Cantu',LOM,70-79,1,0,0,1,0,0,0,1,0,1,Lombardia,ITC4
2021-01-10,PF/BT,30072,Centro Vaccinale Covid Vizzolo - ASST Melegnano Martesana,LOM,20-29,9,14,0,16,7,0,0,23,0,23,Lombardia,ITC4
2021-01-10,PF/BT,30072,Centro Vaccinale Covid Vizzolo - ASST Melegnano Martesana,LOM,30-39,13,26,0,27,12,0,0,39,0,39,Lombardia,ITC4
2021-01-10,PF/BT,30072,Centro Vaccinale Covid Vizzolo - ASST Melegnano Martesana,LOM,40-49,12,32,0,32,12,0,0,44,0,44,Lombardia,ITC4
2021-01-10,PF/BT,30072,Centro Vaccinale Covid Vizzolo - ASST Melegnano Martesana,LOM,50-59,28,59,0,66,21,0,0,87,0,87,Lombardia,ITC4
2021-01-10,PF/BT,30072,Centro Vaccinale Covid Vizzolo - ASST Melegnano Martesana,LOM,60-69,41,45,0,77,9,0,0,86,0,86,Lombardia,ITC4
2021-01-10,PF/BT,30072,Centro Vaccinale Covid Vizzolo - ASST Melegnano Martesana,LOM,70-79,6,2,0,8,0,0,0,8,0,8,Lombardia,ITC4
2021-01-10,PF/BT,30073,CV Bollate,LOM,16-19,0,1,0,1,0,0,0,1,0,1,Lombardia,ITC4
2021-01-10,PF/BT,30073,CV Bollate,LOM,20-29,8,6,0,14,0,0,0,14,0,14,Lombardia,ITC4
2021-01-10,PF/BT,30073,CV Bollate,LOM,30-39,3,0,0,3,0,0,0,3,0,3,Lombardia,ITC4
2021-01-10,PF/BT,30073,CV Bollate,LOM,40-49,5,1,0,6,0,0,0,6,0,6,Lombardia,ITC4
2021-01-10,PF/BT,30073,CV Bollate,LOM,50-59,4,4,0,8,0,0,0,8,0,8,Lombardia,ITC4
2021-01-10,PF/BT,30073,CV Bollate,LOM,60-69,0,1,0,1,0,0,0,1,0,1,Lombardia,ITC4
2021-01-10,PF/BT,30073,CV Bollate,LOM,70-79,2,1,0,3,0,0,0,3,0,3,Lombardia,ITC4
2021-01-10,PF/BT,30073,cv rho,LOM,16-19,2,4,0,6,0,0,0,6,0,6,Lombardia,ITC4
2021-01-10,PF/BT,30073,cv rho,LOM,20-29,12,17,0,29,0,0,0,29,0,29,Lombardia,ITC4
2021-01-10,PF/BT,30073,cv rho,LOM,30-39,16,14,0,30,0,0,0,30,0,30,Lombardia,ITC4
2021-01-10,PF/BT,30073,cv rho,LOM,40-49,11,13,0,22,2,0,0,24,0,24,Lombardia,ITC4
2021-01-10,PF/BT,30073,cv rho,LOM,50-59,12,22,0,33,1,0,0,34,0,34,Lombardia,ITC4
2021-01-10,PF/BT,30073,cv rho,LOM,60-69,18,11,0,28,1,0,0,29,0,29,Lombardia,ITC4
2021-01-10,PF/BT,30073,cv rho,LOM,70-79,9,1,0,10,0,0,0,10,0,10,Lombardia,ITC4
2021-01-10,PF/BT,30074,HUB COVID MAGENTA,LOM,20-29,2,4,0,6,0,0,0,6,0,6,Lombardia,ITC4
2021-01-10,PF/BT,30074,HUB COVID MAGENTA,LOM,30-39,12,18,0,25,5,0,0,30,0,30,Lombardia,ITC4
2021-01-10,PF/BT,30074,HUB COVID MAGENTA,LOM,40-49,0,24,0,22,2,0,0,24,0,24,Lombardia,ITC4
2021-01-10,PF/BT,30074,HUB COVID MAGENTA,LOM,50-59,12,40,0,52,0,0,0,52,0,52,Lombardia,ITC4
2021-01-10,PF/BT,30074,HUB COVID MAGENTA,LOM,60-69,40,22,0,61,1,0,0,62,0,62,Lombardia,ITC4
2021-01-10,PF/BT,30074,HUB COVID MAGENTA,LOM,70-79,2,1,0,3,0,0,0,3,0,3,Lombardia,ITC4
2021-01-10,PF/BT,30156,Centro Vaccinale Covid Desenzano,LOM,20-29,6,15,0,21,0,0,0,21,0,21,Lombardia,ITC4
2021-01-10,PF/BT,30156,Centro Vaccinale Covid Desenzano,LOM,30-39,6,5,0,9,0,0,2,11,0,11,Lombardia,ITC4
2021-01-10,PF/BT,30156,Centro Vaccinale Covid Desenzano,LOM,40-49,6,11,0,12,4,0,1,17,0,17,Lombardia,ITC4
2021-01-10,PF/BT,30156,Centro Vaccinale Covid Desenzano,LOM,50-59,14,26,0,26,8,0,6,40,0,40,Lombardia,ITC4
2021-01-10,PF/BT,30156,Centro Vaccinale Covid Desenzano,LOM,60-69,11,8,0,15,3,0,1,19,0,19,Lombardia,ITC4
2021-01-10,PF/BT,30157,Centro Vaccinale Covid Gavardo,LOM,20-29,6,7,0,2,0,0,11,13,0,13,Lombardia,ITC4
2021-01-10,PF/BT,30157,Centro Vaccinale Covid Gavardo,LOM,30-39,9,7,0,1,0,0,15,16,0,16,Lombardia,ITC4
2021-01-10,PF/BT,30157,Centro Vaccinale Covid Gavardo,LOM,40-49,13,10,0,7,0,0,16,23,0,23,Lombardia,ITC4
2021-01-10,PF/BT,30157,Centro Vaccinale Covid Gavardo,LOM,50-59,10,9,0,6,0,0,13,19,0,19,Lombardia,ITC4
2021-01-10,PF/BT,30157,Centro Vaccinale Covid Gavardo,LOM,60-69,14,5,0,3,0,0,16,19,0,19,Lombardia,ITC4
2021-01-10,PF/BT,30157,Centro Vaccinale Covid Gavardo,LOM,70-79,4,1,0,0,0,0,5,5,0,5,Lombardia,ITC4
2021-01-10,PF/BT,30176,ISTITUTO CLINICO S. ANNA di ISTITUTI OSPEDALIERI BRESCIANI S.p.A.,LOM,20-29,1,5,0,6,0,0,0,6,0,6,Lombardia,ITC4
2021-01-10,PF/BT,30176,ISTITUTO CLINICO S. ANNA di ISTITUTI OSPEDALIERI BRESCIANI S.p.A.,LOM,30-39,3,12,0,15,0,0,0,15,0,15,Lombardia,ITC4
2021-01-10,PF/BT,30176,ISTITUTO CLINICO S. ANNA di ISTITUTI OSPEDALIERI BRESCIANI S.p.A.,LOM,40-49,3,18,0,21,0,0,0,21,0,21,Lombardia,ITC4
2021-01-10,PF/BT,30176,ISTITUTO CLINICO S. ANNA di ISTITUTI OSPEDALIERI BRESCIANI S.p.A.,LOM,50-59,1,6,0,7,0,0,0,7,0,7,Lombardia,ITC4
2021-01-10,PF/BT,30176,ISTITUTO CLINICO S. ANNA di ISTITUTI OSPEDALIERI BRESCIANI S.p.A.,LOM,60-69,3,1,0,4,0,0,0,4,0,4,Lombardia,ITC4
2021-01-10,PF/BT,30176,ISTITUTO CLINICO S. ANNA di ISTITUTI OSPEDALIERI BRESCIANI S.p.A.,LOM,70-79,1,0,0,1,0,0,0,1,0,1,Lombardia,ITC4
2021-01-10,PF/BT,30184,Centro Vaccinale Covid Manerbio,LOM,20-29,0,7,0,7,0,0,0,7,0,7,Lombardia,ITC4
2021-01-10,PF/BT,30184,Centro Vaccinale Covid Manerbio,LOM,30-39,2,14,0,15,1,0,0,16,0,16,Lombardia,ITC4
2021-01-10,PF/BT,30184,Centro Vaccinale Covid Manerbio,LOM,40-49,7,26,0,26,7,0,0,33,0,33,Lombardia,ITC4
2021-01-10,PF/BT,30184,Centro Vaccinale Covid Manerbio,LOM,50-59,7,29,0,35,1,0,0,36,0,36,Lombardia,ITC4
2021-01-10,PF/BT,30184,Centro Vaccinale Covid Manerbio,LOM,60-69,9,6,0,14,1,0,0,15,0,15,Lombardia,ITC4
2021-01-10,PF/BT,30184,Centro Vaccinale Covid Manerbio,LOM,70-79,1,0,0,1,0,0,0,1,0,1,Lombardia,ITC4
2021-01-10,PF/BT,30193,Ambulatorio HUB Vigevano,LOM,20-29,3,10,0,13,0,0,0,13,0,13,Lombardia,ITC4
2021-01-10,PF/BT,30193,Ambulatorio HUB Vigevano,LOM,30-39,2,11,0,11,2,0,0,13,0,13,Lombardia,ITC4
2021-01-10,PF/BT,30193,Ambulatorio HUB Vigevano,LOM,40-49,5,14,0,17,2,0,0,19,0,19,Lombardia,ITC4
2021-01-10,PF/BT,30193,Ambulatorio HUB Vigevano,LOM,50-59,6,29,0,33,2,0,0,35,0,35,Lombardia,ITC4
2021-01-10,PF/BT,30193,Ambulatorio HUB Vigevano,LOM,60-69,4,16,0,15,5,0,0,20,0,20,Lombardia,ITC4
2021-01-10,PF/BT,30194,AMBULATORIO HUB VOGHERA,LOM,20-29,3,13,0,14,2,0,0,16,0,16,Lombardia,ITC4
2021-01-10,PF/BT,30194,AMBULATORIO HUB VOGHERA,LOM,30-39,9,20,0,26,3,0,0,29,0,29,Lombardia,ITC4
2021-01-10,PF/BT,30194,AMBULATORIO HUB VOGHERA,LOM,40-49,6,27,0,29,4,0,0,33,0,33,Lombardia,ITC4
2021-01-10,PF/BT,30194,AMBULATORIO HUB VOGHERA,LOM,50-59,13,53,0,53,13,0,0,66,0,66,Lombardia,ITC4
2021-01-10,PF/BT,30194,AMBULATORIO HUB VOGHERA,LOM,60-69,5,12,0,17,0,0,0,17,0,17,Lombardia,ITC4
2021-01-10,PF/BT,30209,OSPEDALE MAGGIORE DI CREMA,LOM,16-19,0,1,0,0,0,0,1,1,0,1,Lombardia,ITC4
2021-01-10,PF/BT,30209,OSPEDALE MAGGIORE DI CREMA,LOM,20-29,2,7,0,2,0,0,7,9,0,9,Lombardia,ITC4
2021-01-10,PF/BT,30209,OSPEDALE MAGGIORE DI CREMA,LOM,30-39,3,16,0,4,0,0,15,19,0,19,Lombardia,ITC4
2021-01-10,PF/BT,30209,OSPEDALE MAGGIORE DI CREMA,LOM,40-49,6,16,0,0,0,0,22,22,0,22,Lombardia,ITC4
2021-01-10,PF/BT,30209,OSPEDALE MAGGIORE DI CREMA,LOM,50-59,9,20,0,1,0,0,28,29,0,29,Lombardia,ITC4
2021-01-10,PF/BT,30209,OSPEDALE MAGGIORE DI CREMA,LOM,60-69,2,8,0,1,1,0,8,10,0,10,Lombardia,ITC4
2021-01-10,PF/BT,30281,HUB COVID LEGNANO,LOM,20-29,5,4,0,9,0,0,0,9,0,9,Lombardia,ITC4
2021-01-10,PF/BT,30281,HUB COVID LEGNANO,LOM,30-39,3,16,0,19,0,0,0,19,0,19,Lombardia,ITC4
2021-01-10,PF/BT,30281,HUB COVID LEGNANO,LOM,40-49,3,19,0,22,0,0,0,22,0,22,Lombardia,ITC4
2021-01-10,PF/BT,30281,HUB COVID LEGNANO,LOM,50-59,18,45,0,61,2,0,0,63,0,63,Lombardia,ITC4
2021-01-10,PF/BT,30281,HUB COVID LEGNANO,LOM,60-69,51,30,0,81,0,0,0,81,0,81,Lombardia,ITC4
2021-01-10,PF/BT,3034800,CASA DI CURA VILLA GEMMA PRESSO CASA DI CURA VILLA BARBARANO,LOM,20-29,0,4,0,3,1,0,0,4,0,4,Lombardia,ITC4
2021-01-10,PF/BT,3034800,CASA DI CURA VILLA GEMMA PRESSO CASA DI CURA VILLA BARBARANO,LOM,30-39,1,3,0,4,0,0,0,4,0,4,Lombardia,ITC4
2021-01-10,PF/BT,3034800,CASA DI CURA VILLA GEMMA PRESSO CASA DI CURA VILLA BARBARANO,LOM,40-49,5,6,0,9,2,0,0,11,0,11,Lombardia,ITC4
2021-01-10,PF/BT,3034800,CASA DI CURA VILLA GEMMA PRESSO CASA DI CURA VILLA BARBARANO,LOM,50-59,5,9,0,10,4,0,0,14,0,14,Lombardia,ITC4
2021-01-10,PF/BT,3034800,CASA DI CURA VILLA GEMMA PRESSO CASA DI CURA VILLA BARBARANO,LOM,60-69,3,4,0,6,1,0,0,7,0,7,Lombardia,ITC4
2021-01-10,PF/BT,3034800,CASA DI CURA VILLA GEMMA PRESSO CASA DI CURA VILLA BARBARANO,LOM,70-79,2,1,0,2,1,0,0,3,0,3,Lombardia,ITC4
2021-01-10,PF/BT,30701,ASST GRANDE OSPEDALE METROPOLITANO NIGUARDA,LOM,20-29,14,11,0,12,3,0,10,25,0,25,Lombardia,ITC4
2021-01-10,PF/BT,30701,ASST GRANDE OSPEDALE METROPOLITANO NIGUARDA,LOM,30-39,24,18,0,18,7,0,17,42,0,42,Lombardia,ITC4
2021-01-10,PF/BT,30701,ASST GRANDE OSPEDALE METROPOLITANO NIGUARDA,LOM,40-49,46,30,0,18,13,0,45,76,0,76,Lombardia,ITC4
2021-01-10,PF/BT,30701,ASST GRANDE OSPEDALE METROPOLITANO NIGUARDA,LOM,50-59,51,34,0,15,25,0,45,85,0,85,Lombardia,ITC4
2021-01-10,PF/BT,30701,ASST GRANDE OSPEDALE METROPOLITANO NIGUARDA,LOM,60-69,17,16,0,6,12,0,15,33,0,33,Lombardia,ITC4
2021-01-10,PF/BT,30701,ASST GRANDE OSPEDALE METROPOLITANO NIGUARDA,LOM,70-79,3,0,0,0,2,0,1,3,0,3,Lombardia,ITC4
2021-01-10,PF/BT,30718,ASST PAPA GIOVANNI XXIII,LOM,20-29,8,30,0,36,2,0,0,38,0,38,Lombardia,ITC4
2021-01-10,PF/BT,30718,ASST PAPA GIOVANNI XXIII,LOM,30-39,10,31,0,32,9,0,0,41,0,41,Lombardia,ITC4
2021-01-10,PF/BT,30718,ASST PAPA GIOVANNI XXIII,LOM,40-49,10,32,0,38,4,0,0,42,0,42,Lombardia,ITC4
2021-01-10,PF/BT,30718,ASST PAPA GIOVANNI XXIII,LOM,50-59,19,59,0,65,13,0,0,78,0,78,Lombardia,ITC4
2021-01-10,PF/BT,30718,ASST PAPA GIOVANNI XXIII,LOM,60-69,13,14,0,24,3,0,0,27,0,27,Lombardia,ITC4
2021-01-10,PF/BT,30718,ASST PAPA GIOVANNI XXIII,LOM,70-79,1,0,0,1,0,0,0,1,0,1,Lombardia,ITC4
2021-01-10,PF/BT,30902,Ospedale S.Anna - Como,LOM,16-19,3,3,0,0,6,0,0,6,0,6,Lombardia,ITC4
2021-01-10,PF/BT,30902,Ospedale S.Anna - Como,LOM,20-29,23,32,0,15,40,0,0,55,0,55,Lombardia,ITC4
2021-01-10,PF/BT,30902,Ospedale S.Anna - Como,LOM,30-39,21,27,0,15,33,0,0,48,0,48,Lombardia,ITC4
2021-01-10,PF/BT,30902,Ospedale S.Anna - Como,LOM,40-49,38,42,0,12,68,0,0,80,0,80,Lombardia,ITC4
2021-01-10,PF/BT,30902,Ospedale S.Anna - Como,LOM,50-59,37,52,0,26,63,0,0,89,0,89,Lombardia,ITC4
2021-01-10,PF/BT,30902,Ospedale S.Anna - Como,LOM,60-69,44,25,0,20,49,0,0,69,0,69,Lombardia,ITC4
2021-01-10,PF/BT,30902,Ospedale S.Anna - Como,LOM,70-79,7,5,0,0,12,0,0,12,0,12,Lombardia,ITC4
2021-01-10,PF/BT,30902,Ospedale S.Anna - Como,LOM,90+,0,1,0,0,1,0,0,1,0,1,Lombardia,ITC4
2021-01-10,PF/BT,30909,amb covid monza,LOM,16-19,0,1,0,1,0,0,0,1,0,1,Lombardia,ITC4
2021-01-10,PF/BT,30909,amb covid monza,LOM,20-29,15,41,0,52,4,0,0,56,0,56,Lombardia,ITC4
2021-01-10,PF/BT,30909,amb covid monza,LOM,30-39,22,46,0,62,6,0,0,68,0,68,Lombardia,ITC4
2021-01-10,PF/BT,30909,amb covid monza,LOM,40-49,9,47,0,47,8,0,1,56,0,56,Lombardia,ITC4
2021-01-10,PF/BT,30909,amb covid monza,LOM,50-59,17,81,0,72,25,0,1,98,0,98,Lombardia,ITC4
2021-01-10,PF/BT,30909,amb covid monza,LOM,60-69,23,25,0,40,8,0,0,48,0,48,Lombardia,ITC4
2021-01-10,PF/BT,30909,amb covid monza,LOM,70-79,3,4,0,4,3,0,0,7,0,7,Lombardia,ITC4
2021-01-10,PF/BT,30909,amb covid monza,LOM,80-89,0,2,0,0,1,0,1,2,0,2,Lombardia,ITC4
2021-01-10,PF/BT,32170712,ambulatorio covid SESTO SAN GIOVANNI,LOM,20-29,7,12,0,16,3,0,0,19,0,19,Lombardia,ITC4
2021-01-10,PF/BT,32170712,ambulatorio covid SESTO SAN GIOVANNI,LOM,30-39,18,30,0,47,1,0,0,48,0,48,Lombardia,ITC4
2021-01-10,PF/BT,32170712,ambulatorio covid SESTO SAN GIOVANNI,LOM,40-49,17,51,0,67,1,0,0,68,0,68,Lombardia,ITC4
2021-01-10,PF/BT,32170712,ambulatorio covid SESTO SAN GIOVANNI,LOM,50-59,19,66,0,83,2,0,0,85,0,85,Lombardia,ITC4
2021-01-10,PF/BT,32170712,ambulatorio covid SESTO SAN GIOVANNI,LOM,60-69,13,25,0,38,0,0,0,38,0,38,Lombardia,ITC4
2021-01-10,PF/BT,322000728,RSA CAMELOT,LOM,20-29,0,1,0,1,0,0,0,1,0,1,Lombardia,ITC4
2021-01-10,PF/BT,322000728,RSA CAMELOT,LOM,30-39,2,5,0,7,0,0,0,7,0,7,Lombardia,ITC4
2021-01-10,PF/BT,322000728,RSA CAMELOT,LOM,40-49,2,5,0,7,0,0,0,7,0,7,Lombardia,ITC4
2021-01-10,PF/BT,322000728,RSA CAMELOT,LOM,50-59,0,2,0,2,0,0,0,2,0,2,Lombardia,ITC4
2021-01-10,PF/BT,322000728,RSA CAMELOT,LOM,60-69,0,1,0,1,0,0,0,1,0,1,Lombardia,ITC4
2021-01-10,PF/BT,322000728,RSA CAMELOT,LOM,80-89,0,4,0,0,0,4,0,4,0,4,Lombardia,ITC4
2021-01-10,PF/BT,322000728,RSA CAMELOT,LOM,90+,0,2,0,0,0,2,0,2,0,2,Lombardia,ITC4
2021-01-10,PF/BT,32271028,AMBULATORIO COVID OSPEDALE CIRCOLO,LOM,16-19,2,2,0,4,0,0,0,4,0,4,Lombardia,ITC4
2021-01-10,PF/BT,32271028,AMBULATORIO COVID OSPEDALE CIRCOLO,LOM,20-29,14,46,0,60,0,0,0,60,0,60,Lombardia,ITC4
2021-01-10,PF/BT,32271028,AMBULATORIO COVID OSPEDALE CIRCOLO,LOM,30-39,45,82,0,127,0,0,0,127,0,127,Lombardia,ITC4
2021-01-10,PF/BT,32271028,AMBULATORIO COVID OSPEDALE CIRCOLO,LOM,40-49,28,97,0,125,0,0,0,125,0,125,Lombardia,ITC4
2021-01-10,PF/BT,32271028,AMBULATORIO COVID OSPEDALE CIRCOLO,LOM,50-59,34,152,0,186,0,0,0,186,0,186,Lombardia,ITC4
2021-01-10,PF/BT,32271028,AMBULATORIO COVID OSPEDALE CIRCOLO,LOM,60-69,43,46,0,89,0,0,0,89,0,89,Lombardia,ITC4
2021-01-10,PF/BT,32271028,AMBULATORIO COVID OSPEDALE CIRCOLO,LOM,70-79,7,1,0,8,0,0,0,8,0,8,Lombardia,ITC4
2021-01-10,PF/BT,32271028,AMBULATORIO COVID OSPEDALE CIRCOLO,LOM,80-89,1,0,0,1,0,0,0,1,0,1,Lombardia,ITC4
2021-01-10,PF/BT,32572021,Ambulatorio COVID PO Alzano Lombardo,LOM,16-19,0,1,0,1,0,0,0,1,0,1,Lombardia,ITC4
2021-01-10,PF/BT,32572021,Ambulatorio COVID PO Alzano Lombardo,LOM,20-29,10,6,0,16,0,0,0,16,0,16,Lombardia,ITC4
2021-01-10,PF/BT,32572021,Ambulatorio COVID PO Alzano Lombardo,LOM,30-39,6,5,0,11,0,0,0,11,0,11,Lombardia,ITC4
2021-01-10,PF/BT,32572021,Ambulatorio COVID PO Alzano Lombardo,LOM,40-49,8,13,0,21,0,0,0,21,0,21,Lombardia,ITC4
2021-01-10,PF/BT,32572021,Ambulatorio COVID PO Alzano Lombardo,LOM,50-59,13,7,0,20,0,0,0,20,0,20,Lombardia,ITC4
2021-01-10,PF/BT,32572021,Ambulatorio COVID PO Alzano Lombardo,LOM,60-69,8,4,0,12,0,0,0,12,0,12,Lombardia,ITC4
2021-01-10,PF/BT,32572021,Ambulatorio COVID PO Alzano Lombardo,LOM,70-79,1,2,0,3,0,0,0,3,0,3,Lombardia,ITC4
2021-01-10,PF/BT,32572027,Ambulatorio COVID SERIATE,LOM,20-29,8,7,0,15,0,0,0,15,0,15,Lombardia,ITC4
2021-01-10,PF/BT,32572027,Ambulatorio COVID SERIATE,LOM,30-39,8,9,0,15,0,0,2,17,0,17,Lombardia,ITC4
2021-01-10,PF/BT,32572027,Ambulatorio COVID SERIATE,LOM,40-49,3,22,0,25,0,0,0,25,0,25,Lombardia,ITC4
2021-01-10,PF/BT,32572027,Ambulatorio COVID SERIATE,LOM,50-59,17,28,0,45,0,0,0,45,0,45,Lombardia,ITC4
2021-01-10,PF/BT,32572027,Ambulatorio COVID SERIATE,LOM,60-69,25,17,0,42,0,0,0,42,0,42,Lombardia,ITC4
2021-01-10,PF/BT,32572027,Ambulatorio COVID SERIATE,LOM,70-79,5,0,0,5,0,0,0,5,0,5,Lombardia,ITC4
2021-01-10,PF/BT,32572027,Ambulatorio COVID SERIATE,LOM,80-89,1,0,0,1,0,0,0,1,0,1,Lombardia,ITC4
2021-01-10,PF/BT,32772401,cv casalmaggiore,LOM,20-29,4,5,0,9,0,0,0,9,0,9,Lombardia,ITC4
2021-01-10,PF/BT,32772401,cv casalmaggiore,LOM,30-39,6,14,0,19,0,0,1,20,0,20,Lombardia,ITC4
2021-01-10,PF/BT,32772401,cv casalmaggiore,LOM,40-49,8,11,0,16,0,0,3,19,0,19,Lombardia,ITC4
2021-01-10,PF/BT,32772401,cv casalmaggiore,LOM,50-59,8,15,0,19,0,0,4,23,0,23,Lombardia,ITC4
2021-01-10,PF/BT,32772401,cv casalmaggiore,LOM,60-69,15,15,0,29,0,0,1,30,0,30,Lombardia,ITC4
2021-01-10,PF/BT,32772401,cv casalmaggiore,LOM,70-79,13,0,0,12,0,0,1,13,0,13,Lombardia,ITC4
2021-01-10,PF/BT,32772407,CV COVID CREMONA,LOM,16-19,1,1,0,2,0,0,0,2,0,2,Lombardia,ITC4
2021-01-10,PF/BT,32772407,CV COVID CREMONA,LOM,20-29,15,14,0,28,0,0,1,29,0,29,Lombardia,ITC4
2021-01-10,PF/BT,32772407,CV COVID CREMONA,LOM,30-39,18,16,0,32,0,0,2,34,0,34,Lombardia,ITC4
2021-01-10,PF/BT,32772407,CV COVID CREMONA,LOM,40-49,17,34,0,46,2,0,3,51,0,51,Lombardia,ITC4
2021-01-10,PF/BT,32772407,CV COVID CREMONA,LOM,50-59,30,40,0,70,0,0,0,70,0,70,Lombardia,ITC4
2021-01-10,PF/BT,32772407,CV COVID CREMONA,LOM,60-69,28,21,0,49,0,0,0,49,0,49,Lombardia,ITC4
2021-01-10,PF/BT,32772407,CV COVID CREMONA,LOM,70-79,17,4,0,21,0,0,0,21,0,21,Lombardia,ITC4
2021-01-10,PF/BT,32772407,CV COVID CREMONA,LOM,80-89,2,0,0,2,0,0,0,2,0,2,Lombardia,ITC4
2021-01-10,PF/BT,32772513,ASST DI MANTOVA - POMA,LOM,16-19,2,2,0,4,0,0,0,4,0,4,Lombardia,ITC4
2021-01-10,PF/BT,32772513,ASST DI MANTOVA - POMA,LOM,20-29,22,28,0,49,1,0,0,50,0,50,Lombardia,ITC4
2021-01-10,PF/BT,32772513,ASST DI MANTOVA - POMA,LOM,30-39,19,36,0,52,3,0,0,55,0,55,Lombardia,ITC4
2021-01-10,PF/BT,32772513,ASST DI MANTOVA - POMA,LOM,40-49,18,38,0,51,5,0,0,56,0,56,Lombardia,ITC4
2021-01-10,PF/BT,32772513,ASST DI MANTOVA - POMA,LOM,50-59,24,34,0,56,2,0,0,58,0,58,Lombardia,ITC4
2021-01-10,PF/BT,32772513,ASST DI MANTOVA - POMA,LOM,60-69,31,20,0,50,1,0,0,51,0,51,Lombardia,ITC4
2021-01-10,PF/BT,32772513,ASST DI MANTOVA - POMA,LOM,70-79,7,0,0,7,0,0,0,7,0,7,Lombardia,ITC4
2021-01-10,PF/BT,558,RSA PIO ALBERGO TRIVULZIO,LOM,20-29,4,6,0,6,4,0,0,10,0,10,Lombardia,ITC4
2021-01-10,PF/BT,558,RSA PIO ALBERGO TRIVULZIO,LOM,30-39,11,4,0,9,6,0,0,15,0,15,Lombardia,ITC4
2021-01-10,PF/BT,558,RSA PIO ALBERGO TRIVULZIO,LOM,40-49,5,15,0,8,12,0,0,20,0,20,Lombardia,ITC4
2021-01-10,PF/BT,558,RSA PIO ALBERGO TRIVULZIO,LOM,50-59,9,25,0,20,14,0,0,34,0,34,Lombardia,ITC4
2021-01-10,PF/BT,558,RSA PIO ALBERGO TRIVULZIO,LOM,60-69,7,9,0,4,12,0,0,16,0,16,Lombardia,ITC4
2021-01-10,PF/BT,558,RSA PIO ALBERGO TRIVULZIO,LOM,70-79,1,0,0,0,1,0,0,1,0,1,Lombardia,ITC4
2021-01-10,PF/BT,HSP11-11bis,32170223 HUB COVID SS PAOLO E CARLO - PVO Ospedale San Paolo,LOM,16-19,1,0,0,1,0,0,0,1,0,1,Lombardia,ITC4
2021-01-10,PF/BT,HSP11-11bis,32170223 HUB COVID SS PAOLO E CARLO - PVO Ospedale San Paolo,LOM,20-29,10,36,0,42,3,0,1,46,0,46,Lombardia,ITC4
2021-01-10,PF/BT,HSP11-11bis,32170223 HUB COVID SS PAOLO E CARLO - PVO Ospedale San Paolo,LOM,30-39,24,28,0,50,2,0,0,52,0,52,Lombardia,ITC4
2021-01-10,PF/BT,HSP11-11bis,32170223 HUB COVID SS PAOLO E CARLO - PVO Ospedale San Paolo,LOM,40-49,26,38,0,58,5,0,1,64,0,64,Lombardia,ITC4
2021-01-10,PF/BT,HSP11-11bis,32170223 HUB COVID SS PAOLO E CARLO - PVO Ospedale San Paolo,LOM,50-59,34,51,0,69,15,0,1,85,0,85,Lombardia,ITC4
2021-01-10,PF/BT,HSP11-11bis,32170223 HUB COVID SS PAOLO E CARLO - PVO Ospedale San Paolo,LOM,60-69,22,27,0,42,5,0,2,49,0,49,Lombardia,ITC4
2021-01-10,PF/BT,HSP11-11bis,32170223 HUB COVID SS PAOLO E CARLO - PVO Ospedale San Paolo,LOM,70-79,1,2,0,3,0,0,0,3,0,3,Lombardia,ITC4
2021-01-10,PF/BT,HSP11-11bis,32170224 HUB COVID OSP. SAN CARLO,LOM,16-19,1,3,0,0,0,0,4,4,0,4,Lombardia,ITC4
2021-01-10,PF/BT,HSP11-11bis,32170224 HUB COVID OSP. SAN CARLO,LOM,20-29,27,34,0,24,4,0,33,61,0,61,Lombardia,ITC4
2021-01-10,PF/BT,HSP11-11bis,32170224 HUB COVID OSP. SAN CARLO,LOM,30-39,23,25,0,21,7,0,20,48,0,48,Lombardia,ITC4
2021-01-10,PF/BT,HSP11-11bis,32170224 HUB COVID OSP. SAN CARLO,LOM,40-49,21,32,0,23,10,0,20,53,0,53,Lombardia,ITC4
2021-01-10,PF/BT,HSP11-11bis,32170224 HUB COVID OSP. SAN CARLO,LOM,50-59,28,38,0,27,11,0,28,66,0,66,Lombardia,ITC4
2021-01-10,PF/BT,HSP11-11bis,32170224 HUB COVID OSP. SAN CARLO,LOM,60-69,17,23,0,25,5,0,10,40,0,40,Lombardia,ITC4
2021-01-10,PF/BT,HSP11-11bis,32170224 HUB COVID OSP. SAN CARLO,LOM,70-79,1,1,0,2,0,0,0,2,0,2,Lombardia,ITC4
2021-01-10,PF/BT,HSP11-11bis,Ambulatorio COVID PO Casalpusterlengo,LOM,16-19,0,2,0,2,0,0,0,2,0,2,Lombardia,ITC4
2021-01-10,PF/BT,HSP11-11bis,Ambulatorio COVID PO Casalpusterlengo,LOM,20-29,3,5,0,7,1,0,0,8,0,8,Lombardia,ITC4
2021-01-10,PF/BT,HSP11-11bis,Ambulatorio COVID PO Casalpusterlengo,LOM,30-39,3,3,0,4,2,0,0,6,0,6,Lombardia,ITC4
2021-01-10,PF/BT,HSP11-11bis,Ambulatorio COVID PO Casalpusterlengo,LOM,40-49,4,14,0,11,7,0,0,18,0,18,Lombardia,ITC4
2021-01-10,PF/BT,HSP11-11bis,Ambulatorio COVID PO Casalpusterlengo,LOM,50-59,3,10,0,9,4,0,0,13,0,13,Lombardia,ITC4
2021-01-10,PF/BT,HSP11-11bis,Ambulatorio COVID PO Casalpusterlengo,LOM,60-69,1,4,0,3,2,0,0,5,0,5,Lombardia,ITC4
2021-01-10,PF/BT,HSP11-11bis,Ambulatorio COVID PO Casalpusterlengo,LOM,70-79,2,0,0,2,0,0,0,2,0,2,Lombardia,ITC4
2021-01-10,PF/BT,HSP11-11bis,Ambulatorio COVID PO S.Angelo Lod.,LOM,16-19,0,1,0,0,1,0,0,1,0,1,Lombardia,ITC4
2021-01-10,PF/BT,HSP11-11bis,Ambulatorio COVID PO S.Angelo Lod.,LOM,20-29,4,5,0,5,4,0,0,9,0,9,Lombardia,ITC4
2021-01-10,PF/BT,HSP11-11bis,Ambulatorio COVID PO S.Angelo Lod.,LOM,30-39,7,12,0,13,6,0,0,19,0,19,Lombardia,ITC4
2021-01-10,PF/BT,HSP11-11bis,Ambulatorio COVID PO S.Angelo Lod.,LOM,40-49,3,21,0,22,2,0,0,24,0,24,Lombardia,ITC4
2021-01-10,PF/BT,HSP11-11bis,Ambulatorio COVID PO S.Angelo Lod.,LOM,50-59,11,26,0,29,8,0,0,37,0,37,Lombardia,ITC4
2021-01-10,PF/BT,HSP11-11bis,Ambulatorio COVID PO S.Angelo Lod.,LOM,60-69,8,17,0,19,6,0,0,25,0,25,Lombardia,ITC4
2021-01-10,PF/BT,HSP11-11bis,Ambulatorio COVID PO S.Angelo Lod.,LOM,70-79,3,1,0,2,2,0,0,4,0,4,Lombardia,ITC4
2021-01-10,PF/BT,HSP11-11bis,Ambulatorio COVID PO S.Angelo Lod.,LOM,80-89,1,0,0,1,0,0,0,1,0,1,Lombardia,ITC4
2021-01-10,PF/BT,HSP11-11bis,AMBULATORIO COVID PO SACCO,LOM,16-19,3,9,0,4,8,0,0,12,0,12,Lombardia,ITC4
2021-01-10,PF/BT,HSP11-11bis,AMBULATORIO COVID PO SACCO,LOM,20-29,57,81,0,93,45,0,0,138,0,138,Lombardia,ITC4
2021-01-10,PF/BT,HSP11-11bis,AMBULATORIO COVID PO SACCO,LOM,30-39,41,72,0,80,33,0,0,113,0,113,Lombardia,ITC4
2021-01-10,PF/BT,HSP11-11bis,AMBULATORIO COVID PO SACCO,LOM,40-49,49,71,0,96,24,0,0,120,0,120,Lombardia,ITC4
2021-01-10,PF/BT,HSP11-11bis,AMBULATORIO COVID PO SACCO,LOM,50-59,56,77,0,102,31,0,0,133,0,133,Lombardia,ITC4
2021-01-10,PF/BT,HSP11-11bis,AMBULATORIO COVID PO SACCO,LOM,60-69,58,41,0,80,19,0,0,99,0,99,Lombardia,ITC4
2021-01-10,PF/BT,HSP11-11bis,AMBULATORIO COVID PO SACCO,LOM,70-79,9,5,0,9,5,0,0,14,0,14,Lombardia,ITC4
2021-01-10,PF/BT,HSP11-11bis,AMBULATORIO COVID PO SACCO,LOM,80-89,1,0,0,1,0,0,0,1,0,1,Lombardia,ITC4
2021-01-10,PF/BT,HSP11-11bis,ASST BERGAMO OVEST - OSPEDALE ROMANO DI L.DIA,LOM,20-29,7,9,0,14,2,0,0,16,0,16,Lombardia,ITC4
2021-01-10,PF/BT,HSP11-11bis,ASST BERGAMO OVEST - OSPEDALE ROMANO DI L.DIA,LOM,30-39,3,8,0,9,2,0,0,11,0,11,Lombardia,ITC4
2021-01-10,PF/BT,HSP11-11bis,ASST BERGAMO OVEST - OSPEDALE ROMANO DI L.DIA,LOM,40-49,4,9,0,11,2,0,0,13,0,13,Lombardia,ITC4
2021-01-10,PF/BT,HSP11-11bis,ASST BERGAMO OVEST - OSPEDALE ROMANO DI L.DIA,LOM,50-59,2,17,0,13,6,0,0,19,0,19,Lombardia,ITC4
2021-01-10,PF/BT,HSP11-11bis,ASST BERGAMO OVEST - OSPEDALE ROMANO DI L.DIA,LOM,60-69,20,17,0,36,1,0,0,37,0,37,Lombardia,ITC4
2021-01-10,PF/BT,HSP11-11bis,ASST BERGAMO OVEST - OSPEDALE TREVIGLIO,LOM,20-29,9,13,0,18,2,0,2,22,0,22,Lombardia,ITC4
2021-01-10,PF/BT,HSP11-11bis,ASST BERGAMO OVEST - OSPEDALE TREVIGLIO,LOM,30-39,8,10,0,12,2,0,4,18,0,18,Lombardia,ITC4
2021-01-10,PF/BT,HSP11-11bis,ASST BERGAMO OVEST - OSPEDALE TREVIGLIO,LOM,40-49,12,25,0,31,3,0,3,37,0,37,Lombardia,ITC4
2021-01-10,PF/BT,HSP11-11bis,ASST BERGAMO OVEST - OSPEDALE TREVIGLIO,LOM,50-59,18,45,0,49,11,0,3,63,0,63,Lombardia,ITC4
2021-01-10,PF/BT,HSP11-11bis,ASST BERGAMO OVEST - OSPEDALE TREVIGLIO,LOM,60-69,48,26,0,69,2,0,3,74,0,74,Lombardia,ITC4
2021-01-10,PF/BT,HSP11-11bis,ASST BERGAMO OVEST - OSPEDALE TREVIGLIO,LOM,70-79,2,0,0,1,0,0,1,2,0,2,Lombardia,ITC4
2021-01-10,PF/BT,HSP11-11bis,PVO Ospedale San Paolo,LOM,16-19,1,0,0,1,0,0,0,1,0,1,Lombardia,ITC4
2021-01-10,PF/BT,HSP11-11bis,PVO Ospedale San Paolo,LOM,20-29,10,36,0,42,3,0,1,46,0,46,Lombardia,ITC4
2021-01-10,PF/BT,HSP11-11bis,PVO Ospedale San Paolo,LOM,30-39,24,28,0,50,2,0,0,52,0,52,Lombardia,ITC4
2021-01-10,PF/BT,HSP11-11bis,PVO Ospedale San Paolo,LOM,40-49,26,38,0,58,5,0,1,64,0,64,Lombardia,ITC4
2021-01-10,PF/BT,HSP11-11bis,PVO Ospedale San Paolo,LOM,50-59,34,51,0,69,15,0,1,85,0,85,Lombardia,ITC4
2021-01-10,PF/BT,HSP11-11bis,PVO Ospedale San Paolo,LOM,60-69,22,27,0,42,5,0,2,49,0,49,Lombardia,ITC4
2021-01-10,PF/BT,HSP11-11bis,PVO Ospedale San Paolo,LOM,70-79,1,2,0,3,0,0,0,3,0,3,Lombardia,ITC4
2021-01-10,PF/BT,HSP11-11BIS-03010600,CASA DI CURA POLICLINICO DI MONZA-MONZA-,LOM,20-29,9,12,0,10,11,0,0,21,0,21,Lombardia,ITC4
2021-01-10,PF/BT,HSP11-11BIS-03010600,CASA DI CURA POLICLINICO DI MONZA-MONZA-,LOM,30-39,11,13,0,14,10,0,0,24,0,24,Lombardia,ITC4
2021-01-10,PF/BT,HSP11-11BIS-03010600,CASA DI CURA POLICLINICO DI MONZA-MONZA-,LOM,40-49,12,26,0,21,17,0,0,38,0,38,Lombardia,ITC4
2021-01-10,PF/BT,HSP11-11BIS-03010600,CASA DI CURA POLICLINICO DI MONZA-MONZA-,LOM,50-59,6,7,0,8,5,0,0,13,0,13,Lombardia,ITC4
2021-01-10,PF/BT,HSP11-11BIS-03010600,CASA DI CURA POLICLINICO DI MONZA-MONZA-,LOM,60-69,6,0,0,5,1,0,0,6,0,6,Lombardia,ITC4
2021-01-10,PF/BT,S09, PII ISTITUTI UNIFICATI ONLUS,LOM,30-39,0,8,0,8,0,0,0,8,0,8,Lombardia,ITC4
2021-01-10,PF/BT,S09, PII ISTITUTI UNIFICATI ONLUS,LOM,40-49,4,6,0,8,2,0,0,10,0,10,Lombardia,ITC4
2021-01-10,PF/BT,S09, PII ISTITUTI UNIFICATI ONLUS,LOM,50-59,2,9,0,11,0,0,0,11,0,11,Lombardia,ITC4
2021-01-10,PF/BT,S09, PII ISTITUTI UNIFICATI ONLUS,LOM,60-69,1,0,0,0,1,0,0,1,0,1,Lombardia,ITC4
2021-01-10,PF/BT,STS11,PVT COVID BRESCIA VIA ACERBI,LOM,16-19,1,2,0,0,0,0,3,3,0,3,Lombardia,ITC4
2021-01-10,PF/BT,STS11,PVT COVID BRESCIA VIA ACERBI,LOM,20-29,21,19,0,0,0,0,40,40,0,40,Lombardia,ITC4
2021-01-10,PF/BT,STS11,PVT COVID BRESCIA VIA ACERBI,LOM,30-39,8,13,0,0,0,0,21,21,0,21,Lombardia,ITC4
2021-01-10,PF/BT,STS11,PVT COVID BRESCIA VIA ACERBI,LOM,40-49,15,13,0,0,0,0,28,28,0,28,Lombardia,ITC4
2021-01-10,PF/BT,STS11,PVT COVID BRESCIA VIA ACERBI,LOM,50-59,22,15,0,0,0,0,37,37,0,37,Lombardia,ITC4
2021-01-10,PF/BT,STS11,PVT COVID BRESCIA VIA ACERBI,LOM,60-69,29,8,0,0,0,0,37,37,0,37,Lombardia,ITC4
2021-01-10,PF/BT,STS11,PVT COVID BRESCIA VIA ACERBI,LOM,70-79,11,3,0,0,0,0,14,14,0,14,Lombardia,ITC4
2021-01-11,PF/BT,(03027500/001752),PVO Istituto Clinico San Rocco (Spoke),LOM,20-29,0,5,0,3,2,0,0,5,0,5,Lombardia,ITC4
2021-01-11,PF/BT,(03027500/001752),PVO Istituto Clinico San Rocco (Spoke),LOM,30-39,3,4,0,7,0,0,0,7,0,7,Lombardia,ITC4
2021-01-11,PF/BT,(03027500/001752),PVO Istituto Clinico San Rocco (Spoke),LOM,40-49,3,6,0,8,1,0,0,9,0,9,Lombardia,ITC4
2021-01-11,PF/BT,(03027500/001752),PVO Istituto Clinico San Rocco (Spoke),LOM,50-59,5,12,0,16,1,0,0,17,0,17,Lombardia,ITC4
2021-01-11,PF/BT,(03027500/001752),PVO Istituto Clinico San Rocco (Spoke),LOM,60-69,1,1,0,2,0,0,0,2,0,2,Lombardia,ITC4
2021-01-11,PF/BT,(03027500/001752),PVO Istituto Clinico San Rocco (Spoke),LOM,70-79,2,0,0,2,0,0,0,2,0,2,Lombardia,ITC4
2021-01-11,PF/BT,.030042,ASST VALTELLINA ALTO LARIO - PRESIDIO OSPEDALIERO DI SONDRIO,LOM,20-29,2,6,0,7,1,0,0,8,0,8,Lombardia,ITC4
2021-01-11,PF/BT,.030042,ASST VALTELLINA ALTO LARIO - PRESIDIO OSPEDALIERO DI SONDRIO,LOM,30-39,7,7,0,7,7,0,0,14,0,14,Lombardia,ITC4
2021-01-11,PF/BT,.030042,ASST VALTELLINA ALTO LARIO - PRESIDIO OSPEDALIERO DI SONDRIO,LOM,40-49,6,12,0,15,3,0,0,18,0,18,Lombardia,ITC4
2021-01-11,PF/BT,.030042,ASST VALTELLINA ALTO LARIO - PRESIDIO OSPEDALIERO DI SONDRIO,LOM,50-59,12,43,0,36,19,0,0,55,0,55,Lombardia,ITC4
2021-01-11,PF/BT,.030042,ASST VALTELLINA ALTO LARIO - PRESIDIO OSPEDALIERO DI SONDRIO,LOM,60-69,7,12,0,13,6,0,0,19,0,19,Lombardia,ITC4
2021-01-11,PF/BT,0,FONDAZIONE CARISMA BERGAMO,LOM,50-59,0,1,0,0,0,1,0,1,0,1,Lombardia,ITC4
2021-01-11,PF/BT,0,FONDAZIONE CARISMA BERGAMO,LOM,60-69,3,3,0,0,0,6,0,6,0,6,Lombardia,ITC4
2021-01-11,PF/BT,0,FONDAZIONE CARISMA BERGAMO,LOM,70-79,7,5,0,0,0,12,0,12,0,12,Lombardia,ITC4
2021-01-11,PF/BT,0,FONDAZIONE CARISMA BERGAMO,LOM,80-89,3,19,0,0,1,21,0,22,0,22,Lombardia,ITC4
2021-01-11,PF/BT,0,FONDAZIONE CARISMA BERGAMO,LOM,90+,4,14,0,0,0,18,0,18,0,18,Lombardia,ITC4
2021-01-11,PF/BT,0,Istituto Redaelli Milano,LOM,20-29,2,7,0,9,0,0,0,9,0,9,Lombardia,ITC4
2021-01-11,PF/BT,0,Istituto Redaelli Milano,LOM,30-39,5,10,0,15,0,0,0,15,0,15,Lombardia,ITC4
2021-01-11,PF/BT,0,Istituto Redaelli Milano,LOM,40-49,5,20,0,25,0,0,0,25,0,25,Lombardia,ITC4
2021-01-11,PF/BT,0,Istituto Redaelli Milano,LOM,50-59,9,34,0,43,0,0,0,43,0,43,Lombardia,ITC4
2021-01-11,PF/BT,0,Istituto Redaelli Milano,LOM,60-69,7,8,0,15,0,0,0,15,0,15,Lombardia,ITC4
2021-01-11,PF/BT,000050,Poliambulatorio IRCSS OSPEDALE SAN LUCA,LOM,20-29,3,5,0,8,0,0,0,8,0,8,Lombardia,ITC4
2021-01-11,PF/BT,000050,Poliambulatorio IRCSS OSPEDALE SAN LUCA,LOM,30-39,3,3,0,6,0,0,0,6,0,6,Lombardia,ITC4
2021-01-11,PF/BT,000050,Poliambulatorio IRCSS OSPEDALE SAN LUCA,LOM,40-49,1,7,0,8,0,0,0,8,0,8,Lombardia,ITC4
2021-01-11,PF/BT,000050,Poliambulatorio IRCSS OSPEDALE SAN LUCA,LOM,50-59,8,8,0,15,1,0,0,16,0,16,Lombardia,ITC4
2021-01-11,PF/BT,000050,Poliambulatorio IRCSS OSPEDALE SAN LUCA,LOM,60-69,0,2,0,2,0,0,0,2,0,2,Lombardia,ITC4
2021-01-11,PF/BT,000050,Poliambulatorio IRCSS OSPEDALE SAN LUCA,LOM,70-79,1,1,0,2,0,0,0,2,0,2,Lombardia,ITC4
2021-01-11,PF/BT,000119,POLIAMBULATORIO IRCSS OSPEDALE SAN MICHELE,LOM,30-39,0,1,0,1,0,0,0,1,0,1,Lombardia,ITC4
2021-01-11,PF/BT,000119,POLIAMBULATORIO IRCSS OSPEDALE SAN MICHELE,LOM,40-49,1,3,0,4,0,0,0,4,0,4,Lombardia,ITC4
2021-01-11,PF/BT,000119,POLIAMBULATORIO IRCSS OSPEDALE SAN MICHELE,LOM,50-59,2,3,0,5,0,0,0,5,0,5,Lombardia,ITC4
2021-01-11,PF/BT,000119,POLIAMBULATORIO IRCSS OSPEDALE SAN MICHELE,LOM,60-69,1,1,0,2,0,0,0,2,0,2,Lombardia,ITC4
2021-01-11,PF/BT,000417,POLIAMBULATORIO IRCCS OSPEDALE CAPITANIO,LOM,20-29,2,7,0,9,0,0,0,9,0,9,Lombardia,ITC4
2021-01-11,PF/BT,000417,POLIAMBULATORIO IRCCS OSPEDALE CAPITANIO,LOM,30-39,0,3,0,3,0,0,0,3,0,3,Lombardia,ITC4
2021-01-11,PF/BT,000417,POLIAMBULATORIO IRCCS OSPEDALE CAPITANIO,LOM,40-49,1,1,0,2,0,0,0,2,0,2,Lombardia,ITC4
2021-01-11,PF/BT,000417,POLIAMBULATORIO IRCCS OSPEDALE CAPITANIO,LOM,50-59,2,4,0,6,0,0,0,6,0,6,Lombardia,ITC4
2021-01-11,PF/BT,000417,POLIAMBULATORIO IRCCS OSPEDALE CAPITANIO,LOM,60-69,2,2,0,4,0,0,0,4,0,4,Lombardia,ITC4
2021-01-11,PF/BT,000500,RSA MONSIGNOR BICCHIERAI 2,LOM,90+,0,4,0,0,0,4,0,4,0,4,Lombardia,ITC4
2021-01-11,PF/BT,000542,RSA MONSIGNOR BICCHIERAI 1,LOM,80-89,1,2,0,0,0,3,0,3,0,3,Lombardia,ITC4
2021-01-11,PF/BT,000542,RSA MONSIGNOR BICCHIERAI 1,LOM,90+,1,4,0,0,0,5,0,5,0,5,Lombardia,ITC4
2021-01-11,PF/BT,001534,"Fondazione ""Martinelli-Granata-Piantoni"" Onlus",LOM,30-39,0,1,0,1,0,0,0,1,0,1,Lombardia,ITC4
2021-01-11,PF/BT,001534,"Fondazione ""Martinelli-Granata-Piantoni"" Onlus",LOM,40-49,1,4,0,4,1,0,0,5,0,5,Lombardia,ITC4
2021-01-11,PF/BT,001534,"Fondazione ""Martinelli-Granata-Piantoni"" Onlus",LOM,50-59,0,7,0,7,0,0,0,7,0,7,Lombardia,ITC4
2021-01-11,PF/BT,001534,"Fondazione ""Martinelli-Granata-Piantoni"" Onlus",LOM,70-79,1,6,0,0,0,7,0,7,0,7,Lombardia,ITC4
2021-01-11,PF/BT,001534,"Fondazione ""Martinelli-Granata-Piantoni"" Onlus",LOM,80-89,2,6,0,0,0,8,0,8,0,8,Lombardia,ITC4
2021-01-11,PF/BT,001534,"Fondazione ""Martinelli-Granata-Piantoni"" Onlus",LOM,90+,2,6,0,0,0,8,0,8,0,8,Lombardia,ITC4
2021-01-11,PF/BT,001655,"FONDAZIONE DI CURA ""CITTA' DI GARDONE VALTROMPIA - ONLUS""",LOM,20-29,1,3,0,3,1,0,0,4,0,4,Lombardia,ITC4
2021-01-11,PF/BT,001655,"FONDAZIONE DI CURA ""CITTA' DI GARDONE VALTROMPIA - ONLUS""",LOM,30-39,1,6,0,7,0,0,0,7,0,7,Lombardia,ITC4
2021-01-11,PF/BT,001655,"FONDAZIONE DI CURA ""CITTA' DI GARDONE VALTROMPIA - ONLUS""",LOM,40-49,1,14,0,14,1,0,0,15,0,15,Lombardia,ITC4
2021-01-11,PF/BT,001655,"FONDAZIONE DI CURA ""CITTA' DI GARDONE VALTROMPIA - ONLUS""",LOM,50-59,1,13,0,10,4,0,0,14,0,14,Lombardia,ITC4
2021-01-11,PF/BT,001655,"FONDAZIONE DI CURA ""CITTA' DI GARDONE VALTROMPIA - ONLUS""",LOM,60-69,0,2,0,1,1,0,0,2,0,2,Lombardia,ITC4
2021-01-11,PF/BT,00290,LA PICCOLA CASA DEL RIFUGIO,LOM,20-29,1,2,0,3,0,0,0,3,0,3,Lombardia,ITC4
2021-01-11,PF/BT,00290,LA PICCOLA CASA DEL RIFUGIO,LOM,30-39,1,4,0,4,0,1,0,5,0,5,Lombardia,ITC4
2021-01-11,PF/BT,00290,LA PICCOLA CASA DEL RIFUGIO,LOM,40-49,2,6,0,6,1,1,0,8,0,8,Lombardia,ITC4
2021-01-11,PF/BT,00290,LA PICCOLA CASA DEL RIFUGIO,LOM,50-59,2,15,0,15,0,2,0,17,0,17,Lombardia,ITC4
2021-01-11,PF/BT,00290,LA PICCOLA CASA DEL RIFUGIO,LOM,60-69,1,2,0,1,1,1,0,3,0,3,Lombardia,ITC4
2021-01-11,PF/BT,002987,POLIAMBULATORIO OSPEDALE ESINE,LOM,20-29,21,58,0,8,71,0,0,79,0,79,Lombardia,ITC4
2021-01-11,PF/BT,002987,POLIAMBULATORIO OSPEDALE ESINE,LOM,30-39,10,22,0,13,19,0,0,32,0,32,Lombardia,ITC4
2021-01-11,PF/BT,002987,POLIAMBULATORIO OSPEDALE ESINE,LOM,40-49,11,46,0,32,25,0,0,57,0,57,Lombardia,ITC4
2021-01-11,PF/BT,002987,POLIAMBULATORIO OSPEDALE ESINE,LOM,50-59,22,62,0,37,47,0,0,84,0,84,Lombardia,ITC4
2021-01-11,PF/BT,002987,POLIAMBULATORIO OSPEDALE ESINE,LOM,60-69,6,12,0,7,11,0,0,18,0,18,Lombardia,ITC4
2021-01-11,PF/BT,002987,POLIAMBULATORIO OSPEDALE ESINE,LOM,70-79,4,1,0,0,5,0,0,5,0,5,Lombardia,ITC4
2021-01-11,PF/BT,002987,POLIAMBULATORIO OSPEDALE ESINE,LOM,80-89,0,1,0,1,0,0,0,1,0,1,Lombardia,ITC4
2021-01-11,PF/BT,003328,HUB COV CHIARI - P.O. ISEO -  ASST FRANCIACORTA,LOM,16-19,1,0,0,1,0,0,0,1,0,1,Lombardia,ITC4
2021-01-11,PF/BT,003328,HUB COV CHIARI - P.O. ISEO -  ASST FRANCIACORTA,LOM,20-29,6,9,0,12,3,0,0,15,0,15,Lombardia,ITC4
2021-01-11,PF/BT,003328,HUB COV CHIARI - P.O. ISEO -  ASST FRANCIACORTA,LOM,30-39,7,8,0,14,1,0,0,15,0,15,Lombardia,ITC4
2021-01-11,PF/BT,003328,HUB COV CHIARI - P.O. ISEO -  ASST FRANCIACORTA,LOM,40-49,18,14,0,27,5,0,0,32,0,32,Lombardia,ITC4
2021-01-11,PF/BT,003328,HUB COV CHIARI - P.O. ISEO -  ASST FRANCIACORTA,LOM,50-59,15,24,0,35,4,0,0,39,0,39,Lombardia,ITC4
2021-01-11,PF/BT,003328,HUB COV CHIARI - P.O. ISEO -  ASST FRANCIACORTA,LOM,60-69,16,15,0,27,4,0,0,31,0,31,Lombardia,ITC4
2021-01-11,PF/BT,003328,HUB COV CHIARI - P.O. ISEO -  ASST FRANCIACORTA,LOM,70-79,7,4,0,11,0,0,0,11,0,11,Lombardia,ITC4
2021-01-11,PF/BT,003335,HUB COV CHIARI - P.O. CHIARI ASST FRANCIACORTA,LOM,20-29,7,16,0,21,2,0,0,23,0,23,Lombardia,ITC4
2021-01-11,PF/BT,003335,HUB COV CHIARI - P.O. CHIARI ASST FRANCIACORTA,LOM,30-39,13,15,0,24,4,0,0,28,0,28,Lombardia,ITC4
2021-01-11,PF/BT,003335,HUB COV CHIARI - P.O. CHIARI ASST FRANCIACORTA,LOM,40-49,17,28,0,42,3,0,0,45,0,45,Lombardia,ITC4
2021-01-11,PF/BT,003335,HUB COV CHIARI - P.O. CHIARI ASST FRANCIACORTA,LOM,50-59,17,34,0,40,11,0,0,51,0,51,Lombardia,ITC4
2021-01-11,PF/BT,003335,HUB COV CHIARI - P.O. CHIARI ASST FRANCIACORTA,LOM,60-69,14,5,0,16,3,0,0,19,0,19,Lombardia,ITC4
2021-01-11,PF/BT,003335,HUB COV CHIARI - P.O. CHIARI ASST FRANCIACORTA,LOM,70-79,2,0,0,2,0,0,0,2,0,2,Lombardia,ITC4
2021-01-11,PF/BT,030 198,ISTITUTO CLINICO BEATO MATTEO,LOM,20-29,4,0,0,4,0,0,0,4,0,4,Lombardia,ITC4
2021-01-11,PF/BT,030 198,ISTITUTO CLINICO BEATO MATTEO,LOM,30-39,3,0,0,3,0,0,0,3,0,3,Lombardia,ITC4
2021-01-11,PF/BT,030 198,ISTITUTO CLINICO BEATO MATTEO,LOM,40-49,0,4,0,4,0,0,0,4,0,4,Lombardia,ITC4
2021-01-11,PF/BT,030 198,ISTITUTO CLINICO BEATO MATTEO,LOM,50-59,1,3,0,4,0,0,0,4,0,4,Lombardia,ITC4
2021-01-11,PF/BT,030 198,ISTITUTO CLINICO BEATO MATTEO,LOM,60-69,1,1,0,2,0,0,0,2,0,2,Lombardia,ITC4
2021-01-11,PF/BT,030 202,ISTITUTO DI CURA CITTA' DI PAVIA,LOM,20-29,0,1,0,1,0,0,0,1,0,1,Lombardia,ITC4
2021-01-11,PF/BT,030 202,ISTITUTO DI CURA CITTA' DI PAVIA,LOM,30-39,1,0,0,1,0,0,0,1,0,1,Lombardia,ITC4
2021-01-11,PF/BT,030 202,ISTITUTO DI CURA CITTA' DI PAVIA,LOM,40-49,1,6,0,7,0,0,0,7,0,7,Lombardia,ITC4
2021-01-11,PF/BT,030 202,ISTITUTO DI CURA CITTA' DI PAVIA,LOM,50-59,2,6,0,8,0,0,0,8,0,8,Lombardia,ITC4
2021-01-11,PF/BT,030 202,ISTITUTO DI CURA CITTA' DI PAVIA,LOM,60-69,0,1,0,1,0,0,0,1,0,1,Lombardia,ITC4
2021-01-11,PF/BT,030017,Istituto clinico Casa di cura Mater Domini -Castellanza,LOM,20-29,1,1,0,2,0,0,0,2,0,2,Lombardia,ITC4
2021-01-11,PF/BT,030017,Istituto clinico Casa di cura Mater Domini -Castellanza,LOM,30-39,2,3,0,5,0,0,0,5,0,5,Lombardia,ITC4
2021-01-11,PF/BT,030017,Istituto clinico Casa di cura Mater Domini -Castellanza,LOM,40-49,6,13,0,19,0,0,0,19,0,19,Lombardia,ITC4
2021-01-11,PF/BT,030017,Istituto clinico Casa di cura Mater Domini -Castellanza,LOM,50-59,7,3,0,10,0,0,0,10,0,10,Lombardia,ITC4
2021-01-11,PF/BT,030030,OSPEDALE VALDUCE – AMBULATORIO VACCINALE  COVID,LOM,20-29,5,10,0,15,0,0,0,15,0,15,Lombardia,ITC4
2021-01-11,PF/BT,030030,OSPEDALE VALDUCE – AMBULATORIO VACCINALE  COVID,LOM,30-39,9,7,0,16,0,0,0,16,0,16,Lombardia,ITC4
2021-01-11,PF/BT,030030,OSPEDALE VALDUCE – AMBULATORIO VACCINALE  COVID,LOM,40-49,7,8,0,15,0,0,0,15,0,15,Lombardia,ITC4
2021-01-11,PF/BT,030030,OSPEDALE VALDUCE – AMBULATORIO VACCINALE  COVID,LOM,50-59,3,7,0,10,0,0,0,10,0,10,Lombardia,ITC4
2021-01-11,PF/BT,030030,OSPEDALE VALDUCE – AMBULATORIO VACCINALE  COVID,LOM,60-69,3,1,0,4,0,0,0,4,0,4,Lombardia,ITC4
2021-01-11,PF/BT,030035,C.O.F. LANZO HOSPITAL - ALTA VALLE INTELVI,LOM,20-29,1,3,0,4,0,0,0,4,0,4,Lombardia,ITC4
2021-01-11,PF/BT,030035,C.O.F. LANZO HOSPITAL - ALTA VALLE INTELVI,LOM,30-39,1,0,0,1,0,0,0,1,0,1,Lombardia,ITC4
2021-01-11,PF/BT,030035,C.O.F. LANZO HOSPITAL - ALTA VALLE INTELVI,LOM,40-49,1,5,0,6,0,0,0,6,0,6,Lombardia,ITC4
2021-01-11,PF/BT,030035,C.O.F. LANZO HOSPITAL - ALTA VALLE INTELVI,LOM,50-59,1,6,0,7,0,0,0,7,0,7,Lombardia,ITC4
2021-01-11,PF/BT,030035,C.O.F. LANZO HOSPITAL - ALTA VALLE INTELVI,LOM,60-69,4,1,0,5,0,0,0,5,0,5,Lombardia,ITC4
2021-01-11,PF/BT,030066,CV Garbagnate,LOM,16-19,3,1,0,4,0,0,0,4,0,4,Lombardia,ITC4
2021-01-11,PF/BT,030066,CV Garbagnate,LOM,20-29,10,36,0,42,4,0,0,46,0,46,Lombardia,ITC4
2021-01-11,PF/BT,030066,CV Garbagnate,LOM,30-39,14,21,0,30,5,0,0,35,0,35,Lombardia,ITC4
2021-01-11,PF/BT,030066,CV Garbagnate,LOM,40-49,15,18,0,30,3,0,0,33,0,33,Lombardia,ITC4
2021-01-11,PF/BT,030066,CV Garbagnate,LOM,50-59,22,48,0,56,14,0,0,70,0,70,Lombardia,ITC4
2021-01-11,PF/BT,030066,CV Garbagnate,LOM,60-69,7,19,0,21,5,0,0,26,0,26,Lombardia,ITC4
2021-01-11,PF/BT,030066,CV Garbagnate,LOM,70-79,3,2,0,5,0,0,0,5,0,5,Lombardia,ITC4
2021-01-11,PF/BT,030068,PUNTO VACCINALE OSPEDALIERO DESIO,LOM,20-29,10,15,0,22,3,0,0,25,0,25,Lombardia,ITC4
2021-01-11,PF/BT,030068,PUNTO VACCINALE OSPEDALIERO DESIO,LOM,30-39,10,15,0,24,1,0,0,25,0,25,Lombardia,ITC4
2021-01-11,PF/BT,030068,PUNTO VACCINALE OSPEDALIERO DESIO,LOM,40-49,17,26,0,34,8,0,1,43,0,43,Lombardia,ITC4
2021-01-11,PF/BT,030068,PUNTO VACCINALE OSPEDALIERO DESIO,LOM,50-59,16,56,0,52,20,0,0,72,0,72,Lombardia,ITC4
2021-01-11,PF/BT,030068,PUNTO VACCINALE OSPEDALIERO DESIO,LOM,60-69,22,12,0,25,9,0,0,34,0,34,Lombardia,ITC4
2021-01-11,PF/BT,030068,PUNTO VACCINALE OSPEDALIERO DESIO,LOM,70-79,6,0,0,6,0,0,0,6,0,6,Lombardia,ITC4
2021-01-11,PF/BT,030070,PUNTO VACCINALE OSPEDALIERO CARATE BRIANZA,LOM,20-29,5,9,0,12,2,0,0,14,0,14,Lombardia,ITC4
2021-01-11,PF/BT,030070,PUNTO VACCINALE OSPEDALIERO CARATE BRIANZA,LOM,30-39,8,14,0,19,3,0,0,22,0,22,Lombardia,ITC4
2021-01-11,PF/BT,030070,PUNTO VACCINALE OSPEDALIERO CARATE BRIANZA,LOM,40-49,10,13,0,17,6,0,0,23,0,23,Lombardia,ITC4
2021-01-11,PF/BT,030070,PUNTO VACCINALE OSPEDALIERO CARATE BRIANZA,LOM,50-59,14,40,0,39,15,0,0,54,0,54,Lombardia,ITC4
2021-01-11,PF/BT,030070,PUNTO VACCINALE OSPEDALIERO CARATE BRIANZA,LOM,60-69,11,11,0,20,2,0,0,22,0,22,Lombardia,ITC4
2021-01-11,PF/BT,030070,PUNTO VACCINALE OSPEDALIERO CARATE BRIANZA,LOM,70-79,5,2,0,7,0,0,0,7,0,7,Lombardia,ITC4
2021-01-11,PF/BT,030078,PUNTO VACCINALE OSPEDALIERO VIMERCATE,LOM,20-29,6,11,0,10,7,0,0,17,0,17,Lombardia,ITC4
2021-01-11,PF/BT,030078,PUNTO VACCINALE OSPEDALIERO VIMERCATE,LOM,30-39,12,25,0,29,8,0,0,37,0,37,Lombardia,ITC4
2021-01-11,PF/BT,030078,PUNTO VACCINALE OSPEDALIERO VIMERCATE,LOM,40-49,18,28,0,32,14,0,0,46,0,46,Lombardia,ITC4
2021-01-11,PF/BT,030078,PUNTO VACCINALE OSPEDALIERO VIMERCATE,LOM,50-59,14,36,0,34,15,0,1,50,0,50,Lombardia,ITC4
2021-01-11,PF/BT,030078,PUNTO VACCINALE OSPEDALIERO VIMERCATE,LOM,60-69,21,19,0,31,8,0,1,40,0,40,Lombardia,ITC4
2021-01-11,PF/BT,030078,PUNTO VACCINALE OSPEDALIERO VIMERCATE,LOM,70-79,4,2,0,6,0,0,0,6,0,6,Lombardia,ITC4
2021-01-11,PF/BT,030078,PUNTO VACCINALE OSPEDALIERO VIMERCATE,LOM,80-89,2,0,0,2,0,0,0,2,0,2,Lombardia,ITC4
2021-01-11,PF/BT,030097,ISTITUTO CLINICO CITTA' STUDI - MILANO,LOM,20-29,3,1,0,4,0,0,0,4,0,4,Lombardia,ITC4
2021-01-11,PF/BT,030097,ISTITUTO CLINICO CITTA' STUDI - MILANO,LOM,30-39,7,7,0,14,0,0,0,14,0,14,Lombardia,ITC4
2021-01-11,PF/BT,030097,ISTITUTO CLINICO CITTA' STUDI - MILANO,LOM,40-49,11,4,0,15,0,0,0,15,0,15,Lombardia,ITC4
2021-01-11,PF/BT,030097,ISTITUTO CLINICO CITTA' STUDI - MILANO,LOM,50-59,13,5,0,18,0,0,0,18,0,18,Lombardia,ITC4
2021-01-11,PF/BT,030097,ISTITUTO CLINICO CITTA' STUDI - MILANO,LOM,60-69,4,3,0,7,0,0,0,7,0,7,Lombardia,ITC4
2021-01-11,PF/BT,030097,ISTITUTO CLINICO CITTA' STUDI - MILANO,LOM,70-79,0,2,0,2,0,0,0,2,0,2,Lombardia,ITC4
2021-01-11,PF/BT,030107,ISTITUTI CLINICI ZUCCHI - PRESIDIO DI MONZA,LOM,20-29,4,8,0,12,0,0,0,12,0,12,Lombardia,ITC4
2021-01-11,PF/BT,030107,ISTITUTI CLINICI ZUCCHI - PRESIDIO DI MONZA,LOM,30-39,11,13,0,24,0,0,0,24,0,24,Lombardia,ITC4
2021-01-11,PF/BT,030107,ISTITUTI CLINICI ZUCCHI - PRESIDIO DI MONZA,LOM,40-49,8,20,0,28,0,0,0,28,0,28,Lombardia,ITC4
2021-01-11,PF/BT,030107,ISTITUTI CLINICI ZUCCHI - PRESIDIO DI MONZA,LOM,50-59,10,20,0,30,0,0,0,30,0,30,Lombardia,ITC4
2021-01-11,PF/BT,030107,ISTITUTI CLINICI ZUCCHI - PRESIDIO DI MONZA,LOM,60-69,7,5,0,12,0,0,0,12,0,12,Lombardia,ITC4
2021-01-11,PF/BT,030107,ISTITUTI CLINICI ZUCCHI - PRESIDIO DI MONZA,LOM,70-79,1,0,0,1,0,0,0,1,0,1,Lombardia,ITC4
2021-01-11,PF/BT,030107,ISTITUTI CLINICI ZUCCHI - PRESIDIO DI MONZA,LOM,80-89,1,0,0,1,0,0,0,1,0,1,Lombardia,ITC4
2021-01-11,PF/BT,030178,ISTITUTO CLINICO CITTA' DI BRESCIA DI ISTITUTI OSPEDALIERI BRESCIANI,LOM,20-29,2,2,0,4,0,0,0,4,0,4,Lombardia,ITC4
2021-01-11,PF/BT,030178,ISTITUTO CLINICO CITTA' DI BRESCIA DI ISTITUTI OSPEDALIERI BRESCIANI,LOM,30-39,3,5,0,7,1,0,0,8,0,8,Lombardia,ITC4
2021-01-11,PF/BT,030178,ISTITUTO CLINICO CITTA' DI BRESCIA DI ISTITUTI OSPEDALIERI BRESCIANI,LOM,40-49,4,10,0,13,1,0,0,14,0,14,Lombardia,ITC4
2021-01-11,PF/BT,030178,ISTITUTO CLINICO CITTA' DI BRESCIA DI ISTITUTI OSPEDALIERI BRESCIANI,LOM,50-59,8,6,0,11,3,0,0,14,0,14,Lombardia,ITC4
2021-01-11,PF/BT,030178,ISTITUTO CLINICO CITTA' DI BRESCIA DI ISTITUTI OSPEDALIERI BRESCIANI,LOM,60-69,5,2,0,7,0,0,0,7,0,7,Lombardia,ITC4
2021-01-11,PF/BT,030178,ISTITUTO CLINICO CITTA' DI BRESCIA DI ISTITUTI OSPEDALIERI BRESCIANI,LOM,70-79,1,0,0,1,0,0,0,1,0,1,Lombardia,ITC4
2021-01-11,PF/BT,030295,Fondazione Poliambulanza - Brescia,LOM,20-29,3,15,0,16,2,0,0,18,0,18,Lombardia,ITC4
2021-01-11,PF/BT,030295,Fondazione Poliambulanza - Brescia,LOM,30-39,14,20,0,33,1,0,0,34,0,34,Lombardia,ITC4
2021-01-11,PF/BT,030295,Fondazione Poliambulanza - Brescia,LOM,40-49,10,36,0,45,1,0,0,46,0,46,Lombardia,ITC4
2021-01-11,PF/BT,030295,Fondazione Poliambulanza - Brescia,LOM,50-59,12,28,0,40,0,0,0,40,0,40,Lombardia,ITC4
2021-01-11,PF/BT,030295,Fondazione Poliambulanza - Brescia,LOM,60-69,13,3,0,16,0,0,0,16,0,16,Lombardia,ITC4
2021-01-11,PF/BT,030295,Fondazione Poliambulanza - Brescia,LOM,70-79,2,0,0,1,1,0,0,2,0,2,Lombardia,ITC4
2021-01-11,PF/BT,030321000265,ISTITUTO MONS. LUIGI BIRAGHI,LOM,30-39,1,4,0,3,2,0,0,5,0,5,Lombardia,ITC4
2021-01-11,PF/BT,030321000265,ISTITUTO MONS. LUIGI BIRAGHI,LOM,40-49,0,6,0,5,1,0,0,6,0,6,Lombardia,ITC4
2021-01-11,PF/BT,030321000265,ISTITUTO MONS. LUIGI BIRAGHI,LOM,50-59,2,16,0,17,1,0,0,18,0,18,Lombardia,ITC4
2021-01-11,PF/BT,030321000265,ISTITUTO MONS. LUIGI BIRAGHI,LOM,60-69,1,1,0,2,0,0,0,2,0,2,Lombardia,ITC4
2021-01-11,PF/BT,030321000265,ISTITUTO MONS. LUIGI BIRAGHI,LOM,70-79,0,3,0,1,2,0,0,3,0,3,Lombardia,ITC4
2021-01-11,PF/BT,030321000265,ISTITUTO MONS. LUIGI BIRAGHI,LOM,80-89,0,8,0,0,0,8,0,8,0,8,Lombardia,ITC4
2021-01-11,PF/BT,030321000265,ISTITUTO MONS. LUIGI BIRAGHI,LOM,90+,1,5,0,0,0,6,0,6,0,6,Lombardia,ITC4
2021-01-11,PF/BT,030-322-030032,Istituto Clinico Villa Aprica,LOM,30-39,5,5,0,10,0,0,0,10,0,10,Lombardia,ITC4
2021-01-11,PF/BT,030-322-030032,Istituto Clinico Villa Aprica,LOM,40-49,1,5,0,6,0,0,0,6,0,6,Lombardia,ITC4
2021-01-11,PF/BT,030-322-030032,Istituto Clinico Villa Aprica,LOM,50-59,4,3,0,7,0,0,0,7,0,7,Lombardia,ITC4
2021-01-11,PF/BT,030-322-030032,Istituto Clinico Villa Aprica,LOM,60-69,5,2,0,7,0,0,0,7,0,7,Lombardia,ITC4
2021-01-11,PF/BT,030-322-030347,CASA DI CURA VILLA S.GIUSEPPE-ANZANO DEL PARCO,LOM,20-29,0,2,0,2,0,0,0,2,0,2,Lombardia,ITC4
2021-01-11,PF/BT,030-322-030347,CASA DI CURA VILLA S.GIUSEPPE-ANZANO DEL PARCO,LOM,30-39,3,4,0,7,0,0,0,7,0,7,Lombardia,ITC4
2021-01-11,PF/BT,030-322-030347,CASA DI CURA VILLA S.GIUSEPPE-ANZANO DEL PARCO,LOM,40-49,1,6,0,5,2,0,0,7,0,7,Lombardia,ITC4
2021-01-11,PF/BT,030-322-030347,CASA DI CURA VILLA S.GIUSEPPE-ANZANO DEL PARCO,LOM,50-59,4,13,0,13,4,0,0,17,0,17,Lombardia,ITC4
2021-01-11,PF/BT,030-322-030347,CASA DI CURA VILLA S.GIUSEPPE-ANZANO DEL PARCO,LOM,60-69,2,0,0,2,0,0,0,2,0,2,Lombardia,ITC4
2021-01-11,PF/BT,030-322-030347,CASA DI CURA VILLA S.GIUSEPPE-ANZANO DEL PARCO,LOM,70-79,1,0,0,1,0,0,0,1,0,1,Lombardia,ITC4
2021-01-11,PF/BT,030324001093 -  030324001116,ISTIT.RIUNITI AIROLDI E MUZZI,LOM,20-29,0,2,0,2,0,0,0,2,0,2,Lombardia,ITC4
2021-01-11,PF/BT,030324001093 -  030324001116,ISTIT.RIUNITI AIROLDI E MUZZI,LOM,30-39,1,2,0,3,0,0,0,3,0,3,Lombardia,ITC4
2021-01-11,PF/BT,030324001093 -  030324001116,ISTIT.RIUNITI AIROLDI E MUZZI,LOM,40-49,3,6,0,7,1,1,0,9,0,9,Lombardia,ITC4
2021-01-11,PF/BT,030324001093 -  030324001116,ISTIT.RIUNITI AIROLDI E MUZZI,LOM,50-59,1,6,0,5,0,2,0,7,0,7,Lombardia,ITC4
2021-01-11,PF/BT,030324001093 -  030324001116,ISTIT.RIUNITI AIROLDI E MUZZI,LOM,60-69,1,2,0,3,0,0,0,3,0,3,Lombardia,ITC4
2021-01-11,PF/BT,030324001093 -  030324001116,ISTIT.RIUNITI AIROLDI E MUZZI,LOM,70-79,6,6,0,0,0,12,0,12,0,12,Lombardia,ITC4
2021-01-11,PF/BT,030324001093 -  030324001116,ISTIT.RIUNITI AIROLDI E MUZZI,LOM,80-89,6,10,0,0,0,16,0,16,0,16,Lombardia,ITC4
2021-01-11,PF/BT,030324001093 -  030324001116,ISTIT.RIUNITI AIROLDI E MUZZI,LOM,90+,5,3,0,0,0,8,0,8,0,8,Lombardia,ITC4
2021-01-11,PF/BT,030704,Polo Riabilitativo FFO,LOM,20-29,2,2,0,4,0,0,0,4,0,4,Lombardia,ITC4
2021-01-11,PF/BT,030704,Polo Riabilitativo FFO,LOM,30-39,4,8,0,12,0,0,0,12,0,12,Lombardia,ITC4
2021-01-11,PF/BT,030704,Polo Riabilitativo FFO,LOM,40-49,5,6,0,11,0,0,0,11,0,11,Lombardia,ITC4
2021-01-11,PF/BT,030704,Polo Riabilitativo FFO,LOM,50-59,3,5,0,8,0,0,0,8,0,8,Lombardia,ITC4
2021-01-11,PF/BT,030704,Polo Riabilitativo FFO,LOM,60-69,0,1,0,1,0,0,0,1,0,1,Lombardia,ITC4
2021-01-11,PF/BT,030704,Presidio Ospedaliero CTO,LOM,20-29,2,5,0,7,0,0,0,7,0,7,Lombardia,ITC4
2021-01-11,PF/BT,030704,Presidio Ospedaliero CTO,LOM,30-39,7,3,0,10,0,0,0,10,0,10,Lombardia,ITC4
2021-01-11,PF/BT,030704,Presidio Ospedaliero CTO,LOM,40-49,1,7,0,7,1,0,0,8,0,8,Lombardia,ITC4
2021-01-11,PF/BT,030704,Presidio Ospedaliero CTO,LOM,50-59,6,14,0,17,3,0,0,20,0,20,Lombardia,ITC4
2021-01-11,PF/BT,030704,Presidio Ospedaliero CTO,LOM,60-69,8,6,0,11,3,0,0,14,0,14,Lombardia,ITC4
2021-01-11,PF/BT,030704,Presidio Ospedaliero CTO,LOM,70-79,1,0,0,0,1,0,0,1,0,1,Lombardia,ITC4
2021-01-11,PF/BT,030704,Presidio Ospedaliero G. Pini,LOM,20-29,6,8,0,10,4,0,0,14,0,14,Lombardia,ITC4
2021-01-11,PF/BT,030704,Presidio Ospedaliero G. Pini,LOM,30-39,14,6,0,16,4,0,0,20,0,20,Lombardia,ITC4
2021-01-11,PF/BT,030704,Presidio Ospedaliero G. Pini,LOM,40-49,8,11,0,14,5,0,0,19,0,19,Lombardia,ITC4
2021-01-11,PF/BT,030704,Presidio Ospedaliero G. Pini,LOM,50-59,14,13,0,17,10,0,0,27,0,27,Lombardia,ITC4
2021-01-11,PF/BT,030704,Presidio Ospedaliero G. Pini,LOM,60-69,11,4,0,9,6,0,0,15,0,15,Lombardia,ITC4
2021-01-11,PF/BT,030704,Presidio Ospedaliero G. Pini,LOM,70-79,1,0,0,0,1,0,0,1,0,1,Lombardia,ITC4
2021-01-11,PF/BT,030903,AMB COVID LECCO,LOM,20-29,17,48,0,47,18,0,0,65,0,65,Lombardia,ITC4
2021-01-11,PF/BT,030903,AMB COVID LECCO,LOM,30-39,32,87,0,91,28,0,0,119,0,119,Lombardia,ITC4
2021-01-11,PF/BT,030903,AMB COVID LECCO,LOM,40-49,43,126,0,119,50,0,0,169,0,169,Lombardia,ITC4
2021-01-11,PF/BT,030903,AMB COVID LECCO,LOM,50-59,49,148,0,132,65,0,0,197,0,197,Lombardia,ITC4
2021-01-11,PF/BT,030903,AMB COVID LECCO,LOM,60-69,33,39,0,50,22,0,0,72,0,72,Lombardia,ITC4
2021-01-11,PF/BT,030903,AMB COVID LECCO,LOM,70-79,7,13,0,7,13,0,0,20,0,20,Lombardia,ITC4
2021-01-11,PF/BT,030903,AMB COVID LECCO,LOM,80-89,1,0,0,1,0,0,0,1,0,1,Lombardia,ITC4
2021-01-11,PF/BT,030922,"FOND.IRCCS ""ISTIT.NAZ.LE TUMORI""MILANO",LOM,20-29,10,18,0,26,2,0,0,28,0,28,Lombardia,ITC4
2021-01-11,PF/BT,030922,"FOND.IRCCS ""ISTIT.NAZ.LE TUMORI""MILANO",LOM,30-39,18,40,0,45,13,0,0,58,0,58,Lombardia,ITC4
2021-01-11,PF/BT,030922,"FOND.IRCCS ""ISTIT.NAZ.LE TUMORI""MILANO",LOM,40-49,10,36,0,33,13,0,0,46,0,46,Lombardia,ITC4
2021-01-11,PF/BT,030922,"FOND.IRCCS ""ISTIT.NAZ.LE TUMORI""MILANO",LOM,50-59,18,60,0,56,20,0,2,78,0,78,Lombardia,ITC4
2021-01-11,PF/BT,030922,"FOND.IRCCS ""ISTIT.NAZ.LE TUMORI""MILANO",LOM,60-69,18,12,0,29,1,0,0,30,0,30,Lombardia,ITC4
2021-01-11,PF/BT,030923,FOND.IRCCS IST.NAZ.NEUROLOGICO C.BESTA-M,LOM,20-29,3,15,0,14,3,0,1,18,0,18,Lombardia,ITC4
2021-01-11,PF/BT,030923,FOND.IRCCS IST.NAZ.NEUROLOGICO C.BESTA-M,LOM,30-39,8,16,0,16,5,0,3,24,0,24,Lombardia,ITC4
2021-01-11,PF/BT,030923,FOND.IRCCS IST.NAZ.NEUROLOGICO C.BESTA-M,LOM,40-49,8,20,0,20,5,0,3,28,0,28,Lombardia,ITC4
2021-01-11,PF/BT,030923,FOND.IRCCS IST.NAZ.NEUROLOGICO C.BESTA-M,LOM,50-59,6,21,0,18,4,0,5,27,0,27,Lombardia,ITC4
2021-01-11,PF/BT,030923,FOND.IRCCS IST.NAZ.NEUROLOGICO C.BESTA-M,LOM,60-69,5,6,0,6,4,0,1,11,0,11,Lombardia,ITC4
2021-01-11,PF/BT,030924,IRCCS POLICLINICO S. MATTEO - PAVIA,LOM,20-29,12,26,0,34,4,0,0,38,0,38,Lombardia,ITC4
2021-01-11,PF/BT,030924,IRCCS POLICLINICO S. MATTEO - PAVIA,LOM,30-39,19,36,0,50,5,0,0,55,0,55,Lombardia,ITC4
2021-01-11,PF/BT,030924,IRCCS POLICLINICO S. MATTEO - PAVIA,LOM,40-49,42,82,0,103,20,0,1,124,0,124,Lombardia,ITC4
2021-01-11,PF/BT,030924,IRCCS POLICLINICO S. MATTEO - PAVIA,LOM,50-59,20,42,0,44,17,0,1,62,0,62,Lombardia,ITC4
2021-01-11,PF/BT,030924,IRCCS POLICLINICO S. MATTEO - PAVIA,LOM,60-69,12,14,0,22,4,0,0,26,0,26,Lombardia,ITC4
2021-01-11,PF/BT,030924,IRCCS POLICLINICO S. MATTEO - PAVIA,LOM,70-79,1,0,0,0,0,0,1,1,0,1,Lombardia,ITC4
2021-01-11,PF/BT,030925,Fondazione IRCCS Ca' Granda Ospedale Maggiore Policlinico,LOM,20-29,10,22,0,32,0,0,0,32,0,32,Lombardia,ITC4
2021-01-11,PF/BT,030925,Fondazione IRCCS Ca' Granda Ospedale Maggiore Policlinico,LOM,30-39,25,45,0,69,1,0,0,70,0,70,Lombardia,ITC4
2021-01-11,PF/BT,030925,Fondazione IRCCS Ca' Granda Ospedale Maggiore Policlinico,LOM,40-49,17,49,0,54,12,0,0,66,0,66,Lombardia,ITC4
2021-01-11,PF/BT,030925,Fondazione IRCCS Ca' Granda Ospedale Maggiore Policlinico,LOM,50-59,19,62,0,64,17,0,0,81,0,81,Lombardia,ITC4
2021-01-11,PF/BT,030925,Fondazione IRCCS Ca' Granda Ospedale Maggiore Policlinico,LOM,60-69,10,10,0,17,3,0,0,20,0,20,Lombardia,ITC4
2021-01-11,PF/BT,030925,Fondazione IRCCS Ca' Granda Ospedale Maggiore Policlinico,LOM,70-79,0,1,0,1,0,0,0,1,0,1,Lombardia,ITC4
2021-01-11,PF/BT,030935,IRCCS    S. RAFFAELE - MILANO,LOM,20-29,3,2,0,5,0,0,0,5,0,5,Lombardia,ITC4
2021-01-11,PF/BT,030935,IRCCS    S. RAFFAELE - MILANO,LOM,30-39,1,3,0,4,0,0,0,4,0,4,Lombardia,ITC4
2021-01-11,PF/BT,030935,IRCCS    S. RAFFAELE - MILANO,LOM,40-49,29,56,0,85,0,0,0,85,0,85,Lombardia,ITC4
2021-01-11,PF/BT,030935,IRCCS    S. RAFFAELE - MILANO,LOM,50-59,34,74,0,108,0,0,0,108,0,108,Lombardia,ITC4
2021-01-11,PF/BT,030935,IRCCS    S. RAFFAELE - MILANO,LOM,60-69,5,3,0,8,0,0,0,8,0,8,Lombardia,ITC4
2021-01-11,PF/BT,030937,PRO JOVENTUDE DON C. GNOCCHI - MI IRCCS PRIVATO,LOM,20-29,0,2,0,2,0,0,0,2,0,2,Lombardia,ITC4
2021-01-11,PF/BT,030937,PRO JOVENTUDE DON C. GNOCCHI - MI IRCCS PRIVATO,LOM,30-39,5,2,0,7,0,0,0,7,0,7,Lombardia,ITC4
2021-01-11,PF/BT,030937,PRO JOVENTUDE DON C. GNOCCHI - MI IRCCS PRIVATO,LOM,40-49,3,13,0,15,1,0,0,16,0,16,Lombardia,ITC4
2021-01-11,PF/BT,030937,PRO JOVENTUDE DON C. GNOCCHI - MI IRCCS PRIVATO,LOM,50-59,1,11,0,10,2,0,0,12,0,12,Lombardia,ITC4
2021-01-11,PF/BT,030937,PRO JOVENTUDE DON C. GNOCCHI - MI IRCCS PRIVATO,LOM,60-69,7,4,0,10,1,0,0,11,0,11,Lombardia,ITC4
2021-01-11,PF/BT,030943,Istituto Clinico Humanitas,LOM,20-29,22,35,0,27,30,0,0,57,0,57,Lombardia,ITC4
2021-01-11,PF/BT,030943,Istituto Clinico Humanitas,LOM,30-39,44,49,0,57,36,0,0,93,0,93,Lombardia,ITC4
2021-01-11,PF/BT,030943,Istituto Clinico Humanitas,LOM,40-49,32,69,0,69,32,0,0,101,0,101,Lombardia,ITC4
2021-01-11,PF/BT,030943,Istituto Clinico Humanitas,LOM,50-59,24,37,0,39,22,0,0,61,0,61,Lombardia,ITC4
2021-01-11,PF/BT,030943,Istituto Clinico Humanitas,LOM,60-69,6,3,0,7,2,0,0,9,0,9,Lombardia,ITC4
2021-01-11,PF/BT,030943,Istituto Clinico Humanitas,LOM,70-79,1,1,0,1,1,0,0,2,0,2,Lombardia,ITC4
2021-01-11,PF/BT,030950,IRCCS   S. RAFFAELE TURRO - MILANO,LOM,30-39,0,1,0,1,0,0,0,1,0,1,Lombardia,ITC4
2021-01-11,PF/BT,030950,IRCCS   S. RAFFAELE TURRO - MILANO,LOM,40-49,5,22,0,27,0,0,0,27,0,27,Lombardia,ITC4
2021-01-11,PF/BT,030950,IRCCS   S. RAFFAELE TURRO - MILANO,LOM,50-59,3,6,0,9,0,0,0,9,0,9,Lombardia,ITC4
2021-01-11,PF/BT,1206,RSA ANNA E GUIDO  FOSSATI - MONZA,LOM,60-69,1,0,0,0,0,1,0,1,0,1,Lombardia,ITC4
2021-01-11,PF/BT,1206,RSA ANNA E GUIDO  FOSSATI - MONZA,LOM,70-79,0,2,0,0,0,2,0,2,0,2,Lombardia,ITC4
2021-01-11,PF/BT,1206,RSA ANNA E GUIDO  FOSSATI - MONZA,LOM,80-89,3,9,0,0,0,12,0,12,0,12,Lombardia,ITC4
2021-01-11,PF/BT,1206,RSA ANNA E GUIDO  FOSSATI - MONZA,LOM,90+,0,9,0,0,0,9,0,9,0,9,Lombardia,ITC4
2021-01-11,PF/BT,1323,RSA NOBILE BAGLIONI,LOM,70-79,0,2,0,0,0,2,0,2,0,2,Lombardia,ITC4
2021-01-11,PF/BT,1323,RSA NOBILE BAGLIONI,LOM,80-89,1,10,0,0,0,11,0,11,0,11,Lombardia,ITC4
2021-01-11,PF/BT,1323,RSA NOBILE BAGLIONI,LOM,90+,3,5,0,0,0,8,0,8,0,8,Lombardia,ITC4
2021-01-11,PF/BT,1411,Fondazione Don Stefano Palla Onlus,LOM,60-69,0,3,0,0,0,3,0,3,0,3,Lombardia,ITC4
2021-01-11,PF/BT,1411,Fondazione Don Stefano Palla Onlus,LOM,70-79,5,10,0,0,0,15,0,15,0,15,Lombardia,ITC4
2021-01-11,PF/BT,1411,Fondazione Don Stefano Palla Onlus,LOM,80-89,11,33,0,0,0,44,0,44,0,44,Lombardia,ITC4
2021-01-11,PF/BT,1411,Fondazione Don Stefano Palla Onlus,LOM,90+,1,9,0,0,0,10,0,10,0,10,Lombardia,ITC4
2021-01-11,PF/BT,1480,"Rsa ""Sorelle Girelli"" Marone (BS)",LOM,30-39,1,3,0,4,0,0,0,4,0,4,Lombardia,ITC4
2021-01-11,PF/BT,1480,"Rsa ""Sorelle Girelli"" Marone (BS)",LOM,40-49,0,4,0,2,2,0,0,4,0,4,Lombardia,ITC4
2021-01-11,PF/BT,1480,"Rsa ""Sorelle Girelli"" Marone (BS)",LOM,50-59,0,9,0,5,4,0,0,9,0,9,Lombardia,ITC4
2021-01-11,PF/BT,1480,"Rsa ""Sorelle Girelli"" Marone (BS)",LOM,60-69,0,2,0,2,0,0,0,2,0,2,Lombardia,ITC4
2021-01-11,PF/BT,1480,"Rsa ""Sorelle Girelli"" Marone (BS)",LOM,80-89,0,4,0,0,0,4,0,4,0,4,Lombardia,ITC4
2021-01-11,PF/BT,1480,"Rsa ""Sorelle Girelli"" Marone (BS)",LOM,90+,0,1,0,0,0,1,0,1,0,1,Lombardia,ITC4
2021-01-11,PF/BT,1544,CENTRO DIURNO RSA CASA INDUSTRIA,LOM,20-29,0,1,0,1,0,0,0,1,0,1,Lombardia,ITC4
2021-01-11,PF/BT,1544,CENTRO DIURNO RSA CASA INDUSTRIA,LOM,30-39,0,2,0,2,0,0,0,2,0,2,Lombardia,ITC4
2021-01-11,PF/BT,1544,CENTRO DIURNO RSA CASA INDUSTRIA,LOM,40-49,0,1,0,1,0,0,0,1,0,1,Lombardia,ITC4
2021-01-11,PF/BT,1544,CENTRO DIURNO RSA CASA INDUSTRIA,LOM,50-59,1,1,0,1,1,0,0,2,0,2,Lombardia,ITC4
2021-01-11,PF/BT,1585,RSA FEROLDI,LOM,20-29,2,9,0,11,0,0,0,11,0,11,Lombardia,ITC4
2021-01-11,PF/BT,1585,RSA FEROLDI,LOM,30-39,1,5,0,6,0,0,0,6,0,6,Lombardia,ITC4
2021-01-11,PF/BT,1585,RSA FEROLDI,LOM,40-49,0,8,0,7,1,0,0,8,0,8,Lombardia,ITC4
2021-01-11,PF/BT,1585,RSA FEROLDI,LOM,50-59,0,9,0,6,3,0,0,9,0,9,Lombardia,ITC4
2021-01-11,PF/BT,1585,RSA FEROLDI,LOM,60-69,0,2,0,2,0,0,0,2,0,2,Lombardia,ITC4
2021-01-11,PF/BT,1626,KOS CARE RSA VILLAGGIO SAN FRANCESCO,LOM,20-29,0,3,0,3,0,0,0,3,0,3,Lombardia,ITC4
2021-01-11,PF/BT,1626,KOS CARE RSA VILLAGGIO SAN FRANCESCO,LOM,30-39,2,5,0,7,0,0,0,7,0,7,Lombardia,ITC4
2021-01-11,PF/BT,1626,KOS CARE RSA VILLAGGIO SAN FRANCESCO,LOM,40-49,1,3,0,4,0,0,0,4,0,4,Lombardia,ITC4
2021-01-11,PF/BT,1626,KOS CARE RSA VILLAGGIO SAN FRANCESCO,LOM,50-59,0,1,0,1,0,0,0,1,0,1,Lombardia,ITC4
2021-01-11,PF/BT,1626,KOS CARE RSA VILLAGGIO SAN FRANCESCO,LOM,60-69,1,2,0,3,0,0,0,3,0,3,Lombardia,ITC4
2021-01-11,PF/BT,1640,001640 RSA LORENZO E GIANNA ZIROTTI,LOM,20-29,1,1,0,2,0,0,0,2,0,2,Lombardia,ITC4
2021-01-11,PF/BT,1640,001640 RSA LORENZO E GIANNA ZIROTTI,LOM,30-39,2,6,0,7,1,0,0,8,0,8,Lombardia,ITC4
2021-01-11,PF/BT,1640,001640 RSA LORENZO E GIANNA ZIROTTI,LOM,40-49,1,8,0,7,2,0,0,9,0,9,Lombardia,ITC4
2021-01-11,PF/BT,1640,001640 RSA LORENZO E GIANNA ZIROTTI,LOM,50-59,2,6,0,7,1,0,0,8,0,8,Lombardia,ITC4
2021-01-11,PF/BT,1640,001640 RSA LORENZO E GIANNA ZIROTTI,LOM,60-69,0,2,0,2,0,0,0,2,0,2,Lombardia,ITC4
2021-01-11,PF/BT,167,ASST SPEDALI CIVILI AMBULATORIO COVID BRESCIA,LOM,20-29,19,49,0,63,5,0,0,68,0,68,Lombardia,ITC4
2021-01-11,PF/BT,167,ASST SPEDALI CIVILI AMBULATORIO COVID BRESCIA,LOM,30-39,40,65,0,95,10,0,0,105,0,105,Lombardia,ITC4
2021-01-11,PF/BT,167,ASST SPEDALI CIVILI AMBULATORIO COVID BRESCIA,LOM,40-49,27,90,0,95,22,0,0,117,0,117,Lombardia,ITC4
2021-01-11,PF/BT,167,ASST SPEDALI CIVILI AMBULATORIO COVID BRESCIA,LOM,50-59,38,103,0,87,54,0,0,141,0,141,Lombardia,ITC4
2021-01-11,PF/BT,167,ASST SPEDALI CIVILI AMBULATORIO COVID BRESCIA,LOM,60-69,20,22,0,36,6,0,0,42,0,42,Lombardia,ITC4
2021-01-11,PF/BT,1739,RSA ARICI SEGA,LOM,20-29,0,2,0,2,0,0,0,2,0,2,Lombardia,ITC4
2021-01-11,PF/BT,1739,RSA ARICI SEGA,LOM,30-39,1,3,0,3,1,0,0,4,0,4,Lombardia,ITC4
2021-01-11,PF/BT,1739,RSA ARICI SEGA,LOM,40-49,1,3,0,4,0,0,0,4,0,4,Lombardia,ITC4
2021-01-11,PF/BT,1739,RSA ARICI SEGA,LOM,50-59,2,4,0,5,1,0,0,6,0,6,Lombardia,ITC4
2021-01-11,PF/BT,1739,RSA ARICI SEGA,LOM,60-69,0,2,0,1,1,0,0,2,0,2,Lombardia,ITC4
2021-01-11,PF/BT,1798,FONDAZIONE GIUSEPPINA BRUNENGHI,LOM,20-29,2,3,0,4,1,0,0,5,0,5,Lombardia,ITC4
2021-01-11,PF/BT,1798,FONDAZIONE GIUSEPPINA BRUNENGHI,LOM,30-39,1,3,0,3,1,0,0,4,0,4,Lombardia,ITC4
2021-01-11,PF/BT,1798,FONDAZIONE GIUSEPPINA BRUNENGHI,LOM,40-49,2,11,0,12,1,0,0,13,0,13,Lombardia,ITC4
2021-01-11,PF/BT,1798,FONDAZIONE GIUSEPPINA BRUNENGHI,LOM,50-59,3,8,0,6,5,0,0,11,0,11,Lombardia,ITC4
2021-01-11,PF/BT,1798,FONDAZIONE GIUSEPPINA BRUNENGHI,LOM,60-69,2,3,0,3,0,0,2,5,0,5,Lombardia,ITC4
2021-01-11,PF/BT,1798,FONDAZIONE GIUSEPPINA BRUNENGHI,LOM,70-79,6,4,0,0,0,9,1,10,0,10,Lombardia,ITC4
2021-01-11,PF/BT,1798,FONDAZIONE GIUSEPPINA BRUNENGHI,LOM,80-89,5,25,0,0,0,27,3,30,0,30,Lombardia,ITC4
2021-01-11,PF/BT,1798,FONDAZIONE GIUSEPPINA BRUNENGHI,LOM,90+,0,18,0,0,0,18,0,18,0,18,Lombardia,ITC4
2021-01-11,PF/BT,1824,Fondazione Benefattori Cremaschi - RSA Zurla,LOM,40-49,0,2,0,2,0,0,0,2,0,2,Lombardia,ITC4
2021-01-11,PF/BT,1824,Fondazione Benefattori Cremaschi - RSA Zurla,LOM,50-59,0,3,0,3,0,0,0,3,0,3,Lombardia,ITC4
2021-01-11,PF/BT,1824,Fondazione Benefattori Cremaschi - RSA Zurla,LOM,60-69,1,0,0,1,0,0,0,1,0,1,Lombardia,ITC4
2021-01-11,PF/BT,1842,RSA VILLA AZZURRA,LOM,30-39,1,1,0,2,0,0,0,2,0,2,Lombardia,ITC4
2021-01-11,PF/BT,1842,RSA VILLA AZZURRA,LOM,40-49,0,4,0,3,1,0,0,4,0,4,Lombardia,ITC4
2021-01-11,PF/BT,1842,RSA VILLA AZZURRA,LOM,50-59,1,10,0,9,2,0,0,11,0,11,Lombardia,ITC4
2021-01-11,PF/BT,1842,RSA VILLA AZZURRA,LOM,60-69,0,4,0,4,0,0,0,4,0,4,Lombardia,ITC4
2021-01-11,PF/BT,1842,RSA VILLA AZZURRA,LOM,70-79,0,1,0,0,0,1,0,1,0,1,Lombardia,ITC4
2021-01-11,PF/BT,1842,RSA VILLA AZZURRA,LOM,80-89,0,1,0,0,0,1,0,1,0,1,Lombardia,ITC4
2021-01-11,PF/BT,1842,RSA VILLA AZZURRA,LOM,90+,0,1,0,0,0,1,0,1,0,1,Lombardia,ITC4
2021-01-11,PF/BT,1918,RSA CASA ROSANNA,LOM,30-39,3,4,0,7,0,0,0,7,0,7,Lombardia,ITC4
2021-01-11,PF/BT,1918,RSA CASA ROSANNA,LOM,40-49,0,5,0,5,0,0,0,5,0,5,Lombardia,ITC4
2021-01-11,PF/BT,1918,RSA CASA ROSANNA,LOM,50-59,0,5,0,4,1,0,0,5,0,5,Lombardia,ITC4
2021-01-11,PF/BT,1918,RSA CASA ROSANNA,LOM,60-69,0,1,0,1,0,0,0,1,0,1,Lombardia,ITC4
2021-01-11,PF/BT,1953,RSA BEATA PAOLA,LOM,30-39,0,1,0,1,0,0,0,1,0,1,Lombardia,ITC4
2021-01-11,PF/BT,1953,RSA BEATA PAOLA,LOM,40-49,1,3,0,4,0,0,0,4,0,4,Lombardia,ITC4
2021-01-11,PF/BT,1953,RSA BEATA PAOLA,LOM,50-59,0,2,0,2,0,0,0,2,0,2,Lombardia,ITC4
2021-01-11,PF/BT,1953,RSA BEATA PAOLA,LOM,60-69,0,1,0,0,1,0,0,1,0,1,Lombardia,ITC4
2021-01-11,PF/BT,1953,RSA BEATA PAOLA,LOM,70-79,1,0,0,0,0,1,0,1,0,1,Lombardia,ITC4
2021-01-11,PF/BT,1953,RSA BEATA PAOLA,LOM,80-89,3,8,0,0,0,11,0,11,0,11,Lombardia,ITC4
2021-01-11,PF/BT,1953,RSA BEATA PAOLA,LOM,90+,0,4,0,0,0,4,0,4,0,4,Lombardia,ITC4
2021-01-11,PF/BT,2001,RESIDENZA SANITARIA ASSISTITA UNITA' GERIATRICA RIABILITATIVA ONLUS,LOM,30-39,1,0,0,1,0,0,0,1,0,1,Lombardia,ITC4
2021-01-11,PF/BT,2001,RESIDENZA SANITARIA ASSISTITA UNITA' GERIATRICA RIABILITATIVA ONLUS,LOM,50-59,2,5,0,7,0,0,0,7,0,7,Lombardia,ITC4
2021-01-11,PF/BT,2001,RESIDENZA SANITARIA ASSISTITA UNITA' GERIATRICA RIABILITATIVA ONLUS,LOM,60-69,0,1,0,1,0,0,0,1,0,1,Lombardia,ITC4
2021-01-11,PF/BT,2001,RESIDENZA SANITARIA ASSISTITA UNITA' GERIATRICA RIABILITATIVA ONLUS,LOM,70-79,0,1,0,0,0,1,0,1,0,1,Lombardia,ITC4
2021-01-11,PF/BT,2001,RESIDENZA SANITARIA ASSISTITA UNITA' GERIATRICA RIABILITATIVA ONLUS,LOM,80-89,3,1,0,0,0,4,0,4,0,4,Lombardia,ITC4
2021-01-11,PF/BT,2001,RESIDENZA SANITARIA ASSISTITA UNITA' GERIATRICA RIABILITATIVA ONLUS,LOM,90+,0,4,0,0,0,4,0,4,0,4,Lombardia,ITC4
2021-01-11,PF/BT,24,FONDAZIONE OSPEDALE MARCHESI DI INZAGO,LOM,30-39,0,1,0,1,0,0,0,1,0,1,Lombardia,ITC4
2021-01-11,PF/BT,24,FONDAZIONE OSPEDALE MARCHESI DI INZAGO,LOM,40-49,0,4,0,4,0,0,0,4,0,4,Lombardia,ITC4
2021-01-11,PF/BT,24,FONDAZIONE OSPEDALE MARCHESI DI INZAGO,LOM,50-59,1,3,0,3,1,0,0,4,0,4,Lombardia,ITC4
2021-01-11,PF/BT,24,FONDAZIONE OSPEDALE MARCHESI DI INZAGO,LOM,60-69,2,0,0,2,0,0,0,2,0,2,Lombardia,ITC4
2021-01-11,PF/BT,24,FONDAZIONE OSPEDALE MARCHESI DI INZAGO,LOM,70-79,1,5,0,0,0,6,0,6,0,6,Lombardia,ITC4
2021-01-11,PF/BT,24,FONDAZIONE OSPEDALE MARCHESI DI INZAGO,LOM,80-89,1,12,0,0,0,13,0,13,0,13,Lombardia,ITC4
2021-01-11,PF/BT,24,FONDAZIONE OSPEDALE MARCHESI DI INZAGO,LOM,90+,2,16,0,0,0,18,0,18,0,18,Lombardia,ITC4
2021-01-11,PF/BT,2859,RSA FONDAZIONE BELLARIA ONLUS,LOM,20-29,1,2,0,3,0,0,0,3,0,3,Lombardia,ITC4
2021-01-11,PF/BT,2859,RSA FONDAZIONE BELLARIA ONLUS,LOM,30-39,0,2,0,1,1,0,0,2,0,2,Lombardia,ITC4
2021-01-11,PF/BT,2859,RSA FONDAZIONE BELLARIA ONLUS,LOM,40-49,2,7,0,8,0,0,1,9,0,9,Lombardia,ITC4
2021-01-11,PF/BT,2859,RSA FONDAZIONE BELLARIA ONLUS,LOM,50-59,1,8,0,9,0,0,0,9,0,9,Lombardia,ITC4
2021-01-11,PF/BT,2859,RSA FONDAZIONE BELLARIA ONLUS,LOM,90+,0,1,0,0,0,0,1,1,0,1,Lombardia,ITC4
2021-01-11,PF/BT,30044,Ambulatorio Covid Chiavenna,LOM,20-29,2,0,0,2,0,0,0,2,0,2,Lombardia,ITC4
2021-01-11,PF/BT,30044,Ambulatorio Covid Chiavenna,LOM,30-39,0,2,0,2,0,0,0,2,0,2,Lombardia,ITC4
2021-01-11,PF/BT,30044,Ambulatorio Covid Chiavenna,LOM,40-49,2,3,0,5,0,0,0,5,0,5,Lombardia,ITC4
2021-01-11,PF/BT,30044,Ambulatorio Covid Chiavenna,LOM,50-59,8,20,0,21,7,0,0,28,0,28,Lombardia,ITC4
2021-01-11,PF/BT,30044,Ambulatorio Covid Chiavenna,LOM,60-69,3,4,0,3,4,0,0,7,0,7,Lombardia,ITC4
2021-01-11,PF/BT,30071,Centro Vaccinale Covid Melzo - ASST Melegnano Martesana,LOM,16-19,0,1,0,1,0,0,0,1,0,1,Lombardia,ITC4
2021-01-11,PF/BT,30071,Centro Vaccinale Covid Melzo - ASST Melegnano Martesana,LOM,20-29,25,25,0,49,1,0,0,50,0,50,Lombardia,ITC4
2021-01-11,PF/BT,30071,Centro Vaccinale Covid Melzo - ASST Melegnano Martesana,LOM,30-39,16,19,0,33,2,0,0,35,0,35,Lombardia,ITC4
2021-01-11,PF/BT,30071,Centro Vaccinale Covid Melzo - ASST Melegnano Martesana,LOM,40-49,20,29,0,45,4,0,0,49,0,49,Lombardia,ITC4
2021-01-11,PF/BT,30071,Centro Vaccinale Covid Melzo - ASST Melegnano Martesana,LOM,50-59,25,44,0,62,7,0,0,69,0,69,Lombardia,ITC4
2021-01-11,PF/BT,30071,Centro Vaccinale Covid Melzo - ASST Melegnano Martesana,LOM,60-69,35,15,0,42,8,0,0,50,0,50,Lombardia,ITC4
2021-01-11,PF/BT,30071,Centro Vaccinale Covid Melzo - ASST Melegnano Martesana,LOM,70-79,23,7,0,11,19,0,0,30,0,30,Lombardia,ITC4
2021-01-11,PF/BT,30071,Centro Vaccinale Covid Melzo - ASST Melegnano Martesana,LOM,80-89,3,0,0,2,1,0,0,3,0,3,Lombardia,ITC4
2021-01-11,PF/BT,30072,Centro Vaccinale Covid Vizzolo - ASST Melegnano Martesana,LOM,16-19,1,0,0,1,0,0,0,1,0,1,Lombardia,ITC4
2021-01-11,PF/BT,30072,Centro Vaccinale Covid Vizzolo - ASST Melegnano Martesana,LOM,20-29,7,18,0,23,2,0,0,25,0,25,Lombardia,ITC4
2021-01-11,PF/BT,30072,Centro Vaccinale Covid Vizzolo - ASST Melegnano Martesana,LOM,30-39,7,12,0,10,9,0,0,19,0,19,Lombardia,ITC4
2021-01-11,PF/BT,30072,Centro Vaccinale Covid Vizzolo - ASST Melegnano Martesana,LOM,40-49,13,28,0,33,8,0,0,41,0,41,Lombardia,ITC4
2021-01-11,PF/BT,30072,Centro Vaccinale Covid Vizzolo - ASST Melegnano Martesana,LOM,50-59,31,31,0,49,13,0,0,62,0,62,Lombardia,ITC4
2021-01-11,PF/BT,30072,Centro Vaccinale Covid Vizzolo - ASST Melegnano Martesana,LOM,60-69,15,14,0,22,7,0,0,29,0,29,Lombardia,ITC4
2021-01-11,PF/BT,30072,Centro Vaccinale Covid Vizzolo - ASST Melegnano Martesana,LOM,70-79,0,1,0,1,0,0,0,1,0,1,Lombardia,ITC4
2021-01-11,PF/BT,30073,CV Bollate,LOM,20-29,13,26,0,39,0,0,0,39,0,39,Lombardia,ITC4
2021-01-11,PF/BT,30073,CV Bollate,LOM,30-39,8,3,0,11,0,0,0,11,0,11,Lombardia,ITC4
2021-01-11,PF/BT,30073,CV Bollate,LOM,40-49,13,3,0,16,0,0,0,16,0,16,Lombardia,ITC4
2021-01-11,PF/BT,30073,CV Bollate,LOM,50-59,13,9,0,22,0,0,0,22,0,22,Lombardia,ITC4
2021-01-11,PF/BT,30073,CV Bollate,LOM,60-69,4,3,0,7,0,0,0,7,0,7,Lombardia,ITC4
2021-01-11,PF/BT,30073,cv rho,LOM,16-19,1,2,0,3,0,0,0,3,0,3,Lombardia,ITC4
2021-01-11,PF/BT,30073,cv rho,LOM,20-29,8,13,0,21,0,0,0,21,0,21,Lombardia,ITC4
2021-01-11,PF/BT,30073,cv rho,LOM,30-39,8,12,0,20,0,0,0,20,0,20,Lombardia,ITC4
2021-01-11,PF/BT,30073,cv rho,LOM,40-49,13,30,0,39,4,0,0,43,0,43,Lombardia,ITC4
2021-01-11,PF/BT,30073,cv rho,LOM,50-59,16,43,0,53,5,0,1,59,0,59,Lombardia,ITC4
2021-01-11,PF/BT,30073,cv rho,LOM,60-69,7,13,0,17,3,0,0,20,0,20,Lombardia,ITC4
2021-01-11,PF/BT,30073,cv rho,LOM,70-79,1,1,0,2,0,0,0,2,0,2,Lombardia,ITC4
2021-01-11,PF/BT,30074,HUB COVID MAGENTA,LOM,20-29,2,9,0,11,0,0,0,11,0,11,Lombardia,ITC4
2021-01-11,PF/BT,30074,HUB COVID MAGENTA,LOM,30-39,13,25,0,32,6,0,0,38,0,38,Lombardia,ITC4
2021-01-11,PF/BT,30074,HUB COVID MAGENTA,LOM,40-49,14,32,0,44,2,0,0,46,0,46,Lombardia,ITC4
2021-01-11,PF/BT,30074,HUB COVID MAGENTA,LOM,50-59,13,92,0,77,28,0,0,105,0,105,Lombardia,ITC4
2021-01-11,PF/BT,30074,HUB COVID MAGENTA,LOM,60-69,6,14,0,14,6,0,0,20,0,20,Lombardia,ITC4
2021-01-11,PF/BT,30085,Centro Vaccinale Covid Cernusco - ASST Melegnano Martesana,LOM,30-39,6,10,0,13,3,0,0,16,0,16,Lombardia,ITC4
2021-01-11,PF/BT,30085,Centro Vaccinale Covid Cernusco - ASST Melegnano Martesana,LOM,40-49,8,14,0,17,5,0,0,22,0,22,Lombardia,ITC4
2021-01-11,PF/BT,30085,Centro Vaccinale Covid Cernusco - ASST Melegnano Martesana,LOM,50-59,8,29,0,31,6,0,0,37,0,37,Lombardia,ITC4
2021-01-11,PF/BT,30085,Centro Vaccinale Covid Cernusco - ASST Melegnano Martesana,LOM,60-69,9,11,0,16,4,0,0,20,0,20,Lombardia,ITC4
2021-01-11,PF/BT,30085,Centro Vaccinale Covid Cernusco - ASST Melegnano Martesana,LOM,70-79,1,0,0,1,0,0,0,1,0,1,Lombardia,ITC4
2021-01-11,PF/BT,30156,Centro Vaccinale Covid Desenzano,LOM,20-29,1,5,0,6,0,0,0,6,0,6,Lombardia,ITC4
2021-01-11,PF/BT,30156,Centro Vaccinale Covid Desenzano,LOM,30-39,7,15,0,17,2,0,3,22,0,22,Lombardia,ITC4
2021-01-11,PF/BT,30156,Centro Vaccinale Covid Desenzano,LOM,40-49,7,23,0,25,4,0,1,30,0,30,Lombardia,ITC4
2021-01-11,PF/BT,30156,Centro Vaccinale Covid Desenzano,LOM,50-59,4,29,0,28,5,0,0,33,0,33,Lombardia,ITC4
2021-01-11,PF/BT,30156,Centro Vaccinale Covid Desenzano,LOM,60-69,8,7,0,14,1,0,0,15,0,15,Lombardia,ITC4
2021-01-11,PF/BT,30156,Centro Vaccinale Covid Desenzano,LOM,70-79,2,0,0,2,0,0,0,2,0,2,Lombardia,ITC4
2021-01-11,PF/BT,30157,Centro Vaccinale Covid Gavardo,LOM,20-29,9,5,0,0,0,0,14,14,0,14,Lombardia,ITC4
2021-01-11,PF/BT,30157,Centro Vaccinale Covid Gavardo,LOM,30-39,8,3,0,0,0,0,11,11,0,11,Lombardia,ITC4
2021-01-11,PF/BT,30157,Centro Vaccinale Covid Gavardo,LOM,40-49,16,16,0,3,0,0,29,32,0,32,Lombardia,ITC4
2021-01-11,PF/BT,30157,Centro Vaccinale Covid Gavardo,LOM,50-59,8,10,0,5,0,0,13,18,0,18,Lombardia,ITC4
2021-01-11,PF/BT,30157,Centro Vaccinale Covid Gavardo,LOM,60-69,17,7,0,0,0,0,24,24,0,24,Lombardia,ITC4
2021-01-11,PF/BT,30157,Centro Vaccinale Covid Gavardo,LOM,70-79,8,1,0,0,0,0,9,9,0,9,Lombardia,ITC4
2021-01-11,PF/BT,30176,ISTITUTO CLINICO S. ANNA di ISTITUTI OSPEDALIERI BRESCIANI S.p.A.,LOM,20-29,3,1,0,4,0,0,0,4,0,4,Lombardia,ITC4
2021-01-11,PF/BT,30176,ISTITUTO CLINICO S. ANNA di ISTITUTI OSPEDALIERI BRESCIANI S.p.A.,LOM,30-39,6,10,0,16,0,0,0,16,0,16,Lombardia,ITC4
2021-01-11,PF/BT,30176,ISTITUTO CLINICO S. ANNA di ISTITUTI OSPEDALIERI BRESCIANI S.p.A.,LOM,40-49,3,14,0,17,0,0,0,17,0,17,Lombardia,ITC4
2021-01-11,PF/BT,30176,ISTITUTO CLINICO S. ANNA di ISTITUTI OSPEDALIERI BRESCIANI S.p.A.,LOM,50-59,6,10,0,16,0,0,0,16,0,16,Lombardia,ITC4
2021-01-11,PF/BT,30176,ISTITUTO CLINICO S. ANNA di ISTITUTI OSPEDALIERI BRESCIANI S.p.A.,LOM,60-69,3,2,0,5,0,0,0,5,0,5,Lombardia,ITC4
2021-01-11,PF/BT,30176,ISTITUTO CLINICO S. ANNA di ISTITUTI OSPEDALIERI BRESCIANI S.p.A.,LOM,70-79,2,0,0,2,0,0,0,2,0,2,Lombardia,ITC4
2021-01-11,PF/BT,30184,Centro Vaccinale Covid Manerbio,LOM,20-29,0,12,0,10,0,2,0,12,0,12,Lombardia,ITC4
2021-01-11,PF/BT,30184,Centro Vaccinale Covid Manerbio,LOM,30-39,1,14,0,12,0,3,0,15,0,15,Lombardia,ITC4
2021-01-11,PF/BT,30184,Centro Vaccinale Covid Manerbio,LOM,40-49,3,21,0,22,2,0,0,24,0,24,Lombardia,ITC4
2021-01-11,PF/BT,30184,Centro Vaccinale Covid Manerbio,LOM,50-59,10,31,0,32,8,1,0,41,0,41,Lombardia,ITC4
2021-01-11,PF/BT,30184,Centro Vaccinale Covid Manerbio,LOM,60-69,5,5,0,8,2,0,0,10,0,10,Lombardia,ITC4
2021-01-11,PF/BT,30193,Ambulatorio HUB Vigevano,LOM,20-29,5,18,0,21,2,0,0,23,0,23,Lombardia,ITC4
2021-01-11,PF/BT,30193,Ambulatorio HUB Vigevano,LOM,30-39,5,10,0,11,4,0,0,15,0,15,Lombardia,ITC4
2021-01-11,PF/BT,30193,Ambulatorio HUB Vigevano,LOM,40-49,3,23,0,17,9,0,0,26,0,26,Lombardia,ITC4
2021-01-11,PF/BT,30193,Ambulatorio HUB Vigevano,LOM,50-59,11,33,0,26,18,0,0,44,0,44,Lombardia,ITC4
2021-01-11,PF/BT,30193,Ambulatorio HUB Vigevano,LOM,60-69,6,9,0,10,5,0,0,15,0,15,Lombardia,ITC4
2021-01-11,PF/BT,30194,AMBULATORIO HUB VOGHERA,LOM,20-29,3,8,0,10,1,0,0,11,0,11,Lombardia,ITC4
2021-01-11,PF/BT,30194,AMBULATORIO HUB VOGHERA,LOM,30-39,10,17,0,25,2,0,0,27,0,27,Lombardia,ITC4
2021-01-11,PF/BT,30194,AMBULATORIO HUB VOGHERA,LOM,40-49,9,25,0,26,8,0,0,34,0,34,Lombardia,ITC4
2021-01-11,PF/BT,30194,AMBULATORIO HUB VOGHERA,LOM,50-59,24,56,0,53,27,0,0,80,0,80,Lombardia,ITC4
2021-01-11,PF/BT,30194,AMBULATORIO HUB VOGHERA,LOM,60-69,4,11,0,11,4,0,0,15,0,15,Lombardia,ITC4
2021-01-11,PF/BT,302,Istituto Palazzolo Fondazione Don Carlo Gnocchi,LOM,20-29,1,1,0,2,0,0,0,2,0,2,Lombardia,ITC4
2021-01-11,PF/BT,302,Istituto Palazzolo Fondazione Don Carlo Gnocchi,LOM,30-39,0,1,0,1,0,0,0,1,0,1,Lombardia,ITC4
2021-01-11,PF/BT,302,Istituto Palazzolo Fondazione Don Carlo Gnocchi,LOM,40-49,2,5,0,7,0,0,0,7,0,7,Lombardia,ITC4
2021-01-11,PF/BT,302,Istituto Palazzolo Fondazione Don Carlo Gnocchi,LOM,50-59,0,8,0,8,0,0,0,8,0,8,Lombardia,ITC4
2021-01-11,PF/BT,302,Istituto Palazzolo Fondazione Don Carlo Gnocchi,LOM,60-69,3,3,0,6,0,0,0,6,0,6,Lombardia,ITC4
2021-01-11,PF/BT,30209,OSPEDALE MAGGIORE DI CREMA,LOM,16-19,0,1,0,0,0,0,1,1,0,1,Lombardia,ITC4
2021-01-11,PF/BT,30209,OSPEDALE MAGGIORE DI CREMA,LOM,20-29,4,11,0,9,0,0,6,15,0,15,Lombardia,ITC4
2021-01-11,PF/BT,30209,OSPEDALE MAGGIORE DI CREMA,LOM,30-39,8,11,0,13,1,0,5,19,0,19,Lombardia,ITC4
2021-01-11,PF/BT,30209,OSPEDALE MAGGIORE DI CREMA,LOM,40-49,9,20,0,23,4,0,2,29,0,29,Lombardia,ITC4
2021-01-11,PF/BT,30209,OSPEDALE MAGGIORE DI CREMA,LOM,50-59,12,39,0,28,18,0,5,51,0,51,Lombardia,ITC4
2021-01-11,PF/BT,30209,OSPEDALE MAGGIORE DI CREMA,LOM,60-69,8,16,0,8,4,0,12,24,0,24,Lombardia,ITC4
2021-01-11,PF/BT,30209,OSPEDALE MAGGIORE DI CREMA,LOM,70-79,2,5,0,0,0,0,7,7,0,7,Lombardia,ITC4
2021-01-11,PF/BT,30209,OSPEDALE MAGGIORE DI CREMA,LOM,80-89,1,2,0,0,0,0,3,3,0,3,Lombardia,ITC4
2021-01-11,PF/BT,30281,HUB COVID LEGNANO,LOM,20-29,2,13,0,7,8,0,0,15,0,15,Lombardia,ITC4
2021-01-11,PF/BT,30281,HUB COVID LEGNANO,LOM,30-39,13,36,0,42,7,0,0,49,0,49,Lombardia,ITC4
2021-01-11,PF/BT,30281,HUB COVID LEGNANO,LOM,40-49,18,52,0,64,6,0,0,70,0,70,Lombardia,ITC4
2021-01-11,PF/BT,30281,HUB COVID LEGNANO,LOM,50-59,30,81,0,79,32,0,0,111,0,111,Lombardia,ITC4
2021-01-11,PF/BT,30281,HUB COVID LEGNANO,LOM,60-69,6,14,0,18,2,0,0,20,0,20,Lombardia,ITC4
2021-01-11,PF/BT,30321000338 - 30321000390,Residenze Assistite maleo (Rsa Mons Trabattoni & RSA L. Corazza) Maleo - Lodi,LOM,20-29,1,4,0,5,0,0,0,5,0,5,Lombardia,ITC4
2021-01-11,PF/BT,30321000338 - 30321000390,Residenze Assistite maleo (Rsa Mons Trabattoni & RSA L. Corazza) Maleo - Lodi,LOM,30-39,3,7,0,10,0,0,0,10,0,10,Lombardia,ITC4
2021-01-11,PF/BT,30321000338 - 30321000390,Residenze Assistite maleo (Rsa Mons Trabattoni & RSA L. Corazza) Maleo - Lodi,LOM,40-49,2,13,0,10,5,0,0,15,0,15,Lombardia,ITC4
2021-01-11,PF/BT,30321000338 - 30321000390,Residenze Assistite maleo (Rsa Mons Trabattoni & RSA L. Corazza) Maleo - Lodi,LOM,50-59,3,20,0,15,8,0,0,23,0,23,Lombardia,ITC4
2021-01-11,PF/BT,30321000338 - 30321000390,Residenze Assistite maleo (Rsa Mons Trabattoni & RSA L. Corazza) Maleo - Lodi,LOM,60-69,1,4,0,5,0,0,0,5,0,5,Lombardia,ITC4
2021-01-11,PF/BT,30321000338 - 30321000390,Residenze Assistite maleo (Rsa Mons Trabattoni & RSA L. Corazza) Maleo - Lodi,LOM,70-79,1,1,0,1,1,0,0,2,0,2,Lombardia,ITC4
2021-01-11,PF/BT,30322029,Ospedale Religioso Classificato Sacra Famiglia Fatebenefratelli Erba,LOM,20-29,8,25,0,33,0,0,0,33,0,33,Lombardia,ITC4
2021-01-11,PF/BT,30322029,Ospedale Religioso Classificato Sacra Famiglia Fatebenefratelli Erba,LOM,30-39,8,4,0,11,1,0,0,12,0,12,Lombardia,ITC4
2021-01-11,PF/BT,30322029,Ospedale Religioso Classificato Sacra Famiglia Fatebenefratelli Erba,LOM,40-49,6,19,0,24,1,0,0,25,0,25,Lombardia,ITC4
2021-01-11,PF/BT,30322029,Ospedale Religioso Classificato Sacra Famiglia Fatebenefratelli Erba,LOM,50-59,9,16,0,21,4,0,0,25,0,25,Lombardia,ITC4
2021-01-11,PF/BT,30322029,Ospedale Religioso Classificato Sacra Famiglia Fatebenefratelli Erba,LOM,60-69,4,1,0,5,0,0,0,5,0,5,Lombardia,ITC4
2021-01-11,PF/BT,30322029,Ospedale Religioso Classificato Sacra Famiglia Fatebenefratelli Erba,LOM,70-79,2,0,0,1,1,0,0,2,0,2,Lombardia,ITC4
2021-01-11,PF/BT,3034800,CASA DI CURA VILLA GEMMA PRESSO CASA DI CURA VILLA BARBARANO,LOM,30-39,0,1,0,1,0,0,0,1,0,1,Lombardia,ITC4
2021-01-11,PF/BT,3034800,CASA DI CURA VILLA GEMMA PRESSO CASA DI CURA VILLA BARBARANO,LOM,40-49,2,5,0,4,3,0,0,7,0,7,Lombardia,ITC4
2021-01-11,PF/BT,3034800,CASA DI CURA VILLA GEMMA PRESSO CASA DI CURA VILLA BARBARANO,LOM,50-59,2,2,0,2,2,0,0,4,0,4,Lombardia,ITC4
2021-01-11,PF/BT,3035300,OSPEDALE CIVILE VOLTA MANTOVANA SRL,LOM,20-29,1,1,0,2,0,0,0,2,0,2,Lombardia,ITC4
2021-01-11,PF/BT,3035300,OSPEDALE CIVILE VOLTA MANTOVANA SRL,LOM,30-39,5,3,0,8,0,0,0,8,0,8,Lombardia,ITC4
2021-01-11,PF/BT,3035300,OSPEDALE CIVILE VOLTA MANTOVANA SRL,LOM,40-49,5,4,0,9,0,0,0,9,0,9,Lombardia,ITC4
2021-01-11,PF/BT,3035300,OSPEDALE CIVILE VOLTA MANTOVANA SRL,LOM,50-59,3,8,0,11,0,0,0,11,0,11,Lombardia,ITC4
2021-01-11,PF/BT,3035300,OSPEDALE CIVILE VOLTA MANTOVANA SRL,LOM,60-69,2,1,0,3,0,0,0,3,0,3,Lombardia,ITC4
2021-01-11,PF/BT,3035300,OSPEDALE CIVILE VOLTA MANTOVANA SRL,LOM,70-79,3,0,0,3,0,0,0,3,0,3,Lombardia,ITC4
2021-01-11,PF/BT,3035500,ospedale di suzzara spa,LOM,20-29,3,0,0,3,0,0,0,3,0,3,Lombardia,ITC4
2021-01-11,PF/BT,3035500,ospedale di suzzara spa,LOM,30-39,2,3,0,5,0,0,0,5,0,5,Lombardia,ITC4
2021-01-11,PF/BT,3035500,ospedale di suzzara spa,LOM,40-49,9,3,0,12,0,0,0,12,0,12,Lombardia,ITC4
2021-01-11,PF/BT,3035500,ospedale di suzzara spa,LOM,50-59,5,6,0,10,1,0,0,11,0,11,Lombardia,ITC4
2021-01-11,PF/BT,3035500,ospedale di suzzara spa,LOM,60-69,3,1,0,4,0,0,0,4,0,4,Lombardia,ITC4
2021-01-11,PF/BT,3035500,ospedale di suzzara spa,LOM,70-79,1,0,0,1,0,0,0,1,0,1,Lombardia,ITC4
2021-01-11,PF/BT,3035700,OSPEDALE SAN PELLEGRINO SRL,LOM,20-29,1,3,0,4,0,0,0,4,0,4,Lombardia,ITC4
2021-01-11,PF/BT,3035700,OSPEDALE SAN PELLEGRINO SRL,LOM,30-39,1,2,0,3,0,0,0,3,0,3,Lombardia,ITC4
2021-01-11,PF/BT,3035700,OSPEDALE SAN PELLEGRINO SRL,LOM,40-49,4,4,0,6,2,0,0,8,0,8,Lombardia,ITC4
2021-01-11,PF/BT,3035700,OSPEDALE SAN PELLEGRINO SRL,LOM,50-59,4,5,0,8,1,0,0,9,0,9,Lombardia,ITC4
2021-01-11,PF/BT,3035700,OSPEDALE SAN PELLEGRINO SRL,LOM,60-69,6,0,0,5,1,0,0,6,0,6,Lombardia,ITC4
2021-01-11,PF/BT,30701,ASST GRANDE OSPEDALE METROPOLITANO NIGUARDA,LOM,16-19,0,1,0,0,0,0,1,1,0,1,Lombardia,ITC4
2021-01-11,PF/BT,30701,ASST GRANDE OSPEDALE METROPOLITANO NIGUARDA,LOM,20-29,27,102,0,51,11,0,67,129,0,129,Lombardia,ITC4
2021-01-11,PF/BT,30701,ASST GRANDE OSPEDALE METROPOLITANO NIGUARDA,LOM,30-39,37,59,0,64,12,0,20,96,0,96,Lombardia,ITC4
2021-01-11,PF/BT,30701,ASST GRANDE OSPEDALE METROPOLITANO NIGUARDA,LOM,40-49,43,58,0,52,23,0,26,101,0,101,Lombardia,ITC4
2021-01-11,PF/BT,30701,ASST GRANDE OSPEDALE METROPOLITANO NIGUARDA,LOM,50-59,54,117,0,79,54,0,38,171,0,171,Lombardia,ITC4
2021-01-11,PF/BT,30701,ASST GRANDE OSPEDALE METROPOLITANO NIGUARDA,LOM,60-69,23,45,0,35,15,0,18,68,0,68,Lombardia,ITC4
2021-01-11,PF/BT,30701,ASST GRANDE OSPEDALE METROPOLITANO NIGUARDA,LOM,70-79,2,5,0,0,1,0,6,7,0,7,Lombardia,ITC4
2021-01-11,PF/BT,30701,ASST GRANDE OSPEDALE METROPOLITANO NIGUARDA,LOM,80-89,2,0,0,2,0,0,0,2,0,2,Lombardia,ITC4
2021-01-11,PF/BT,30902,Ospedale S.Anna - Como,LOM,16-19,4,3,0,1,6,0,0,7,0,7,Lombardia,ITC4
2021-01-11,PF/BT,30902,Ospedale S.Anna - Como,LOM,20-29,25,56,0,40,41,0,0,81,0,81,Lombardia,ITC4
2021-01-11,PF/BT,30902,Ospedale S.Anna - Como,LOM,30-39,43,65,0,61,47,0,0,108,0,108,Lombardia,ITC4
2021-01-11,PF/BT,30902,Ospedale S.Anna - Como,LOM,40-49,51,80,0,66,65,0,0,131,0,131,Lombardia,ITC4
2021-01-11,PF/BT,30902,Ospedale S.Anna - Como,LOM,50-59,68,112,0,85,95,0,0,180,0,180,Lombardia,ITC4
2021-01-11,PF/BT,30902,Ospedale S.Anna - Como,LOM,60-69,41,32,0,25,48,0,0,73,0,73,Lombardia,ITC4
2021-01-11,PF/BT,30902,Ospedale S.Anna - Como,LOM,70-79,12,2,0,4,10,0,0,14,0,14,Lombardia,ITC4
2021-01-11,PF/BT,30902,Ospedale S.Anna - Como,LOM,80-89,3,0,0,0,3,0,0,3,0,3,Lombardia,ITC4
2021-01-11,PF/BT,30904,ASST VALTELLINA E ALTO LARIO PRESIDIO OSPEDALIERO DI SONDALO,LOM,20-29,1,3,0,4,0,0,0,4,0,4,Lombardia,ITC4
2021-01-11,PF/BT,30904,ASST VALTELLINA E ALTO LARIO PRESIDIO OSPEDALIERO DI SONDALO,LOM,30-39,2,8,0,9,1,0,0,10,0,10,Lombardia,ITC4
2021-01-11,PF/BT,30904,ASST VALTELLINA E ALTO LARIO PRESIDIO OSPEDALIERO DI SONDALO,LOM,40-49,3,10,0,12,1,0,0,13,0,13,Lombardia,ITC4
2021-01-11,PF/BT,30904,ASST VALTELLINA E ALTO LARIO PRESIDIO OSPEDALIERO DI SONDALO,LOM,50-59,14,23,0,34,3,0,0,37,0,37,Lombardia,ITC4
2021-01-11,PF/BT,30904,ASST VALTELLINA E ALTO LARIO PRESIDIO OSPEDALIERO DI SONDALO,LOM,60-69,4,4,0,8,0,0,0,8,0,8,Lombardia,ITC4
2021-01-11,PF/BT,30909,amb covid monza,LOM,16-19,1,7,0,7,1,0,0,8,0,8,Lombardia,ITC4
2021-01-11,PF/BT,30909,amb covid monza,LOM,20-29,31,62,0,88,3,0,2,93,0,93,Lombardia,ITC4
2021-01-11,PF/BT,30909,amb covid monza,LOM,30-39,29,50,0,68,8,0,3,79,0,79,Lombardia,ITC4
2021-01-11,PF/BT,30909,amb covid monza,LOM,40-49,23,60,0,66,15,0,2,83,0,83,Lombardia,ITC4
2021-01-11,PF/BT,30909,amb covid monza,LOM,50-59,29,60,0,64,22,0,3,89,0,89,Lombardia,ITC4
2021-01-11,PF/BT,30909,amb covid monza,LOM,60-69,24,21,0,35,10,0,0,45,0,45,Lombardia,ITC4
2021-01-11,PF/BT,30909,amb covid monza,LOM,70-79,2,0,0,1,1,0,0,2,0,2,Lombardia,ITC4
2021-01-11,PF/BT,30909,amb covid monza,LOM,80-89,2,1,0,3,0,0,0,3,0,3,Lombardia,ITC4
2021-01-11,PF/BT,3093400,0,LOM,20-29,10,14,0,16,8,0,0,24,0,24,Lombardia,ITC4
2021-01-11,PF/BT,3093400,0,LOM,30-39,11,15,0,18,8,0,0,26,0,26,Lombardia,ITC4
2021-01-11,PF/BT,3093400,0,LOM,40-49,18,20,0,27,11,0,0,38,0,38,Lombardia,ITC4
2021-01-11,PF/BT,3093400,0,LOM,50-59,8,18,0,19,7,0,0,26,0,26,Lombardia,ITC4
2021-01-11,PF/BT,3093400,0,LOM,60-69,2,4,0,4,2,0,0,6,0,6,Lombardia,ITC4
2021-01-11,PF/BT,3093400,CENTRO CARDIOLOGICO MONZINO,LOM,20-29,1,11,0,10,2,0,0,12,0,12,Lombardia,ITC4
2021-01-11,PF/BT,3093400,CENTRO CARDIOLOGICO MONZINO,LOM,30-39,10,12,0,14,8,0,0,22,0,22,Lombardia,ITC4
2021-01-11,PF/BT,3093400,CENTRO CARDIOLOGICO MONZINO,LOM,40-49,4,8,0,12,0,0,0,12,0,12,Lombardia,ITC4
2021-01-11,PF/BT,3093400,CENTRO CARDIOLOGICO MONZINO,LOM,50-59,6,10,0,11,5,0,0,16,0,16,Lombardia,ITC4
2021-01-11,PF/BT,3093400,CENTRO CARDIOLOGICO MONZINO,LOM,60-69,4,4,0,7,1,0,0,8,0,8,Lombardia,ITC4
2021-01-11,PF/BT,30941,ISTITUTO EUROPEO DI ONCOLOGIA,LOM,20-29,5,7,0,11,1,0,0,12,0,12,Lombardia,ITC4
2021-01-11,PF/BT,30941,ISTITUTO EUROPEO DI ONCOLOGIA,LOM,30-39,21,16,0,35,2,0,0,37,0,37,Lombardia,ITC4
2021-01-11,PF/BT,30941,ISTITUTO EUROPEO DI ONCOLOGIA,LOM,40-49,14,24,0,38,0,0,0,38,0,38,Lombardia,ITC4
2021-01-11,PF/BT,30941,ISTITUTO EUROPEO DI ONCOLOGIA,LOM,50-59,22,37,0,59,0,0,0,59,0,59,Lombardia,ITC4
2021-01-11,PF/BT,30941,ISTITUTO EUROPEO DI ONCOLOGIA,LOM,60-69,1,3,0,4,0,0,0,4,0,4,Lombardia,ITC4
2021-01-11,PF/BT,3094602,IST.CLINICO S.SIRO SPA-MILANO,LOM,20-29,2,0,0,2,0,0,0,2,0,2,Lombardia,ITC4
2021-01-11,PF/BT,3094602,IST.CLINICO S.SIRO SPA-MILANO,LOM,30-39,2,1,0,3,0,0,0,3,0,3,Lombardia,ITC4
2021-01-11,PF/BT,3094602,IST.CLINICO S.SIRO SPA-MILANO,LOM,40-49,2,2,0,4,0,0,0,4,0,4,Lombardia,ITC4
2021-01-11,PF/BT,3094602,IST.CLINICO S.SIRO SPA-MILANO,LOM,50-59,5,1,0,4,2,0,0,6,0,6,Lombardia,ITC4
2021-01-11,PF/BT,3094602,IST.CLINICO S.SIRO SPA-MILANO,LOM,60-69,3,3,0,6,0,0,0,6,0,6,Lombardia,ITC4
2021-01-11,PF/BT,3094602,IST.CLINICO S.SIRO SPA-MILANO,LOM,70-79,3,0,0,3,0,0,0,3,0,3,Lombardia,ITC4
2021-01-11,PF/BT,321000483,RSA SAN FRANCESCO D'ASSISI,LOM,16-19,0,1,0,0,1,0,0,1,0,1,Lombardia,ITC4
2021-01-11,PF/BT,321000483,RSA SAN FRANCESCO D'ASSISI,LOM,20-29,1,2,0,2,1,0,0,3,0,3,Lombardia,ITC4
2021-01-11,PF/BT,321000483,RSA SAN FRANCESCO D'ASSISI,LOM,30-39,2,4,0,4,2,0,0,6,0,6,Lombardia,ITC4
2021-01-11,PF/BT,321000483,RSA SAN FRANCESCO D'ASSISI,LOM,40-49,0,7,0,4,3,0,0,7,0,7,Lombardia,ITC4
2021-01-11,PF/BT,321000483,RSA SAN FRANCESCO D'ASSISI,LOM,50-59,1,3,0,1,3,0,0,4,0,4,Lombardia,ITC4
2021-01-11,PF/BT,321000483,RSA SAN FRANCESCO D'ASSISI,LOM,60-69,1,1,0,0,2,0,0,2,0,2,Lombardia,ITC4
2021-01-11,PF/BT,321000483,RSA SAN FRANCESCO D'ASSISI,LOM,70-79,1,0,0,0,1,0,0,1,0,1,Lombardia,ITC4
2021-01-11,PF/BT,321000483,RSA SAN FRANCESCO D'ASSISI,LOM,90+,1,2,0,0,0,3,0,3,0,3,Lombardia,ITC4
2021-01-11,PF/BT,322000728,RSA CAMELOT,LOM,20-29,0,3,0,2,1,0,0,3,0,3,Lombardia,ITC4
2021-01-11,PF/BT,322000728,RSA CAMELOT,LOM,30-39,0,2,0,1,1,0,0,2,0,2,Lombardia,ITC4
2021-01-11,PF/BT,322000728,RSA CAMELOT,LOM,40-49,1,4,0,2,3,0,0,5,0,5,Lombardia,ITC4
2021-01-11,PF/BT,322000728,RSA CAMELOT,LOM,50-59,0,6,0,5,1,0,0,6,0,6,Lombardia,ITC4
2021-01-11,PF/BT,322000728,RSA CAMELOT,LOM,60-69,4,5,0,2,4,3,0,9,0,9,Lombardia,ITC4
2021-01-11,PF/BT,322000728,RSA CAMELOT,LOM,70-79,3,2,0,2,0,3,0,5,0,5,Lombardia,ITC4
2021-01-11,PF/BT,322000728,RSA CAMELOT,LOM,80-89,0,1,0,0,0,1,0,1,0,1,Lombardia,ITC4
2021-01-11,PF/BT,322000728,RSA CAMELOT,LOM,90+,1,4,0,0,0,5,0,5,0,5,Lombardia,ITC4
2021-01-11,PF/BT,32271028,AMBULATORIO COVID OSPEDALE CIRCOLO,LOM,20-29,25,35,0,60,0,0,0,60,0,60,Lombardia,ITC4
2021-01-11,PF/BT,32271028,AMBULATORIO COVID OSPEDALE CIRCOLO,LOM,30-39,50,86,0,136,0,0,0,136,0,136,Lombardia,ITC4
2021-01-11,PF/BT,32271028,AMBULATORIO COVID OSPEDALE CIRCOLO,LOM,40-49,31,122,0,153,0,0,0,153,0,153,Lombardia,ITC4
2021-01-11,PF/BT,32271028,AMBULATORIO COVID OSPEDALE CIRCOLO,LOM,50-59,45,148,0,193,0,0,0,193,0,193,Lombardia,ITC4
2021-01-11,PF/BT,32271028,AMBULATORIO COVID OSPEDALE CIRCOLO,LOM,60-69,22,64,0,86,0,0,0,86,0,86,Lombardia,ITC4
2021-01-11,PF/BT,32271028,AMBULATORIO COVID OSPEDALE CIRCOLO,LOM,70-79,0,26,0,26,0,0,0,26,0,26,Lombardia,ITC4
2021-01-11,PF/BT,32271116,ambulatorio covid Gallarate,LOM,20-29,6,8,0,14,0,0,0,14,0,14,Lombardia,ITC4
2021-01-11,PF/BT,32271116,ambulatorio covid Gallarate,LOM,30-39,4,19,0,23,0,0,0,23,0,23,Lombardia,ITC4
2021-01-11,PF/BT,32271116,ambulatorio covid Gallarate,LOM,40-49,10,30,0,40,0,0,0,40,0,40,Lombardia,ITC4
2021-01-11,PF/BT,32271116,ambulatorio covid Gallarate,LOM,50-59,14,66,0,80,0,0,0,80,0,80,Lombardia,ITC4
2021-01-11,PF/BT,32271116,ambulatorio covid Gallarate,LOM,60-69,5,12,0,17,0,0,0,17,0,17,Lombardia,ITC4
2021-01-11,PF/BT,32271117,ambulatorio covid Saronno,LOM,20-29,1,1,0,2,0,0,0,2,0,2,Lombardia,ITC4
2021-01-11,PF/BT,32271117,ambulatorio covid Saronno,LOM,30-39,2,6,0,8,0,0,0,8,0,8,Lombardia,ITC4
2021-01-11,PF/BT,32271117,ambulatorio covid Saronno,LOM,40-49,2,20,0,22,0,0,0,22,0,22,Lombardia,ITC4
2021-01-11,PF/BT,32271117,ambulatorio covid Saronno,LOM,50-59,3,28,0,31,0,0,0,31,0,31,Lombardia,ITC4
2021-01-11,PF/BT,32271117,ambulatorio covid Saronno,LOM,60-69,4,5,0,9,0,0,0,9,0,9,Lombardia,ITC4
2021-01-11,PF/BT,32271118,ambulatorio covid Busto A.,LOM,20-29,3,8,0,11,0,0,0,11,0,11,Lombardia,ITC4
2021-01-11,PF/BT,32271118,ambulatorio covid Busto A.,LOM,30-39,11,17,0,28,0,0,0,28,0,28,Lombardia,ITC4
2021-01-11,PF/BT,32271118,ambulatorio covid Busto A.,LOM,40-49,11,49,0,60,0,0,0,60,0,60,Lombardia,ITC4
2021-01-11,PF/BT,32271118,ambulatorio covid Busto A.,LOM,50-59,19,69,0,88,0,0,0,88,0,88,Lombardia,ITC4
2021-01-11,PF/BT,32271118,ambulatorio covid Busto A.,LOM,60-69,7,18,0,25,0,0,0,25,0,25,Lombardia,ITC4
2021-01-11,PF/BT,325001272,RSA SAN SISTO,LOM,60-69,1,0,0,0,0,1,0,1,0,1,Lombardia,ITC4
2021-01-11,PF/BT,325001272,RSA SAN SISTO,LOM,70-79,1,1,0,0,0,2,0,2,0,2,Lombardia,ITC4
2021-01-11,PF/BT,325001272,RSA SAN SISTO,LOM,80-89,2,7,0,0,0,9,0,9,0,9,Lombardia,ITC4
2021-01-11,PF/BT,325001272,RSA SAN SISTO,LOM,90+,2,4,0,0,0,6,0,6,0,6,Lombardia,ITC4
2021-01-11,PF/BT,325001342,CLINICHE GAVAZZENI SPA,LOM,20-29,4,18,0,22,0,0,0,22,0,22,Lombardia,ITC4
2021-01-11,PF/BT,325001342,CLINICHE GAVAZZENI SPA,LOM,30-39,3,10,0,13,0,0,0,13,0,13,Lombardia,ITC4
2021-01-11,PF/BT,325001342,CLINICHE GAVAZZENI SPA,LOM,40-49,5,6,0,11,0,0,0,11,0,11,Lombardia,ITC4
2021-01-11,PF/BT,325001342,CLINICHE GAVAZZENI SPA,LOM,50-59,5,4,0,9,0,0,0,9,0,9,Lombardia,ITC4
2021-01-11,PF/BT,325001342,CLINICHE GAVAZZENI SPA,LOM,60-69,4,0,0,4,0,0,0,4,0,4,Lombardia,ITC4
2021-01-11,PF/BT,325001342,CLINICHE GAVAZZENI SPA,LOM,70-79,1,0,0,1,0,0,0,1,0,1,Lombardia,ITC4
2021-01-11,PF/BT,325001412,ISTITUTO CASA DI RIPOSO CAPROTTI ZAVARITT,LOM,70-79,2,0,0,0,0,2,0,2,0,2,Lombardia,ITC4
2021-01-11,PF/BT,325001412,ISTITUTO CASA DI RIPOSO CAPROTTI ZAVARITT,LOM,80-89,5,16,0,0,0,21,0,21,0,21,Lombardia,ITC4
2021-01-11,PF/BT,325001412,ISTITUTO CASA DI RIPOSO CAPROTTI ZAVARITT,LOM,90+,3,10,0,0,0,13,0,13,0,13,Lombardia,ITC4
2021-01-11,PF/BT,32572021,AMBULATORIO COVID P.O. ALZANO,LOM,16-19,0,1,0,1,0,0,0,1,0,1,Lombardia,ITC4
2021-01-11,PF/BT,32572021,AMBULATORIO COVID P.O. ALZANO,LOM,20-29,3,6,0,9,0,0,0,9,0,9,Lombardia,ITC4
2021-01-11,PF/BT,32572021,AMBULATORIO COVID P.O. ALZANO,LOM,30-39,7,6,0,13,0,0,0,13,0,13,Lombardia,ITC4
2021-01-11,PF/BT,32572021,AMBULATORIO COVID P.O. ALZANO,LOM,40-49,9,6,0,15,0,0,0,15,0,15,Lombardia,ITC4
2021-01-11,PF/BT,32572021,AMBULATORIO COVID P.O. ALZANO,LOM,50-59,13,8,0,21,0,0,0,21,0,21,Lombardia,ITC4
2021-01-11,PF/BT,32572021,AMBULATORIO COVID P.O. ALZANO,LOM,60-69,14,3,0,17,0,0,0,17,0,17,Lombardia,ITC4
2021-01-11,PF/BT,32572021,AMBULATORIO COVID P.O. ALZANO,LOM,70-79,5,3,0,8,0,0,0,8,0,8,Lombardia,ITC4
2021-01-11,PF/BT,32572027,Ambulatorio COVID SERIATE,LOM,20-29,3,8,0,11,0,0,0,11,0,11,Lombardia,ITC4
2021-01-11,PF/BT,32572027,Ambulatorio COVID SERIATE,LOM,30-39,9,11,0,20,0,0,0,20,0,20,Lombardia,ITC4
2021-01-11,PF/BT,32572027,Ambulatorio COVID SERIATE,LOM,40-49,17,18,0,32,2,0,1,35,0,35,Lombardia,ITC4
2021-01-11,PF/BT,32572027,Ambulatorio COVID SERIATE,LOM,50-59,16,41,0,47,3,0,7,57,0,57,Lombardia,ITC4
2021-01-11,PF/BT,32572027,Ambulatorio COVID SERIATE,LOM,60-69,8,9,0,11,2,0,4,17,0,17,Lombardia,ITC4
2021-01-11,PF/BT,32572027,Ambulatorio COVID SERIATE,LOM,70-79,1,2,0,1,2,0,0,3,0,3,Lombardia,ITC4
2021-01-11,PF/BT,32572027,Ambulatorio COVID SERIATE,LOM,80-89,1,0,0,0,0,0,1,1,0,1,Lombardia,ITC4
2021-01-11,PF/BT,327001818,R.S.A. VILLA MADDALENA,LOM,20-29,1,2,0,3,0,0,0,3,0,3,Lombardia,ITC4
2021-01-11,PF/BT,327001818,R.S.A. VILLA MADDALENA,LOM,30-39,2,2,0,4,0,0,0,4,0,4,Lombardia,ITC4
2021-01-11,PF/BT,327001818,R.S.A. VILLA MADDALENA,LOM,40-49,4,2,0,6,0,0,0,6,0,6,Lombardia,ITC4
2021-01-11,PF/BT,327001818,R.S.A. VILLA MADDALENA,LOM,50-59,0,7,0,7,0,0,0,7,0,7,Lombardia,ITC4
2021-01-11,PF/BT,327001818,R.S.A. VILLA MADDALENA,LOM,70-79,2,2,0,0,0,4,0,4,0,4,Lombardia,ITC4
2021-01-11,PF/BT,327001818,R.S.A. VILLA MADDALENA,LOM,80-89,2,8,0,0,0,10,0,10,0,10,Lombardia,ITC4
2021-01-11,PF/BT,327001818,R.S.A. VILLA MADDALENA,LOM,90+,2,6,0,0,0,8,0,8,0,8,Lombardia,ITC4
2021-01-11,PF/BT,327001875,RSA Fondazione Pietro Sissa,LOM,20-29,1,1,0,2,0,0,0,2,0,2,Lombardia,ITC4
2021-01-11,PF/BT,327001875,RSA Fondazione Pietro Sissa,LOM,30-39,1,3,0,0,4,0,0,4,0,4,Lombardia,ITC4
2021-01-11,PF/BT,327001875,RSA Fondazione Pietro Sissa,LOM,40-49,1,11,0,8,4,0,0,12,0,12,Lombardia,ITC4
2021-01-11,PF/BT,327001875,RSA Fondazione Pietro Sissa,LOM,50-59,2,14,0,10,6,0,0,16,0,16,Lombardia,ITC4
2021-01-11,PF/BT,327001875,RSA Fondazione Pietro Sissa,LOM,60-69,0,3,0,1,1,1,0,3,0,3,Lombardia,ITC4
2021-01-11,PF/BT,327001875,RSA Fondazione Pietro Sissa,LOM,70-79,0,3,0,0,0,3,0,3,0,3,Lombardia,ITC4
2021-01-11,PF/BT,327001875,RSA Fondazione Pietro Sissa,LOM,80-89,2,8,0,0,0,10,0,10,0,10,Lombardia,ITC4
2021-01-11,PF/BT,327001875,RSA Fondazione Pietro Sissa,LOM,90+,1,9,0,0,0,10,0,10,0,10,Lombardia,ITC4
2021-01-11,PF/BT,327003606,RSA RODIGO,LOM,30-39,1,1,0,2,0,0,0,2,0,2,Lombardia,ITC4
2021-01-11,PF/BT,327003606,RSA RODIGO,LOM,50-59,1,1,0,1,1,0,0,2,0,2,Lombardia,ITC4
2021-01-11,PF/BT,327003606,RSA RODIGO,LOM,60-69,1,0,0,0,0,1,0,1,0,1,Lombardia,ITC4
2021-01-11,PF/BT,327003606,RSA RODIGO,LOM,70-79,5,1,0,1,0,5,0,6,0,6,Lombardia,ITC4
2021-01-11,PF/BT,327003606,RSA RODIGO,LOM,80-89,4,10,0,0,0,14,0,14,0,14,Lombardia,ITC4
2021-01-11,PF/BT,327003606,RSA RODIGO,LOM,90+,2,14,0,0,0,16,0,16,0,16,Lombardia,ITC4
2021-01-11,PF/BT,32772407,CV COVID CREMONA,LOM,20-29,7,15,0,15,4,0,3,22,0,22,Lombardia,ITC4
2021-01-11,PF/BT,32772407,CV COVID CREMONA,LOM,30-39,10,31,0,32,6,0,3,41,0,41,Lombardia,ITC4
2021-01-11,PF/BT,32772407,CV COVID CREMONA,LOM,40-49,14,38,0,34,17,0,1,52,0,52,Lombardia,ITC4
2021-01-11,PF/BT,32772407,CV COVID CREMONA,LOM,50-59,21,77,0,67,30,0,1,98,0,98,Lombardia,ITC4
2021-01-11,PF/BT,32772407,CV COVID CREMONA,LOM,60-69,14,13,0,21,6,0,0,27,0,27,Lombardia,ITC4
2021-01-11,PF/BT,347,Fondazione San Giuseppe Moscati,LOM,30-39,0,1,0,1,0,0,0,1,0,1,Lombardia,ITC4
2021-01-11,PF/BT,347,Fondazione San Giuseppe Moscati,LOM,50-59,0,1,0,1,0,0,0,1,0,1,Lombardia,ITC4
2021-01-11,PF/BT,347,Fondazione San Giuseppe Moscati,LOM,60-69,1,2,0,1,1,1,0,3,0,3,Lombardia,ITC4
2021-01-11,PF/BT,347,Fondazione San Giuseppe Moscati,LOM,70-79,1,4,0,0,0,5,0,5,0,5,Lombardia,ITC4
2021-01-11,PF/BT,347,Fondazione San Giuseppe Moscati,LOM,80-89,5,9,0,0,0,14,0,14,0,14,Lombardia,ITC4
2021-01-11,PF/BT,347,Fondazione San Giuseppe Moscati,LOM,90+,2,10,0,0,0,12,0,12,0,12,Lombardia,ITC4
2021-01-11,PF/BT,558,RSA PIO ALBERGO TRIVULZIO,LOM,20-29,3,5,0,6,2,0,0,8,0,8,Lombardia,ITC4
2021-01-11,PF/BT,558,RSA PIO ALBERGO TRIVULZIO,LOM,30-39,3,6,0,4,5,0,0,9,0,9,Lombardia,ITC4
2021-01-11,PF/BT,558,RSA PIO ALBERGO TRIVULZIO,LOM,40-49,10,13,0,7,16,0,0,23,0,23,Lombardia,ITC4
2021-01-11,PF/BT,558,RSA PIO ALBERGO TRIVULZIO,LOM,50-59,17,26,0,18,25,0,0,43,0,43,Lombardia,ITC4
2021-01-11,PF/BT,558,RSA PIO ALBERGO TRIVULZIO,LOM,60-69,10,9,0,6,12,1,0,19,0,19,Lombardia,ITC4
2021-01-11,PF/BT,558,RSA PIO ALBERGO TRIVULZIO,LOM,70-79,3,0,0,0,0,3,0,3,0,3,Lombardia,ITC4
2021-01-11,PF/BT,558,RSA PIO ALBERGO TRIVULZIO,LOM,80-89,2,1,0,0,0,3,0,3,0,3,Lombardia,ITC4
2021-01-11,PF/BT,616,Residenza Borromea,LOM,20-29,0,4,0,2,2,0,0,4,0,4,Lombardia,ITC4
2021-01-11,PF/BT,616,Residenza Borromea,LOM,30-39,0,9,0,6,3,0,0,9,0,9,Lombardia,ITC4
2021-01-11,PF/BT,616,Residenza Borromea,LOM,40-49,4,23,0,23,4,0,0,27,0,27,Lombardia,ITC4
2021-01-11,PF/BT,616,Residenza Borromea,LOM,50-59,4,17,0,19,2,0,0,21,0,21,Lombardia,ITC4
2021-01-11,PF/BT,616,Residenza Borromea,LOM,60-69,1,5,0,4,1,1,0,6,0,6,Lombardia,ITC4
2021-01-11,PF/BT,616,Residenza Borromea,LOM,70-79,5,3,0,1,2,5,0,8,0,8,Lombardia,ITC4
2021-01-11,PF/BT,616,Residenza Borromea,LOM,80-89,5,10,0,0,0,15,0,15,0,15,Lombardia,ITC4
2021-01-11,PF/BT,616,Residenza Borromea,LOM,90+,3,3,0,0,0,6,0,6,0,6,Lombardia,ITC4
2021-01-11,PF/BT,697,CASA RIPOSO F.LLI MOLINA P.E.T,LOM,20-29,1,4,0,5,0,0,0,5,0,5,Lombardia,ITC4
2021-01-11,PF/BT,697,CASA RIPOSO F.LLI MOLINA P.E.T,LOM,30-39,2,7,0,8,1,0,0,9,0,9,Lombardia,ITC4
2021-01-11,PF/BT,697,CASA RIPOSO F.LLI MOLINA P.E.T,LOM,40-49,3,13,0,15,1,0,0,16,0,16,Lombardia,ITC4
2021-01-11,PF/BT,697,CASA RIPOSO F.LLI MOLINA P.E.T,LOM,50-59,4,12,0,12,4,0,0,16,0,16,Lombardia,ITC4
2021-01-11,PF/BT,697,CASA RIPOSO F.LLI MOLINA P.E.T,LOM,60-69,0,2,0,2,0,0,0,2,0,2,Lombardia,ITC4
2021-01-11,PF/BT,947,I.R.C.C.S. POLICLINICO SAN DONATO,LOM,20-29,8,14,0,18,4,0,0,22,0,22,Lombardia,ITC4
2021-01-11,PF/BT,947,I.R.C.C.S. POLICLINICO SAN DONATO,LOM,30-39,6,23,0,28,1,0,0,29,0,29,Lombardia,ITC4
2021-01-11,PF/BT,947,I.R.C.C.S. POLICLINICO SAN DONATO,LOM,40-49,16,39,0,47,8,0,0,55,0,55,Lombardia,ITC4
2021-01-11,PF/BT,947,I.R.C.C.S. POLICLINICO SAN DONATO,LOM,50-59,12,19,0,26,5,0,0,31,0,31,Lombardia,ITC4
2021-01-11,PF/BT,947,I.R.C.C.S. POLICLINICO SAN DONATO,LOM,60-69,4,10,0,12,2,0,0,14,0,14,Lombardia,ITC4
2021-01-11,PF/BT,947,I.R.C.C.S. POLICLINICO SAN DONATO,LOM,70-79,3,2,0,5,0,0,0,5,0,5,Lombardia,ITC4
2021-01-11,PF/BT,CUDES 321000261,FONDAZIONE CASTELLINI ONLUS MELEGNANO,LOM,20-29,3,1,0,4,0,0,0,4,0,4,Lombardia,ITC4
2021-01-11,PF/BT,CUDES 321000261,FONDAZIONE CASTELLINI ONLUS MELEGNANO,LOM,30-39,1,3,0,4,0,0,0,4,0,4,Lombardia,ITC4
2021-01-11,PF/BT,CUDES 321000261,FONDAZIONE CASTELLINI ONLUS MELEGNANO,LOM,40-49,1,8,0,9,0,0,0,9,0,9,Lombardia,ITC4
2021-01-11,PF/BT,CUDES 321000261,FONDAZIONE CASTELLINI ONLUS MELEGNANO,LOM,50-59,2,9,0,11,0,0,0,11,0,11,Lombardia,ITC4
2021-01-11,PF/BT,CUDES 321000261,FONDAZIONE CASTELLINI ONLUS MELEGNANO,LOM,60-69,0,4,0,2,0,2,0,4,0,4,Lombardia,ITC4
2021-01-11,PF/BT,CUDES 321000261,FONDAZIONE CASTELLINI ONLUS MELEGNANO,LOM,70-79,0,3,0,0,0,3,0,3,0,3,Lombardia,ITC4
2021-01-11,PF/BT,CUDES 321000261,FONDAZIONE CASTELLINI ONLUS MELEGNANO,LOM,80-89,2,14,0,0,0,16,0,16,0,16,Lombardia,ITC4
2021-01-11,PF/BT,CUDES 321000261,FONDAZIONE CASTELLINI ONLUS MELEGNANO,LOM,90+,1,8,0,0,0,9,0,9,0,9,Lombardia,ITC4
2021-01-11,PF/BT,HSP11-11 bis,Policlinico San Pietro,LOM,20-29,0,6,0,6,0,0,0,6,0,6,Lombardia,ITC4
2021-01-11,PF/BT,HSP11-11 bis,Policlinico San Pietro,LOM,30-39,1,2,0,3,0,0,0,3,0,3,Lombardia,ITC4
2021-01-11,PF/BT,HSP11-11 bis,Policlinico San Pietro,LOM,40-49,3,13,0,16,0,0,0,16,0,16,Lombardia,ITC4
2021-01-11,PF/BT,HSP11-11 bis,Policlinico San Pietro,LOM,50-59,3,6,0,9,0,0,0,9,0,9,Lombardia,ITC4
2021-01-11,PF/BT,HSP11-11 bis,Policlinico San Pietro,LOM,60-69,0,5,0,5,0,0,0,5,0,5,Lombardia,ITC4
2021-01-11,PF/BT,HSP11-11 bis,Policlinico San Pietro,LOM,70-79,1,1,0,2,0,0,0,2,0,2,Lombardia,ITC4
2021-01-11,PF/BT,HSP11-11bis,32170223 HUB COVID SS PAOLO E CARLO - PVO Ospedale San Paolo,LOM,16-19,0,1,0,1,0,0,0,1,0,1,Lombardia,ITC4
2021-01-11,PF/BT,HSP11-11bis,32170223 HUB COVID SS PAOLO E CARLO - PVO Ospedale San Paolo,LOM,20-29,19,40,0,55,4,0,0,59,0,59,Lombardia,ITC4
2021-01-11,PF/BT,HSP11-11bis,32170223 HUB COVID SS PAOLO E CARLO - PVO Ospedale San Paolo,LOM,30-39,19,47,0,62,4,0,0,66,0,66,Lombardia,ITC4
2021-01-11,PF/BT,HSP11-11bis,32170223 HUB COVID SS PAOLO E CARLO - PVO Ospedale San Paolo,LOM,40-49,19,46,0,57,8,0,0,65,0,65,Lombardia,ITC4
2021-01-11,PF/BT,HSP11-11bis,32170223 HUB COVID SS PAOLO E CARLO - PVO Ospedale San Paolo,LOM,50-59,37,58,0,73,22,0,0,95,0,95,Lombardia,ITC4
2021-01-11,PF/BT,HSP11-11bis,32170223 HUB COVID SS PAOLO E CARLO - PVO Ospedale San Paolo,LOM,60-69,15,22,0,30,7,0,0,37,0,37,Lombardia,ITC4
2021-01-11,PF/BT,HSP11-11bis,32170224 HUB COVID OSP. SAN CARLO,LOM,16-19,3,0,0,0,2,0,1,3,0,3,Lombardia,ITC4
2021-01-11,PF/BT,HSP11-11bis,32170224 HUB COVID OSP. SAN CARLO,LOM,20-29,19,19,0,23,0,0,15,38,0,38,Lombardia,ITC4
2021-01-11,PF/BT,HSP11-11bis,32170224 HUB COVID OSP. SAN CARLO,LOM,30-39,19,34,0,41,2,0,10,53,0,53,Lombardia,ITC4
2021-01-11,PF/BT,HSP11-11bis,32170224 HUB COVID OSP. SAN CARLO,LOM,40-49,23,44,0,46,9,0,12,67,0,67,Lombardia,ITC4
2021-01-11,PF/BT,HSP11-11bis,32170224 HUB COVID OSP. SAN CARLO,LOM,50-59,31,67,0,68,22,0,8,98,0,98,Lombardia,ITC4
2021-01-11,PF/BT,HSP11-11bis,32170224 HUB COVID OSP. SAN CARLO,LOM,60-69,26,23,0,28,10,0,11,49,0,49,Lombardia,ITC4
2021-01-11,PF/BT,HSP11-11bis,32170224 HUB COVID OSP. SAN CARLO,LOM,70-79,0,1,0,0,0,0,1,1,0,1,Lombardia,ITC4
2021-01-11,PF/BT,HSP11-11bis,Ambulatorio COVID PO Codogno,LOM,20-29,2,3,0,4,1,0,0,5,0,5,Lombardia,ITC4
2021-01-11,PF/BT,HSP11-11bis,Ambulatorio COVID PO Codogno,LOM,30-39,3,8,0,7,4,0,0,11,0,11,Lombardia,ITC4
2021-01-11,PF/BT,HSP11-11bis,Ambulatorio COVID PO Codogno,LOM,40-49,5,11,0,8,8,0,0,16,0,16,Lombardia,ITC4
2021-01-11,PF/BT,HSP11-11bis,Ambulatorio COVID PO Codogno,LOM,50-59,6,16,0,9,13,0,0,22,0,22,Lombardia,ITC4
2021-01-11,PF/BT,HSP11-11bis,Ambulatorio COVID PO Codogno,LOM,60-69,5,6,0,8,3,0,0,11,0,11,Lombardia,ITC4
2021-01-11,PF/BT,HSP11-11bis,Ambulatorio COVID PO Codogno,LOM,70-79,1,0,0,1,0,0,0,1,0,1,Lombardia,ITC4
2021-01-11,PF/BT,HSP11-11bis,Ambulatorio COVID PO LODI,LOM,20-29,6,15,0,14,7,0,0,21,0,21,Lombardia,ITC4
2021-01-11,PF/BT,HSP11-11bis,Ambulatorio COVID PO LODI,LOM,30-39,13,17,0,26,4,0,0,30,0,30,Lombardia,ITC4
2021-01-11,PF/BT,HSP11-11bis,Ambulatorio COVID PO LODI,LOM,40-49,12,22,0,23,11,0,0,34,0,34,Lombardia,ITC4
2021-01-11,PF/BT,HSP11-11bis,Ambulatorio COVID PO LODI,LOM,50-59,21,47,0,42,26,0,0,68,0,68,Lombardia,ITC4
2021-01-11,PF/BT,HSP11-11bis,Ambulatorio COVID PO LODI,LOM,60-69,18,11,0,20,9,0,0,29,0,29,Lombardia,ITC4
2021-01-11,PF/BT,HSP11-11bis,Ambulatorio COVID PO S.Angelo Lod.,LOM,20-29,0,3,0,0,3,0,0,3,0,3,Lombardia,ITC4
2021-01-11,PF/BT,HSP11-11bis,Ambulatorio COVID PO S.Angelo Lod.,LOM,30-39,0,1,0,0,1,0,0,1,0,1,Lombardia,ITC4
2021-01-11,PF/BT,HSP11-11bis,Ambulatorio COVID PO S.Angelo Lod.,LOM,40-49,1,8,0,6,3,0,0,9,0,9,Lombardia,ITC4
2021-01-11,PF/BT,HSP11-11bis,Ambulatorio COVID PO S.Angelo Lod.,LOM,50-59,5,15,0,15,5,0,0,20,0,20,Lombardia,ITC4
2021-01-11,PF/BT,HSP11-11bis,Ambulatorio COVID PO S.Angelo Lod.,LOM,60-69,4,2,0,2,4,0,0,6,0,6,Lombardia,ITC4
2021-01-11,PF/BT,HSP11-11bis,Ambulatorio COVID PO S.Angelo Lod.,LOM,70-79,3,0,0,0,3,0,0,3,0,3,Lombardia,ITC4
2021-01-11,PF/BT,HSP11-11bis,AMBULATORIO COVID PO SACCO,LOM,20-29,34,74,0,91,17,0,0,108,0,108,Lombardia,ITC4
2021-01-11,PF/BT,HSP11-11bis,AMBULATORIO COVID PO SACCO,LOM,30-39,39,62,0,90,11,0,0,101,0,101,Lombardia,ITC4
2021-01-11,PF/BT,HSP11-11bis,AMBULATORIO COVID PO SACCO,LOM,40-49,18,57,0,59,16,0,0,75,0,75,Lombardia,ITC4
2021-01-11,PF/BT,HSP11-11bis,AMBULATORIO COVID PO SACCO,LOM,50-59,36,93,0,113,16,0,0,129,0,129,Lombardia,ITC4
2021-01-11,PF/BT,HSP11-11bis,AMBULATORIO COVID PO SACCO,LOM,60-69,27,41,0,46,22,0,0,68,0,68,Lombardia,ITC4
2021-01-11,PF/BT,HSP11-11bis,AMBULATORIO COVID PO SACCO,LOM,70-79,3,2,0,2,3,0,0,5,0,5,Lombardia,ITC4
2021-01-11,PF/BT,HSP11-11bis,ASST BERGAMO OVEST - OSPEDALE ROMANO DI L.DIA,LOM,20-29,2,8,0,7,1,0,2,10,0,10,Lombardia,ITC4
2021-01-11,PF/BT,HSP11-11bis,ASST BERGAMO OVEST - OSPEDALE ROMANO DI L.DIA,LOM,30-39,3,8,0,6,2,0,3,11,0,11,Lombardia,ITC4
2021-01-11,PF/BT,HSP11-11bis,ASST BERGAMO OVEST - OSPEDALE ROMANO DI L.DIA,LOM,40-49,7,21,0,13,4,0,11,28,0,28,Lombardia,ITC4
2021-01-11,PF/BT,HSP11-11bis,ASST BERGAMO OVEST - OSPEDALE ROMANO DI L.DIA,LOM,50-59,8,30,0,13,5,0,20,38,0,38,Lombardia,ITC4
2021-01-11,PF/BT,HSP11-11bis,ASST BERGAMO OVEST - OSPEDALE ROMANO DI L.DIA,LOM,60-69,3,6,0,6,1,0,2,9,0,9,Lombardia,ITC4
2021-01-11,PF/BT,HSP11-11bis,ASST BERGAMO OVEST - OSPEDALE TREVIGLIO,LOM,20-29,3,9,0,6,2,0,4,12,0,12,Lombardia,ITC4
2021-01-11,PF/BT,HSP11-11bis,ASST BERGAMO OVEST - OSPEDALE TREVIGLIO,LOM,30-39,6,13,0,15,1,0,3,19,0,19,Lombardia,ITC4
2021-01-11,PF/BT,HSP11-11bis,ASST BERGAMO OVEST - OSPEDALE TREVIGLIO,LOM,40-49,15,48,0,47,5,0,11,63,0,63,Lombardia,ITC4
2021-01-11,PF/BT,HSP11-11bis,ASST BERGAMO OVEST - OSPEDALE TREVIGLIO,LOM,50-59,12,67,0,49,13,0,17,79,0,79,Lombardia,ITC4
2021-01-11,PF/BT,HSP11-11bis,ASST BERGAMO OVEST - OSPEDALE TREVIGLIO,LOM,60-69,13,12,0,12,9,0,4,25,0,25,Lombardia,ITC4
2021-01-11,PF/BT,HSP11-11bis,"Policlinico San Marco, Osio Sotto (BG)",LOM,20-29,2,4,0,6,0,0,0,6,0,6,Lombardia,ITC4
2021-01-11,PF/BT,HSP11-11bis,"Policlinico San Marco, Osio Sotto (BG)",LOM,30-39,9,1,0,10,0,0,0,10,0,10,Lombardia,ITC4
2021-01-11,PF/BT,HSP11-11bis,"Policlinico San Marco, Osio Sotto (BG)",LOM,40-49,3,7,0,10,0,0,0,10,0,10,Lombardia,ITC4
2021-01-11,PF/BT,HSP11-11bis,"Policlinico San Marco, Osio Sotto (BG)",LOM,50-59,7,9,0,16,0,0,0,16,0,16,Lombardia,ITC4
2021-01-11,PF/BT,HSP11-11bis,"Policlinico San Marco, Osio Sotto (BG)",LOM,60-69,9,1,0,10,0,0,0,10,0,10,Lombardia,ITC4
2021-01-11,PF/BT,HSP11-11bis,"Policlinico San Marco, Osio Sotto (BG)",LOM,70-79,1,0,0,1,0,0,0,1,0,1,Lombardia,ITC4
2021-01-11,PF/BT,HSP11-11bis,"Policlinico San Marco, Osio Sotto (BG)",LOM,80-89,1,0,0,1,0,0,0,1,0,1,Lombardia,ITC4
2021-01-11,PF/BT,HSP11-11BIS-03010600,CASA DI CURA POLICLINICO DI MONZA-MONZA-,LOM,20-29,1,3,0,4,0,0,0,4,0,4,Lombardia,ITC4
2021-01-11,PF/BT,HSP11-11BIS-03010600,CASA DI CURA POLICLINICO DI MONZA-MONZA-,LOM,30-39,4,1,0,5,0,0,0,5,0,5,Lombardia,ITC4
2021-01-11,PF/BT,HSP11-11BIS-03010600,CASA DI CURA POLICLINICO DI MONZA-MONZA-,LOM,40-49,1,5,0,5,1,0,0,6,0,6,Lombardia,ITC4
2021-01-11,PF/BT,HSP11-11BIS-03010600,CASA DI CURA POLICLINICO DI MONZA-MONZA-,LOM,50-59,0,6,0,5,1,0,0,6,0,6,Lombardia,ITC4
2021-01-11,PF/BT,HSP11-11BIS-03010600,CASA DI CURA POLICLINICO DI MONZA-MONZA-,LOM,60-69,1,1,0,0,2,0,0,2,0,2,Lombardia,ITC4
2021-01-11,PF/BT,HSP11-11BIS-03010600,CASA DI CURA POLICLINICO DI MONZA-MONZA-,LOM,70-79,1,0,0,1,0,0,0,1,0,1,Lombardia,ITC4
2021-01-11,PF/BT,S09, PII ISTITUTI UNIFICATI ONLUS,LOM,20-29,0,2,0,2,0,0,0,2,0,2,Lombardia,ITC4
2021-01-11,PF/BT,S09, PII ISTITUTI UNIFICATI ONLUS,LOM,30-39,2,2,0,4,0,0,0,4,0,4,Lombardia,ITC4
2021-01-11,PF/BT,S09, PII ISTITUTI UNIFICATI ONLUS,LOM,40-49,0,7,0,7,0,0,0,7,0,7,Lombardia,ITC4
2021-01-11,PF/BT,S09, PII ISTITUTI UNIFICATI ONLUS,LOM,50-59,0,7,0,7,0,0,0,7,0,7,Lombardia,ITC4
2021-01-11,PF/BT,S10," PII ISTITUTI UNIFICATI ONLUS - CENTRO DIURNO DISABILI ""IL GIARDINO""",LOM,20-29,3,3,0,0,0,6,0,6,0,6,Lombardia,ITC4
2021-01-11,PF/BT,S10," PII ISTITUTI UNIFICATI ONLUS - CENTRO DIURNO DISABILI ""IL GIARDINO""",LOM,30-39,4,4,0,0,2,6,0,8,0,8,Lombardia,ITC4
2021-01-11,PF/BT,S10," PII ISTITUTI UNIFICATI ONLUS - CENTRO DIURNO DISABILI ""IL GIARDINO""",LOM,40-49,4,4,0,0,2,6,0,8,0,8,Lombardia,ITC4
2021-01-11,PF/BT,S10," PII ISTITUTI UNIFICATI ONLUS - CENTRO DIURNO DISABILI ""IL GIARDINO""",LOM,50-59,2,3,0,1,2,2,0,5,0,5,Lombardia,ITC4
2021-01-11,PF/BT,S10," PII ISTITUTI UNIFICATI ONLUS - CENTRO DIURNO DISABILI ""IL GIARDINO""",LOM,60-69,1,0,0,0,0,1,0,1,0,1,Lombardia,ITC4
2021-01-11,PF/BT,STS 11,FONDAZIONE ONLUS NINJ BECCAGUTTI,LOM,60-69,1,0,0,0,0,1,0,1,0,1,Lombardia,ITC4
2021-01-11,PF/BT,STS 11,FONDAZIONE ONLUS NINJ BECCAGUTTI,LOM,70-79,4,4,0,0,0,8,0,8,0,8,Lombardia,ITC4
2021-01-11,PF/BT,STS 11,FONDAZIONE ONLUS NINJ BECCAGUTTI,LOM,80-89,4,9,0,0,0,13,0,13,0,13,Lombardia,ITC4
2021-01-11,PF/BT,STS 11,FONDAZIONE ONLUS NINJ BECCAGUTTI,LOM,90+,0,8,0,0,0,8,0,8,0,8,Lombardia,ITC4
2021-01-11,PF/BT,STS11,FONDAZIONE POMPEO E CESARE MAZZOCCHI  ONLUS - COCCAGLIO,LOM,30-39,0,2,0,1,1,0,0,2,0,2,Lombardia,ITC4
2021-01-11,PF/BT,STS11,FONDAZIONE POMPEO E CESARE MAZZOCCHI  ONLUS - COCCAGLIO,LOM,40-49,0,3,0,3,0,0,0,3,0,3,Lombardia,ITC4
2021-01-11,PF/BT,STS11,FONDAZIONE POMPEO E CESARE MAZZOCCHI  ONLUS - COCCAGLIO,LOM,50-59,1,6,0,7,0,0,0,7,0,7,Lombardia,ITC4
2021-01-11,PF/BT,STS11,PVT COVID BRESCIA VIA ACERBI,LOM,20-29,10,10,0,0,0,0,20,20,0,20,Lombardia,ITC4
2021-01-11,PF/BT,STS11,PVT COVID BRESCIA VIA ACERBI,LOM,30-39,5,6,0,0,0,0,11,11,0,11,Lombardia,ITC4
2021-01-11,PF/BT,STS11,PVT COVID BRESCIA VIA ACERBI,LOM,40-49,7,6,0,0,0,0,13,13,0,13,Lombardia,ITC4
2021-01-11,PF/BT,STS11,PVT COVID BRESCIA VIA ACERBI,LOM,50-59,11,13,0,1,0,0,23,24,0,24,Lombardia,ITC4
2021-01-11,PF/BT,STS11,PVT COVID BRESCIA VIA ACERBI,LOM,60-69,21,4,0,0,0,0,25,25,0,25,Lombardia,ITC4
2021-01-11,PF/BT,STS11,PVT COVID BRESCIA VIA ACERBI,LOM,70-79,7,2,0,0,0,0,9,9,0,9,Lombardia,ITC4
2021-01-11,PF/BT,STS11/32170226,32170226 AMBULATORIO COVID OSP. MILITARE,LOM,20-29,4,4,0,8,0,0,0,8,0,8,Lombardia,ITC4
2021-01-11,PF/BT,STS11/32170226,32170226 AMBULATORIO COVID OSP. MILITARE,LOM,30-39,8,3,0,11,0,0,0,11,0,11,Lombardia,ITC4
2021-01-11,PF/BT,STS11/32170226,32170226 AMBULATORIO COVID OSP. MILITARE,LOM,40-49,11,0,0,11,0,0,0,11,0,11,Lombardia,ITC4
2021-01-11,PF/BT,STS11/32170226,32170226 AMBULATORIO COVID OSP. MILITARE,LOM,50-59,12,0,0,11,1,0,0,12,0,12,Lombardia,ITC4
2021-01-11,PF/BT,STS24,RSA FONDAZIONE ONLUS MONS. A. MAZZALI MANTOVA,LOM,20-29,0,1,0,1,0,0,0,1,0,1,Lombardia,ITC4
2021-01-11,PF/BT,STS24,RSA FONDAZIONE ONLUS MONS. A. MAZZALI MANTOVA,LOM,30-39,0,1,0,1,0,0,0,1,0,1,Lombardia,ITC4
2021-01-11,PF/BT,STS24,RSA FONDAZIONE ONLUS MONS. A. MAZZALI MANTOVA,LOM,40-49,0,1,0,1,0,0,0,1,0,1,Lombardia,ITC4
2021-01-11,PF/BT,STS24,RSA FONDAZIONE ONLUS MONS. A. MAZZALI MANTOVA,LOM,50-59,5,8,0,13,0,0,0,13,0,13,Lombardia,ITC4
2021-01-11,PF/BT,STS24,RSA FONDAZIONE ONLUS MONS. A. MAZZALI MANTOVA,LOM,60-69,1,1,0,2,0,0,0,2,0,2,Lombardia,ITC4
2021-01-12,PF/BT,"""000916""",CASA RIPOSO CITTA' DI SONDRIO,LOM,16-19,0,1,0,1,0,0,0,1,0,1,Lombardia,ITC4
2021-01-12,PF/BT,"""000916""",CASA RIPOSO CITTA' DI SONDRIO,LOM,20-29,0,5,0,4,1,0,0,5,0,5,Lombardia,ITC4
2021-01-12,PF/BT,"""000916""",CASA RIPOSO CITTA' DI SONDRIO,LOM,30-39,0,2,0,1,1,0,0,2,0,2,Lombardia,ITC4
2021-01-12,PF/BT,"""000916""",CASA RIPOSO CITTA' DI SONDRIO,LOM,40-49,3,8,0,10,1,0,0,11,0,11,Lombardia,ITC4
2021-01-12,PF/BT,"""000916""",CASA RIPOSO CITTA' DI SONDRIO,LOM,50-59,4,13,0,9,8,0,0,17,0,17,Lombardia,ITC4
2021-01-12,PF/BT,"""000916""",CASA RIPOSO CITTA' DI SONDRIO,LOM,60-69,1,4,0,3,2,0,0,5,0,5,Lombardia,ITC4
2021-01-12,PF/BT,"""000916""",CASA RIPOSO CITTA' DI SONDRIO,LOM,70-79,0,1,0,0,0,1,0,1,0,1,Lombardia,ITC4
2021-01-12,PF/BT,"""000916""",CASA RIPOSO CITTA' DI SONDRIO,LOM,80-89,1,4,0,0,0,5,0,5,0,5,Lombardia,ITC4
2021-01-12,PF/BT,"""000916""",CASA RIPOSO CITTA' DI SONDRIO,LOM,90+,1,6,0,0,0,7,0,7,0,7,Lombardia,ITC4
2021-01-12,PF/BT,(03027500/001752),PVO Istituto Clinico San Rocco (Spoke),LOM,20-29,2,1,0,3,0,0,0,3,0,3,Lombardia,ITC4
2021-01-12,PF/BT,(03027500/001752),PVO Istituto Clinico San Rocco (Spoke),LOM,30-39,1,4,0,5,0,0,0,5,0,5,Lombardia,ITC4
2021-01-12,PF/BT,(03027500/001752),PVO Istituto Clinico San Rocco (Spoke),LOM,40-49,2,6,0,7,1,0,0,8,0,8,Lombardia,ITC4
2021-01-12,PF/BT,(03027500/001752),PVO Istituto Clinico San Rocco (Spoke),LOM,50-59,2,3,0,4,1,0,0,5,0,5,Lombardia,ITC4
2021-01-12,PF/BT,(03027500/001752),PVO Istituto Clinico San Rocco (Spoke),LOM,60-69,2,0,0,2,0,0,0,2,0,2,Lombardia,ITC4
2021-01-12,PF/BT,(03027500/001752),PVO Istituto Clinico San Rocco (Spoke),LOM,70-79,1,0,0,1,0,0,0,1,0,1,Lombardia,ITC4
2021-01-12,PF/BT,.030042,ASST VALTELLINA ALTO LARIO - PRESIDIO OSPEDALIERO DI SONDRIO,LOM,20-29,6,15,0,16,5,0,0,21,0,21,Lombardia,ITC4
2021-01-12,PF/BT,.030042,ASST VALTELLINA ALTO LARIO - PRESIDIO OSPEDALIERO DI SONDRIO,LOM,30-39,12,18,0,21,9,0,0,30,0,30,Lombardia,ITC4
2021-01-12,PF/BT,.030042,ASST VALTELLINA ALTO LARIO - PRESIDIO OSPEDALIERO DI SONDRIO,LOM,40-49,17,26,0,33,10,0,0,43,0,43,Lombardia,ITC4
2021-01-12,PF/BT,.030042,ASST VALTELLINA ALTO LARIO - PRESIDIO OSPEDALIERO DI SONDRIO,LOM,50-59,17,61,0,55,23,0,0,78,0,78,Lombardia,ITC4
2021-01-12,PF/BT,.030042,ASST VALTELLINA ALTO LARIO - PRESIDIO OSPEDALIERO DI SONDRIO,LOM,60-69,15,16,0,26,5,0,0,31,0,31,Lombardia,ITC4
2021-01-12,PF/BT,.030042,ASST VALTELLINA ALTO LARIO - PRESIDIO OSPEDALIERO DI SONDRIO,LOM,70-79,1,0,0,1,0,0,0,1,0,1,Lombardia,ITC4
2021-01-12,PF/BT,0,FONDAZIONE CARISMA BERGAMO,LOM,50-59,1,0,0,0,0,1,0,1,0,1,Lombardia,ITC4
2021-01-12,PF/BT,0,FONDAZIONE CARISMA BERGAMO,LOM,60-69,4,0,0,0,0,4,0,4,0,4,Lombardia,ITC4
2021-01-12,PF/BT,0,FONDAZIONE CARISMA BERGAMO,LOM,70-79,2,2,0,0,0,4,0,4,0,4,Lombardia,ITC4
2021-01-12,PF/BT,0,FONDAZIONE CARISMA BERGAMO,LOM,80-89,8,30,0,0,0,38,0,38,0,38,Lombardia,ITC4
2021-01-12,PF/BT,0,FONDAZIONE CARISMA BERGAMO,LOM,90+,4,11,0,0,0,15,0,15,0,15,Lombardia,ITC4
2021-01-12,PF/BT,0,OPERA CHARITAS S.ANNA - RSA VILLA ENRICA - ALBONESE (PV),LOM,70-79,3,2,0,0,0,5,0,5,0,5,Lombardia,ITC4
2021-01-12,PF/BT,0,OPERA CHARITAS S.ANNA - RSA VILLA ENRICA - ALBONESE (PV),LOM,80-89,0,4,0,0,0,4,0,4,0,4,Lombardia,ITC4
2021-01-12,PF/BT,0,OPERA CHARITAS S.ANNA - RSA VILLA ENRICA - ALBONESE (PV),LOM,90+,1,2,0,0,0,3,0,3,0,3,Lombardia,ITC4
2021-01-12,PF/BT,0,"RSA “ISTITUTO GERIATRICO MILANESE""",LOM,70-79,0,2,0,0,0,2,0,2,0,2,Lombardia,ITC4
2021-01-12,PF/BT,0,"RSA “ISTITUTO GERIATRICO MILANESE""",LOM,80-89,0,4,0,0,0,4,0,4,0,4,Lombardia,ITC4
2021-01-12,PF/BT,0,"RSA “ISTITUTO GERIATRICO MILANESE""",LOM,90+,0,12,0,0,0,12,0,12,0,12,Lombardia,ITC4
2021-01-12,PF/BT,000050,Poliambulatorio IRCSS OSPEDALE SAN LUCA,LOM,20-29,4,6,0,10,0,0,0,10,0,10,Lombardia,ITC4
2021-01-12,PF/BT,000050,Poliambulatorio IRCSS OSPEDALE SAN LUCA,LOM,30-39,4,5,0,9,0,0,0,9,0,9,Lombardia,ITC4
2021-01-12,PF/BT,000050,Poliambulatorio IRCSS OSPEDALE SAN LUCA,LOM,40-49,4,12,0,15,1,0,0,16,0,16,Lombardia,ITC4
2021-01-12,PF/BT,000050,Poliambulatorio IRCSS OSPEDALE SAN LUCA,LOM,50-59,2,13,0,15,0,0,0,15,0,15,Lombardia,ITC4
2021-01-12,PF/BT,000050,Poliambulatorio IRCSS OSPEDALE SAN LUCA,LOM,60-69,4,3,0,7,0,0,0,7,0,7,Lombardia,ITC4
2021-01-12,PF/BT,000050,Poliambulatorio IRCSS OSPEDALE SAN LUCA,LOM,70-79,2,0,0,2,0,0,0,2,0,2,Lombardia,ITC4
2021-01-12,PF/BT,000050,Poliambulatorio IRCSS OSPEDALE SAN LUCA,LOM,80-89,1,0,0,0,1,0,0,1,0,1,Lombardia,ITC4
2021-01-12,PF/BT,000119,POLIAMBULATORIO IRCSS OSPEDALE SAN MICHELE,LOM,20-29,1,2,0,3,0,0,0,3,0,3,Lombardia,ITC4
2021-01-12,PF/BT,000119,POLIAMBULATORIO IRCSS OSPEDALE SAN MICHELE,LOM,30-39,0,1,0,1,0,0,0,1,0,1,Lombardia,ITC4
2021-01-12,PF/BT,000119,POLIAMBULATORIO IRCSS OSPEDALE SAN MICHELE,LOM,40-49,0,2,0,2,0,0,0,2,0,2,Lombardia,ITC4
2021-01-12,PF/BT,000119,POLIAMBULATORIO IRCSS OSPEDALE SAN MICHELE,LOM,50-59,2,0,0,2,0,0,0,2,0,2,Lombardia,ITC4
2021-01-12,PF/BT,000119,POLIAMBULATORIO IRCSS OSPEDALE SAN MICHELE,LOM,60-69,1,2,0,3,0,0,0,3,0,3,Lombardia,ITC4
2021-01-12,PF/BT,000119,POLIAMBULATORIO IRCSS OSPEDALE SAN MICHELE,LOM,70-79,1,0,0,1,0,0,0,1,0,1,Lombardia,ITC4
2021-01-12,PF/BT,000417,POLIAMBULATORIO IRCCS OSPEDALE CAPITANIO,LOM,20-29,0,5,0,5,0,0,0,5,0,5,Lombardia,ITC4
2021-01-12,PF/BT,000417,POLIAMBULATORIO IRCCS OSPEDALE CAPITANIO,LOM,30-39,4,2,0,6,0,0,0,6,0,6,Lombardia,ITC4
2021-01-12,PF/BT,000417,POLIAMBULATORIO IRCCS OSPEDALE CAPITANIO,LOM,40-49,3,1,0,4,0,0,0,4,0,4,Lombardia,ITC4
2021-01-12,PF/BT,000417,POLIAMBULATORIO IRCCS OSPEDALE CAPITANIO,LOM,50-59,3,1,0,4,0,0,0,4,0,4,Lombardia,ITC4
2021-01-12,PF/BT,000417,POLIAMBULATORIO IRCCS OSPEDALE CAPITANIO,LOM,60-69,3,1,0,4,0,0,0,4,0,4,Lombardia,ITC4
2021-01-12,PF/BT,000417,POLIAMBULATORIO IRCCS OSPEDALE CAPITANIO,LOM,70-79,1,0,0,1,0,0,0,1,0,1,Lombardia,ITC4
2021-01-12,PF/BT,000427,CENTRO DIAGNOSTICO PIOLTELLO,LOM,20-29,1,0,0,1,0,0,0,1,0,1,Lombardia,ITC4
2021-01-12,PF/BT,000427,CENTRO DIAGNOSTICO PIOLTELLO,LOM,30-39,1,0,0,1,0,0,0,1,0,1,Lombardia,ITC4
2021-01-12,PF/BT,000427,CENTRO DIAGNOSTICO PIOLTELLO,LOM,40-49,0,5,0,5,0,0,0,5,0,5,Lombardia,ITC4
2021-01-12,PF/BT,000427,CENTRO DIAGNOSTICO PIOLTELLO,LOM,50-59,2,2,0,4,0,0,0,4,0,4,Lombardia,ITC4
2021-01-12,PF/BT,000427,CENTRO DIAGNOSTICO PIOLTELLO,LOM,80-89,1,0,0,1,0,0,0,1,0,1,Lombardia,ITC4
2021-01-12,PF/BT,000500,RSA MONSIGNOR BICCHIERAI 2,LOM,80-89,1,5,0,0,0,6,0,6,0,6,Lombardia,ITC4
2021-01-12,PF/BT,000500,RSA MONSIGNOR BICCHIERAI 2,LOM,90+,0,6,0,0,0,6,0,6,0,6,Lombardia,ITC4
2021-01-12,PF/BT,000928,RSA FONDAZIONE VISCONTI VENOSTA GROSIO,LOM,20-29,0,1,0,1,0,0,0,1,0,1,Lombardia,ITC4
2021-01-12,PF/BT,000928,RSA FONDAZIONE VISCONTI VENOSTA GROSIO,LOM,40-49,0,3,0,3,0,0,0,3,0,3,Lombardia,ITC4
2021-01-12,PF/BT,000928,RSA FONDAZIONE VISCONTI VENOSTA GROSIO,LOM,50-59,3,4,0,5,2,0,0,7,0,7,Lombardia,ITC4
2021-01-12,PF/BT,000928,RSA FONDAZIONE VISCONTI VENOSTA GROSIO,LOM,80-89,3,1,0,0,0,4,0,4,0,4,Lombardia,ITC4
2021-01-12,PF/BT,000928,RSA FONDAZIONE VISCONTI VENOSTA GROSIO,LOM,90+,0,2,0,0,0,2,0,2,0,2,Lombardia,ITC4
2021-01-12,PF/BT,001534,"Fondazione ""Martinelli-Granata-Piantoni"" Onlus",LOM,20-29,0,1,0,1,0,0,0,1,0,1,Lombardia,ITC4
2021-01-12,PF/BT,001534,"Fondazione ""Martinelli-Granata-Piantoni"" Onlus",LOM,30-39,0,4,0,4,0,0,0,4,0,4,Lombardia,ITC4
2021-01-12,PF/BT,001534,"Fondazione ""Martinelli-Granata-Piantoni"" Onlus",LOM,40-49,0,2,0,2,0,0,0,2,0,2,Lombardia,ITC4
2021-01-12,PF/BT,001534,"Fondazione ""Martinelli-Granata-Piantoni"" Onlus",LOM,60-69,0,3,0,3,0,0,0,3,0,3,Lombardia,ITC4
2021-01-12,PF/BT,001534,"Fondazione ""Martinelli-Granata-Piantoni"" Onlus",LOM,70-79,1,1,0,0,0,2,0,2,0,2,Lombardia,ITC4
2021-01-12,PF/BT,001534,"Fondazione ""Martinelli-Granata-Piantoni"" Onlus",LOM,80-89,3,13,0,0,0,16,0,16,0,16,Lombardia,ITC4
2021-01-12,PF/BT,001534,"Fondazione ""Martinelli-Granata-Piantoni"" Onlus",LOM,90+,0,13,0,0,0,13,0,13,0,13,Lombardia,ITC4
2021-01-12,PF/BT,001814,RSA COMUNALE,LOM,20-29,0,1,0,1,0,0,0,1,0,1,Lombardia,ITC4
2021-01-12,PF/BT,001814,RSA COMUNALE,LOM,30-39,2,5,0,6,1,0,0,7,0,7,Lombardia,ITC4
2021-01-12,PF/BT,001814,RSA COMUNALE,LOM,40-49,0,8,0,7,1,0,0,8,0,8,Lombardia,ITC4
2021-01-12,PF/BT,001814,RSA COMUNALE,LOM,50-59,2,10,0,10,2,0,0,12,0,12,Lombardia,ITC4
2021-01-12,PF/BT,001814,RSA COMUNALE,LOM,60-69,0,6,0,3,2,1,0,6,0,6,Lombardia,ITC4
2021-01-12,PF/BT,001814,RSA COMUNALE,LOM,70-79,1,1,0,0,0,2,0,2,0,2,Lombardia,ITC4
2021-01-12,PF/BT,001814,RSA COMUNALE,LOM,80-89,2,6,0,0,0,8,0,8,0,8,Lombardia,ITC4
2021-01-12,PF/BT,001814,RSA COMUNALE,LOM,90+,3,0,0,0,0,3,0,3,0,3,Lombardia,ITC4
2021-01-12,PF/BT,001874,FONDAZIONE SAN BIAGIO ONLUS,LOM,20-29,0,2,0,0,2,0,0,2,0,2,Lombardia,ITC4
2021-01-12,PF/BT,001874,FONDAZIONE SAN BIAGIO ONLUS,LOM,30-39,1,2,0,2,1,0,0,3,0,3,Lombardia,ITC4
2021-01-12,PF/BT,001874,FONDAZIONE SAN BIAGIO ONLUS,LOM,40-49,1,4,0,4,1,0,0,5,0,5,Lombardia,ITC4
2021-01-12,PF/BT,001874,FONDAZIONE SAN BIAGIO ONLUS,LOM,50-59,0,4,0,3,1,0,0,4,0,4,Lombardia,ITC4
2021-01-12,PF/BT,001874,FONDAZIONE SAN BIAGIO ONLUS,LOM,60-69,0,3,0,1,0,0,2,3,0,3,Lombardia,ITC4
2021-01-12,PF/BT,001874,FONDAZIONE SAN BIAGIO ONLUS,LOM,70-79,0,1,0,0,0,0,1,1,0,1,Lombardia,ITC4
2021-01-12,PF/BT,00290,LA PICCOLA CASA DEL RIFUGIO,LOM,30-39,0,2,0,2,0,0,0,2,0,2,Lombardia,ITC4
2021-01-12,PF/BT,00290,LA PICCOLA CASA DEL RIFUGIO,LOM,50-59,0,5,0,5,0,0,0,5,0,5,Lombardia,ITC4
2021-01-12,PF/BT,00290,LA PICCOLA CASA DEL RIFUGIO,LOM,60-69,1,0,0,0,0,1,0,1,0,1,Lombardia,ITC4
2021-01-12,PF/BT,00290,LA PICCOLA CASA DEL RIFUGIO,LOM,70-79,5,2,0,1,0,6,0,7,0,7,Lombardia,ITC4
2021-01-12,PF/BT,00290,LA PICCOLA CASA DEL RIFUGIO,LOM,80-89,2,5,0,0,0,7,0,7,0,7,Lombardia,ITC4
2021-01-12,PF/BT,00290,LA PICCOLA CASA DEL RIFUGIO,LOM,90+,4,10,0,0,0,14,0,14,0,14,Lombardia,ITC4
2021-01-12,PF/BT,002987,POLIAMBULATORIO OSPEDALE ESINE,LOM,20-29,4,4,0,6,2,0,0,8,0,8,Lombardia,ITC4
2021-01-12,PF/BT,002987,POLIAMBULATORIO OSPEDALE ESINE,LOM,30-39,7,15,0,15,7,0,0,22,0,22,Lombardia,ITC4
2021-01-12,PF/BT,002987,POLIAMBULATORIO OSPEDALE ESINE,LOM,40-49,6,38,0,25,19,0,0,44,0,44,Lombardia,ITC4
2021-01-12,PF/BT,002987,POLIAMBULATORIO OSPEDALE ESINE,LOM,50-59,15,47,0,36,26,0,0,62,0,62,Lombardia,ITC4
2021-01-12,PF/BT,002987,POLIAMBULATORIO OSPEDALE ESINE,LOM,60-69,5,14,0,11,8,0,0,19,0,19,Lombardia,ITC4
2021-01-12,PF/BT,002987,POLIAMBULATORIO OSPEDALE ESINE,LOM,70-79,1,0,0,1,0,0,0,1,0,1,Lombardia,ITC4
2021-01-12,PF/BT,003328,HUB COV CHIARI - P.O. ISEO -  ASST FRANCIACORTA,LOM,20-29,11,9,0,19,1,0,0,20,0,20,Lombardia,ITC4
2021-01-12,PF/BT,003328,HUB COV CHIARI - P.O. ISEO -  ASST FRANCIACORTA,LOM,30-39,13,10,0,22,1,0,0,23,0,23,Lombardia,ITC4
2021-01-12,PF/BT,003328,HUB COV CHIARI - P.O. ISEO -  ASST FRANCIACORTA,LOM,40-49,16,11,0,24,3,0,0,27,0,27,Lombardia,ITC4
2021-01-12,PF/BT,003328,HUB COV CHIARI - P.O. ISEO -  ASST FRANCIACORTA,LOM,50-59,17,17,0,32,2,0,0,34,0,34,Lombardia,ITC4
2021-01-12,PF/BT,003328,HUB COV CHIARI - P.O. ISEO -  ASST FRANCIACORTA,LOM,60-69,20,13,0,32,1,0,0,33,0,33,Lombardia,ITC4
2021-01-12,PF/BT,003328,HUB COV CHIARI - P.O. ISEO -  ASST FRANCIACORTA,LOM,70-79,6,1,0,7,0,0,0,7,0,7,Lombardia,ITC4
2021-01-12,PF/BT,003335,HUB COV CHIARI - P.O. CHIARI ASST FRANCIACORTA,LOM,16-19,2,0,0,2,0,0,0,2,0,2,Lombardia,ITC4
2021-01-12,PF/BT,003335,HUB COV CHIARI - P.O. CHIARI ASST FRANCIACORTA,LOM,20-29,4,13,0,16,1,0,0,17,0,17,Lombardia,ITC4
2021-01-12,PF/BT,003335,HUB COV CHIARI - P.O. CHIARI ASST FRANCIACORTA,LOM,30-39,7,13,0,18,2,0,0,20,0,20,Lombardia,ITC4
2021-01-12,PF/BT,003335,HUB COV CHIARI - P.O. CHIARI ASST FRANCIACORTA,LOM,40-49,18,16,0,34,0,0,0,34,0,34,Lombardia,ITC4
2021-01-12,PF/BT,003335,HUB COV CHIARI - P.O. CHIARI ASST FRANCIACORTA,LOM,50-59,21,29,0,49,1,0,0,50,0,50,Lombardia,ITC4
2021-01-12,PF/BT,003335,HUB COV CHIARI - P.O. CHIARI ASST FRANCIACORTA,LOM,60-69,24,13,0,35,2,0,0,37,0,37,Lombardia,ITC4
2021-01-12,PF/BT,003335,HUB COV CHIARI - P.O. CHIARI ASST FRANCIACORTA,LOM,70-79,4,3,0,7,0,0,0,7,0,7,Lombardia,ITC4
2021-01-12,PF/BT,003335,HUB COV CHIARI - P.O. CHIARI ASST FRANCIACORTA,LOM,80-89,1,0,0,1,0,0,0,1,0,1,Lombardia,ITC4
2021-01-12,PF/BT,030017,Istituto clinico Casa di cura Mater Domini -Castellanza,LOM,20-29,9,21,0,23,7,0,0,30,0,30,Lombardia,ITC4
2021-01-12,PF/BT,030017,Istituto clinico Casa di cura Mater Domini -Castellanza,LOM,30-39,13,27,0,30,10,0,0,40,0,40,Lombardia,ITC4
2021-01-12,PF/BT,030017,Istituto clinico Casa di cura Mater Domini -Castellanza,LOM,40-49,15,23,0,32,6,0,0,38,0,38,Lombardia,ITC4
2021-01-12,PF/BT,030017,Istituto clinico Casa di cura Mater Domini -Castellanza,LOM,50-59,11,10,0,18,3,0,0,21,0,21,Lombardia,ITC4
2021-01-12,PF/BT,030017,Istituto clinico Casa di cura Mater Domini -Castellanza,LOM,60-69,8,2,0,10,0,0,0,10,0,10,Lombardia,ITC4
2021-01-12,PF/BT,030017,Istituto clinico Casa di cura Mater Domini -Castellanza,LOM,70-79,4,1,0,5,0,0,0,5,0,5,Lombardia,ITC4
2021-01-12,PF/BT,030035,C.O.F. LANZO HOSPITAL - ALTA VALLE INTELVI,LOM,20-29,1,3,0,4,0,0,0,4,0,4,Lombardia,ITC4
2021-01-12,PF/BT,030035,C.O.F. LANZO HOSPITAL - ALTA VALLE INTELVI,LOM,30-39,2,1,0,3,0,0,0,3,0,3,Lombardia,ITC4
2021-01-12,PF/BT,030035,C.O.F. LANZO HOSPITAL - ALTA VALLE INTELVI,LOM,40-49,1,7,0,7,1,0,0,8,0,8,Lombardia,ITC4
2021-01-12,PF/BT,030035,C.O.F. LANZO HOSPITAL - ALTA VALLE INTELVI,LOM,50-59,6,8,0,13,1,0,0,14,0,14,Lombardia,ITC4
2021-01-12,PF/BT,030035,C.O.F. LANZO HOSPITAL - ALTA VALLE INTELVI,LOM,60-69,3,1,0,4,0,0,0,4,0,4,Lombardia,ITC4
2021-01-12,PF/BT,030035,C.O.F. LANZO HOSPITAL - ALTA VALLE INTELVI,LOM,70-79,3,0,0,3,0,0,0,3,0,3,Lombardia,ITC4
2021-01-12,PF/BT,030037,CASA DI CURA VILLA SAN BENEDETTO,LOM,20-29,0,3,0,3,0,0,0,3,0,3,Lombardia,ITC4
2021-01-12,PF/BT,030037,CASA DI CURA VILLA SAN BENEDETTO,LOM,30-39,0,3,0,3,0,0,0,3,0,3,Lombardia,ITC4
2021-01-12,PF/BT,030037,CASA DI CURA VILLA SAN BENEDETTO,LOM,40-49,1,3,0,4,0,0,0,4,0,4,Lombardia,ITC4
2021-01-12,PF/BT,030037,CASA DI CURA VILLA SAN BENEDETTO,LOM,50-59,2,0,0,2,0,0,0,2,0,2,Lombardia,ITC4
2021-01-12,PF/BT,030066,CV Garbagnate,LOM,16-19,1,3,0,4,0,0,0,4,0,4,Lombardia,ITC4
2021-01-12,PF/BT,030066,CV Garbagnate,LOM,20-29,28,36,0,64,0,0,0,64,0,64,Lombardia,ITC4
2021-01-12,PF/BT,030066,CV Garbagnate,LOM,30-39,24,16,0,38,2,0,0,40,0,40,Lombardia,ITC4
2021-01-12,PF/BT,030066,CV Garbagnate,LOM,40-49,18,18,0,31,5,0,0,36,0,36,Lombardia,ITC4
2021-01-12,PF/BT,030066,CV Garbagnate,LOM,50-59,26,31,0,48,9,0,0,57,0,57,Lombardia,ITC4
2021-01-12,PF/BT,030066,CV Garbagnate,LOM,60-69,19,4,0,20,3,0,0,23,0,23,Lombardia,ITC4
2021-01-12,PF/BT,030066,CV Garbagnate,LOM,70-79,7,3,0,10,0,0,0,10,0,10,Lombardia,ITC4
2021-01-12,PF/BT,030068,PUNTO VACCINALE OSPEDALIERO DESIO,LOM,16-19,0,1,0,1,0,0,0,1,0,1,Lombardia,ITC4
2021-01-12,PF/BT,030068,PUNTO VACCINALE OSPEDALIERO DESIO,LOM,20-29,6,14,0,18,2,0,0,20,0,20,Lombardia,ITC4
2021-01-12,PF/BT,030068,PUNTO VACCINALE OSPEDALIERO DESIO,LOM,30-39,7,17,0,19,5,0,0,24,0,24,Lombardia,ITC4
2021-01-12,PF/BT,030068,PUNTO VACCINALE OSPEDALIERO DESIO,LOM,40-49,8,37,0,32,13,0,0,45,0,45,Lombardia,ITC4
2021-01-12,PF/BT,030068,PUNTO VACCINALE OSPEDALIERO DESIO,LOM,50-59,26,64,0,66,24,0,0,90,0,90,Lombardia,ITC4
2021-01-12,PF/BT,030068,PUNTO VACCINALE OSPEDALIERO DESIO,LOM,60-69,20,23,0,33,10,0,0,43,0,43,Lombardia,ITC4
2021-01-12,PF/BT,030068,PUNTO VACCINALE OSPEDALIERO DESIO,LOM,70-79,13,0,0,13,0,0,0,13,0,13,Lombardia,ITC4
2021-01-12,PF/BT,030068,PUNTO VACCINALE OSPEDALIERO DESIO,LOM,80-89,1,0,0,1,0,0,0,1,0,1,Lombardia,ITC4
2021-01-12,PF/BT,030070,PUNTO VACCINALE OSPEDALIERO CARATE BRIANZA,LOM,16-19,0,1,0,1,0,0,0,1,0,1,Lombardia,ITC4
2021-01-12,PF/BT,030070,PUNTO VACCINALE OSPEDALIERO CARATE BRIANZA,LOM,20-29,2,8,0,7,3,0,0,10,0,10,Lombardia,ITC4
2021-01-12,PF/BT,030070,PUNTO VACCINALE OSPEDALIERO CARATE BRIANZA,LOM,30-39,6,13,0,13,6,0,0,19,0,19,Lombardia,ITC4
2021-01-12,PF/BT,030070,PUNTO VACCINALE OSPEDALIERO CARATE BRIANZA,LOM,40-49,6,23,0,19,10,0,0,29,0,29,Lombardia,ITC4
2021-01-12,PF/BT,030070,PUNTO VACCINALE OSPEDALIERO CARATE BRIANZA,LOM,50-59,24,40,0,42,22,0,0,64,0,64,Lombardia,ITC4
2021-01-12,PF/BT,030070,PUNTO VACCINALE OSPEDALIERO CARATE BRIANZA,LOM,60-69,11,10,0,19,2,0,0,21,0,21,Lombardia,ITC4
2021-01-12,PF/BT,030070,PUNTO VACCINALE OSPEDALIERO CARATE BRIANZA,LOM,70-79,9,1,0,8,2,0,0,10,0,10,Lombardia,ITC4
2021-01-12,PF/BT,030078,PUNTO VACCINALE OSPEDALIERO VIMERCATE,LOM,20-29,7,10,0,14,3,0,0,17,0,17,Lombardia,ITC4
2021-01-12,PF/BT,030078,PUNTO VACCINALE OSPEDALIERO VIMERCATE,LOM,30-39,9,12,0,12,9,0,0,21,0,21,Lombardia,ITC4
2021-01-12,PF/BT,030078,PUNTO VACCINALE OSPEDALIERO VIMERCATE,LOM,40-49,9,19,0,20,8,0,0,28,0,28,Lombardia,ITC4
2021-01-12,PF/BT,030078,PUNTO VACCINALE OSPEDALIERO VIMERCATE,LOM,50-59,14,57,0,40,31,0,0,71,0,71,Lombardia,ITC4
2021-01-12,PF/BT,030078,PUNTO VACCINALE OSPEDALIERO VIMERCATE,LOM,60-69,16,13,0,24,5,0,0,29,0,29,Lombardia,ITC4
2021-01-12,PF/BT,030078,PUNTO VACCINALE OSPEDALIERO VIMERCATE,LOM,70-79,11,0,0,11,0,0,0,11,0,11,Lombardia,ITC4
2021-01-12,PF/BT,030078,PUNTO VACCINALE OSPEDALIERO VIMERCATE,LOM,80-89,2,0,0,2,0,0,0,2,0,2,Lombardia,ITC4
2021-01-12,PF/BT,030097,ISTITUTO CLINICO CITTA' STUDI - MILANO,LOM,20-29,3,8,0,11,0,0,0,11,0,11,Lombardia,ITC4
2021-01-12,PF/BT,030097,ISTITUTO CLINICO CITTA' STUDI - MILANO,LOM,30-39,6,14,0,20,0,0,0,20,0,20,Lombardia,ITC4
2021-01-12,PF/BT,030097,ISTITUTO CLINICO CITTA' STUDI - MILANO,LOM,40-49,7,24,0,31,0,0,0,31,0,31,Lombardia,ITC4
2021-01-12,PF/BT,030097,ISTITUTO CLINICO CITTA' STUDI - MILANO,LOM,50-59,8,21,0,29,0,0,0,29,0,29,Lombardia,ITC4
2021-01-12,PF/BT,030097,ISTITUTO CLINICO CITTA' STUDI - MILANO,LOM,60-69,7,2,0,9,0,0,0,9,0,9,Lombardia,ITC4
2021-01-12,PF/BT,030097,ISTITUTO CLINICO CITTA' STUDI - MILANO,LOM,70-79,1,1,0,2,0,0,0,2,0,2,Lombardia,ITC4
2021-01-12,PF/BT,030107,ISTITUTI CLINICI ZUCCHI - PRESIDIO DI MONZA,LOM,20-29,4,3,0,7,0,0,0,7,0,7,Lombardia,ITC4
2021-01-12,PF/BT,030107,ISTITUTI CLINICI ZUCCHI - PRESIDIO DI MONZA,LOM,30-39,9,8,0,17,0,0,0,17,0,17,Lombardia,ITC4
2021-01-12,PF/BT,030107,ISTITUTI CLINICI ZUCCHI - PRESIDIO DI MONZA,LOM,40-49,6,17,0,23,0,0,0,23,0,23,Lombardia,ITC4
2021-01-12,PF/BT,030107,ISTITUTI CLINICI ZUCCHI - PRESIDIO DI MONZA,LOM,50-59,7,17,0,24,0,0,0,24,0,24,Lombardia,ITC4
2021-01-12,PF/BT,030107,ISTITUTI CLINICI ZUCCHI - PRESIDIO DI MONZA,LOM,60-69,1,4,0,5,0,0,0,5,0,5,Lombardia,ITC4
2021-01-12,PF/BT,030107,ISTITUTI CLINICI ZUCCHI - PRESIDIO DI MONZA,LOM,70-79,2,0,0,2,0,0,0,2,0,2,Lombardia,ITC4
2021-01-12,PF/BT,030108,ISTITUTI CLINICI ZUCCHI - PRESIDIO DI CARATE BRIANZA,LOM,20-29,0,1,0,1,0,0,0,1,0,1,Lombardia,ITC4
2021-01-12,PF/BT,030108,ISTITUTI CLINICI ZUCCHI - PRESIDIO DI CARATE BRIANZA,LOM,30-39,11,18,0,29,0,0,0,29,0,29,Lombardia,ITC4
2021-01-12,PF/BT,030108,ISTITUTI CLINICI ZUCCHI - PRESIDIO DI CARATE BRIANZA,LOM,40-49,9,30,0,39,0,0,0,39,0,39,Lombardia,ITC4
2021-01-12,PF/BT,030108,ISTITUTI CLINICI ZUCCHI - PRESIDIO DI CARATE BRIANZA,LOM,50-59,11,23,0,34,0,0,0,34,0,34,Lombardia,ITC4
2021-01-12,PF/BT,030108,ISTITUTI CLINICI ZUCCHI - PRESIDIO DI CARATE BRIANZA,LOM,60-69,2,3,0,5,0,0,0,5,0,5,Lombardia,ITC4
2021-01-12,PF/BT,030178,ISTITUTO CLINICO CITTA' DI BRESCIA DI ISTITUTI OSPEDALIERI BRESCIANI,LOM,20-29,4,1,0,5,0,0,0,5,0,5,Lombardia,ITC4
2021-01-12,PF/BT,030178,ISTITUTO CLINICO CITTA' DI BRESCIA DI ISTITUTI OSPEDALIERI BRESCIANI,LOM,30-39,2,5,0,7,0,0,0,7,0,7,Lombardia,ITC4
2021-01-12,PF/BT,030178,ISTITUTO CLINICO CITTA' DI BRESCIA DI ISTITUTI OSPEDALIERI BRESCIANI,LOM,40-49,2,12,0,10,4,0,0,14,0,14,Lombardia,ITC4
2021-01-12,PF/BT,030178,ISTITUTO CLINICO CITTA' DI BRESCIA DI ISTITUTI OSPEDALIERI BRESCIANI,LOM,50-59,6,19,0,20,5,0,0,25,0,25,Lombardia,ITC4
2021-01-12,PF/BT,030178,ISTITUTO CLINICO CITTA' DI BRESCIA DI ISTITUTI OSPEDALIERI BRESCIANI,LOM,60-69,3,1,0,3,1,0,0,4,0,4,Lombardia,ITC4
2021-01-12,PF/BT,030178,ISTITUTO CLINICO CITTA' DI BRESCIA DI ISTITUTI OSPEDALIERI BRESCIANI,LOM,70-79,3,2,0,5,0,0,0,5,0,5,Lombardia,ITC4
2021-01-12,PF/BT,03019800,ISTITUTO CLINICO BEATO MATTEO,LOM,20-29,1,1,0,2,0,0,0,2,0,2,Lombardia,ITC4
2021-01-12,PF/BT,03019800,ISTITUTO CLINICO BEATO MATTEO,LOM,30-39,2,2,0,4,0,0,0,4,0,4,Lombardia,ITC4
2021-01-12,PF/BT,03019800,ISTITUTO CLINICO BEATO MATTEO,LOM,40-49,5,4,0,9,0,0,0,9,0,9,Lombardia,ITC4
2021-01-12,PF/BT,03019800,ISTITUTO CLINICO BEATO MATTEO,LOM,50-59,2,3,0,5,0,0,0,5,0,5,Lombardia,ITC4
2021-01-12,PF/BT,03019800,ISTITUTO CLINICO BEATO MATTEO,LOM,60-69,3,1,0,4,0,0,0,4,0,4,Lombardia,ITC4
2021-01-12,PF/BT,03020200,ISTITUTO DI CURA CITTA' DI PAVIA,LOM,20-29,1,0,0,1,0,0,0,1,0,1,Lombardia,ITC4
2021-01-12,PF/BT,03020200,ISTITUTO DI CURA CITTA' DI PAVIA,LOM,30-39,1,0,0,1,0,0,0,1,0,1,Lombardia,ITC4
2021-01-12,PF/BT,03020200,ISTITUTO DI CURA CITTA' DI PAVIA,LOM,40-49,1,9,0,10,0,0,0,10,0,10,Lombardia,ITC4
2021-01-12,PF/BT,03020200,ISTITUTO DI CURA CITTA' DI PAVIA,LOM,50-59,3,7,0,10,0,0,0,10,0,10,Lombardia,ITC4
2021-01-12,PF/BT,03020200,ISTITUTO DI CURA CITTA' DI PAVIA,LOM,60-69,2,0,0,2,0,0,0,2,0,2,Lombardia,ITC4
2021-01-12,PF/BT,030295,Fondazione Poliambulanza - Brescia,LOM,20-29,5,23,0,26,2,0,0,28,0,28,Lombardia,ITC4
2021-01-12,PF/BT,030295,Fondazione Poliambulanza - Brescia,LOM,30-39,9,35,0,40,4,0,0,44,0,44,Lombardia,ITC4
2021-01-12,PF/BT,030295,Fondazione Poliambulanza - Brescia,LOM,40-49,12,33,0,36,9,0,0,45,0,45,Lombardia,ITC4
2021-01-12,PF/BT,030295,Fondazione Poliambulanza - Brescia,LOM,50-59,11,30,0,35,6,0,0,41,0,41,Lombardia,ITC4
2021-01-12,PF/BT,030295,Fondazione Poliambulanza - Brescia,LOM,60-69,4,3,0,5,2,0,0,7,0,7,Lombardia,ITC4
2021-01-12,PF/BT,030295,Fondazione Poliambulanza - Brescia,LOM,70-79,3,0,0,3,0,0,0,3,0,3,Lombardia,ITC4
2021-01-12,PF/BT,030321000265,ISTITUTO MONS. LUIGI BIRAGHI,LOM,20-29,1,0,0,1,0,0,0,1,0,1,Lombardia,ITC4
2021-01-12,PF/BT,030321000265,ISTITUTO MONS. LUIGI BIRAGHI,LOM,40-49,1,6,0,7,0,0,0,7,0,7,Lombardia,ITC4
2021-01-12,PF/BT,030321000265,ISTITUTO MONS. LUIGI BIRAGHI,LOM,50-59,1,7,0,6,2,0,0,8,0,8,Lombardia,ITC4
2021-01-12,PF/BT,030321000265,ISTITUTO MONS. LUIGI BIRAGHI,LOM,60-69,0,4,0,0,2,2,0,4,0,4,Lombardia,ITC4
2021-01-12,PF/BT,030321000265,ISTITUTO MONS. LUIGI BIRAGHI,LOM,70-79,0,7,0,0,0,7,0,7,0,7,Lombardia,ITC4
2021-01-12,PF/BT,030321000265,ISTITUTO MONS. LUIGI BIRAGHI,LOM,80-89,3,23,0,0,0,26,0,26,0,26,Lombardia,ITC4
2021-01-12,PF/BT,030321000265,ISTITUTO MONS. LUIGI BIRAGHI,LOM,90+,1,24,0,0,0,25,0,25,0,25,Lombardia,ITC4
2021-01-12,PF/BT,030-322-030032,Istituto Clinico Villa Aprica,LOM,20-29,1,3,0,4,0,0,0,4,0,4,Lombardia,ITC4
2021-01-12,PF/BT,030-322-030032,Istituto Clinico Villa Aprica,LOM,30-39,1,1,0,2,0,0,0,2,0,2,Lombardia,ITC4
2021-01-12,PF/BT,030-322-030032,Istituto Clinico Villa Aprica,LOM,40-49,5,4,0,9,0,0,0,9,0,9,Lombardia,ITC4
2021-01-12,PF/BT,030-322-030032,Istituto Clinico Villa Aprica,LOM,50-59,4,3,0,7,0,0,0,7,0,7,Lombardia,ITC4
2021-01-12,PF/BT,030-322-030032,Istituto Clinico Villa Aprica,LOM,60-69,6,0,0,6,0,0,0,6,0,6,Lombardia,ITC4
2021-01-12,PF/BT,030-322-030032,Istituto Clinico Villa Aprica,LOM,70-79,2,0,0,2,0,0,0,2,0,2,Lombardia,ITC4
2021-01-12,PF/BT,030-322-030347,CASA DI CURA VILLA S.GIUSEPPE-ANZANO DEL PARCO,LOM,20-29,2,3,0,5,0,0,0,5,0,5,Lombardia,ITC4
2021-01-12,PF/BT,030-322-030347,CASA DI CURA VILLA S.GIUSEPPE-ANZANO DEL PARCO,LOM,30-39,5,6,0,11,0,0,0,11,0,11,Lombardia,ITC4
2021-01-12,PF/BT,030-322-030347,CASA DI CURA VILLA S.GIUSEPPE-ANZANO DEL PARCO,LOM,40-49,1,7,0,7,1,0,0,8,0,8,Lombardia,ITC4
2021-01-12,PF/BT,030-322-030347,CASA DI CURA VILLA S.GIUSEPPE-ANZANO DEL PARCO,LOM,50-59,2,5,0,3,4,0,0,7,0,7,Lombardia,ITC4
2021-01-12,PF/BT,030-322-030347,CASA DI CURA VILLA S.GIUSEPPE-ANZANO DEL PARCO,LOM,60-69,3,1,0,4,0,0,0,4,0,4,Lombardia,ITC4
2021-01-12,PF/BT,030-322-030347,CASA DI CURA VILLA S.GIUSEPPE-ANZANO DEL PARCO,LOM,70-79,1,0,0,1,0,0,0,1,0,1,Lombardia,ITC4
2021-01-12,PF/BT,030324001093 -  030324001116,ISTIT.RIUNITI AIROLDI E MUZZI,LOM,30-39,1,8,0,6,3,0,0,9,0,9,Lombardia,ITC4
2021-01-12,PF/BT,030324001093 -  030324001116,ISTIT.RIUNITI AIROLDI E MUZZI,LOM,40-49,1,8,0,8,1,0,0,9,0,9,Lombardia,ITC4
2021-01-12,PF/BT,030324001093 -  030324001116,ISTIT.RIUNITI AIROLDI E MUZZI,LOM,50-59,2,9,0,7,2,2,0,11,0,11,Lombardia,ITC4
2021-01-12,PF/BT,030324001093 -  030324001116,ISTIT.RIUNITI AIROLDI E MUZZI,LOM,60-69,7,7,0,2,1,11,0,14,0,14,Lombardia,ITC4
2021-01-12,PF/BT,030324001093 -  030324001116,ISTIT.RIUNITI AIROLDI E MUZZI,LOM,70-79,10,7,0,0,0,17,0,17,0,17,Lombardia,ITC4
2021-01-12,PF/BT,030324001093 -  030324001116,ISTIT.RIUNITI AIROLDI E MUZZI,LOM,80-89,7,41,0,0,0,48,0,48,0,48,Lombardia,ITC4
2021-01-12,PF/BT,030324001093 -  030324001116,ISTIT.RIUNITI AIROLDI E MUZZI,LOM,90+,4,32,0,0,0,36,0,36,0,36,Lombardia,ITC4
2021-01-12,PF/BT,030-327-001768,FONDAZIONE RSA SONCINO ONLUS,LOM,20-29,0,1,0,1,0,0,0,1,0,1,Lombardia,ITC4
2021-01-12,PF/BT,030-327-001768,FONDAZIONE RSA SONCINO ONLUS,LOM,30-39,1,4,0,4,1,0,0,5,0,5,Lombardia,ITC4
2021-01-12,PF/BT,030-327-001768,FONDAZIONE RSA SONCINO ONLUS,LOM,40-49,0,8,0,8,0,0,0,8,0,8,Lombardia,ITC4
2021-01-12,PF/BT,030-327-001768,FONDAZIONE RSA SONCINO ONLUS,LOM,50-59,4,9,0,8,5,0,0,13,0,13,Lombardia,ITC4
2021-01-12,PF/BT,030-327-001768,FONDAZIONE RSA SONCINO ONLUS,LOM,60-69,0,4,0,3,1,0,0,4,0,4,Lombardia,ITC4
2021-01-12,PF/BT,030-327-001768,FONDAZIONE RSA SONCINO ONLUS,LOM,70-79,1,1,0,0,0,2,0,2,0,2,Lombardia,ITC4
2021-01-12,PF/BT,030-327-001768,FONDAZIONE RSA SONCINO ONLUS,LOM,80-89,5,4,0,0,0,9,0,9,0,9,Lombardia,ITC4
2021-01-12,PF/BT,030-327-001768,FONDAZIONE RSA SONCINO ONLUS,LOM,90+,3,3,0,0,0,6,0,6,0,6,Lombardia,ITC4
2021-01-12,PF/BT,030704,Polo Riabilitativo FFO,LOM,20-29,1,3,0,3,1,0,0,4,0,4,Lombardia,ITC4
2021-01-12,PF/BT,030704,Polo Riabilitativo FFO,LOM,30-39,1,7,0,5,3,0,0,8,0,8,Lombardia,ITC4
2021-01-12,PF/BT,030704,Polo Riabilitativo FFO,LOM,40-49,3,3,0,4,2,0,0,6,0,6,Lombardia,ITC4
2021-01-12,PF/BT,030704,Polo Riabilitativo FFO,LOM,50-59,4,7,0,8,3,0,0,11,0,11,Lombardia,ITC4
2021-01-12,PF/BT,030704,Polo Riabilitativo FFO,LOM,60-69,0,1,0,1,0,0,0,1,0,1,Lombardia,ITC4
2021-01-12,PF/BT,030704,Presidio Ospedaliero CTO,LOM,20-29,0,2,0,0,2,0,0,2,0,2,Lombardia,ITC4
2021-01-12,PF/BT,030704,Presidio Ospedaliero CTO,LOM,30-39,2,6,0,6,2,0,0,8,0,8,Lombardia,ITC4
2021-01-12,PF/BT,030704,Presidio Ospedaliero CTO,LOM,40-49,1,10,0,8,3,0,0,11,0,11,Lombardia,ITC4
2021-01-12,PF/BT,030704,Presidio Ospedaliero CTO,LOM,50-59,12,15,0,21,6,0,0,27,0,27,Lombardia,ITC4
2021-01-12,PF/BT,030704,Presidio Ospedaliero CTO,LOM,60-69,7,5,0,6,6,0,0,12,0,12,Lombardia,ITC4
2021-01-12,PF/BT,030704,Presidio Ospedaliero G. Pini,LOM,20-29,7,10,0,13,4,0,0,17,0,17,Lombardia,ITC4
2021-01-12,PF/BT,030704,Presidio Ospedaliero G. Pini,LOM,30-39,11,15,0,16,10,0,0,26,0,26,Lombardia,ITC4
2021-01-12,PF/BT,030704,Presidio Ospedaliero G. Pini,LOM,40-49,5,6,0,6,5,0,0,11,0,11,Lombardia,ITC4
2021-01-12,PF/BT,030704,Presidio Ospedaliero G. Pini,LOM,50-59,7,20,0,16,11,0,0,27,0,27,Lombardia,ITC4
2021-01-12,PF/BT,030704,Presidio Ospedaliero G. Pini,LOM,60-69,6,8,0,5,9,0,0,14,0,14,Lombardia,ITC4
2021-01-12,PF/BT,030704,Presidio Ospedaliero G. Pini,LOM,70-79,1,0,0,0,1,0,0,1,0,1,Lombardia,ITC4
2021-01-12,PF/BT,030903,AMB COVID LECCO,LOM,16-19,0,3,0,3,0,0,0,3,0,3,Lombardia,ITC4
2021-01-12,PF/BT,030903,AMB COVID LECCO,LOM,20-29,19,37,0,40,16,0,0,56,0,56,Lombardia,ITC4
2021-01-12,PF/BT,030903,AMB COVID LECCO,LOM,30-39,28,59,0,63,24,0,0,87,0,87,Lombardia,ITC4
2021-01-12,PF/BT,030903,AMB COVID LECCO,LOM,40-49,38,85,0,72,51,0,0,123,0,123,Lombardia,ITC4
2021-01-12,PF/BT,030903,AMB COVID LECCO,LOM,50-59,41,178,0,118,101,0,0,219,0,219,Lombardia,ITC4
2021-01-12,PF/BT,030903,AMB COVID LECCO,LOM,60-69,36,35,0,42,29,0,0,71,0,71,Lombardia,ITC4
2021-01-12,PF/BT,030903,AMB COVID LECCO,LOM,70-79,8,4,0,5,7,0,0,12,0,12,Lombardia,ITC4
2021-01-12,PF/BT,030903,AMB COVID LECCO,LOM,80-89,4,1,0,1,4,0,0,5,0,5,Lombardia,ITC4
2021-01-12,PF/BT,030922,"FOND.IRCCS ""ISTIT.NAZ.LE TUMORI""MILANO",LOM,20-29,8,30,0,29,8,0,1,38,0,38,Lombardia,ITC4
2021-01-12,PF/BT,030922,"FOND.IRCCS ""ISTIT.NAZ.LE TUMORI""MILANO",LOM,30-39,17,47,0,50,14,0,0,64,0,64,Lombardia,ITC4
2021-01-12,PF/BT,030922,"FOND.IRCCS ""ISTIT.NAZ.LE TUMORI""MILANO",LOM,40-49,7,36,0,32,10,0,1,43,0,43,Lombardia,ITC4
2021-01-12,PF/BT,030922,"FOND.IRCCS ""ISTIT.NAZ.LE TUMORI""MILANO",LOM,50-59,21,55,0,52,24,0,0,76,0,76,Lombardia,ITC4
2021-01-12,PF/BT,030922,"FOND.IRCCS ""ISTIT.NAZ.LE TUMORI""MILANO",LOM,60-69,8,11,0,15,4,0,0,19,0,19,Lombardia,ITC4
2021-01-12,PF/BT,030922,"FOND.IRCCS ""ISTIT.NAZ.LE TUMORI""MILANO",LOM,70-79,1,1,0,1,1,0,0,2,0,2,Lombardia,ITC4
2021-01-12,PF/BT,030923,FOND.IRCCS IST.NAZ.NEUROLOGICO C.BESTA-M,LOM,20-29,5,6,0,8,2,0,1,11,0,11,Lombardia,ITC4
2021-01-12,PF/BT,030923,FOND.IRCCS IST.NAZ.NEUROLOGICO C.BESTA-M,LOM,30-39,8,12,0,9,5,0,6,20,0,20,Lombardia,ITC4
2021-01-12,PF/BT,030923,FOND.IRCCS IST.NAZ.NEUROLOGICO C.BESTA-M,LOM,40-49,12,24,0,21,3,0,12,36,0,36,Lombardia,ITC4
2021-01-12,PF/BT,030923,FOND.IRCCS IST.NAZ.NEUROLOGICO C.BESTA-M,LOM,50-59,8,19,0,12,10,0,5,27,0,27,Lombardia,ITC4
2021-01-12,PF/BT,030923,FOND.IRCCS IST.NAZ.NEUROLOGICO C.BESTA-M,LOM,60-69,1,5,0,3,0,0,3,6,0,6,Lombardia,ITC4
2021-01-12,PF/BT,030923,FOND.IRCCS IST.NAZ.NEUROLOGICO C.BESTA-M,LOM,70-79,3,3,0,0,0,0,6,6,0,6,Lombardia,ITC4
2021-01-12,PF/BT,030923,FOND.IRCCS IST.NAZ.NEUROLOGICO C.BESTA-M,LOM,80-89,1,0,0,0,0,0,1,1,0,1,Lombardia,ITC4
2021-01-12,PF/BT,030924,IRCCS POLICLINICO S. MATTEO - PAVIA,LOM,20-29,20,24,0,41,2,0,1,44,0,44,Lombardia,ITC4
2021-01-12,PF/BT,030924,IRCCS POLICLINICO S. MATTEO - PAVIA,LOM,30-39,28,51,0,70,9,0,0,79,0,79,Lombardia,ITC4
2021-01-12,PF/BT,030924,IRCCS POLICLINICO S. MATTEO - PAVIA,LOM,40-49,18,48,0,49,17,0,0,66,0,66,Lombardia,ITC4
2021-01-12,PF/BT,030924,IRCCS POLICLINICO S. MATTEO - PAVIA,LOM,50-59,29,72,0,46,49,0,6,101,0,101,Lombardia,ITC4
2021-01-12,PF/BT,030924,IRCCS POLICLINICO S. MATTEO - PAVIA,LOM,60-69,3,13,0,13,3,0,0,16,0,16,Lombardia,ITC4
2021-01-12,PF/BT,030925,Fondazione IRCCS Ca' Granda Ospedale Maggiore Policlinico,LOM,20-29,11,27,0,37,1,0,0,38,0,38,Lombardia,ITC4
2021-01-12,PF/BT,030925,Fondazione IRCCS Ca' Granda Ospedale Maggiore Policlinico,LOM,30-39,19,37,0,51,5,0,0,56,0,56,Lombardia,ITC4
2021-01-12,PF/BT,030925,Fondazione IRCCS Ca' Granda Ospedale Maggiore Policlinico,LOM,40-49,17,44,0,55,6,0,0,61,0,61,Lombardia,ITC4
2021-01-12,PF/BT,030925,Fondazione IRCCS Ca' Granda Ospedale Maggiore Policlinico,LOM,50-59,23,53,0,60,16,0,0,76,0,76,Lombardia,ITC4
2021-01-12,PF/BT,030925,Fondazione IRCCS Ca' Granda Ospedale Maggiore Policlinico,LOM,60-69,15,19,0,34,0,0,0,34,0,34,Lombardia,ITC4
2021-01-12,PF/BT,030925,Fondazione IRCCS Ca' Granda Ospedale Maggiore Policlinico,LOM,70-79,1,2,0,3,0,0,0,3,0,3,Lombardia,ITC4
2021-01-12,PF/BT,030925,Fondazione IRCCS Ca' Granda Ospedale Maggiore Policlinico,LOM,80-89,1,0,0,1,0,0,0,1,0,1,Lombardia,ITC4
2021-01-12,PF/BT,030935,IRCCS    S. RAFFAELE - MILANO,LOM,20-29,1,8,0,9,0,0,0,9,0,9,Lombardia,ITC4
2021-01-12,PF/BT,030935,IRCCS    S. RAFFAELE - MILANO,LOM,30-39,5,10,0,15,0,0,0,15,0,15,Lombardia,ITC4
2021-01-12,PF/BT,030935,IRCCS    S. RAFFAELE - MILANO,LOM,40-49,32,49,0,81,0,0,0,81,0,81,Lombardia,ITC4
2021-01-12,PF/BT,030935,IRCCS    S. RAFFAELE - MILANO,LOM,50-59,31,76,0,107,0,0,0,107,0,107,Lombardia,ITC4
2021-01-12,PF/BT,030935,IRCCS    S. RAFFAELE - MILANO,LOM,60-69,3,6,0,9,0,0,0,9,0,9,Lombardia,ITC4
2021-01-12,PF/BT,030935,IRCCS    S. RAFFAELE - MILANO,LOM,70-79,1,0,0,1,0,0,0,1,0,1,Lombardia,ITC4
2021-01-12,PF/BT,030937,PRO JOVENTUDE DON C. GNOCCHI - MI IRCCS PRIVATO,LOM,20-29,7,2,0,8,1,0,0,9,0,9,Lombardia,ITC4
2021-01-12,PF/BT,030937,PRO JOVENTUDE DON C. GNOCCHI - MI IRCCS PRIVATO,LOM,30-39,7,22,0,28,1,0,0,29,0,29,Lombardia,ITC4
2021-01-12,PF/BT,030937,PRO JOVENTUDE DON C. GNOCCHI - MI IRCCS PRIVATO,LOM,40-49,4,22,0,19,7,0,0,26,0,26,Lombardia,ITC4
2021-01-12,PF/BT,030937,PRO JOVENTUDE DON C. GNOCCHI - MI IRCCS PRIVATO,LOM,50-59,16,19,0,27,8,0,0,35,0,35,Lombardia,ITC4
2021-01-12,PF/BT,030937,PRO JOVENTUDE DON C. GNOCCHI - MI IRCCS PRIVATO,LOM,60-69,7,8,0,13,2,0,0,15,0,15,Lombardia,ITC4
2021-01-12,PF/BT,030943,Istituto Clinico Humanitas,LOM,20-29,25,30,0,30,25,0,0,55,0,55,Lombardia,ITC4
2021-01-12,PF/BT,030943,Istituto Clinico Humanitas,LOM,30-39,31,56,0,44,43,0,0,87,0,87,Lombardia,ITC4
2021-01-12,PF/BT,030943,Istituto Clinico Humanitas,LOM,40-49,17,57,0,48,26,0,0,74,0,74,Lombardia,ITC4
2021-01-12,PF/BT,030943,Istituto Clinico Humanitas,LOM,50-59,11,32,0,24,19,0,0,43,0,43,Lombardia,ITC4
2021-01-12,PF/BT,030943,Istituto Clinico Humanitas,LOM,60-69,4,3,0,6,1,0,0,7,0,7,Lombardia,ITC4
2021-01-12,PF/BT,030943,Istituto Clinico Humanitas,LOM,70-79,1,2,0,1,2,0,0,3,0,3,Lombardia,ITC4
2021-01-12,PF/BT,030943,Istituto Clinico Humanitas,LOM,80-89,0,1,0,0,1,0,0,1,0,1,Lombardia,ITC4
2021-01-12,PF/BT,030950,IRCCS   S. RAFFAELE TURRO - MILANO,LOM,30-39,3,6,0,9,0,0,0,9,0,9,Lombardia,ITC4
2021-01-12,PF/BT,030950,IRCCS   S. RAFFAELE TURRO - MILANO,LOM,40-49,4,6,0,10,0,0,0,10,0,10,Lombardia,ITC4
2021-01-12,PF/BT,030950,IRCCS   S. RAFFAELE TURRO - MILANO,LOM,50-59,5,10,0,15,0,0,0,15,0,15,Lombardia,ITC4
2021-01-12,PF/BT,030950,IRCCS   S. RAFFAELE TURRO - MILANO,LOM,60-69,0,2,0,2,0,0,0,2,0,2,Lombardia,ITC4
2021-01-12,PF/BT,066549,RSA BERNINA,LOM,20-29,1,0,0,0,1,0,0,1,0,1,Lombardia,ITC4
2021-01-12,PF/BT,066549,RSA BERNINA,LOM,50-59,0,1,0,0,1,0,0,1,0,1,Lombardia,ITC4
2021-01-12,PF/BT,066549,RSA BERNINA,LOM,60-69,0,1,0,0,0,1,0,1,0,1,Lombardia,ITC4
2021-01-12,PF/BT,066549,RSA BERNINA,LOM,70-79,1,0,0,0,0,1,0,1,0,1,Lombardia,ITC4
2021-01-12,PF/BT,066549,RSA BERNINA,LOM,80-89,2,10,0,0,0,12,0,12,0,12,Lombardia,ITC4
2021-01-12,PF/BT,066549,RSA BERNINA,LOM,90+,2,12,0,0,0,14,0,14,0,14,Lombardia,ITC4
2021-01-12,PF/BT,1143,RSA BRAMBILLA-NAVA,LOM,30-39,2,1,0,3,0,0,0,3,0,3,Lombardia,ITC4
2021-01-12,PF/BT,1143,RSA BRAMBILLA-NAVA,LOM,40-49,1,0,0,1,0,0,0,1,0,1,Lombardia,ITC4
2021-01-12,PF/BT,1143,RSA BRAMBILLA-NAVA,LOM,60-69,1,0,0,0,0,1,0,1,0,1,Lombardia,ITC4
2021-01-12,PF/BT,1143,RSA BRAMBILLA-NAVA,LOM,70-79,1,3,0,0,0,4,0,4,0,4,Lombardia,ITC4
2021-01-12,PF/BT,1143,RSA BRAMBILLA-NAVA,LOM,80-89,1,10,0,0,0,11,0,11,0,11,Lombardia,ITC4
2021-01-12,PF/BT,1143,RSA BRAMBILLA-NAVA,LOM,90+,1,21,0,0,0,22,0,22,0,22,Lombardia,ITC4
2021-01-12,PF/BT,1411,Fondazione Don Stefano Palla Onlus,LOM,20-29,0,3,0,3,0,0,0,3,0,3,Lombardia,ITC4
2021-01-12,PF/BT,1411,Fondazione Don Stefano Palla Onlus,LOM,40-49,2,2,0,4,0,0,0,4,0,4,Lombardia,ITC4
2021-01-12,PF/BT,1411,Fondazione Don Stefano Palla Onlus,LOM,50-59,1,6,0,7,0,0,0,7,0,7,Lombardia,ITC4
2021-01-12,PF/BT,1411,Fondazione Don Stefano Palla Onlus,LOM,60-69,1,0,0,1,0,0,0,1,0,1,Lombardia,ITC4
2021-01-12,PF/BT,1411,Fondazione Don Stefano Palla Onlus,LOM,70-79,2,1,0,0,1,2,0,3,0,3,Lombardia,ITC4
2021-01-12,PF/BT,1411,Fondazione Don Stefano Palla Onlus,LOM,80-89,3,1,0,0,0,4,0,4,0,4,Lombardia,ITC4
2021-01-12,PF/BT,1411,Fondazione Don Stefano Palla Onlus,LOM,90+,0,1,0,0,0,1,0,1,0,1,Lombardia,ITC4
2021-01-12,PF/BT,1430,RSA CASA SANT'ANGELA MERICI,LOM,20-29,1,6,0,7,0,0,0,7,0,7,Lombardia,ITC4
2021-01-12,PF/BT,1430,RSA CASA SANT'ANGELA MERICI,LOM,30-39,0,9,0,6,3,0,0,9,0,9,Lombardia,ITC4
2021-01-12,PF/BT,1430,RSA CASA SANT'ANGELA MERICI,LOM,40-49,1,19,0,17,3,0,0,20,0,20,Lombardia,ITC4
2021-01-12,PF/BT,1430,RSA CASA SANT'ANGELA MERICI,LOM,50-59,3,17,0,19,1,0,0,20,0,20,Lombardia,ITC4
2021-01-12,PF/BT,1430,RSA CASA SANT'ANGELA MERICI,LOM,60-69,4,5,0,5,1,3,0,9,0,9,Lombardia,ITC4
2021-01-12,PF/BT,1430,RSA CASA SANT'ANGELA MERICI,LOM,70-79,6,3,0,0,0,9,0,9,0,9,Lombardia,ITC4
2021-01-12,PF/BT,1430,RSA CASA SANT'ANGELA MERICI,LOM,80-89,8,11,0,0,0,19,0,19,0,19,Lombardia,ITC4
2021-01-12,PF/BT,1430,RSA CASA SANT'ANGELA MERICI,LOM,90+,2,7,0,0,0,9,0,9,0,9,Lombardia,ITC4
2021-01-12,PF/BT,1480,"Rsa ""Sorelle Girelli"" Marone (BS)",LOM,20-29,0,1,0,1,0,0,0,1,0,1,Lombardia,ITC4
2021-01-12,PF/BT,1480,"Rsa ""Sorelle Girelli"" Marone (BS)",LOM,30-39,0,4,0,4,0,0,0,4,0,4,Lombardia,ITC4
2021-01-12,PF/BT,1480,"Rsa ""Sorelle Girelli"" Marone (BS)",LOM,40-49,1,6,0,5,2,0,0,7,0,7,Lombardia,ITC4
2021-01-12,PF/BT,1480,"Rsa ""Sorelle Girelli"" Marone (BS)",LOM,50-59,1,9,0,7,3,0,0,10,0,10,Lombardia,ITC4
2021-01-12,PF/BT,1480,"Rsa ""Sorelle Girelli"" Marone (BS)",LOM,60-69,0,2,0,1,1,0,0,2,0,2,Lombardia,ITC4
2021-01-12,PF/BT,1544,CENTRO DIURNO RSA CASA INDUSTRIA,LOM,30-39,1,0,0,1,0,0,0,1,0,1,Lombardia,ITC4
2021-01-12,PF/BT,1544,CENTRO DIURNO RSA CASA INDUSTRIA,LOM,40-49,1,3,0,4,0,0,0,4,0,4,Lombardia,ITC4
2021-01-12,PF/BT,1544,CENTRO DIURNO RSA CASA INDUSTRIA,LOM,50-59,1,6,0,5,2,0,0,7,0,7,Lombardia,ITC4
2021-01-12,PF/BT,1585,RSA FEROLDI,LOM,20-29,3,6,0,9,0,0,0,9,0,9,Lombardia,ITC4
2021-01-12,PF/BT,1585,RSA FEROLDI,LOM,30-39,3,4,0,5,2,0,0,7,0,7,Lombardia,ITC4
2021-01-12,PF/BT,1585,RSA FEROLDI,LOM,40-49,5,22,0,19,8,0,0,27,0,27,Lombardia,ITC4
2021-01-12,PF/BT,1585,RSA FEROLDI,LOM,50-59,1,26,0,18,9,0,0,27,0,27,Lombardia,ITC4
2021-01-12,PF/BT,1585,RSA FEROLDI,LOM,60-69,2,4,0,3,3,0,0,6,0,6,Lombardia,ITC4
2021-01-12,PF/BT,1585,RSA FEROLDI,LOM,70-79,1,1,0,0,2,0,0,2,0,2,Lombardia,ITC4
2021-01-12,PF/BT,1591,Fondazione O.P. Delbarba Maselli Dandolo ONLUS,LOM,20-29,0,2,0,2,0,0,0,2,0,2,Lombardia,ITC4
2021-01-12,PF/BT,1591,Fondazione O.P. Delbarba Maselli Dandolo ONLUS,LOM,30-39,0,1,0,1,0,0,0,1,0,1,Lombardia,ITC4
2021-01-12,PF/BT,1591,Fondazione O.P. Delbarba Maselli Dandolo ONLUS,LOM,40-49,1,2,0,2,1,0,0,3,0,3,Lombardia,ITC4
2021-01-12,PF/BT,1591,Fondazione O.P. Delbarba Maselli Dandolo ONLUS,LOM,50-59,0,9,0,8,1,0,0,9,0,9,Lombardia,ITC4
2021-01-12,PF/BT,1591,Fondazione O.P. Delbarba Maselli Dandolo ONLUS,LOM,60-69,0,2,0,2,0,0,0,2,0,2,Lombardia,ITC4
2021-01-12,PF/BT,1591,Fondazione O.P. Delbarba Maselli Dandolo ONLUS,LOM,70-79,1,0,0,0,1,0,0,1,0,1,Lombardia,ITC4
2021-01-12,PF/BT,1626,KOS CARE VILLAGGIO SAN FRANCESCO,LOM,20-29,0,2,0,2,0,0,0,2,0,2,Lombardia,ITC4
2021-01-12,PF/BT,1626,KOS CARE VILLAGGIO SAN FRANCESCO,LOM,30-39,0,6,0,5,1,0,0,6,0,6,Lombardia,ITC4
2021-01-12,PF/BT,1626,KOS CARE VILLAGGIO SAN FRANCESCO,LOM,40-49,1,9,0,7,3,0,0,10,0,10,Lombardia,ITC4
2021-01-12,PF/BT,1626,KOS CARE VILLAGGIO SAN FRANCESCO,LOM,50-59,1,10,0,6,4,1,0,11,0,11,Lombardia,ITC4
2021-01-12,PF/BT,1626,KOS CARE VILLAGGIO SAN FRANCESCO,LOM,60-69,2,5,0,1,1,5,0,7,0,7,Lombardia,ITC4
2021-01-12,PF/BT,1626,KOS CARE VILLAGGIO SAN FRANCESCO,LOM,70-79,2,2,0,0,0,4,0,4,0,4,Lombardia,ITC4
2021-01-12,PF/BT,1626,KOS CARE VILLAGGIO SAN FRANCESCO,LOM,80-89,1,10,0,0,0,11,0,11,0,11,Lombardia,ITC4
2021-01-12,PF/BT,1626,KOS CARE VILLAGGIO SAN FRANCESCO,LOM,90+,3,3,0,0,0,6,0,6,0,6,Lombardia,ITC4
2021-01-12,PF/BT,1640, RSA LORENZO E GIANNA ZIROTTI,LOM,20-29,1,1,0,2,0,0,0,2,0,2,Lombardia,ITC4
2021-01-12,PF/BT,1640, RSA LORENZO E GIANNA ZIROTTI,LOM,30-39,0,3,0,3,0,0,0,3,0,3,Lombardia,ITC4
2021-01-12,PF/BT,1640, RSA LORENZO E GIANNA ZIROTTI,LOM,40-49,1,5,0,3,3,0,0,6,0,6,Lombardia,ITC4
2021-01-12,PF/BT,1640, RSA LORENZO E GIANNA ZIROTTI,LOM,50-59,0,9,0,6,3,0,0,9,0,9,Lombardia,ITC4
2021-01-12,PF/BT,1640, RSA LORENZO E GIANNA ZIROTTI,LOM,60-69,0,4,0,3,1,0,0,4,0,4,Lombardia,ITC4
2021-01-12,PF/BT,167,ASST SPEDALI CIVILI AMBULATORIO COVID BRESCIA,LOM,20-29,17,26,0,37,6,0,0,43,0,43,Lombardia,ITC4
2021-01-12,PF/BT,167,ASST SPEDALI CIVILI AMBULATORIO COVID BRESCIA,LOM,30-39,42,65,0,91,16,0,0,107,0,107,Lombardia,ITC4
2021-01-12,PF/BT,167,ASST SPEDALI CIVILI AMBULATORIO COVID BRESCIA,LOM,40-49,23,82,0,77,28,0,0,105,0,105,Lombardia,ITC4
2021-01-12,PF/BT,167,ASST SPEDALI CIVILI AMBULATORIO COVID BRESCIA,LOM,50-59,27,135,0,114,48,0,0,162,0,162,Lombardia,ITC4
2021-01-12,PF/BT,167,ASST SPEDALI CIVILI AMBULATORIO COVID BRESCIA,LOM,60-69,16,38,0,39,15,0,0,54,0,54,Lombardia,ITC4
2021-01-12,PF/BT,167,ASST SPEDALI CIVILI AMBULATORIO COVID BRESCIA,LOM,70-79,2,0,0,2,0,0,0,2,0,2,Lombardia,ITC4
2021-01-12,PF/BT,1798,FONDAZIONE GIUSEPPINA BRUNENGHI,LOM,20-29,2,5,0,7,0,0,0,7,0,7,Lombardia,ITC4
2021-01-12,PF/BT,1798,FONDAZIONE GIUSEPPINA BRUNENGHI,LOM,30-39,1,7,0,8,0,0,0,8,0,8,Lombardia,ITC4
2021-01-12,PF/BT,1798,FONDAZIONE GIUSEPPINA BRUNENGHI,LOM,40-49,1,19,0,16,3,0,1,20,0,20,Lombardia,ITC4
2021-01-12,PF/BT,1798,FONDAZIONE GIUSEPPINA BRUNENGHI,LOM,50-59,6,26,0,26,5,0,1,32,0,32,Lombardia,ITC4
2021-01-12,PF/BT,1798,FONDAZIONE GIUSEPPINA BRUNENGHI,LOM,60-69,7,7,0,7,0,0,7,14,0,14,Lombardia,ITC4
2021-01-12,PF/BT,1798,FONDAZIONE GIUSEPPINA BRUNENGHI,LOM,70-79,8,0,0,1,0,0,7,8,0,8,Lombardia,ITC4
2021-01-12,PF/BT,1798,FONDAZIONE GIUSEPPINA BRUNENGHI,LOM,80-89,1,0,0,0,0,1,0,1,0,1,Lombardia,ITC4
2021-01-12,PF/BT,1824,Fondazione Benefattori Cremaschi - RSA Zurla,LOM,20-29,0,1,0,1,0,0,0,1,0,1,Lombardia,ITC4
2021-01-12,PF/BT,1824,Fondazione Benefattori Cremaschi - RSA Zurla,LOM,30-39,0,2,0,2,0,0,0,2,0,2,Lombardia,ITC4
2021-01-12,PF/BT,1824,Fondazione Benefattori Cremaschi - RSA Zurla,LOM,40-49,1,2,0,2,1,0,0,3,0,3,Lombardia,ITC4
2021-01-12,PF/BT,1824,Fondazione Benefattori Cremaschi - RSA Zurla,LOM,50-59,2,4,0,3,3,0,0,6,0,6,Lombardia,ITC4
2021-01-12,PF/BT,1824,Fondazione Benefattori Cremaschi - RSA Zurla,LOM,60-69,1,1,0,0,0,2,0,2,0,2,Lombardia,ITC4
2021-01-12,PF/BT,1824,Fondazione Benefattori Cremaschi - RSA Zurla,LOM,70-79,5,9,0,0,0,14,0,14,0,14,Lombardia,ITC4
2021-01-12,PF/BT,1824,Fondazione Benefattori Cremaschi - RSA Zurla,LOM,80-89,3,15,0,0,0,18,0,18,0,18,Lombardia,ITC4
2021-01-12,PF/BT,1824,Fondazione Benefattori Cremaschi - RSA Zurla,LOM,90+,1,13,0,0,0,14,0,14,0,14,Lombardia,ITC4
2021-01-12,PF/BT,1842,RSA VILLA AZZURRA,LOM,60-69,1,0,0,0,0,1,0,1,0,1,Lombardia,ITC4
2021-01-12,PF/BT,1842,RSA VILLA AZZURRA,LOM,70-79,3,0,0,0,0,3,0,3,0,3,Lombardia,ITC4
2021-01-12,PF/BT,1842,RSA VILLA AZZURRA,LOM,80-89,1,7,0,0,0,8,0,8,0,8,Lombardia,ITC4
2021-01-12,PF/BT,1842,RSA VILLA AZZURRA,LOM,90+,1,11,0,0,0,12,0,12,0,12,Lombardia,ITC4
2021-01-12,PF/BT,1918,RSA CASA ROSANNA,LOM,30-39,0,2,0,2,0,0,0,2,0,2,Lombardia,ITC4
2021-01-12,PF/BT,1918,RSA CASA ROSANNA,LOM,40-49,0,3,0,3,0,0,0,3,0,3,Lombardia,ITC4
2021-01-12,PF/BT,1918,RSA CASA ROSANNA,LOM,50-59,0,1,0,1,0,0,0,1,0,1,Lombardia,ITC4
2021-01-12,PF/BT,1918,RSA CASA ROSANNA,LOM,60-69,0,1,0,1,0,0,0,1,0,1,Lombardia,ITC4
2021-01-12,PF/BT,1918,RSA CASA ROSANNA,LOM,70-79,1,3,0,0,0,4,0,4,0,4,Lombardia,ITC4
2021-01-12,PF/BT,1918,RSA CASA ROSANNA,LOM,80-89,2,9,0,0,0,11,0,11,0,11,Lombardia,ITC4
2021-01-12,PF/BT,1918,RSA CASA ROSANNA,LOM,90+,1,1,0,0,0,2,0,2,0,2,Lombardia,ITC4
2021-01-12,PF/BT,1946,"FONDAZIONE ""CONTE DR. CARLO CARACCI"" - ONLUS",LOM,30-39,1,1,0,2,0,0,0,2,0,2,Lombardia,ITC4
2021-01-12,PF/BT,1946,"FONDAZIONE ""CONTE DR. CARLO CARACCI"" - ONLUS",LOM,40-49,1,3,0,3,1,0,0,4,0,4,Lombardia,ITC4
2021-01-12,PF/BT,1946,"FONDAZIONE ""CONTE DR. CARLO CARACCI"" - ONLUS",LOM,50-59,0,3,0,3,0,0,0,3,0,3,Lombardia,ITC4
2021-01-12,PF/BT,1946,"FONDAZIONE ""CONTE DR. CARLO CARACCI"" - ONLUS",LOM,60-69,1,1,0,1,1,0,0,2,0,2,Lombardia,ITC4
2021-01-12,PF/BT,1946,"FONDAZIONE ""CONTE DR. CARLO CARACCI"" - ONLUS",LOM,70-79,1,3,0,0,0,4,0,4,0,4,Lombardia,ITC4
2021-01-12,PF/BT,1946,"FONDAZIONE ""CONTE DR. CARLO CARACCI"" - ONLUS",LOM,80-89,1,5,0,0,0,6,0,6,0,6,Lombardia,ITC4
2021-01-12,PF/BT,1946,"FONDAZIONE ""CONTE DR. CARLO CARACCI"" - ONLUS",LOM,90+,0,3,0,0,0,3,0,3,0,3,Lombardia,ITC4
2021-01-12,PF/BT,1948,FONDAZIONE SCARPARI FORATTINI ONLUS,LOM,20-29,1,3,0,4,0,0,0,4,0,4,Lombardia,ITC4
2021-01-12,PF/BT,1948,FONDAZIONE SCARPARI FORATTINI ONLUS,LOM,30-39,2,4,0,2,4,0,0,6,0,6,Lombardia,ITC4
2021-01-12,PF/BT,1948,FONDAZIONE SCARPARI FORATTINI ONLUS,LOM,40-49,0,5,0,4,1,0,0,5,0,5,Lombardia,ITC4
2021-01-12,PF/BT,1948,FONDAZIONE SCARPARI FORATTINI ONLUS,LOM,50-59,1,16,0,8,9,0,0,17,0,17,Lombardia,ITC4
2021-01-12,PF/BT,1948,FONDAZIONE SCARPARI FORATTINI ONLUS,LOM,60-69,3,7,0,6,3,0,1,10,0,10,Lombardia,ITC4
2021-01-12,PF/BT,1948,FONDAZIONE SCARPARI FORATTINI ONLUS,LOM,70-79,4,1,0,0,1,4,0,5,0,5,Lombardia,ITC4
2021-01-12,PF/BT,1948,FONDAZIONE SCARPARI FORATTINI ONLUS,LOM,80-89,2,7,0,0,0,9,0,9,0,9,Lombardia,ITC4
2021-01-12,PF/BT,1948,FONDAZIONE SCARPARI FORATTINI ONLUS,LOM,90+,1,8,0,0,0,9,0,9,0,9,Lombardia,ITC4
2021-01-12,PF/BT,1953,RSA BEATA PAOLA,LOM,30-39,0,1,0,1,0,0,0,1,0,1,Lombardia,ITC4
2021-01-12,PF/BT,1953,RSA BEATA PAOLA,LOM,40-49,1,2,0,3,0,0,0,3,0,3,Lombardia,ITC4
2021-01-12,PF/BT,1953,RSA BEATA PAOLA,LOM,50-59,0,4,0,4,0,0,0,4,0,4,Lombardia,ITC4
2021-01-12,PF/BT,1953,RSA BEATA PAOLA,LOM,60-69,1,0,0,0,0,1,0,1,0,1,Lombardia,ITC4
2021-01-12,PF/BT,1953,RSA BEATA PAOLA,LOM,70-79,2,0,0,0,0,2,0,2,0,2,Lombardia,ITC4
2021-01-12,PF/BT,1953,RSA BEATA PAOLA,LOM,80-89,0,2,0,0,0,2,0,2,0,2,Lombardia,ITC4
2021-01-12,PF/BT,1953,RSA BEATA PAOLA,LOM,90+,2,3,0,0,0,5,0,5,0,5,Lombardia,ITC4
2021-01-12,PF/BT,1965,RESIDENZA SANITARIA ASSISTENZIALE FONDAZIONE LUIGI BONI ONLUS,LOM,30-39,0,2,0,2,0,0,0,2,0,2,Lombardia,ITC4
2021-01-12,PF/BT,1965,RESIDENZA SANITARIA ASSISTENZIALE FONDAZIONE LUIGI BONI ONLUS,LOM,40-49,0,3,0,3,0,0,0,3,0,3,Lombardia,ITC4
2021-01-12,PF/BT,1965,RESIDENZA SANITARIA ASSISTENZIALE FONDAZIONE LUIGI BONI ONLUS,LOM,50-59,2,6,0,8,0,0,0,8,0,8,Lombardia,ITC4
2021-01-12,PF/BT,1965,RESIDENZA SANITARIA ASSISTENZIALE FONDAZIONE LUIGI BONI ONLUS,LOM,60-69,1,4,0,5,0,0,0,5,0,5,Lombardia,ITC4
2021-01-12,PF/BT,20,cv cremona,LOM,20-29,0,4,0,4,0,0,0,4,0,4,Lombardia,ITC4
2021-01-12,PF/BT,20,cv cremona,LOM,30-39,1,7,0,6,2,0,0,8,0,8,Lombardia,ITC4
2021-01-12,PF/BT,20,cv cremona,LOM,40-49,3,20,0,14,9,0,0,23,0,23,Lombardia,ITC4
2021-01-12,PF/BT,20,cv cremona,LOM,50-59,4,15,0,11,8,0,0,19,0,19,Lombardia,ITC4
2021-01-12,PF/BT,20,cv cremona,LOM,60-69,1,4,0,4,1,0,0,5,0,5,Lombardia,ITC4
2021-01-12,PF/BT,2001,RESIDENZA SANITARIA ASSISTITA UNITA' GERIATRICA RIABILITATIVA ONLUS,LOM,20-29,1,2,0,3,0,0,0,3,0,3,Lombardia,ITC4
2021-01-12,PF/BT,2001,RESIDENZA SANITARIA ASSISTITA UNITA' GERIATRICA RIABILITATIVA ONLUS,LOM,50-59,0,2,0,2,0,0,0,2,0,2,Lombardia,ITC4
2021-01-12,PF/BT,2001,RESIDENZA SANITARIA ASSISTITA UNITA' GERIATRICA RIABILITATIVA ONLUS,LOM,70-79,0,2,0,0,0,2,0,2,0,2,Lombardia,ITC4
2021-01-12,PF/BT,2001,RESIDENZA SANITARIA ASSISTITA UNITA' GERIATRICA RIABILITATIVA ONLUS,LOM,80-89,1,6,0,0,0,7,0,7,0,7,Lombardia,ITC4
2021-01-12,PF/BT,2001,RESIDENZA SANITARIA ASSISTITA UNITA' GERIATRICA RIABILITATIVA ONLUS,LOM,90+,0,4,0,0,0,4,0,4,0,4,Lombardia,ITC4
2021-01-12,PF/BT,2054,fondazione san germano onlus RSA,LOM,20-29,0,1,0,1,0,0,0,1,0,1,Lombardia,ITC4
2021-01-12,PF/BT,2054,fondazione san germano onlus RSA,LOM,30-39,4,2,0,5,1,0,0,6,0,6,Lombardia,ITC4
2021-01-12,PF/BT,2054,fondazione san germano onlus RSA,LOM,40-49,4,20,0,21,3,0,0,24,0,24,Lombardia,ITC4
2021-01-12,PF/BT,2054,fondazione san germano onlus RSA,LOM,50-59,3,15,0,16,1,1,0,18,0,18,Lombardia,ITC4
2021-01-12,PF/BT,2054,fondazione san germano onlus RSA,LOM,60-69,3,9,0,8,0,4,0,12,0,12,Lombardia,ITC4
2021-01-12,PF/BT,2054,fondazione san germano onlus RSA,LOM,70-79,6,4,0,1,0,9,0,10,0,10,Lombardia,ITC4
2021-01-12,PF/BT,2054,fondazione san germano onlus RSA,LOM,80-89,17,16,0,0,0,33,0,33,0,33,Lombardia,ITC4
2021-01-12,PF/BT,2054,fondazione san germano onlus RSA,LOM,90+,4,17,0,0,0,21,0,21,0,21,Lombardia,ITC4
2021-01-12,PF/BT,2165,RSA Mezzana Bigli,LOM,20-29,0,1,0,0,1,0,0,1,0,1,Lombardia,ITC4
2021-01-12,PF/BT,2165,RSA Mezzana Bigli,LOM,30-39,0,1,0,1,0,0,0,1,0,1,Lombardia,ITC4
2021-01-12,PF/BT,2165,RSA Mezzana Bigli,LOM,40-49,0,2,0,2,0,0,0,2,0,2,Lombardia,ITC4
2021-01-12,PF/BT,2165,RSA Mezzana Bigli,LOM,50-59,1,1,0,2,0,0,0,2,0,2,Lombardia,ITC4
2021-01-12,PF/BT,2199,RSA LE TORRI,LOM,20-29,1,0,0,1,0,0,0,1,0,1,Lombardia,ITC4
2021-01-12,PF/BT,2199,RSA LE TORRI,LOM,30-39,0,2,0,1,1,0,0,2,0,2,Lombardia,ITC4
2021-01-12,PF/BT,2199,RSA LE TORRI,LOM,40-49,0,5,0,3,2,0,0,5,0,5,Lombardia,ITC4
2021-01-12,PF/BT,2199,RSA LE TORRI,LOM,50-59,1,5,0,5,1,0,0,6,0,6,Lombardia,ITC4
2021-01-12,PF/BT,2199,RSA LE TORRI,LOM,70-79,1,0,0,1,0,0,0,1,0,1,Lombardia,ITC4
2021-01-12,PF/BT,24,FONDAZIONE OSPEDALE MARCHESI DI INZAGO,LOM,30-39,0,2,0,2,0,0,0,2,0,2,Lombardia,ITC4
2021-01-12,PF/BT,24,FONDAZIONE OSPEDALE MARCHESI DI INZAGO,LOM,40-49,0,8,0,8,0,0,0,8,0,8,Lombardia,ITC4
2021-01-12,PF/BT,24,FONDAZIONE OSPEDALE MARCHESI DI INZAGO,LOM,50-59,0,8,0,8,0,0,0,8,0,8,Lombardia,ITC4
2021-01-12,PF/BT,2884,RSA fondazione ferriere e fonderie dongo onlus,LOM,60-69,2,0,0,0,0,2,0,2,0,2,Lombardia,ITC4
2021-01-12,PF/BT,2884,RSA fondazione ferriere e fonderie dongo onlus,LOM,70-79,3,5,0,0,0,8,0,8,0,8,Lombardia,ITC4
2021-01-12,PF/BT,2884,RSA fondazione ferriere e fonderie dongo onlus,LOM,80-89,4,17,0,0,0,21,0,21,0,21,Lombardia,ITC4
2021-01-12,PF/BT,2884,RSA fondazione ferriere e fonderie dongo onlus,LOM,90+,4,19,0,0,0,23,0,23,0,23,Lombardia,ITC4
2021-01-12,PF/BT,294,Casa di cura Domus Salutis - Brescia,LOM,20-29,5,14,0,18,1,0,0,19,0,19,Lombardia,ITC4
2021-01-12,PF/BT,294,Casa di cura Domus Salutis - Brescia,LOM,30-39,16,14,0,24,5,0,1,30,0,30,Lombardia,ITC4
2021-01-12,PF/BT,294,Casa di cura Domus Salutis - Brescia,LOM,40-49,15,58,0,56,17,0,0,73,0,73,Lombardia,ITC4
2021-01-12,PF/BT,294,Casa di cura Domus Salutis - Brescia,LOM,50-59,16,39,0,42,13,0,0,55,0,55,Lombardia,ITC4
2021-01-12,PF/BT,294,Casa di cura Domus Salutis - Brescia,LOM,60-69,8,9,0,14,3,0,0,17,0,17,Lombardia,ITC4
2021-01-12,PF/BT,294,Casa di cura Domus Salutis - Brescia,LOM,70-79,4,5,0,3,6,0,0,9,0,9,Lombardia,ITC4
2021-01-12,PF/BT,294,Casa di cura Domus Salutis - Brescia,LOM,80-89,2,4,0,3,3,0,0,6,0,6,Lombardia,ITC4
2021-01-12,PF/BT,30030,OSPEDALE VALDUCE-AMBULATORIO VACCINALE COVID,LOM,20-29,16,40,0,56,0,0,0,56,0,56,Lombardia,ITC4
2021-01-12,PF/BT,30030,OSPEDALE VALDUCE-AMBULATORIO VACCINALE COVID,LOM,30-39,17,17,0,34,0,0,0,34,0,34,Lombardia,ITC4
2021-01-12,PF/BT,30030,OSPEDALE VALDUCE-AMBULATORIO VACCINALE COVID,LOM,40-49,11,34,0,44,0,0,1,45,0,45,Lombardia,ITC4
2021-01-12,PF/BT,30030,OSPEDALE VALDUCE-AMBULATORIO VACCINALE COVID,LOM,50-59,13,19,0,32,0,0,0,32,0,32,Lombardia,ITC4
2021-01-12,PF/BT,30030,OSPEDALE VALDUCE-AMBULATORIO VACCINALE COVID,LOM,60-69,7,5,0,12,0,0,0,12,0,12,Lombardia,ITC4
2021-01-12,PF/BT,30030,OSPEDALE VALDUCE-AMBULATORIO VACCINALE COVID,LOM,70-79,0,1,0,0,0,0,1,1,0,1,Lombardia,ITC4
2021-01-12,PF/BT,30044,Ambulatorio Covid Chiavenna,LOM,20-29,0,4,0,4,0,0,0,4,0,4,Lombardia,ITC4
2021-01-12,PF/BT,30044,Ambulatorio Covid Chiavenna,LOM,30-39,3,7,0,9,1,0,0,10,0,10,Lombardia,ITC4
2021-01-12,PF/BT,30044,Ambulatorio Covid Chiavenna,LOM,40-49,3,14,0,14,3,0,0,17,0,17,Lombardia,ITC4
2021-01-12,PF/BT,30044,Ambulatorio Covid Chiavenna,LOM,50-59,11,33,0,27,17,0,0,44,0,44,Lombardia,ITC4
2021-01-12,PF/BT,30044,Ambulatorio Covid Chiavenna,LOM,60-69,3,6,0,7,2,0,0,9,0,9,Lombardia,ITC4
2021-01-12,PF/BT,30071,Centro Vaccinale Covid Melzo - ASST Melegnano Martesana,LOM,16-19,1,1,0,2,0,0,0,2,0,2,Lombardia,ITC4
2021-01-12,PF/BT,30071,Centro Vaccinale Covid Melzo - ASST Melegnano Martesana,LOM,20-29,16,13,0,26,3,0,0,29,0,29,Lombardia,ITC4
2021-01-12,PF/BT,30071,Centro Vaccinale Covid Melzo - ASST Melegnano Martesana,LOM,30-39,16,18,0,33,1,0,0,34,0,34,Lombardia,ITC4
2021-01-12,PF/BT,30071,Centro Vaccinale Covid Melzo - ASST Melegnano Martesana,LOM,40-49,25,16,0,35,6,0,0,41,0,41,Lombardia,ITC4
2021-01-12,PF/BT,30071,Centro Vaccinale Covid Melzo - ASST Melegnano Martesana,LOM,50-59,33,46,0,66,13,0,0,79,0,79,Lombardia,ITC4
2021-01-12,PF/BT,30071,Centro Vaccinale Covid Melzo - ASST Melegnano Martesana,LOM,60-69,45,27,0,55,17,0,0,72,0,72,Lombardia,ITC4
2021-01-12,PF/BT,30071,Centro Vaccinale Covid Melzo - ASST Melegnano Martesana,LOM,70-79,20,9,0,0,0,0,29,29,0,29,Lombardia,ITC4
2021-01-12,PF/BT,30071,Centro Vaccinale Covid Melzo - ASST Melegnano Martesana,LOM,80-89,1,0,0,0,0,0,1,1,0,1,Lombardia,ITC4
2021-01-12,PF/BT,30072,Centro Vaccinale Covid Vizzolo - ASST Melegnano Martesana,LOM,16-19,0,1,0,1,0,0,0,1,0,1,Lombardia,ITC4
2021-01-12,PF/BT,30072,Centro Vaccinale Covid Vizzolo - ASST Melegnano Martesana,LOM,20-29,20,34,0,51,3,0,0,54,0,54,Lombardia,ITC4
2021-01-12,PF/BT,30072,Centro Vaccinale Covid Vizzolo - ASST Melegnano Martesana,LOM,30-39,21,28,0,43,6,0,0,49,0,49,Lombardia,ITC4
2021-01-12,PF/BT,30072,Centro Vaccinale Covid Vizzolo - ASST Melegnano Martesana,LOM,40-49,25,35,0,54,6,0,0,60,0,60,Lombardia,ITC4
2021-01-12,PF/BT,30072,Centro Vaccinale Covid Vizzolo - ASST Melegnano Martesana,LOM,50-59,15,62,0,67,10,0,0,77,0,77,Lombardia,ITC4
2021-01-12,PF/BT,30072,Centro Vaccinale Covid Vizzolo - ASST Melegnano Martesana,LOM,60-69,13,22,0,30,5,0,0,35,0,35,Lombardia,ITC4
2021-01-12,PF/BT,30072,Centro Vaccinale Covid Vizzolo - ASST Melegnano Martesana,LOM,70-79,3,2,0,1,0,0,4,5,0,5,Lombardia,ITC4
2021-01-12,PF/BT,30072,Centro Vaccinale Covid Vizzolo - ASST Melegnano Martesana,LOM,80-89,1,1,0,0,0,0,2,2,0,2,Lombardia,ITC4
2021-01-12,PF/BT,30073,CV Bollate,LOM,16-19,1,0,0,1,0,0,0,1,0,1,Lombardia,ITC4
2021-01-12,PF/BT,30073,CV Bollate,LOM,20-29,9,8,0,17,0,0,0,17,0,17,Lombardia,ITC4
2021-01-12,PF/BT,30073,CV Bollate,LOM,30-39,2,9,0,11,0,0,0,11,0,11,Lombardia,ITC4
2021-01-12,PF/BT,30073,CV Bollate,LOM,40-49,15,12,0,27,0,0,0,27,0,27,Lombardia,ITC4
2021-01-12,PF/BT,30073,CV Bollate,LOM,50-59,9,13,0,22,0,0,0,22,0,22,Lombardia,ITC4
2021-01-12,PF/BT,30073,CV Bollate,LOM,60-69,11,6,0,17,0,0,0,17,0,17,Lombardia,ITC4
2021-01-12,PF/BT,30073,CV Bollate,LOM,70-79,1,0,0,1,0,0,0,1,0,1,Lombardia,ITC4
2021-01-12,PF/BT,30073,cv rho,LOM,16-19,0,1,0,1,0,0,0,1,0,1,Lombardia,ITC4
2021-01-12,PF/BT,30073,cv rho,LOM,20-29,3,14,0,16,1,0,0,17,0,17,Lombardia,ITC4
2021-01-12,PF/BT,30073,cv rho,LOM,30-39,2,7,0,8,1,0,0,9,0,9,Lombardia,ITC4
2021-01-12,PF/BT,30073,cv rho,LOM,40-49,6,16,0,20,2,0,0,22,0,22,Lombardia,ITC4
2021-01-12,PF/BT,30073,cv rho,LOM,50-59,17,47,0,60,4,0,0,64,0,64,Lombardia,ITC4
2021-01-12,PF/BT,30073,cv rho,LOM,60-69,11,13,0,20,4,0,0,24,0,24,Lombardia,ITC4
2021-01-12,PF/BT,30073,cv rho,LOM,70-79,1,0,0,0,0,0,1,1,0,1,Lombardia,ITC4
2021-01-12,PF/BT,30074,HUB COVID MAGENTA,LOM,20-29,1,6,0,6,1,0,0,7,0,7,Lombardia,ITC4
2021-01-12,PF/BT,30074,HUB COVID MAGENTA,LOM,30-39,9,15,0,19,5,0,0,24,0,24,Lombardia,ITC4
2021-01-12,PF/BT,30074,HUB COVID MAGENTA,LOM,40-49,4,32,0,25,11,0,0,36,0,36,Lombardia,ITC4
2021-01-12,PF/BT,30074,HUB COVID MAGENTA,LOM,50-59,13,68,0,62,19,0,0,81,0,81,Lombardia,ITC4
2021-01-12,PF/BT,30074,HUB COVID MAGENTA,LOM,60-69,9,18,0,17,10,0,0,27,0,27,Lombardia,ITC4
2021-01-12,PF/BT,30074,HUB COVID MAGENTA,LOM,70-79,0,1,0,0,1,0,0,1,0,1,Lombardia,ITC4
2021-01-12,PF/BT,30085,Centro Vaccinale Covid Cernusco - ASST Melegnano Martesana,LOM,30-39,3,9,0,12,0,0,0,12,0,12,Lombardia,ITC4
2021-01-12,PF/BT,30085,Centro Vaccinale Covid Cernusco - ASST Melegnano Martesana,LOM,40-49,6,15,0,19,2,0,0,21,0,21,Lombardia,ITC4
2021-01-12,PF/BT,30085,Centro Vaccinale Covid Cernusco - ASST Melegnano Martesana,LOM,50-59,7,15,0,18,4,0,0,22,0,22,Lombardia,ITC4
2021-01-12,PF/BT,30085,Centro Vaccinale Covid Cernusco - ASST Melegnano Martesana,LOM,60-69,3,7,0,9,1,0,0,10,0,10,Lombardia,ITC4
2021-01-12,PF/BT,30085,Centro Vaccinale Covid Cernusco - ASST Melegnano Martesana,LOM,70-79,1,0,0,1,0,0,0,1,0,1,Lombardia,ITC4
2021-01-12,PF/BT,30156,Centro Vaccinale Covid Desenzano,LOM,20-29,1,14,0,5,1,0,9,15,0,15,Lombardia,ITC4
2021-01-12,PF/BT,30156,Centro Vaccinale Covid Desenzano,LOM,30-39,12,11,0,19,0,0,4,23,0,23,Lombardia,ITC4
2021-01-12,PF/BT,30156,Centro Vaccinale Covid Desenzano,LOM,40-49,9,10,0,8,3,0,8,19,0,19,Lombardia,ITC4
2021-01-12,PF/BT,30156,Centro Vaccinale Covid Desenzano,LOM,50-59,13,44,0,36,13,0,8,57,0,57,Lombardia,ITC4
2021-01-12,PF/BT,30156,Centro Vaccinale Covid Desenzano,LOM,60-69,5,7,0,5,6,0,1,12,0,12,Lombardia,ITC4
2021-01-12,PF/BT,30157,Centro Vaccinale Covid Gavardo,LOM,20-29,2,14,0,13,0,0,3,16,0,16,Lombardia,ITC4
2021-01-12,PF/BT,30157,Centro Vaccinale Covid Gavardo,LOM,30-39,10,6,0,9,1,0,6,16,0,16,Lombardia,ITC4
2021-01-12,PF/BT,30157,Centro Vaccinale Covid Gavardo,LOM,40-49,6,13,0,9,4,0,6,19,0,19,Lombardia,ITC4
2021-01-12,PF/BT,30157,Centro Vaccinale Covid Gavardo,LOM,50-59,4,29,0,24,4,0,5,33,0,33,Lombardia,ITC4
2021-01-12,PF/BT,30157,Centro Vaccinale Covid Gavardo,LOM,60-69,15,12,0,10,0,0,17,27,0,27,Lombardia,ITC4
2021-01-12,PF/BT,30157,Centro Vaccinale Covid Gavardo,LOM,70-79,3,0,0,0,0,0,3,3,0,3,Lombardia,ITC4
2021-01-12,PF/BT,30176,ISTITUTO CLINICO S. ANNA di ISTITUTI OSPEDALIERI BRESCIANI S.p.A.,LOM,20-29,0,2,0,2,0,0,0,2,0,2,Lombardia,ITC4
2021-01-12,PF/BT,30176,ISTITUTO CLINICO S. ANNA di ISTITUTI OSPEDALIERI BRESCIANI S.p.A.,LOM,30-39,2,3,0,5,0,0,0,5,0,5,Lombardia,ITC4
2021-01-12,PF/BT,30176,ISTITUTO CLINICO S. ANNA di ISTITUTI OSPEDALIERI BRESCIANI S.p.A.,LOM,40-49,5,7,0,10,2,0,0,12,0,12,Lombardia,ITC4
2021-01-12,PF/BT,30176,ISTITUTO CLINICO S. ANNA di ISTITUTI OSPEDALIERI BRESCIANI S.p.A.,LOM,50-59,2,1,0,3,0,0,0,3,0,3,Lombardia,ITC4
2021-01-12,PF/BT,30176,ISTITUTO CLINICO S. ANNA di ISTITUTI OSPEDALIERI BRESCIANI S.p.A.,LOM,60-69,2,0,0,2,0,0,0,2,0,2,Lombardia,ITC4
2021-01-12,PF/BT,30184,Centro Vaccinale Covid Manerbio,LOM,20-29,4,6,0,6,1,0,3,10,0,10,Lombardia,ITC4
2021-01-12,PF/BT,30184,Centro Vaccinale Covid Manerbio,LOM,30-39,4,15,0,17,1,0,1,19,0,19,Lombardia,ITC4
2021-01-12,PF/BT,30184,Centro Vaccinale Covid Manerbio,LOM,40-49,2,31,0,28,4,0,1,33,0,33,Lombardia,ITC4
2021-01-12,PF/BT,30184,Centro Vaccinale Covid Manerbio,LOM,50-59,13,26,0,28,7,0,4,39,0,39,Lombardia,ITC4
2021-01-12,PF/BT,30184,Centro Vaccinale Covid Manerbio,LOM,60-69,7,6,0,10,2,0,1,13,0,13,Lombardia,ITC4
2021-01-12,PF/BT,30193,Ambulatorio HUB Vigevano,LOM,20-29,4,6,0,4,6,0,0,10,0,10,Lombardia,ITC4
2021-01-12,PF/BT,30193,Ambulatorio HUB Vigevano,LOM,30-39,5,6,0,5,6,0,0,11,0,11,Lombardia,ITC4
2021-01-12,PF/BT,30193,Ambulatorio HUB Vigevano,LOM,40-49,14,20,0,14,20,0,0,34,0,34,Lombardia,ITC4
2021-01-12,PF/BT,30193,Ambulatorio HUB Vigevano,LOM,50-59,14,32,0,13,33,0,0,46,0,46,Lombardia,ITC4
2021-01-12,PF/BT,30193,Ambulatorio HUB Vigevano,LOM,60-69,13,17,0,6,24,0,0,30,0,30,Lombardia,ITC4
2021-01-12,PF/BT,30193,Ambulatorio HUB Vigevano,LOM,70-79,4,0,0,0,4,0,0,4,0,4,Lombardia,ITC4
2021-01-12,PF/BT,30193,Ambulatorio HUB Vigevano,LOM,80-89,3,0,0,0,3,0,0,3,0,3,Lombardia,ITC4
2021-01-12,PF/BT,30194,AMBULATORIO HUB VOGHERA,LOM,20-29,4,9,0,11,2,0,0,13,0,13,Lombardia,ITC4
2021-01-12,PF/BT,30194,AMBULATORIO HUB VOGHERA,LOM,30-39,15,14,0,13,16,0,0,29,0,29,Lombardia,ITC4
2021-01-12,PF/BT,30194,AMBULATORIO HUB VOGHERA,LOM,40-49,7,21,0,13,15,0,0,28,0,28,Lombardia,ITC4
2021-01-12,PF/BT,30194,AMBULATORIO HUB VOGHERA,LOM,50-59,16,44,0,26,34,0,0,60,0,60,Lombardia,ITC4
2021-01-12,PF/BT,30194,AMBULATORIO HUB VOGHERA,LOM,60-69,7,9,0,8,8,0,0,16,0,16,Lombardia,ITC4
2021-01-12,PF/BT,30194,AMBULATORIO HUB VOGHERA,LOM,70-79,1,0,0,0,1,0,0,1,0,1,Lombardia,ITC4
2021-01-12,PF/BT,302,Istituto Palazzolo Fondazione Don Carlo Gnocchi,LOM,20-29,9,5,0,14,0,0,0,14,0,14,Lombardia,ITC4
2021-01-12,PF/BT,302,Istituto Palazzolo Fondazione Don Carlo Gnocchi,LOM,30-39,4,6,0,7,3,0,0,10,0,10,Lombardia,ITC4
2021-01-12,PF/BT,302,Istituto Palazzolo Fondazione Don Carlo Gnocchi,LOM,40-49,3,12,0,14,1,0,0,15,0,15,Lombardia,ITC4
2021-01-12,PF/BT,302,Istituto Palazzolo Fondazione Don Carlo Gnocchi,LOM,50-59,4,5,0,9,0,0,0,9,0,9,Lombardia,ITC4
2021-01-12,PF/BT,30209,OSPEDALE MAGGIORE DI CREMA,LOM,20-29,3,11,0,6,1,0,7,14,0,14,Lombardia,ITC4
2021-01-12,PF/BT,30209,OSPEDALE MAGGIORE DI CREMA,LOM,30-39,13,11,0,13,4,0,7,24,0,24,Lombardia,ITC4
2021-01-12,PF/BT,30209,OSPEDALE MAGGIORE DI CREMA,LOM,40-49,12,22,0,25,3,0,6,34,0,34,Lombardia,ITC4
2021-01-12,PF/BT,30209,OSPEDALE MAGGIORE DI CREMA,LOM,50-59,13,42,0,28,17,0,10,55,0,55,Lombardia,ITC4
2021-01-12,PF/BT,30209,OSPEDALE MAGGIORE DI CREMA,LOM,60-69,6,12,0,11,5,0,2,18,0,18,Lombardia,ITC4
2021-01-12,PF/BT,30209,OSPEDALE MAGGIORE DI CREMA,LOM,70-79,2,1,0,0,1,0,2,3,0,3,Lombardia,ITC4
2021-01-12,PF/BT,30209,OSPEDALE MAGGIORE DI CREMA,LOM,80-89,1,1,0,0,0,0,2,2,0,2,Lombardia,ITC4
2021-01-12,PF/BT,3021800,Casa di Cura san Camillo cremona,LOM,20-29,1,1,0,2,0,0,0,2,0,2,Lombardia,ITC4
2021-01-12,PF/BT,3021800,Casa di Cura san Camillo cremona,LOM,30-39,3,5,0,7,1,0,0,8,0,8,Lombardia,ITC4
2021-01-12,PF/BT,3021800,Casa di Cura san Camillo cremona,LOM,40-49,1,5,0,5,1,0,0,6,0,6,Lombardia,ITC4
2021-01-12,PF/BT,3021800,Casa di Cura san Camillo cremona,LOM,50-59,6,15,0,21,0,0,0,21,0,21,Lombardia,ITC4
2021-01-12,PF/BT,3021800,Casa di Cura san Camillo cremona,LOM,60-69,12,3,0,15,0,0,0,15,0,15,Lombardia,ITC4
2021-01-12,PF/BT,3021800,Casa di Cura san Camillo cremona,LOM,70-79,1,0,0,1,0,0,0,1,0,1,Lombardia,ITC4
2021-01-12,PF/BT,3021800,Casa di Cura san Camillo cremona,LOM,80-89,0,1,0,1,0,0,0,1,0,1,Lombardia,ITC4
2021-01-12,PF/BT,30281,HUB COVID LEGNANO,LOM,20-29,7,9,0,13,3,0,0,16,0,16,Lombardia,ITC4
2021-01-12,PF/BT,30281,HUB COVID LEGNANO,LOM,30-39,15,34,0,44,5,0,0,49,0,49,Lombardia,ITC4
2021-01-12,PF/BT,30281,HUB COVID LEGNANO,LOM,40-49,11,52,0,15,48,0,0,63,0,63,Lombardia,ITC4
2021-01-12,PF/BT,30281,HUB COVID LEGNANO,LOM,50-59,21,77,0,83,15,0,0,98,0,98,Lombardia,ITC4
2021-01-12,PF/BT,30281,HUB COVID LEGNANO,LOM,60-69,7,17,0,14,10,0,0,24,0,24,Lombardia,ITC4
2021-01-12,PF/BT,30281,HUB COVID LEGNANO,LOM,70-79,1,0,0,0,1,0,0,1,0,1,Lombardia,ITC4
2021-01-12,PF/BT,30321000338 - 30321000390,Residenze Assistite maleo (Rsa Mons Trabattoni & RSA L. Corazza) Maleo - Lodi,LOM,40-49,1,0,0,1,0,0,0,1,0,1,Lombardia,ITC4
2021-01-12,PF/BT,30321000338 - 30321000390,Residenze Assistite maleo (Rsa Mons Trabattoni & RSA L. Corazza) Maleo - Lodi,LOM,50-59,0,1,0,1,0,0,0,1,0,1,Lombardia,ITC4
2021-01-12,PF/BT,30321000338 - 30321000390,Residenze Assistite maleo (Rsa Mons Trabattoni & RSA L. Corazza) Maleo - Lodi,LOM,60-69,2,0,0,0,0,2,0,2,0,2,Lombardia,ITC4
2021-01-12,PF/BT,30321000338 - 30321000390,Residenze Assistite maleo (Rsa Mons Trabattoni & RSA L. Corazza) Maleo - Lodi,LOM,70-79,4,1,0,0,0,5,0,5,0,5,Lombardia,ITC4
2021-01-12,PF/BT,30321000338 - 30321000390,Residenze Assistite maleo (Rsa Mons Trabattoni & RSA L. Corazza) Maleo - Lodi,LOM,80-89,6,26,0,0,0,32,0,32,0,32,Lombardia,ITC4
2021-01-12,PF/BT,30321000338 - 30321000390,Residenze Assistite maleo (Rsa Mons Trabattoni & RSA L. Corazza) Maleo - Lodi,LOM,90+,5,21,0,0,0,26,0,26,0,26,Lombardia,ITC4
2021-01-12,PF/BT,30322000698,RSA Fondazione G. e G.Ronzoni,LOM,20-29,1,4,0,5,0,0,0,5,0,5,Lombardia,ITC4
2021-01-12,PF/BT,30322000698,RSA Fondazione G. e G.Ronzoni,LOM,30-39,0,4,0,4,0,0,0,4,0,4,Lombardia,ITC4
2021-01-12,PF/BT,30322000698,RSA Fondazione G. e G.Ronzoni,LOM,40-49,1,7,0,6,2,0,0,8,0,8,Lombardia,ITC4
2021-01-12,PF/BT,30322000698,RSA Fondazione G. e G.Ronzoni,LOM,50-59,4,8,0,5,7,0,0,12,0,12,Lombardia,ITC4
2021-01-12,PF/BT,30322000698,RSA Fondazione G. e G.Ronzoni,LOM,60-69,1,1,0,0,2,0,0,2,0,2,Lombardia,ITC4
2021-01-12,PF/BT,30322000698,RSA Fondazione G. e G.Ronzoni,LOM,70-79,0,1,0,0,0,1,0,1,0,1,Lombardia,ITC4
2021-01-12,PF/BT,30322000698,RSA Fondazione G. e G.Ronzoni,LOM,80-89,2,1,0,0,0,3,0,3,0,3,Lombardia,ITC4
2021-01-12,PF/BT,30322029,Ospedale Religioso Classificato Sacra Famiglia Fatebenefratelli Erba,LOM,20-29,4,16,0,20,0,0,0,20,0,20,Lombardia,ITC4
2021-01-12,PF/BT,30322029,Ospedale Religioso Classificato Sacra Famiglia Fatebenefratelli Erba,LOM,30-39,5,9,0,14,0,0,0,14,0,14,Lombardia,ITC4
2021-01-12,PF/BT,30322029,Ospedale Religioso Classificato Sacra Famiglia Fatebenefratelli Erba,LOM,40-49,4,12,0,16,0,0,0,16,0,16,Lombardia,ITC4
2021-01-12,PF/BT,30322029,Ospedale Religioso Classificato Sacra Famiglia Fatebenefratelli Erba,LOM,50-59,6,22,0,26,2,0,0,28,0,28,Lombardia,ITC4
2021-01-12,PF/BT,30322029,Ospedale Religioso Classificato Sacra Famiglia Fatebenefratelli Erba,LOM,60-69,5,4,0,9,0,0,0,9,0,9,Lombardia,ITC4
2021-01-12,PF/BT,30322029,Ospedale Religioso Classificato Sacra Famiglia Fatebenefratelli Erba,LOM,80-89,3,0,0,1,2,0,0,3,0,3,Lombardia,ITC4
2021-01-12,PF/BT,30327001819,RSA I GIRASOLI - VIA M. K. GANDHI N° 1 BORGO VIRGILIO (MN),LOM,30-39,0,2,0,2,0,0,0,2,0,2,Lombardia,ITC4
2021-01-12,PF/BT,30327001819,RSA I GIRASOLI - VIA M. K. GANDHI N° 1 BORGO VIRGILIO (MN),LOM,40-49,1,6,0,7,0,0,0,7,0,7,Lombardia,ITC4
2021-01-12,PF/BT,30327001819,RSA I GIRASOLI - VIA M. K. GANDHI N° 1 BORGO VIRGILIO (MN),LOM,50-59,0,3,0,2,1,0,0,3,0,3,Lombardia,ITC4
2021-01-12,PF/BT,3035300,OSPEDALE CIVILE VOLTA MANTOVANA SRL,LOM,20-29,3,2,0,5,0,0,0,5,0,5,Lombardia,ITC4
2021-01-12,PF/BT,3035300,OSPEDALE CIVILE VOLTA MANTOVANA SRL,LOM,30-39,4,3,0,6,1,0,0,7,0,7,Lombardia,ITC4
2021-01-12,PF/BT,3035300,OSPEDALE CIVILE VOLTA MANTOVANA SRL,LOM,40-49,2,2,0,2,2,0,0,4,0,4,Lombardia,ITC4
2021-01-12,PF/BT,3035300,OSPEDALE CIVILE VOLTA MANTOVANA SRL,LOM,50-59,1,9,0,9,1,0,0,10,0,10,Lombardia,ITC4
2021-01-12,PF/BT,3035300,OSPEDALE CIVILE VOLTA MANTOVANA SRL,LOM,60-69,0,2,0,2,0,0,0,2,0,2,Lombardia,ITC4
2021-01-12,PF/BT,3035300,OSPEDALE CIVILE VOLTA MANTOVANA SRL,LOM,70-79,2,0,0,2,0,0,0,2,0,2,Lombardia,ITC4
2021-01-12,PF/BT,3035500,ospedale di suzzara spa,LOM,20-29,2,6,0,7,1,0,0,8,0,8,Lombardia,ITC4
2021-01-12,PF/BT,3035500,ospedale di suzzara spa,LOM,30-39,3,6,0,9,0,0,0,9,0,9,Lombardia,ITC4
2021-01-12,PF/BT,3035500,ospedale di suzzara spa,LOM,40-49,2,6,0,8,0,0,0,8,0,8,Lombardia,ITC4
2021-01-12,PF/BT,3035500,ospedale di suzzara spa,LOM,50-59,0,5,0,4,1,0,0,5,0,5,Lombardia,ITC4
2021-01-12,PF/BT,3035500,ospedale di suzzara spa,LOM,60-69,4,2,0,6,0,0,0,6,0,6,Lombardia,ITC4
2021-01-12,PF/BT,3035700,OSPEDALE SAN PELLEGRINO SRL,LOM,20-29,1,4,0,4,1,0,0,5,0,5,Lombardia,ITC4
2021-01-12,PF/BT,3035700,OSPEDALE SAN PELLEGRINO SRL,LOM,30-39,3,8,0,9,2,0,0,11,0,11,Lombardia,ITC4
2021-01-12,PF/BT,3035700,OSPEDALE SAN PELLEGRINO SRL,LOM,40-49,4,10,0,11,3,0,0,14,0,14,Lombardia,ITC4
2021-01-12,PF/BT,3035700,OSPEDALE SAN PELLEGRINO SRL,LOM,50-59,5,14,0,13,6,0,0,19,0,19,Lombardia,ITC4
2021-01-12,PF/BT,3035700,OSPEDALE SAN PELLEGRINO SRL,LOM,60-69,3,1,0,3,1,0,0,4,0,4,Lombardia,ITC4
2021-01-12,PF/BT,3035700,OSPEDALE SAN PELLEGRINO SRL,LOM,70-79,1,0,0,1,0,0,0,1,0,1,Lombardia,ITC4
2021-01-12,PF/BT,30701,ASST GRANDE OSPEDALE METROPOLITANO NIGUARDA,LOM,16-19,3,1,0,0,4,0,0,4,0,4,Lombardia,ITC4
2021-01-12,PF/BT,30701,ASST GRANDE OSPEDALE METROPOLITANO NIGUARDA,LOM,20-29,31,64,0,44,41,0,10,95,0,95,Lombardia,ITC4
2021-01-12,PF/BT,30701,ASST GRANDE OSPEDALE METROPOLITANO NIGUARDA,LOM,30-39,47,58,0,47,45,0,13,105,0,105,Lombardia,ITC4
2021-01-12,PF/BT,30701,ASST GRANDE OSPEDALE METROPOLITANO NIGUARDA,LOM,40-49,46,50,0,34,48,0,14,96,0,96,Lombardia,ITC4
2021-01-12,PF/BT,30701,ASST GRANDE OSPEDALE METROPOLITANO NIGUARDA,LOM,50-59,79,116,0,91,89,0,15,195,0,195,Lombardia,ITC4
2021-01-12,PF/BT,30701,ASST GRANDE OSPEDALE METROPOLITANO NIGUARDA,LOM,60-69,27,25,0,24,24,0,4,52,0,52,Lombardia,ITC4
2021-01-12,PF/BT,30701,ASST GRANDE OSPEDALE METROPOLITANO NIGUARDA,LOM,70-79,4,0,0,0,4,0,0,4,0,4,Lombardia,ITC4
2021-01-12,PF/BT,30701,ASST GRANDE OSPEDALE METROPOLITANO NIGUARDA,LOM,80-89,0,1,0,0,0,0,1,1,0,1,Lombardia,ITC4
2021-01-12,PF/BT,30718,ASST PAPA GIOVANNI XXIII,LOM,20-29,13,31,0,40,4,0,0,44,0,44,Lombardia,ITC4
2021-01-12,PF/BT,30718,ASST PAPA GIOVANNI XXIII,LOM,30-39,20,46,0,61,5,0,0,66,0,66,Lombardia,ITC4
2021-01-12,PF/BT,30718,ASST PAPA GIOVANNI XXIII,LOM,40-49,22,66,0,80,8,0,0,88,0,88,Lombardia,ITC4
2021-01-12,PF/BT,30718,ASST PAPA GIOVANNI XXIII,LOM,50-59,31,71,0,84,18,0,0,102,0,102,Lombardia,ITC4
2021-01-12,PF/BT,30718,ASST PAPA GIOVANNI XXIII,LOM,60-69,15,23,0,31,7,0,0,38,0,38,Lombardia,ITC4
2021-01-12,PF/BT,30718,ASST PAPA GIOVANNI XXIII,LOM,70-79,2,0,0,0,2,0,0,2,0,2,Lombardia,ITC4
2021-01-12,PF/BT,30902,Ospedale S.Anna - Como,LOM,16-19,1,2,0,0,3,0,0,3,0,3,Lombardia,ITC4
2021-01-12,PF/BT,30902,Ospedale S.Anna - Como,LOM,20-29,43,64,0,36,71,0,0,107,0,107,Lombardia,ITC4
2021-01-12,PF/BT,30902,Ospedale S.Anna - Como,LOM,30-39,63,40,0,46,57,0,0,103,0,103,Lombardia,ITC4
2021-01-12,PF/BT,30902,Ospedale S.Anna - Como,LOM,40-49,74,78,0,74,78,0,0,152,0,152,Lombardia,ITC4
2021-01-12,PF/BT,30902,Ospedale S.Anna - Como,LOM,50-59,76,114,0,84,106,0,0,190,0,190,Lombardia,ITC4
2021-01-12,PF/BT,30902,Ospedale S.Anna - Como,LOM,60-69,61,51,0,38,74,0,0,112,0,112,Lombardia,ITC4
2021-01-12,PF/BT,30902,Ospedale S.Anna - Como,LOM,70-79,35,15,0,7,43,0,0,50,0,50,Lombardia,ITC4
2021-01-12,PF/BT,30902,Ospedale S.Anna - Como,LOM,80-89,1,2,0,0,3,0,0,3,0,3,Lombardia,ITC4
2021-01-12,PF/BT,30904,ASST VALTELLINA E ALTO LARIO PRESIDIO OSPEDALIERO DI SONDALO,LOM,20-29,2,4,0,5,1,0,0,6,0,6,Lombardia,ITC4
2021-01-12,PF/BT,30904,ASST VALTELLINA E ALTO LARIO PRESIDIO OSPEDALIERO DI SONDALO,LOM,30-39,3,7,0,8,2,0,0,10,0,10,Lombardia,ITC4
2021-01-12,PF/BT,30904,ASST VALTELLINA E ALTO LARIO PRESIDIO OSPEDALIERO DI SONDALO,LOM,40-49,10,10,0,17,3,0,0,20,0,20,Lombardia,ITC4
2021-01-12,PF/BT,30904,ASST VALTELLINA E ALTO LARIO PRESIDIO OSPEDALIERO DI SONDALO,LOM,50-59,26,54,0,40,40,0,0,80,0,80,Lombardia,ITC4
2021-01-12,PF/BT,30904,ASST VALTELLINA E ALTO LARIO PRESIDIO OSPEDALIERO DI SONDALO,LOM,60-69,12,16,0,15,13,0,0,28,0,28,Lombardia,ITC4
2021-01-12,PF/BT,30909,amb covid monza,LOM,16-19,0,4,0,4,0,0,0,4,0,4,Lombardia,ITC4
2021-01-12,PF/BT,30909,amb covid monza,LOM,20-29,36,85,0,114,7,0,0,121,0,121,Lombardia,ITC4
2021-01-12,PF/BT,30909,amb covid monza,LOM,30-39,40,61,0,71,30,0,0,101,0,101,Lombardia,ITC4
2021-01-12,PF/BT,30909,amb covid monza,LOM,40-49,34,57,0,62,29,0,0,91,0,91,Lombardia,ITC4
2021-01-12,PF/BT,30909,amb covid monza,LOM,50-59,46,79,0,69,56,0,0,125,0,125,Lombardia,ITC4
2021-01-12,PF/BT,30909,amb covid monza,LOM,60-69,26,28,0,38,16,0,0,54,0,54,Lombardia,ITC4
2021-01-12,PF/BT,30909,amb covid monza,LOM,70-79,5,1,0,5,1,0,0,6,0,6,Lombardia,ITC4
2021-01-12,PF/BT,30909,amb covid monza,LOM,80-89,0,1,0,0,1,0,0,1,0,1,Lombardia,ITC4
2021-01-12,PF/BT,30941,ISTITUTO EUROPEO DI ONCOLOGIA,LOM,20-29,1,21,0,21,1,0,0,22,0,22,Lombardia,ITC4
2021-01-12,PF/BT,30941,ISTITUTO EUROPEO DI ONCOLOGIA,LOM,30-39,14,30,0,44,0,0,0,44,0,44,Lombardia,ITC4
2021-01-12,PF/BT,30941,ISTITUTO EUROPEO DI ONCOLOGIA,LOM,40-49,44,92,0,134,2,0,0,136,0,136,Lombardia,ITC4
2021-01-12,PF/BT,30941,ISTITUTO EUROPEO DI ONCOLOGIA,LOM,50-59,2,18,0,18,2,0,0,20,0,20,Lombardia,ITC4
2021-01-12,PF/BT,30941,ISTITUTO EUROPEO DI ONCOLOGIA,LOM,60-69,0,2,0,1,1,0,0,2,0,2,Lombardia,ITC4
2021-01-12,PF/BT,30941,ISTITUTO EUROPEO DI ONCOLOGIA,LOM,70-79,1,0,0,0,1,0,0,1,0,1,Lombardia,ITC4
2021-01-12,PF/BT,3094602,IST.CLINICO S.SIRO SPA-MILANO,LOM,20-29,2,0,0,2,0,0,0,2,0,2,Lombardia,ITC4
2021-01-12,PF/BT,3094602,IST.CLINICO S.SIRO SPA-MILANO,LOM,30-39,8,2,0,10,0,0,0,10,0,10,Lombardia,ITC4
2021-01-12,PF/BT,3094602,IST.CLINICO S.SIRO SPA-MILANO,LOM,40-49,2,2,0,4,0,0,0,4,0,4,Lombardia,ITC4
2021-01-12,PF/BT,3094602,IST.CLINICO S.SIRO SPA-MILANO,LOM,50-59,2,0,0,2,0,0,0,2,0,2,Lombardia,ITC4
2021-01-12,PF/BT,3094602,IST.CLINICO S.SIRO SPA-MILANO,LOM,60-69,4,1,0,5,0,0,0,5,0,5,Lombardia,ITC4
2021-01-12,PF/BT,3094602,IST.CLINICO S.SIRO SPA-MILANO,LOM,70-79,1,0,0,1,0,0,0,1,0,1,Lombardia,ITC4
2021-01-12,PF/BT,314,RSA SAN GIORGIO,LOM,20-29,0,2,0,1,1,0,0,2,0,2,Lombardia,ITC4
2021-01-12,PF/BT,314,RSA SAN GIORGIO,LOM,30-39,1,1,0,1,1,0,0,2,0,2,Lombardia,ITC4
2021-01-12,PF/BT,314,RSA SAN GIORGIO,LOM,40-49,2,6,0,7,1,0,0,8,0,8,Lombardia,ITC4
2021-01-12,PF/BT,314,RSA SAN GIORGIO,LOM,50-59,2,7,0,3,6,0,0,9,0,9,Lombardia,ITC4
2021-01-12,PF/BT,314,RSA SAN GIORGIO,LOM,60-69,1,2,0,1,2,0,0,3,0,3,Lombardia,ITC4
2021-01-12,PF/BT,321000289,RSA Casa Famiglia,LOM,20-29,1,0,0,1,0,0,0,1,0,1,Lombardia,ITC4
2021-01-12,PF/BT,321000289,RSA Casa Famiglia,LOM,30-39,1,1,0,2,0,0,0,2,0,2,Lombardia,ITC4
2021-01-12,PF/BT,321000289,RSA Casa Famiglia,LOM,50-59,1,0,0,1,0,0,0,1,0,1,Lombardia,ITC4
2021-01-12,PF/BT,321000289,RSA Casa Famiglia,LOM,60-69,0,2,0,0,0,0,2,2,0,2,Lombardia,ITC4
2021-01-12,PF/BT,321000289,RSA Casa Famiglia,LOM,70-79,1,2,0,0,0,1,2,3,0,3,Lombardia,ITC4
2021-01-12,PF/BT,321000289,RSA Casa Famiglia,LOM,80-89,2,12,0,0,0,13,1,14,0,14,Lombardia,ITC4
2021-01-12,PF/BT,321000289,RSA Casa Famiglia,LOM,90+,0,7,0,0,0,7,0,7,0,7,Lombardia,ITC4
2021-01-12,PF/BT,321000354 e 321000584,PUNTO VACCINALE RSA CASA PER CONIUGI,LOM,20-29,1,0,0,0,1,0,0,1,0,1,Lombardia,ITC4
2021-01-12,PF/BT,321000354 e 321000584,PUNTO VACCINALE RSA CASA PER CONIUGI,LOM,40-49,2,1,0,1,2,0,0,3,0,3,Lombardia,ITC4
2021-01-12,PF/BT,321000354 e 321000584,PUNTO VACCINALE RSA CASA PER CONIUGI,LOM,50-59,2,2,0,3,1,0,0,4,0,4,Lombardia,ITC4
2021-01-12,PF/BT,321000354 e 321000584,PUNTO VACCINALE RSA CASA PER CONIUGI,LOM,60-69,1,1,0,0,2,0,0,2,0,2,Lombardia,ITC4
2021-01-12,PF/BT,321000354 e 321000584,PUNTO VACCINALE RSA CASA PER CONIUGI,LOM,70-79,1,1,0,1,1,0,0,2,0,2,Lombardia,ITC4
2021-01-12,PF/BT,32170712,ambulatorio covid SESTO SAN GIOVANNI,LOM,20-29,12,29,0,32,9,0,0,41,0,41,Lombardia,ITC4
2021-01-12,PF/BT,32170712,ambulatorio covid SESTO SAN GIOVANNI,LOM,30-39,19,43,0,36,26,0,0,62,0,62,Lombardia,ITC4
2021-01-12,PF/BT,32170712,ambulatorio covid SESTO SAN GIOVANNI,LOM,40-49,35,69,0,69,35,0,0,104,0,104,Lombardia,ITC4
2021-01-12,PF/BT,32170712,ambulatorio covid SESTO SAN GIOVANNI,LOM,50-59,42,101,0,95,48,0,0,143,0,143,Lombardia,ITC4
2021-01-12,PF/BT,32170712,ambulatorio covid SESTO SAN GIOVANNI,LOM,60-69,30,45,0,58,17,0,0,75,0,75,Lombardia,ITC4
2021-01-12,PF/BT,32170712,ambulatorio covid SESTO SAN GIOVANNI,LOM,80-89,1,0,0,0,1,0,0,1,0,1,Lombardia,ITC4
2021-01-12,PF/BT,322000728,RSA CAMELOT,LOM,20-29,0,1,0,1,0,0,0,1,0,1,Lombardia,ITC4
2021-01-12,PF/BT,322000728,RSA CAMELOT,LOM,30-39,0,3,0,3,0,0,0,3,0,3,Lombardia,ITC4
2021-01-12,PF/BT,322000728,RSA CAMELOT,LOM,40-49,0,8,0,5,3,0,0,8,0,8,Lombardia,ITC4
2021-01-12,PF/BT,322000728,RSA CAMELOT,LOM,50-59,3,5,0,5,3,0,0,8,0,8,Lombardia,ITC4
2021-01-12,PF/BT,322000728,RSA CAMELOT,LOM,60-69,3,4,0,3,0,4,0,7,0,7,Lombardia,ITC4
2021-01-12,PF/BT,322000728,RSA CAMELOT,LOM,70-79,0,2,0,0,0,2,0,2,0,2,Lombardia,ITC4
2021-01-12,PF/BT,322000728,RSA CAMELOT,LOM,80-89,0,4,0,0,4,0,0,4,0,4,Lombardia,ITC4
2021-01-12,PF/BT,322000728,RSA CAMELOT,LOM,90+,0,3,0,0,0,3,0,3,0,3,Lombardia,ITC4
2021-01-12,PF/BT,322000844 - 322000712,Istituto La Provvidenza - UG1 /UG3,LOM,20-29,1,17,0,15,2,0,1,18,0,18,Lombardia,ITC4
2021-01-12,PF/BT,322000844 - 322000712,Istituto La Provvidenza - UG1 /UG3,LOM,30-39,2,14,0,13,3,0,0,16,0,16,Lombardia,ITC4
2021-01-12,PF/BT,322000844 - 322000712,Istituto La Provvidenza - UG1 /UG3,LOM,40-49,8,26,0,26,8,0,0,34,0,34,Lombardia,ITC4
2021-01-12,PF/BT,322000844 - 322000712,Istituto La Provvidenza - UG1 /UG3,LOM,50-59,1,46,0,41,3,0,3,47,0,47,Lombardia,ITC4
2021-01-12,PF/BT,322000844 - 322000712,Istituto La Provvidenza - UG1 /UG3,LOM,60-69,2,3,0,2,2,0,1,5,0,5,Lombardia,ITC4
2021-01-12,PF/BT,32200754,CASA DI RIPOSO BELLORA,LOM,20-29,2,1,0,1,2,0,0,3,0,3,Lombardia,ITC4
2021-01-12,PF/BT,32200754,CASA DI RIPOSO BELLORA,LOM,30-39,1,1,0,0,2,0,0,2,0,2,Lombardia,ITC4
2021-01-12,PF/BT,32200754,CASA DI RIPOSO BELLORA,LOM,40-49,3,12,0,11,4,0,0,15,0,15,Lombardia,ITC4
2021-01-12,PF/BT,32200754,CASA DI RIPOSO BELLORA,LOM,50-59,2,11,0,10,3,0,0,13,0,13,Lombardia,ITC4
2021-01-12,PF/BT,32200754,CASA DI RIPOSO BELLORA,LOM,60-69,2,6,0,7,1,0,0,8,0,8,Lombardia,ITC4
2021-01-12,PF/BT,32200754,CASA DI RIPOSO BELLORA,LOM,70-79,1,0,0,0,1,0,0,1,0,1,Lombardia,ITC4
2021-01-12,PF/BT,32271028,AMBULATORIO COVID OSPEDALE CIRCOLO,LOM,16-19,0,2,0,2,0,0,0,2,0,2,Lombardia,ITC4
2021-01-12,PF/BT,32271028,AMBULATORIO COVID OSPEDALE CIRCOLO,LOM,20-29,26,24,0,50,0,0,0,50,0,50,Lombardia,ITC4
2021-01-12,PF/BT,32271028,AMBULATORIO COVID OSPEDALE CIRCOLO,LOM,30-39,34,34,0,68,0,0,0,68,0,68,Lombardia,ITC4
2021-01-12,PF/BT,32271028,AMBULATORIO COVID OSPEDALE CIRCOLO,LOM,40-49,33,73,0,106,0,0,0,106,0,106,Lombardia,ITC4
2021-01-12,PF/BT,32271028,AMBULATORIO COVID OSPEDALE CIRCOLO,LOM,50-59,50,110,0,160,0,0,0,160,0,160,Lombardia,ITC4
2021-01-12,PF/BT,32271028,AMBULATORIO COVID OSPEDALE CIRCOLO,LOM,60-69,46,30,0,76,0,0,0,76,0,76,Lombardia,ITC4
2021-01-12,PF/BT,32271028,AMBULATORIO COVID OSPEDALE CIRCOLO,LOM,70-79,2,3,0,5,0,0,0,5,0,5,Lombardia,ITC4
2021-01-12,PF/BT,32271028,AMBULATORIO COVID OSPEDALE CIRCOLO,LOM,80-89,0,1,0,1,0,0,0,1,0,1,Lombardia,ITC4
2021-01-12,PF/BT,32271117,ambulatorio covid Saronno,LOM,20-29,1,1,0,2,0,0,0,2,0,2,Lombardia,ITC4
2021-01-12,PF/BT,32271117,ambulatorio covid Saronno,LOM,30-39,3,1,0,4,0,0,0,4,0,4,Lombardia,ITC4
2021-01-12,PF/BT,32271117,ambulatorio covid Saronno,LOM,40-49,4,23,0,27,0,0,0,27,0,27,Lombardia,ITC4
2021-01-12,PF/BT,32271117,ambulatorio covid Saronno,LOM,50-59,10,25,0,35,0,0,0,35,0,35,Lombardia,ITC4
2021-01-12,PF/BT,32271117,ambulatorio covid Saronno,LOM,60-69,0,4,0,4,0,0,0,4,0,4,Lombardia,ITC4
2021-01-12,PF/BT,32271118,ambulatorio covid Busto A.,LOM,20-29,7,17,0,24,0,0,0,24,0,24,Lombardia,ITC4
2021-01-12,PF/BT,32271118,ambulatorio covid Busto A.,LOM,30-39,8,18,0,26,0,0,0,26,0,26,Lombardia,ITC4
2021-01-12,PF/BT,32271118,ambulatorio covid Busto A.,LOM,40-49,18,45,0,63,0,0,0,63,0,63,Lombardia,ITC4
2021-01-12,PF/BT,32271118,ambulatorio covid Busto A.,LOM,50-59,18,69,0,87,0,0,0,87,0,87,Lombardia,ITC4
2021-01-12,PF/BT,32271118,ambulatorio covid Busto A.,LOM,60-69,6,10,0,16,0,0,0,16,0,16,Lombardia,ITC4
2021-01-12,PF/BT,323000904,RSA VILLA MONS.D.ZANI BIENNO (BS),LOM,30-39,0,5,0,3,2,0,0,5,0,5,Lombardia,ITC4
2021-01-12,PF/BT,323000904,RSA VILLA MONS.D.ZANI BIENNO (BS),LOM,40-49,1,3,0,3,1,0,0,4,0,4,Lombardia,ITC4
2021-01-12,PF/BT,323000904,RSA VILLA MONS.D.ZANI BIENNO (BS),LOM,50-59,1,8,0,8,0,0,1,9,0,9,Lombardia,ITC4
2021-01-12,PF/BT,323000904,RSA VILLA MONS.D.ZANI BIENNO (BS),LOM,60-69,1,4,0,4,0,0,1,5,0,5,Lombardia,ITC4
2021-01-12,PF/BT,323000904,RSA VILLA MONS.D.ZANI BIENNO (BS),LOM,70-79,1,1,0,0,0,2,0,2,0,2,Lombardia,ITC4
2021-01-12,PF/BT,323000904,RSA VILLA MONS.D.ZANI BIENNO (BS),LOM,80-89,1,1,0,0,0,2,0,2,0,2,Lombardia,ITC4
2021-01-12,PF/BT,323000904,RSA VILLA MONS.D.ZANI BIENNO (BS),LOM,90+,2,1,0,0,0,3,0,3,0,3,Lombardia,ITC4
2021-01-12,PF/BT,32500125400,RSA SAN FRANCESCO - BERGAMO,LOM,20-29,0,1,0,1,0,0,0,1,0,1,Lombardia,ITC4
2021-01-12,PF/BT,32500125400,RSA SAN FRANCESCO - BERGAMO,LOM,30-39,1,2,0,3,0,0,0,3,0,3,Lombardia,ITC4
2021-01-12,PF/BT,32500125400,RSA SAN FRANCESCO - BERGAMO,LOM,50-59,0,1,0,1,0,0,0,1,0,1,Lombardia,ITC4
2021-01-12,PF/BT,32500125400,RSA SAN FRANCESCO - BERGAMO,LOM,60-69,0,1,0,1,0,0,0,1,0,1,Lombardia,ITC4
2021-01-12,PF/BT,325001342,CLINICHE GAVAZZENI SPA,LOM,20-29,5,8,0,13,0,0,0,13,0,13,Lombardia,ITC4
2021-01-12,PF/BT,325001342,CLINICHE GAVAZZENI SPA,LOM,30-39,5,9,0,14,0,0,0,14,0,14,Lombardia,ITC4
2021-01-12,PF/BT,325001342,CLINICHE GAVAZZENI SPA,LOM,40-49,13,9,0,22,0,0,0,22,0,22,Lombardia,ITC4
2021-01-12,PF/BT,325001342,CLINICHE GAVAZZENI SPA,LOM,50-59,4,6,0,10,0,0,0,10,0,10,Lombardia,ITC4
2021-01-12,PF/BT,325001342,CLINICHE GAVAZZENI SPA,LOM,60-69,5,1,0,6,0,0,0,6,0,6,Lombardia,ITC4
2021-01-12,PF/BT,325001342,CLINICHE GAVAZZENI SPA,LOM,70-79,1,0,0,1,0,0,0,1,0,1,Lombardia,ITC4
2021-01-12,PF/BT,32503014600,CASA DI CURA SAN FRANCESCO - BERGAMO,LOM,20-29,1,6,0,7,0,0,0,7,0,7,Lombardia,ITC4
2021-01-12,PF/BT,32503014600,CASA DI CURA SAN FRANCESCO - BERGAMO,LOM,30-39,0,2,0,2,0,0,0,2,0,2,Lombardia,ITC4
2021-01-12,PF/BT,32503014600,CASA DI CURA SAN FRANCESCO - BERGAMO,LOM,40-49,1,3,0,4,0,0,0,4,0,4,Lombardia,ITC4
2021-01-12,PF/BT,32503014600,CASA DI CURA SAN FRANCESCO - BERGAMO,LOM,50-59,0,3,0,3,0,0,0,3,0,3,Lombardia,ITC4
2021-01-12,PF/BT,32503014600,CASA DI CURA SAN FRANCESCO - BERGAMO,LOM,60-69,1,0,0,1,0,0,0,1,0,1,Lombardia,ITC4
2021-01-12,PF/BT,32503014600,CASA DI CURA SAN FRANCESCO - BERGAMO,LOM,70-79,0,1,0,1,0,0,0,1,0,1,Lombardia,ITC4
2021-01-12,PF/BT,32572021,AMBULATORIO COVID P.O. ALZANO LOMBARDO,LOM,20-29,3,2,0,5,0,0,0,5,0,5,Lombardia,ITC4
2021-01-12,PF/BT,32572021,AMBULATORIO COVID P.O. ALZANO LOMBARDO,LOM,30-39,2,0,0,2,0,0,0,2,0,2,Lombardia,ITC4
2021-01-12,PF/BT,32572021,AMBULATORIO COVID P.O. ALZANO LOMBARDO,LOM,40-49,4,5,0,9,0,0,0,9,0,9,Lombardia,ITC4
2021-01-12,PF/BT,32572021,AMBULATORIO COVID P.O. ALZANO LOMBARDO,LOM,50-59,10,8,0,18,0,0,0,18,0,18,Lombardia,ITC4
2021-01-12,PF/BT,32572021,AMBULATORIO COVID P.O. ALZANO LOMBARDO,LOM,60-69,14,5,0,19,0,0,0,19,0,19,Lombardia,ITC4
2021-01-12,PF/BT,32572021,AMBULATORIO COVID P.O. ALZANO LOMBARDO,LOM,70-79,1,0,0,1,0,0,0,1,0,1,Lombardia,ITC4
2021-01-12,PF/BT,32572026,AMBULATORIO COVID PIARIO,LOM,20-29,1,0,0,1,0,0,0,1,0,1,Lombardia,ITC4
2021-01-12,PF/BT,32572026,AMBULATORIO COVID PIARIO,LOM,30-39,3,8,0,11,0,0,0,11,0,11,Lombardia,ITC4
2021-01-12,PF/BT,32572026,AMBULATORIO COVID PIARIO,LOM,40-49,6,31,0,37,0,0,0,37,0,37,Lombardia,ITC4
2021-01-12,PF/BT,32572026,AMBULATORIO COVID PIARIO,LOM,50-59,8,34,0,40,2,0,0,42,0,42,Lombardia,ITC4
2021-01-12,PF/BT,32572026,AMBULATORIO COVID PIARIO,LOM,60-69,4,6,0,9,1,0,0,10,0,10,Lombardia,ITC4
2021-01-12,PF/BT,32572026,AMBULATORIO COVID PIARIO,LOM,70-79,1,0,0,1,0,0,0,1,0,1,Lombardia,ITC4
2021-01-12,PF/BT,32572026,Ambulatorio COVID SERIATE,LOM,20-29,1,0,0,1,0,0,0,1,0,1,Lombardia,ITC4
2021-01-12,PF/BT,32572026,Ambulatorio COVID SERIATE,LOM,30-39,3,8,0,11,0,0,0,11,0,11,Lombardia,ITC4
2021-01-12,PF/BT,32572026,Ambulatorio COVID SERIATE,LOM,40-49,6,31,0,37,0,0,0,37,0,37,Lombardia,ITC4
2021-01-12,PF/BT,32572026,Ambulatorio COVID SERIATE,LOM,50-59,8,34,0,40,2,0,0,42,0,42,Lombardia,ITC4
2021-01-12,PF/BT,32572026,Ambulatorio COVID SERIATE,LOM,60-69,4,6,0,9,1,0,0,10,0,10,Lombardia,ITC4
2021-01-12,PF/BT,32572026,Ambulatorio COVID SERIATE,LOM,70-79,1,0,0,1,0,0,0,1,0,1,Lombardia,ITC4
2021-01-12,PF/BT,32572026,piario,LOM,20-29,1,0,0,1,0,0,0,1,0,1,Lombardia,ITC4
2021-01-12,PF/BT,32572026,piario,LOM,30-39,3,8,0,11,0,0,0,11,0,11,Lombardia,ITC4
2021-01-12,PF/BT,32572026,piario,LOM,40-49,6,31,0,37,0,0,0,37,0,37,Lombardia,ITC4
2021-01-12,PF/BT,32572026,piario,LOM,50-59,8,34,0,40,2,0,0,42,0,42,Lombardia,ITC4
2021-01-12,PF/BT,32572026,piario,LOM,60-69,4,6,0,9,1,0,0,10,0,10,Lombardia,ITC4
2021-01-12,PF/BT,32572026,piario,LOM,70-79,1,0,0,1,0,0,0,1,0,1,Lombardia,ITC4
2021-01-12,PF/BT,32572027,Ambulatorio COVID SERIATE,LOM,20-29,5,13,0,17,1,0,0,18,0,18,Lombardia,ITC4
2021-01-12,PF/BT,32572027,Ambulatorio COVID SERIATE,LOM,30-39,16,17,0,31,2,0,0,33,0,33,Lombardia,ITC4
2021-01-12,PF/BT,32572027,Ambulatorio COVID SERIATE,LOM,40-49,12,30,0,40,2,0,0,42,0,42,Lombardia,ITC4
2021-01-12,PF/BT,32572027,Ambulatorio COVID SERIATE,LOM,50-59,9,31,0,37,3,0,0,40,0,40,Lombardia,ITC4
2021-01-12,PF/BT,32572027,Ambulatorio COVID SERIATE,LOM,60-69,9,6,0,13,2,0,0,15,0,15,Lombardia,ITC4
2021-01-12,PF/BT,32572027,Ambulatorio COVID SERIATE,LOM,70-79,2,0,0,2,0,0,0,2,0,2,Lombardia,ITC4
2021-01-12,PF/BT,327001818,R.S.A. VILLA MADDALENA,LOM,20-29,0,2,0,2,0,0,0,2,0,2,Lombardia,ITC4
2021-01-12,PF/BT,327001818,R.S.A. VILLA MADDALENA,LOM,30-39,1,4,0,3,2,0,0,5,0,5,Lombardia,ITC4
2021-01-12,PF/BT,327001818,R.S.A. VILLA MADDALENA,LOM,40-49,0,5,0,3,2,0,0,5,0,5,Lombardia,ITC4
2021-01-12,PF/BT,327001818,R.S.A. VILLA MADDALENA,LOM,50-59,0,5,0,3,2,0,0,5,0,5,Lombardia,ITC4
2021-01-12,PF/BT,327001818,R.S.A. VILLA MADDALENA,LOM,70-79,1,1,0,1,0,1,0,2,0,2,Lombardia,ITC4
2021-01-12,PF/BT,327001818,R.S.A. VILLA MADDALENA,LOM,80-89,3,1,0,0,0,4,0,4,0,4,Lombardia,ITC4
2021-01-12,PF/BT,327001818,R.S.A. VILLA MADDALENA,LOM,90+,2,5,0,0,0,7,0,7,0,7,Lombardia,ITC4
2021-01-12,PF/BT,327001960,RSA VILLA CARPANEDA,LOM,20-29,1,2,0,3,0,0,0,3,0,3,Lombardia,ITC4
2021-01-12,PF/BT,327001960,RSA VILLA CARPANEDA,LOM,30-39,2,0,0,2,0,0,0,2,0,2,Lombardia,ITC4
2021-01-12,PF/BT,327001960,RSA VILLA CARPANEDA,LOM,40-49,0,6,0,6,0,0,0,6,0,6,Lombardia,ITC4
2021-01-12,PF/BT,327001960,RSA VILLA CARPANEDA,LOM,50-59,1,9,0,8,2,0,0,10,0,10,Lombardia,ITC4
2021-01-12,PF/BT,327001960,RSA VILLA CARPANEDA,LOM,60-69,0,2,0,2,0,0,0,2,0,2,Lombardia,ITC4
2021-01-12,PF/BT,327003606,RSA RODIGO,LOM,20-29,0,1,0,1,0,0,0,1,0,1,Lombardia,ITC4
2021-01-12,PF/BT,327003606,RSA RODIGO,LOM,30-39,3,2,0,5,0,0,0,5,0,5,Lombardia,ITC4
2021-01-12,PF/BT,327003606,RSA RODIGO,LOM,40-49,1,2,0,3,0,0,0,3,0,3,Lombardia,ITC4
2021-01-12,PF/BT,327003606,RSA RODIGO,LOM,50-59,0,7,0,5,2,0,0,7,0,7,Lombardia,ITC4
2021-01-12,PF/BT,327003606,RSA RODIGO,LOM,60-69,0,3,0,1,1,1,0,3,0,3,Lombardia,ITC4
2021-01-12,PF/BT,327003606,RSA RODIGO,LOM,70-79,3,2,0,0,0,5,0,5,0,5,Lombardia,ITC4
2021-01-12,PF/BT,327003606,RSA RODIGO,LOM,80-89,3,12,0,0,0,15,0,15,0,15,Lombardia,ITC4
2021-01-12,PF/BT,327003606,RSA RODIGO,LOM,90+,1,9,0,0,0,10,0,10,0,10,Lombardia,ITC4
2021-01-12,PF/BT,327004847,RESIDENZA SANITARIA ASSISTENZIALE MORANDO,LOM,20-29,0,1,0,1,0,0,0,1,0,1,Lombardia,ITC4
2021-01-12,PF/BT,327004847,RESIDENZA SANITARIA ASSISTENZIALE MORANDO,LOM,30-39,3,6,0,8,1,0,0,9,0,9,Lombardia,ITC4
2021-01-12,PF/BT,327004847,RESIDENZA SANITARIA ASSISTENZIALE MORANDO,LOM,40-49,2,3,0,4,1,0,0,5,0,5,Lombardia,ITC4
2021-01-12,PF/BT,327004847,RESIDENZA SANITARIA ASSISTENZIALE MORANDO,LOM,50-59,0,4,0,3,1,0,0,4,0,4,Lombardia,ITC4
2021-01-12,PF/BT,327004847,RESIDENZA SANITARIA ASSISTENZIALE MORANDO,LOM,60-69,2,2,0,2,1,1,0,4,0,4,Lombardia,ITC4
2021-01-12,PF/BT,327004847,RESIDENZA SANITARIA ASSISTENZIALE MORANDO,LOM,70-79,1,1,0,0,0,2,0,2,0,2,Lombardia,ITC4
2021-01-12,PF/BT,327004847,RESIDENZA SANITARIA ASSISTENZIALE MORANDO,LOM,80-89,0,10,0,0,0,10,0,10,0,10,Lombardia,ITC4
2021-01-12,PF/BT,327004847,RESIDENZA SANITARIA ASSISTENZIALE MORANDO,LOM,90+,0,7,0,0,0,7,0,7,0,7,Lombardia,ITC4
2021-01-12,PF/BT,347,Fondazione San Giuseppe Moscati,LOM,30-39,0,1,0,1,0,0,0,1,0,1,Lombardia,ITC4
2021-01-12,PF/BT,347,Fondazione San Giuseppe Moscati,LOM,50-59,1,1,0,2,0,0,0,2,0,2,Lombardia,ITC4
2021-01-12,PF/BT,347,Fondazione San Giuseppe Moscati,LOM,60-69,1,1,0,0,0,2,0,2,0,2,Lombardia,ITC4
2021-01-12,PF/BT,347,Fondazione San Giuseppe Moscati,LOM,70-79,3,1,0,0,0,4,0,4,0,4,Lombardia,ITC4
2021-01-12,PF/BT,347,Fondazione San Giuseppe Moscati,LOM,80-89,4,7,0,0,0,11,0,11,0,11,Lombardia,ITC4
2021-01-12,PF/BT,347,Fondazione San Giuseppe Moscati,LOM,90+,12,4,0,0,0,16,0,16,0,16,Lombardia,ITC4
2021-01-12,PF/BT,3611,RSD L 'ABBRACCIO,LOM,20-29,0,2,0,2,0,0,0,2,0,2,Lombardia,ITC4
2021-01-12,PF/BT,3611,RSD L 'ABBRACCIO,LOM,40-49,1,7,0,7,1,0,0,8,0,8,Lombardia,ITC4
2021-01-12,PF/BT,3611,RSD L 'ABBRACCIO,LOM,50-59,1,1,0,1,1,0,0,2,0,2,Lombardia,ITC4
2021-01-12,PF/BT,558,RSA PIO ALBERGO TRIVULZIO,LOM,20-29,4,6,0,8,2,0,0,10,0,10,Lombardia,ITC4
2021-01-12,PF/BT,558,RSA PIO ALBERGO TRIVULZIO,LOM,30-39,3,2,0,1,4,0,0,5,0,5,Lombardia,ITC4
2021-01-12,PF/BT,558,RSA PIO ALBERGO TRIVULZIO,LOM,40-49,3,10,0,5,8,0,0,13,0,13,Lombardia,ITC4
2021-01-12,PF/BT,558,RSA PIO ALBERGO TRIVULZIO,LOM,50-59,3,18,0,8,13,0,0,21,0,21,Lombardia,ITC4
2021-01-12,PF/BT,558,RSA PIO ALBERGO TRIVULZIO,LOM,60-69,2,3,0,2,3,0,0,5,0,5,Lombardia,ITC4
2021-01-12,PF/BT,690548,RSA Fondazione Lucini-Cantù Onlus,LOM,30-39,1,1,0,2,0,0,0,2,0,2,Lombardia,ITC4
2021-01-12,PF/BT,690548,RSA Fondazione Lucini-Cantù Onlus,LOM,40-49,0,2,0,1,1,0,0,2,0,2,Lombardia,ITC4
2021-01-12,PF/BT,690548,RSA Fondazione Lucini-Cantù Onlus,LOM,60-69,0,1,0,0,0,1,0,1,0,1,Lombardia,ITC4
2021-01-12,PF/BT,690548,RSA Fondazione Lucini-Cantù Onlus,LOM,80-89,3,2,0,0,0,5,0,5,0,5,Lombardia,ITC4
2021-01-12,PF/BT,690548,RSA Fondazione Lucini-Cantù Onlus,LOM,90+,2,0,0,0,0,2,0,2,0,2,Lombardia,ITC4
2021-01-12,PF/BT,697,CASA RIPOSO F.LLI MOLINA P.E.T,LOM,20-29,1,6,0,4,3,0,0,7,0,7,Lombardia,ITC4
2021-01-12,PF/BT,697,CASA RIPOSO F.LLI MOLINA P.E.T,LOM,30-39,2,2,0,3,1,0,0,4,0,4,Lombardia,ITC4
2021-01-12,PF/BT,697,CASA RIPOSO F.LLI MOLINA P.E.T,LOM,40-49,2,7,0,8,1,0,0,9,0,9,Lombardia,ITC4
2021-01-12,PF/BT,697,CASA RIPOSO F.LLI MOLINA P.E.T,LOM,50-59,5,16,0,14,7,0,0,21,0,21,Lombardia,ITC4
2021-01-12,PF/BT,697,CASA RIPOSO F.LLI MOLINA P.E.T,LOM,60-69,2,5,0,6,1,0,0,7,0,7,Lombardia,ITC4
2021-01-12,PF/BT,748,"Fondazione Casa Famiglia ""Madonna dei Miracoli"" onlus",LOM,80-89,0,4,0,0,0,4,0,4,0,4,Lombardia,ITC4
2021-01-12,PF/BT,748,"Fondazione Casa Famiglia ""Madonna dei Miracoli"" onlus",LOM,90+,1,7,0,0,0,8,0,8,0,8,Lombardia,ITC4
2021-01-12,PF/BT,906,FONDAZIONE ONLUS NINJ BECCAGUTTI,LOM,20-29,0,3,0,2,1,0,0,3,0,3,Lombardia,ITC4
2021-01-12,PF/BT,906,FONDAZIONE ONLUS NINJ BECCAGUTTI,LOM,30-39,0,4,0,3,1,0,0,4,0,4,Lombardia,ITC4
2021-01-12,PF/BT,906,FONDAZIONE ONLUS NINJ BECCAGUTTI,LOM,40-49,0,12,0,9,3,0,0,12,0,12,Lombardia,ITC4
2021-01-12,PF/BT,906,FONDAZIONE ONLUS NINJ BECCAGUTTI,LOM,50-59,1,10,0,7,3,0,1,11,0,11,Lombardia,ITC4
2021-01-12,PF/BT,906,FONDAZIONE ONLUS NINJ BECCAGUTTI,LOM,60-69,1,3,0,2,0,0,2,4,0,4,Lombardia,ITC4
2021-01-12,PF/BT,906,FONDAZIONE ONLUS NINJ BECCAGUTTI,LOM,70-79,1,0,0,0,0,0,1,1,0,1,Lombardia,ITC4
2021-01-12,PF/BT,906,FONDAZIONE ONLUS NINJ BECCAGUTTI,LOM,80-89,0,1,0,0,0,1,0,1,0,1,Lombardia,ITC4
2021-01-12,PF/BT,913,RSA BELLAVISTA SONDALO,LOM,60-69,2,0,0,0,0,2,0,2,0,2,Lombardia,ITC4
2021-01-12,PF/BT,913,RSA BELLAVISTA SONDALO,LOM,70-79,3,2,0,0,0,5,0,5,0,5,Lombardia,ITC4
2021-01-12,PF/BT,913,RSA BELLAVISTA SONDALO,LOM,80-89,1,6,0,0,0,7,0,7,0,7,Lombardia,ITC4
2021-01-12,PF/BT,913,RSA BELLAVISTA SONDALO,LOM,90+,2,8,0,0,0,10,0,10,0,10,Lombardia,ITC4
2021-01-12,PF/BT,947,I.R.C.C.S. POLICLINICO SAN DONATO,LOM,20-29,8,15,0,19,4,0,0,23,0,23,Lombardia,ITC4
2021-01-12,PF/BT,947,I.R.C.C.S. POLICLINICO SAN DONATO,LOM,30-39,23,21,0,37,7,0,0,44,0,44,Lombardia,ITC4
2021-01-12,PF/BT,947,I.R.C.C.S. POLICLINICO SAN DONATO,LOM,40-49,19,20,0,27,12,0,0,39,0,39,Lombardia,ITC4
2021-01-12,PF/BT,947,I.R.C.C.S. POLICLINICO SAN DONATO,LOM,50-59,17,20,0,22,15,0,0,37,0,37,Lombardia,ITC4
2021-01-12,PF/BT,947,I.R.C.C.S. POLICLINICO SAN DONATO,LOM,60-69,6,7,0,10,3,0,0,13,0,13,Lombardia,ITC4
2021-01-12,PF/BT,951,CASA DI RIPOSO CITTA' DI CHIAVENNA,LOM,20-29,0,2,0,2,0,0,0,2,0,2,Lombardia,ITC4
2021-01-12,PF/BT,951,CASA DI RIPOSO CITTA' DI CHIAVENNA,LOM,30-39,0,3,0,3,0,0,0,3,0,3,Lombardia,ITC4
2021-01-12,PF/BT,951,CASA DI RIPOSO CITTA' DI CHIAVENNA,LOM,40-49,1,4,0,5,0,0,0,5,0,5,Lombardia,ITC4
2021-01-12,PF/BT,951,CASA DI RIPOSO CITTA' DI CHIAVENNA,LOM,50-59,1,7,0,8,0,0,0,8,0,8,Lombardia,ITC4
2021-01-12,PF/BT,951,CASA DI RIPOSO CITTA' DI CHIAVENNA,LOM,60-69,1,3,0,3,0,1,0,4,0,4,Lombardia,ITC4
2021-01-12,PF/BT,951,CASA DI RIPOSO CITTA' DI CHIAVENNA,LOM,70-79,3,4,0,0,0,7,0,7,0,7,Lombardia,ITC4
2021-01-12,PF/BT,951,CASA DI RIPOSO CITTA' DI CHIAVENNA,LOM,80-89,1,9,0,0,0,10,0,10,0,10,Lombardia,ITC4
2021-01-12,PF/BT,951,CASA DI RIPOSO CITTA' DI CHIAVENNA,LOM,90+,1,8,0,0,0,9,0,9,0,9,Lombardia,ITC4
2021-01-12,PF/BT,953,Fondazione Casa di Riposo Bongioni-Lambertenghi Onlus,LOM,70-79,1,0,0,0,0,1,0,1,0,1,Lombardia,ITC4
2021-01-12,PF/BT,953,Fondazione Casa di Riposo Bongioni-Lambertenghi Onlus,LOM,80-89,0,3,0,0,0,3,0,3,0,3,Lombardia,ITC4
2021-01-12,PF/BT,953,Fondazione Casa di Riposo Bongioni-Lambertenghi Onlus,LOM,90+,1,1,0,0,0,2,0,2,0,2,Lombardia,ITC4
2021-01-12,PF/BT,980,CASA MADONNA DEL LAVORO,LOM,20-29,0,1,0,1,0,0,0,1,0,1,Lombardia,ITC4
2021-01-12,PF/BT,980,CASA MADONNA DEL LAVORO,LOM,30-39,2,2,0,2,0,2,0,4,0,4,Lombardia,ITC4
2021-01-12,PF/BT,980,CASA MADONNA DEL LAVORO,LOM,40-49,0,4,0,4,0,0,0,4,0,4,Lombardia,ITC4
2021-01-12,PF/BT,980,CASA MADONNA DEL LAVORO,LOM,50-59,4,5,0,5,2,2,0,9,0,9,Lombardia,ITC4
2021-01-12,PF/BT,980,CASA MADONNA DEL LAVORO,LOM,60-69,4,2,0,1,0,5,0,6,0,6,Lombardia,ITC4
2021-01-12,PF/BT,980,CASA MADONNA DEL LAVORO,LOM,70-79,3,5,0,0,0,8,0,8,0,8,Lombardia,ITC4
2021-01-12,PF/BT,980,CASA MADONNA DEL LAVORO,LOM,80-89,7,14,0,0,0,21,0,21,0,21,Lombardia,ITC4
2021-01-12,PF/BT,980,CASA MADONNA DEL LAVORO,LOM,90+,10,9,0,0,0,19,0,19,0,19,Lombardia,ITC4
2021-01-12,PF/BT,Cudes 001064,"RSA VILLA SAN CLEMENTE via Garibaldi 77 - 20852, Villasanta (MB)",LOM,60-69,1,0,0,0,0,1,0,1,0,1,Lombardia,ITC4
2021-01-12,PF/BT,Cudes 001064,"RSA VILLA SAN CLEMENTE via Garibaldi 77 - 20852, Villasanta (MB)",LOM,70-79,2,1,0,0,0,3,0,3,0,3,Lombardia,ITC4
2021-01-12,PF/BT,Cudes 001064,"RSA VILLA SAN CLEMENTE via Garibaldi 77 - 20852, Villasanta (MB)",LOM,80-89,11,18,0,0,0,29,0,29,0,29,Lombardia,ITC4
2021-01-12,PF/BT,Cudes 001064,"RSA VILLA SAN CLEMENTE via Garibaldi 77 - 20852, Villasanta (MB)",LOM,90+,4,17,0,0,0,21,0,21,0,21,Lombardia,ITC4
2021-01-12,PF/BT,CUDES 321000261,FONDAZIONE CASTELLINI ONLUS MELEGNANO,LOM,20-29,1,3,0,4,0,0,0,4,0,4,Lombardia,ITC4
2021-01-12,PF/BT,CUDES 321000261,FONDAZIONE CASTELLINI ONLUS MELEGNANO,LOM,30-39,0,2,0,2,0,0,0,2,0,2,Lombardia,ITC4
2021-01-12,PF/BT,CUDES 321000261,FONDAZIONE CASTELLINI ONLUS MELEGNANO,LOM,40-49,0,5,0,5,0,0,0,5,0,5,Lombardia,ITC4
2021-01-12,PF/BT,CUDES 321000261,FONDAZIONE CASTELLINI ONLUS MELEGNANO,LOM,50-59,0,13,0,12,0,1,0,13,0,13,Lombardia,ITC4
2021-01-12,PF/BT,CUDES 321000261,FONDAZIONE CASTELLINI ONLUS MELEGNANO,LOM,60-69,1,6,0,6,0,1,0,7,0,7,Lombardia,ITC4
2021-01-12,PF/BT,CUDES 321000261,FONDAZIONE CASTELLINI ONLUS MELEGNANO,LOM,70-79,1,0,0,0,0,1,0,1,0,1,Lombardia,ITC4
2021-01-12,PF/BT,CUDES 321000261,FONDAZIONE CASTELLINI ONLUS MELEGNANO,LOM,80-89,1,16,0,0,0,17,0,17,0,17,Lombardia,ITC4
2021-01-12,PF/BT,CUDES 321000261,FONDAZIONE CASTELLINI ONLUS MELEGNANO,LOM,90+,1,10,0,0,0,11,0,11,0,11,Lombardia,ITC4
2021-01-12,PF/BT,HSP11-11 bis,Policlinico San Pietro,LOM,20-29,2,7,0,8,1,0,0,9,0,9,Lombardia,ITC4
2021-01-12,PF/BT,HSP11-11 bis,Policlinico San Pietro,LOM,30-39,4,8,0,12,0,0,0,12,0,12,Lombardia,ITC4
2021-01-12,PF/BT,HSP11-11 bis,Policlinico San Pietro,LOM,40-49,4,9,0,13,0,0,0,13,0,13,Lombardia,ITC4
2021-01-12,PF/BT,HSP11-11 bis,Policlinico San Pietro,LOM,50-59,2,15,0,16,1,0,0,17,0,17,Lombardia,ITC4
2021-01-12,PF/BT,HSP11-11 bis,Policlinico San Pietro,LOM,60-69,10,2,0,12,0,0,0,12,0,12,Lombardia,ITC4
2021-01-12,PF/BT,HSP11-11 bis,Policlinico San Pietro,LOM,70-79,3,0,0,3,0,0,0,3,0,3,Lombardia,ITC4
2021-01-12,PF/BT,HSP11-11bis,32170223 HUB COVID SS PAOLO E CARLO - PVO Ospedale San Paolo,LOM,20-29,14,33,0,41,5,0,1,47,0,47,Lombardia,ITC4
2021-01-12,PF/BT,HSP11-11bis,32170223 HUB COVID SS PAOLO E CARLO - PVO Ospedale San Paolo,LOM,30-39,23,34,0,46,11,0,0,57,0,57,Lombardia,ITC4
2021-01-12,PF/BT,HSP11-11bis,32170223 HUB COVID SS PAOLO E CARLO - PVO Ospedale San Paolo,LOM,40-49,16,56,0,64,7,0,1,72,0,72,Lombardia,ITC4
2021-01-12,PF/BT,HSP11-11bis,32170223 HUB COVID SS PAOLO E CARLO - PVO Ospedale San Paolo,LOM,50-59,30,63,0,71,21,0,1,93,0,93,Lombardia,ITC4
2021-01-12,PF/BT,HSP11-11bis,32170223 HUB COVID SS PAOLO E CARLO - PVO Ospedale San Paolo,LOM,60-69,18,22,0,27,12,0,1,40,0,40,Lombardia,ITC4
2021-01-12,PF/BT,HSP11-11bis,32170223 HUB COVID SS PAOLO E CARLO - PVO Ospedale San Paolo,LOM,70-79,3,0,0,2,1,0,0,3,0,3,Lombardia,ITC4
2021-01-12,PF/BT,HSP11-11bis,32170224 HUB COVID OSP. SAN CARLO - PVO Ospedale San Carlo,LOM,20-29,16,17,0,22,6,0,5,33,0,33,Lombardia,ITC4
2021-01-12,PF/BT,HSP11-11bis,32170224 HUB COVID OSP. SAN CARLO - PVO Ospedale San Carlo,LOM,30-39,14,33,0,41,3,0,3,47,0,47,Lombardia,ITC4
2021-01-12,PF/BT,HSP11-11bis,32170224 HUB COVID OSP. SAN CARLO - PVO Ospedale San Carlo,LOM,40-49,15,58,0,54,14,0,5,73,0,73,Lombardia,ITC4
2021-01-12,PF/BT,HSP11-11bis,32170224 HUB COVID OSP. SAN CARLO - PVO Ospedale San Carlo,LOM,50-59,35,66,0,61,37,0,3,101,0,101,Lombardia,ITC4
2021-01-12,PF/BT,HSP11-11bis,32170224 HUB COVID OSP. SAN CARLO - PVO Ospedale San Carlo,LOM,60-69,21,21,0,35,5,0,2,42,0,42,Lombardia,ITC4
2021-01-12,PF/BT,HSP11-11bis,32170224 HUB COVID OSP. SAN CARLO - PVO Ospedale San Carlo,LOM,70-79,2,2,0,1,1,0,2,4,0,4,Lombardia,ITC4
2021-01-12,PF/BT,HSP11-11bis,Ambulatorio COVID PO Codogno,LOM,20-29,1,4,0,5,0,0,0,5,0,5,Lombardia,ITC4
2021-01-12,PF/BT,HSP11-11bis,Ambulatorio COVID PO Codogno,LOM,30-39,3,7,0,6,4,0,0,10,0,10,Lombardia,ITC4
2021-01-12,PF/BT,HSP11-11bis,Ambulatorio COVID PO Codogno,LOM,40-49,3,24,0,17,10,0,0,27,0,27,Lombardia,ITC4
2021-01-12,PF/BT,HSP11-11bis,Ambulatorio COVID PO Codogno,LOM,50-59,9,15,0,18,6,0,0,24,0,24,Lombardia,ITC4
2021-01-12,PF/BT,HSP11-11bis,Ambulatorio COVID PO Codogno,LOM,60-69,3,3,0,3,3,0,0,6,0,6,Lombardia,ITC4
2021-01-12,PF/BT,HSP11-11bis,Ambulatorio COVID PO LODI,LOM,20-29,7,30,0,32,5,0,0,37,0,37,Lombardia,ITC4
2021-01-12,PF/BT,HSP11-11bis,Ambulatorio COVID PO LODI,LOM,30-39,14,32,0,27,19,0,0,46,0,46,Lombardia,ITC4
2021-01-12,PF/BT,HSP11-11bis,Ambulatorio COVID PO LODI,LOM,40-49,17,50,0,46,21,0,0,67,0,67,Lombardia,ITC4
2021-01-12,PF/BT,HSP11-11bis,Ambulatorio COVID PO LODI,LOM,50-59,16,47,0,35,28,0,0,63,0,63,Lombardia,ITC4
2021-01-12,PF/BT,HSP11-11bis,Ambulatorio COVID PO LODI,LOM,60-69,16,9,0,11,14,0,0,25,0,25,Lombardia,ITC4
2021-01-12,PF/BT,HSP11-11bis,Ambulatorio COVID PO LODI,LOM,70-79,1,0,0,1,0,0,0,1,0,1,Lombardia,ITC4
2021-01-12,PF/BT,HSP11-11bis,Ambulatorio COVID PO S.Angelo Lod.,LOM,20-29,2,2,0,3,1,0,0,4,0,4,Lombardia,ITC4
2021-01-12,PF/BT,HSP11-11bis,Ambulatorio COVID PO S.Angelo Lod.,LOM,30-39,1,1,0,0,2,0,0,2,0,2,Lombardia,ITC4
2021-01-12,PF/BT,HSP11-11bis,Ambulatorio COVID PO S.Angelo Lod.,LOM,40-49,2,4,0,4,2,0,0,6,0,6,Lombardia,ITC4
2021-01-12,PF/BT,HSP11-11bis,Ambulatorio COVID PO S.Angelo Lod.,LOM,50-59,1,3,0,2,2,0,0,4,0,4,Lombardia,ITC4
2021-01-12,PF/BT,HSP11-11bis,Ambulatorio COVID PO S.Angelo Lod.,LOM,60-69,2,0,0,2,0,0,0,2,0,2,Lombardia,ITC4
2021-01-12,PF/BT,HSP11-11bis,AMBULATORIO COVID PO SACCO,LOM,20-29,30,56,0,56,11,0,19,86,0,86,Lombardia,ITC4
2021-01-12,PF/BT,HSP11-11bis,AMBULATORIO COVID PO SACCO,LOM,30-39,45,66,0,85,18,0,8,111,0,111,Lombardia,ITC4
2021-01-12,PF/BT,HSP11-11bis,AMBULATORIO COVID PO SACCO,LOM,40-49,44,80,0,91,20,0,13,124,0,124,Lombardia,ITC4
2021-01-12,PF/BT,HSP11-11bis,AMBULATORIO COVID PO SACCO,LOM,50-59,48,139,0,123,55,0,9,187,0,187,Lombardia,ITC4
2021-01-12,PF/BT,HSP11-11bis,AMBULATORIO COVID PO SACCO,LOM,60-69,38,58,0,68,21,0,7,96,0,96,Lombardia,ITC4
2021-01-12,PF/BT,HSP11-11bis,AMBULATORIO COVID PO SACCO,LOM,70-79,10,0,0,5,0,0,5,10,0,10,Lombardia,ITC4
2021-01-12,PF/BT,HSP11-11bis,AMBULATORIO COVID PO SACCO,LOM,80-89,1,0,0,0,0,0,1,1,0,1,Lombardia,ITC4
2021-01-12,PF/BT,HSP11-11bis,ASST BERGAMO OVEST - OSPEDALE ROMANO DI L.DIA,LOM,16-19,1,1,0,0,0,0,2,2,0,2,Lombardia,ITC4
2021-01-12,PF/BT,HSP11-11bis,ASST BERGAMO OVEST - OSPEDALE ROMANO DI L.DIA,LOM,20-29,6,14,0,0,2,0,18,20,0,20,Lombardia,ITC4
2021-01-12,PF/BT,HSP11-11bis,ASST BERGAMO OVEST - OSPEDALE ROMANO DI L.DIA,LOM,30-39,15,20,0,7,3,0,25,35,0,35,Lombardia,ITC4
2021-01-12,PF/BT,HSP11-11bis,ASST BERGAMO OVEST - OSPEDALE ROMANO DI L.DIA,LOM,40-49,20,26,0,9,2,0,35,46,0,46,Lombardia,ITC4
2021-01-12,PF/BT,HSP11-11bis,ASST BERGAMO OVEST - OSPEDALE ROMANO DI L.DIA,LOM,50-59,16,18,0,4,1,0,29,34,0,34,Lombardia,ITC4
2021-01-12,PF/BT,HSP11-11bis,ASST BERGAMO OVEST - OSPEDALE ROMANO DI L.DIA,LOM,60-69,28,22,0,2,1,0,47,50,0,50,Lombardia,ITC4
2021-01-12,PF/BT,HSP11-11bis,ASST BERGAMO OVEST - OSPEDALE ROMANO DI L.DIA,LOM,70-79,15,8,0,0,0,0,23,23,0,23,Lombardia,ITC4
2021-01-12,PF/BT,HSP11-11bis,ASST BERGAMO OVEST - OSPEDALE TREVIGLIO,LOM,20-29,3,10,0,8,0,0,5,13,0,13,Lombardia,ITC4
2021-01-12,PF/BT,HSP11-11bis,ASST BERGAMO OVEST - OSPEDALE TREVIGLIO,LOM,30-39,10,18,0,18,4,0,6,28,0,28,Lombardia,ITC4
2021-01-12,PF/BT,HSP11-11bis,ASST BERGAMO OVEST - OSPEDALE TREVIGLIO,LOM,40-49,13,38,0,31,7,0,13,51,0,51,Lombardia,ITC4
2021-01-12,PF/BT,HSP11-11bis,ASST BERGAMO OVEST - OSPEDALE TREVIGLIO,LOM,50-59,10,70,0,43,26,0,11,80,0,80,Lombardia,ITC4
2021-01-12,PF/BT,HSP11-11bis,ASST BERGAMO OVEST - OSPEDALE TREVIGLIO,LOM,60-69,5,13,0,7,5,0,6,18,0,18,Lombardia,ITC4
2021-01-12,PF/BT,HSP11-11bis,ASST BERGAMO OVEST - OSPEDALE TREVIGLIO,LOM,70-79,1,1,0,0,0,0,2,2,0,2,Lombardia,ITC4
2021-01-12,PF/BT,HSP11-11bis,ICS Maugeri- Istituto Scientifico di Montescano (Pv),LOM,20-29,1,4,0,5,0,0,0,5,0,5,Lombardia,ITC4
2021-01-12,PF/BT,HSP11-11bis,ICS Maugeri- Istituto Scientifico di Montescano (Pv),LOM,30-39,0,3,0,3,0,0,0,3,0,3,Lombardia,ITC4
2021-01-12,PF/BT,HSP11-11bis,ICS Maugeri- Istituto Scientifico di Montescano (Pv),LOM,40-49,5,5,0,6,4,0,0,10,0,10,Lombardia,ITC4
2021-01-12,PF/BT,HSP11-11bis,ICS Maugeri- Istituto Scientifico di Montescano (Pv),LOM,50-59,6,19,0,20,5,0,0,25,0,25,Lombardia,ITC4
2021-01-12,PF/BT,HSP11-11bis,ICS Maugeri- Istituto Scientifico di Montescano (Pv),LOM,60-69,3,7,0,9,1,0,0,10,0,10,Lombardia,ITC4
2021-01-12,PF/BT,HSP11-11bis,"Policlinico San Marco, Osio Sotto (BG)",LOM,20-29,3,10,0,13,0,0,0,13,0,13,Lombardia,ITC4
2021-01-12,PF/BT,HSP11-11bis,"Policlinico San Marco, Osio Sotto (BG)",LOM,30-39,6,7,0,13,0,0,0,13,0,13,Lombardia,ITC4
2021-01-12,PF/BT,HSP11-11bis,"Policlinico San Marco, Osio Sotto (BG)",LOM,40-49,10,14,0,24,0,0,0,24,0,24,Lombardia,ITC4
2021-01-12,PF/BT,HSP11-11bis,"Policlinico San Marco, Osio Sotto (BG)",LOM,50-59,7,13,0,20,0,0,0,20,0,20,Lombardia,ITC4
2021-01-12,PF/BT,HSP11-11bis,"Policlinico San Marco, Osio Sotto (BG)",LOM,60-69,11,1,0,12,0,0,0,12,0,12,Lombardia,ITC4
2021-01-12,PF/BT,HSP11-11bis,"Policlinico San Marco, Osio Sotto (BG)",LOM,70-79,1,0,0,1,0,0,0,1,0,1,Lombardia,ITC4
2021-01-12,PF/BT,HSP11-11bis,"Policlinico San Marco, Osio Sotto (BG)",LOM,80-89,1,0,0,1,0,0,0,1,0,1,Lombardia,ITC4
2021-01-12,PF/BT,HSP11-11BIS-03010600,CASA DI CURA POLICLINICO DI MONZA-MONZA-,LOM,20-29,8,20,0,26,2,0,0,28,0,28,Lombardia,ITC4
2021-01-12,PF/BT,HSP11-11BIS-03010600,CASA DI CURA POLICLINICO DI MONZA-MONZA-,LOM,30-39,12,19,0,24,7,0,0,31,0,31,Lombardia,ITC4
2021-01-12,PF/BT,HSP11-11BIS-03010600,CASA DI CURA POLICLINICO DI MONZA-MONZA-,LOM,40-49,14,40,0,47,7,0,0,54,0,54,Lombardia,ITC4
2021-01-12,PF/BT,HSP11-11BIS-03010600,CASA DI CURA POLICLINICO DI MONZA-MONZA-,LOM,50-59,10,32,0,29,13,0,0,42,0,42,Lombardia,ITC4
2021-01-12,PF/BT,HSP11-11BIS-03010600,CASA DI CURA POLICLINICO DI MONZA-MONZA-,LOM,60-69,5,8,0,9,4,0,0,13,0,13,Lombardia,ITC4
2021-01-12,PF/BT,S09, PII ISTITUTI UNIFICATI ONLUS,LOM,20-29,1,2,0,2,0,1,0,3,0,3,Lombardia,ITC4
2021-01-12,PF/BT,S09, PII ISTITUTI UNIFICATI ONLUS,LOM,30-39,4,5,0,9,0,0,0,9,0,9,Lombardia,ITC4
2021-01-12,PF/BT,S09, PII ISTITUTI UNIFICATI ONLUS,LOM,40-49,4,13,0,16,0,0,1,17,0,17,Lombardia,ITC4
2021-01-12,PF/BT,S09, PII ISTITUTI UNIFICATI ONLUS,LOM,50-59,0,17,0,16,0,0,1,17,0,17,Lombardia,ITC4
2021-01-12,PF/BT,S09, PII ISTITUTI UNIFICATI ONLUS,LOM,60-69,0,2,0,2,0,0,0,2,0,2,Lombardia,ITC4
2021-01-12,PF/BT,STS11,FONDAZIONE POMPEO E CESARE MAZZOCCHI  ONLUS - COCCAGLIO,LOM,20-29,1,0,0,1,0,0,0,1,0,1,Lombardia,ITC4
2021-01-12,PF/BT,STS11,FONDAZIONE POMPEO E CESARE MAZZOCCHI  ONLUS - COCCAGLIO,LOM,30-39,0,2,0,2,0,0,0,2,0,2,Lombardia,ITC4
2021-01-12,PF/BT,STS11,FONDAZIONE POMPEO E CESARE MAZZOCCHI  ONLUS - COCCAGLIO,LOM,40-49,0,4,0,4,0,0,0,4,0,4,Lombardia,ITC4
2021-01-12,PF/BT,STS11,FONDAZIONE POMPEO E CESARE MAZZOCCHI  ONLUS - COCCAGLIO,LOM,50-59,0,4,0,4,0,0,0,4,0,4,Lombardia,ITC4
2021-01-12,PF/BT,STS11,FONDAZIONE POMPEO E CESARE MAZZOCCHI  ONLUS - COCCAGLIO,LOM,60-69,0,1,0,1,0,0,0,1,0,1,Lombardia,ITC4
2021-01-12,PF/BT,STS11,RSA - FOND.CASA DI SOGGIORNO PER ANZIANI,LOM,20-29,1,0,0,1,0,0,0,1,0,1,Lombardia,ITC4
2021-01-12,PF/BT,STS11,RSA - FOND.CASA DI SOGGIORNO PER ANZIANI,LOM,40-49,0,6,0,3,1,0,2,6,0,6,Lombardia,ITC4
2021-01-12,PF/BT,STS11,RSA - FOND.CASA DI SOGGIORNO PER ANZIANI,LOM,50-59,3,7,0,7,1,2,0,10,0,10,Lombardia,ITC4
2021-01-12,PF/BT,STS11,RSA - FOND.CASA DI SOGGIORNO PER ANZIANI,LOM,60-69,0,4,0,2,1,1,0,4,0,4,Lombardia,ITC4
2021-01-12,PF/BT,STS11,RSA - FOND.CASA DI SOGGIORNO PER ANZIANI,LOM,70-79,3,2,0,0,0,5,0,5,0,5,Lombardia,ITC4
2021-01-12,PF/BT,STS11,RSA - FOND.CASA DI SOGGIORNO PER ANZIANI,LOM,80-89,3,5,0,0,0,8,0,8,0,8,Lombardia,ITC4
2021-01-12,PF/BT,STS11,RSA - FOND.CASA DI SOGGIORNO PER ANZIANI,LOM,90+,2,6,0,0,0,8,0,8,0,8,Lombardia,ITC4
2021-01-12,PF/BT,STS11,RSA  FONDAZIONE ANNI SERENI TREVIGLIO CARAVAGGI E FARA GA ONLUS,LOM,60-69,1,2,0,0,0,3,0,3,0,3,Lombardia,ITC4
2021-01-12,PF/BT,STS11,RSA  FONDAZIONE ANNI SERENI TREVIGLIO CARAVAGGI E FARA GA ONLUS,LOM,70-79,3,5,0,0,0,8,0,8,0,8,Lombardia,ITC4
2021-01-12,PF/BT,STS11,RSA  FONDAZIONE ANNI SERENI TREVIGLIO CARAVAGGI E FARA GA ONLUS,LOM,80-89,3,14,0,0,0,17,0,17,0,17,Lombardia,ITC4
2021-01-12,PF/BT,STS11,RSA  FONDAZIONE ANNI SERENI TREVIGLIO CARAVAGGI E FARA GA ONLUS,LOM,90+,2,18,0,0,0,20,0,20,0,20,Lombardia,ITC4
2021-01-12,PF/BT,STS11,"RSA ""BEATO INNOCENZO""",LOM,20-29,0,1,0,1,0,0,0,1,0,1,Lombardia,ITC4
2021-01-12,PF/BT,STS11,"RSA ""BEATO INNOCENZO""",LOM,30-39,0,2,0,1,1,0,0,2,0,2,Lombardia,ITC4
2021-01-12,PF/BT,STS11,"RSA ""BEATO INNOCENZO""",LOM,40-49,0,10,0,8,2,0,0,10,0,10,Lombardia,ITC4
2021-01-12,PF/BT,STS11,"RSA ""BEATO INNOCENZO""",LOM,50-59,1,4,0,2,2,1,0,5,0,5,Lombardia,ITC4
2021-01-12,PF/BT,STS11,"RSA ""BEATO INNOCENZO""",LOM,60-69,1,1,0,0,0,2,0,2,0,2,Lombardia,ITC4
2021-01-12,PF/BT,STS11,"RSA ""BEATO INNOCENZO""",LOM,70-79,2,2,0,0,0,4,0,4,0,4,Lombardia,ITC4
2021-01-12,PF/BT,STS11,"RSA ""BEATO INNOCENZO""",LOM,80-89,3,5,0,0,0,8,0,8,0,8,Lombardia,ITC4
2021-01-12,PF/BT,STS11,"RSA ""BEATO INNOCENZO""",LOM,90+,0,4,0,0,0,4,0,4,0,4,Lombardia,ITC4
2021-01-12,PF/BT,STS11 000942,PSVR RSA FONDAZIONE ENTE CELERI BRENO,LOM,30-39,0,2,0,1,1,0,0,2,0,2,Lombardia,ITC4
2021-01-12,PF/BT,STS11 000942,PSVR RSA FONDAZIONE ENTE CELERI BRENO,LOM,40-49,0,6,0,3,3,0,0,6,0,6,Lombardia,ITC4
2021-01-12,PF/BT,STS11 000942,PSVR RSA FONDAZIONE ENTE CELERI BRENO,LOM,50-59,0,4,0,3,1,0,0,4,0,4,Lombardia,ITC4
2021-01-12,PF/BT,STS11 000942,PSVR RSA FONDAZIONE ENTE CELERI BRENO,LOM,70-79,1,0,0,0,0,1,0,1,0,1,Lombardia,ITC4
2021-01-12,PF/BT,STS11 000942,PSVR RSA FONDAZIONE ENTE CELERI BRENO,LOM,80-89,3,6,0,0,0,9,0,9,0,9,Lombardia,ITC4
2021-01-12,PF/BT,STS11 000942,PSVR RSA FONDAZIONE ENTE CELERI BRENO,LOM,90+,0,8,0,0,0,8,0,8,0,8,Lombardia,ITC4
2021-01-12,PF/BT,STS11/32170226,32170226  030321  030702 AMBULATORIO COVID OSP. MILITARE  015146,LOM,20-29,8,8,0,15,1,0,0,16,0,16,Lombardia,ITC4
2021-01-12,PF/BT,STS11/32170226,32170226  030321  030702 AMBULATORIO COVID OSP. MILITARE  015146,LOM,30-39,13,7,0,12,8,0,0,20,0,20,Lombardia,ITC4
2021-01-12,PF/BT,STS11/32170226,32170226  030321  030702 AMBULATORIO COVID OSP. MILITARE  015146,LOM,40-49,16,0,0,4,12,0,0,16,0,16,Lombardia,ITC4
2021-01-12,PF/BT,STS11/32170226,32170226  030321  030702 AMBULATORIO COVID OSP. MILITARE  015146,LOM,50-59,8,0,0,5,3,0,0,8,0,8,Lombardia,ITC4
2021-01-12,PF/BT,STS11-004734,RSA CARLETTO CONCINA - VIA VESPOLATE 14 - CONFIENZA (PAVIA),LOM,20-29,2,0,0,2,0,0,0,2,0,2,Lombardia,ITC4
2021-01-12,PF/BT,STS11-004734,RSA CARLETTO CONCINA - VIA VESPOLATE 14 - CONFIENZA (PAVIA),LOM,30-39,0,6,0,6,0,0,0,6,0,6,Lombardia,ITC4
2021-01-12,PF/BT,STS11-004734,RSA CARLETTO CONCINA - VIA VESPOLATE 14 - CONFIENZA (PAVIA),LOM,40-49,1,0,0,1,0,0,0,1,0,1,Lombardia,ITC4
2021-01-12,PF/BT,STS11-004734,RSA CARLETTO CONCINA - VIA VESPOLATE 14 - CONFIENZA (PAVIA),LOM,50-59,2,0,0,2,0,0,0,2,0,2,Lombardia,ITC4
2021-01-12,PF/BT,STS11-004734,RSA CARLETTO CONCINA - VIA VESPOLATE 14 - CONFIENZA (PAVIA),LOM,60-69,0,3,0,3,0,0,0,3,0,3,Lombardia,ITC4
2021-01-12,PF/BT,STS11-004734,RSA CARLETTO CONCINA - VIA VESPOLATE 14 - CONFIENZA (PAVIA),LOM,70-79,1,1,0,0,0,2,0,2,0,2,Lombardia,ITC4
2021-01-12,PF/BT,STS11-004734,RSA CARLETTO CONCINA - VIA VESPOLATE 14 - CONFIENZA (PAVIA),LOM,80-89,0,2,0,0,0,2,0,2,0,2,Lombardia,ITC4
2021-01-12,PF/BT,STS24,RSA FONDAZIONE ONLUS MONS. A. MAZZALI (MANTOVA),LOM,20-29,0,2,0,2,0,0,0,2,0,2,Lombardia,ITC4
2021-01-12,PF/BT,STS24,RSA FONDAZIONE ONLUS MONS. A. MAZZALI (MANTOVA),LOM,30-39,0,5,0,5,0,0,0,5,0,5,Lombardia,ITC4
2021-01-12,PF/BT,STS24,RSA FONDAZIONE ONLUS MONS. A. MAZZALI (MANTOVA),LOM,40-49,0,4,0,3,1,0,0,4,0,4,Lombardia,ITC4
2021-01-12,PF/BT,STS24,RSA FONDAZIONE ONLUS MONS. A. MAZZALI (MANTOVA),LOM,50-59,1,8,0,5,4,0,0,9,0,9,Lombardia,ITC4
2021-01-12,PF/BT,STS24,RSA FONDAZIONE ONLUS MONS. A. MAZZALI (MANTOVA),LOM,60-69,0,3,0,2,1,0,0,3,0,3,Lombardia,ITC4
2021-01-13,PF/BT,"""000916""",CASA RIPOSO CITTA' DI SONDRIO,LOM,20-29,0,1,0,0,1,0,0,1,0,1,Lombardia,ITC4
2021-01-13,PF/BT,"""000916""",CASA RIPOSO CITTA' DI SONDRIO,LOM,30-39,0,6,0,5,1,0,0,6,0,6,Lombardia,ITC4
2021-01-13,PF/BT,"""000916""",CASA RIPOSO CITTA' DI SONDRIO,LOM,40-49,2,12,0,12,2,0,0,14,0,14,Lombardia,ITC4
2021-01-13,PF/BT,"""000916""",CASA RIPOSO CITTA' DI SONDRIO,LOM,50-59,0,9,0,3,5,1,0,9,0,9,Lombardia,ITC4
2021-01-13,PF/BT,"""000916""",CASA RIPOSO CITTA' DI SONDRIO,LOM,60-69,0,4,0,1,1,2,0,4,0,4,Lombardia,ITC4
2021-01-13,PF/BT,"""000916""",CASA RIPOSO CITTA' DI SONDRIO,LOM,70-79,3,4,0,1,0,5,1,7,0,7,Lombardia,ITC4
2021-01-13,PF/BT,"""000916""",CASA RIPOSO CITTA' DI SONDRIO,LOM,80-89,6,16,0,0,0,22,0,22,0,22,Lombardia,ITC4
2021-01-13,PF/BT,"""000916""",CASA RIPOSO CITTA' DI SONDRIO,LOM,90+,1,20,0,0,0,21,0,21,0,21,Lombardia,ITC4
2021-01-13,PF/BT,(03027500/001752),PVO Istituto Clinico San Rocco (Spoke),LOM,20-29,0,5,0,5,0,0,0,5,0,5,Lombardia,ITC4
2021-01-13,PF/BT,(03027500/001752),PVO Istituto Clinico San Rocco (Spoke),LOM,30-39,0,4,0,4,0,0,0,4,0,4,Lombardia,ITC4
2021-01-13,PF/BT,(03027500/001752),PVO Istituto Clinico San Rocco (Spoke),LOM,40-49,3,5,0,7,1,0,0,8,0,8,Lombardia,ITC4
2021-01-13,PF/BT,(03027500/001752),PVO Istituto Clinico San Rocco (Spoke),LOM,50-59,3,2,0,5,0,0,0,5,0,5,Lombardia,ITC4
2021-01-13,PF/BT,(03027500/001752),PVO Istituto Clinico San Rocco (Spoke),LOM,60-69,1,1,0,2,0,0,0,2,0,2,Lombardia,ITC4
2021-01-13,PF/BT,.030042,ASST VALTELLINA ALTO LARIO - PRESIDIO OSPEDALIERO DI SONDRIO,LOM,20-29,4,10,0,13,1,0,0,14,0,14,Lombardia,ITC4
2021-01-13,PF/BT,.030042,ASST VALTELLINA ALTO LARIO - PRESIDIO OSPEDALIERO DI SONDRIO,LOM,30-39,23,14,0,26,11,0,0,37,0,37,Lombardia,ITC4
2021-01-13,PF/BT,.030042,ASST VALTELLINA ALTO LARIO - PRESIDIO OSPEDALIERO DI SONDRIO,LOM,40-49,10,23,0,17,16,0,0,33,0,33,Lombardia,ITC4
2021-01-13,PF/BT,.030042,ASST VALTELLINA ALTO LARIO - PRESIDIO OSPEDALIERO DI SONDRIO,LOM,50-59,25,47,0,48,24,0,0,72,0,72,Lombardia,ITC4
2021-01-13,PF/BT,.030042,ASST VALTELLINA ALTO LARIO - PRESIDIO OSPEDALIERO DI SONDRIO,LOM,60-69,18,18,0,17,19,0,0,36,0,36,Lombardia,ITC4
2021-01-13,PF/BT,0,FONDAZIONE CARISMA BERGAMO,LOM,50-59,0,2,0,0,0,2,0,2,0,2,Lombardia,ITC4
2021-01-13,PF/BT,0,FONDAZIONE CARISMA BERGAMO,LOM,60-69,2,1,0,0,0,3,0,3,0,3,Lombardia,ITC4
2021-01-13,PF/BT,0,FONDAZIONE CARISMA BERGAMO,LOM,70-79,5,5,0,0,0,10,0,10,0,10,Lombardia,ITC4
2021-01-13,PF/BT,0,FONDAZIONE CARISMA BERGAMO,LOM,80-89,5,17,0,0,0,22,0,22,0,22,Lombardia,ITC4
2021-01-13,PF/BT,0,FONDAZIONE CARISMA BERGAMO,LOM,90+,4,22,0,0,0,26,0,26,0,26,Lombardia,ITC4
2021-01-13,PF/BT,0,"Istituto Geriatrico ""P. Redaelli"" sede di Vimodrone",LOM,20-29,1,2,0,3,0,0,0,3,0,3,Lombardia,ITC4
2021-01-13,PF/BT,0,"Istituto Geriatrico ""P. Redaelli"" sede di Vimodrone",LOM,30-39,2,4,0,6,0,0,0,6,0,6,Lombardia,ITC4
2021-01-13,PF/BT,0,"Istituto Geriatrico ""P. Redaelli"" sede di Vimodrone",LOM,40-49,2,6,0,8,0,0,0,8,0,8,Lombardia,ITC4
2021-01-13,PF/BT,0,"Istituto Geriatrico ""P. Redaelli"" sede di Vimodrone",LOM,50-59,1,4,0,5,0,0,0,5,0,5,Lombardia,ITC4
2021-01-13,PF/BT,0,"Istituto Geriatrico ""P. Redaelli"" sede di Vimodrone",LOM,60-69,1,1,0,2,0,0,0,2,0,2,Lombardia,ITC4
2021-01-13,PF/BT,0,ISTITUTO SACRA FAMIGLIA REGOLEDO,LOM,50-59,0,1,0,0,0,1,0,1,0,1,Lombardia,ITC4
2021-01-13,PF/BT,0,ISTITUTO SACRA FAMIGLIA REGOLEDO,LOM,60-69,1,0,0,0,0,1,0,1,0,1,Lombardia,ITC4
2021-01-13,PF/BT,0,ISTITUTO SACRA FAMIGLIA REGOLEDO,LOM,70-79,2,6,0,0,0,8,0,8,0,8,Lombardia,ITC4
2021-01-13,PF/BT,0,ISTITUTO SACRA FAMIGLIA REGOLEDO,LOM,80-89,1,11,0,0,0,12,0,12,0,12,Lombardia,ITC4
2021-01-13,PF/BT,0,ISTITUTO SACRA FAMIGLIA REGOLEDO,LOM,90+,2,11,0,0,0,13,0,13,0,13,Lombardia,ITC4
2021-01-13,PF/BT,0,OPERA CHARITAS S.ANNA - RSA VILLA ENRICA - ALBONESE (PV),LOM,60-69,0,1,0,0,0,1,0,1,0,1,Lombardia,ITC4
2021-01-13,PF/BT,0,OPERA CHARITAS S.ANNA - RSA VILLA ENRICA - ALBONESE (PV),LOM,70-79,1,2,0,0,0,3,0,3,0,3,Lombardia,ITC4
2021-01-13,PF/BT,0,OPERA CHARITAS S.ANNA - RSA VILLA ENRICA - ALBONESE (PV),LOM,80-89,3,6,0,0,0,9,0,9,0,9,Lombardia,ITC4
2021-01-13,PF/BT,0,OPERA CHARITAS S.ANNA - RSA VILLA ENRICA - ALBONESE (PV),LOM,90+,0,5,0,0,0,5,0,5,0,5,Lombardia,ITC4
2021-01-13,PF/BT,0,RSA “OPERA PASTOR ANGELUCUS”,LOM,60-69,1,0,0,0,0,1,0,1,0,1,Lombardia,ITC4
2021-01-13,PF/BT,0,RSA “OPERA PASTOR ANGELUCUS”,LOM,70-79,1,0,0,0,0,1,0,1,0,1,Lombardia,ITC4
2021-01-13,PF/BT,0,RSA “OPERA PASTOR ANGELUCUS”,LOM,80-89,1,5,0,0,0,6,0,6,0,6,Lombardia,ITC4
2021-01-13,PF/BT,0,RSA “OPERA PASTOR ANGELUCUS”,LOM,90+,1,3,0,0,0,4,0,4,0,4,Lombardia,ITC4
2021-01-13,PF/BT,0,RSA Casa San Lorenzo Ardenno,LOM,20-29,0,1,0,1,0,0,0,1,0,1,Lombardia,ITC4
2021-01-13,PF/BT,0,RSA Casa San Lorenzo Ardenno,LOM,30-39,0,2,0,2,0,0,0,2,0,2,Lombardia,ITC4
2021-01-13,PF/BT,0,RSA Casa San Lorenzo Ardenno,LOM,40-49,0,4,0,4,0,0,0,4,0,4,Lombardia,ITC4
2021-01-13,PF/BT,0,RSA Casa San Lorenzo Ardenno,LOM,50-59,0,4,0,3,1,0,0,4,0,4,Lombardia,ITC4
2021-01-13,PF/BT,0,RSA Casa San Lorenzo Ardenno,LOM,60-69,0,1,0,1,0,0,0,1,0,1,Lombardia,ITC4
2021-01-13,PF/BT,000050,Poliambulatorio IRCSS OSPEDALE SAN LUCA,LOM,20-29,2,3,0,5,0,0,0,5,0,5,Lombardia,ITC4
2021-01-13,PF/BT,000050,Poliambulatorio IRCSS OSPEDALE SAN LUCA,LOM,30-39,1,0,0,1,0,0,0,1,0,1,Lombardia,ITC4
2021-01-13,PF/BT,000050,Poliambulatorio IRCSS OSPEDALE SAN LUCA,LOM,40-49,2,0,0,2,0,0,0,2,0,2,Lombardia,ITC4
2021-01-13,PF/BT,000050,Poliambulatorio IRCSS OSPEDALE SAN LUCA,LOM,50-59,1,1,0,2,0,0,0,2,0,2,Lombardia,ITC4
2021-01-13,PF/BT,000050,Poliambulatorio IRCSS OSPEDALE SAN LUCA,LOM,60-69,0,2,0,2,0,0,0,2,0,2,Lombardia,ITC4
2021-01-13,PF/BT,000119,POLIAMBULATORIO IRCSS OSPEDALE SAN MICHELE,LOM,20-29,3,3,0,3,3,0,0,6,0,6,Lombardia,ITC4
2021-01-13,PF/BT,000119,POLIAMBULATORIO IRCSS OSPEDALE SAN MICHELE,LOM,30-39,4,7,0,3,8,0,0,11,0,11,Lombardia,ITC4
2021-01-13,PF/BT,000119,POLIAMBULATORIO IRCSS OSPEDALE SAN MICHELE,LOM,40-49,2,7,0,4,5,0,0,9,0,9,Lombardia,ITC4
2021-01-13,PF/BT,000119,POLIAMBULATORIO IRCSS OSPEDALE SAN MICHELE,LOM,50-59,7,16,0,11,12,0,0,23,0,23,Lombardia,ITC4
2021-01-13,PF/BT,000119,POLIAMBULATORIO IRCSS OSPEDALE SAN MICHELE,LOM,60-69,4,2,0,5,1,0,0,6,0,6,Lombardia,ITC4
2021-01-13,PF/BT,000119,POLIAMBULATORIO IRCSS OSPEDALE SAN MICHELE,LOM,70-79,4,1,0,4,1,0,0,5,0,5,Lombardia,ITC4
2021-01-13,PF/BT,000417,POLIAMBULATORIO IRCCS OSPEDALE CAPITANIO,LOM,20-29,2,4,0,5,1,0,0,6,0,6,Lombardia,ITC4
2021-01-13,PF/BT,000417,POLIAMBULATORIO IRCCS OSPEDALE CAPITANIO,LOM,30-39,6,7,0,12,1,0,0,13,0,13,Lombardia,ITC4
2021-01-13,PF/BT,000417,POLIAMBULATORIO IRCCS OSPEDALE CAPITANIO,LOM,40-49,3,5,0,5,3,0,0,8,0,8,Lombardia,ITC4
2021-01-13,PF/BT,000417,POLIAMBULATORIO IRCCS OSPEDALE CAPITANIO,LOM,50-59,5,15,0,15,5,0,0,20,0,20,Lombardia,ITC4
2021-01-13,PF/BT,000417,POLIAMBULATORIO IRCCS OSPEDALE CAPITANIO,LOM,60-69,3,3,0,2,4,0,0,6,0,6,Lombardia,ITC4
2021-01-13,PF/BT,000417,POLIAMBULATORIO IRCCS OSPEDALE CAPITANIO,LOM,70-79,1,0,0,1,0,0,0,1,0,1,Lombardia,ITC4
2021-01-13,PF/BT,000427,CENTRO DIAGNOSTICO PIOLTELLO,LOM,20-29,0,2,0,2,0,0,0,2,0,2,Lombardia,ITC4
2021-01-13,PF/BT,000427,CENTRO DIAGNOSTICO PIOLTELLO,LOM,30-39,0,1,0,1,0,0,0,1,0,1,Lombardia,ITC4
2021-01-13,PF/BT,000427,CENTRO DIAGNOSTICO PIOLTELLO,LOM,40-49,0,3,0,3,0,0,0,3,0,3,Lombardia,ITC4
2021-01-13,PF/BT,000427,CENTRO DIAGNOSTICO PIOLTELLO,LOM,50-59,2,2,0,4,0,0,0,4,0,4,Lombardia,ITC4
2021-01-13,PF/BT,000427,CENTRO DIAGNOSTICO PIOLTELLO,LOM,60-69,0,1,0,1,0,0,0,1,0,1,Lombardia,ITC4
2021-01-13,PF/BT,000427,CENTRO DIAGNOSTICO PIOLTELLO,LOM,80-89,1,0,0,1,0,0,0,1,0,1,Lombardia,ITC4
2021-01-13,PF/BT,000500,RSA MONSIGNOR BICCHIERAI 2,LOM,80-89,0,3,0,0,0,3,0,3,0,3,Lombardia,ITC4
2021-01-13,PF/BT,000500,RSA MONSIGNOR BICCHIERAI 2,LOM,90+,1,2,0,0,0,3,0,3,0,3,Lombardia,ITC4
2021-01-13,PF/BT,000913,RSA BELLAVISTA SONDALO,LOM,20-29,0,3,0,2,1,0,0,3,0,3,Lombardia,ITC4
2021-01-13,PF/BT,000913,RSA BELLAVISTA SONDALO,LOM,30-39,1,3,0,4,0,0,0,4,0,4,Lombardia,ITC4
2021-01-13,PF/BT,000913,RSA BELLAVISTA SONDALO,LOM,40-49,0,5,0,3,2,0,0,5,0,5,Lombardia,ITC4
2021-01-13,PF/BT,000913,RSA BELLAVISTA SONDALO,LOM,50-59,0,6,0,6,0,0,0,6,0,6,Lombardia,ITC4
2021-01-13,PF/BT,000913,RSA BELLAVISTA SONDALO,LOM,70-79,1,1,0,0,0,2,0,2,0,2,Lombardia,ITC4
2021-01-13,PF/BT,000913,RSA BELLAVISTA SONDALO,LOM,80-89,1,2,0,0,0,3,0,3,0,3,Lombardia,ITC4
2021-01-13,PF/BT,000913,RSA BELLAVISTA SONDALO,LOM,90+,0,1,0,0,0,1,0,1,0,1,Lombardia,ITC4
2021-01-13,PF/BT,000921,FONDAZIONE CASA DI RIPOSO CITTA' DI TIRANO ONLUS,LOM,30-39,0,2,0,2,0,0,0,2,0,2,Lombardia,ITC4
2021-01-13,PF/BT,000921,FONDAZIONE CASA DI RIPOSO CITTA' DI TIRANO ONLUS,LOM,40-49,0,6,0,6,0,0,0,6,0,6,Lombardia,ITC4
2021-01-13,PF/BT,000921,FONDAZIONE CASA DI RIPOSO CITTA' DI TIRANO ONLUS,LOM,50-59,4,4,0,5,2,1,0,8,0,8,Lombardia,ITC4
2021-01-13,PF/BT,000921,FONDAZIONE CASA DI RIPOSO CITTA' DI TIRANO ONLUS,LOM,60-69,3,3,0,3,0,3,0,6,0,6,Lombardia,ITC4
2021-01-13,PF/BT,000921,FONDAZIONE CASA DI RIPOSO CITTA' DI TIRANO ONLUS,LOM,70-79,2,4,0,0,0,6,0,6,0,6,Lombardia,ITC4
2021-01-13,PF/BT,000921,FONDAZIONE CASA DI RIPOSO CITTA' DI TIRANO ONLUS,LOM,80-89,4,19,0,0,0,23,0,23,0,23,Lombardia,ITC4
2021-01-13,PF/BT,000921,FONDAZIONE CASA DI RIPOSO CITTA' DI TIRANO ONLUS,LOM,90+,1,20,0,0,0,21,0,21,0,21,Lombardia,ITC4
2021-01-13,PF/BT,000928,RSA FONDAZIONE VISCONTI VENOSTA GROSIO,LOM,20-29,1,2,0,3,0,0,0,3,0,3,Lombardia,ITC4
2021-01-13,PF/BT,000928,RSA FONDAZIONE VISCONTI VENOSTA GROSIO,LOM,40-49,0,7,0,6,1,0,0,7,0,7,Lombardia,ITC4
2021-01-13,PF/BT,000928,RSA FONDAZIONE VISCONTI VENOSTA GROSIO,LOM,50-59,0,7,0,7,0,0,0,7,0,7,Lombardia,ITC4
2021-01-13,PF/BT,000928,RSA FONDAZIONE VISCONTI VENOSTA GROSIO,LOM,60-69,3,3,0,4,0,2,0,6,0,6,Lombardia,ITC4
2021-01-13,PF/BT,000928,RSA FONDAZIONE VISCONTI VENOSTA GROSIO,LOM,70-79,1,1,0,0,0,2,0,2,0,2,Lombardia,ITC4
2021-01-13,PF/BT,000928,RSA FONDAZIONE VISCONTI VENOSTA GROSIO,LOM,80-89,3,5,0,0,0,8,0,8,0,8,Lombardia,ITC4
2021-01-13,PF/BT,000928,RSA FONDAZIONE VISCONTI VENOSTA GROSIO,LOM,90+,3,0,0,0,0,3,0,3,0,3,Lombardia,ITC4
2021-01-13,PF/BT,001020,CENTRO DIAGNOSTICO MEDA,LOM,20-29,0,4,0,4,0,0,0,4,0,4,Lombardia,ITC4
2021-01-13,PF/BT,001020,CENTRO DIAGNOSTICO MEDA,LOM,30-39,2,4,0,3,3,0,0,6,0,6,Lombardia,ITC4
2021-01-13,PF/BT,001020,CENTRO DIAGNOSTICO MEDA,LOM,40-49,2,14,0,10,6,0,0,16,0,16,Lombardia,ITC4
2021-01-13,PF/BT,001020,CENTRO DIAGNOSTICO MEDA,LOM,50-59,3,6,0,6,3,0,0,9,0,9,Lombardia,ITC4
2021-01-13,PF/BT,001020,CENTRO DIAGNOSTICO MEDA,LOM,60-69,1,4,0,5,0,0,0,5,0,5,Lombardia,ITC4
2021-01-13,PF/BT,001020,CENTRO DIAGNOSTICO MEDA,LOM,70-79,2,0,0,2,0,0,0,2,0,2,Lombardia,ITC4
2021-01-13,PF/BT,001534,"Fondazione ""Martinelli-Granata-Piantoni"" Onlus",LOM,20-29,1,0,0,1,0,0,0,1,0,1,Lombardia,ITC4
2021-01-13,PF/BT,001534,"Fondazione ""Martinelli-Granata-Piantoni"" Onlus",LOM,30-39,1,2,0,2,1,0,0,3,0,3,Lombardia,ITC4
2021-01-13,PF/BT,001534,"Fondazione ""Martinelli-Granata-Piantoni"" Onlus",LOM,50-59,0,6,0,6,0,0,0,6,0,6,Lombardia,ITC4
2021-01-13,PF/BT,001534,"Fondazione ""Martinelli-Granata-Piantoni"" Onlus",LOM,60-69,0,1,0,1,0,0,0,1,0,1,Lombardia,ITC4
2021-01-13,PF/BT,001814,RSA COMUNALE,LOM,30-39,0,8,0,7,1,0,0,8,0,8,Lombardia,ITC4
2021-01-13,PF/BT,001814,RSA COMUNALE,LOM,40-49,0,5,0,4,1,0,0,5,0,5,Lombardia,ITC4
2021-01-13,PF/BT,001814,RSA COMUNALE,LOM,50-59,1,8,0,4,5,0,0,9,0,9,Lombardia,ITC4
2021-01-13,PF/BT,001814,RSA COMUNALE,LOM,60-69,0,3,0,2,1,0,0,3,0,3,Lombardia,ITC4
2021-01-13,PF/BT,001814,RSA COMUNALE,LOM,70-79,2,2,0,0,0,4,0,4,0,4,Lombardia,ITC4
2021-01-13,PF/BT,001814,RSA COMUNALE,LOM,80-89,2,12,0,0,0,14,0,14,0,14,Lombardia,ITC4
2021-01-13,PF/BT,001814,RSA COMUNALE,LOM,90+,2,9,0,0,0,11,0,11,0,11,Lombardia,ITC4
2021-01-13,PF/BT,001861,CASA FAMIGLIA PADRE F. SPINELLI DI RIVOLTA D'ADDA,LOM,20-29,2,3,0,5,0,0,0,5,0,5,Lombardia,ITC4
2021-01-13,PF/BT,001861,CASA FAMIGLIA PADRE F. SPINELLI DI RIVOLTA D'ADDA,LOM,30-39,1,2,0,0,3,0,0,3,0,3,Lombardia,ITC4
2021-01-13,PF/BT,001861,CASA FAMIGLIA PADRE F. SPINELLI DI RIVOLTA D'ADDA,LOM,40-49,1,13,0,11,3,0,0,14,0,14,Lombardia,ITC4
2021-01-13,PF/BT,001861,CASA FAMIGLIA PADRE F. SPINELLI DI RIVOLTA D'ADDA,LOM,50-59,0,13,0,6,7,0,0,13,0,13,Lombardia,ITC4
2021-01-13,PF/BT,001861,CASA FAMIGLIA PADRE F. SPINELLI DI RIVOLTA D'ADDA,LOM,60-69,1,1,0,1,1,0,0,2,0,2,Lombardia,ITC4
2021-01-13,PF/BT,001861,CASA FAMIGLIA PADRE F. SPINELLI DI RIVOLTA D'ADDA,LOM,70-79,0,2,0,0,0,2,0,2,0,2,Lombardia,ITC4
2021-01-13,PF/BT,001861,CASA FAMIGLIA PADRE F. SPINELLI DI RIVOLTA D'ADDA,LOM,80-89,3,10,0,0,0,13,0,13,0,13,Lombardia,ITC4
2021-01-13,PF/BT,001861,CASA FAMIGLIA PADRE F. SPINELLI DI RIVOLTA D'ADDA,LOM,90+,2,11,0,0,0,13,0,13,0,13,Lombardia,ITC4
2021-01-13,PF/BT,001874,FONDAZIONE SAN BIAGIO ONLUS,LOM,20-29,0,1,0,0,1,0,0,1,0,1,Lombardia,ITC4
2021-01-13,PF/BT,001874,FONDAZIONE SAN BIAGIO ONLUS,LOM,30-39,1,1,0,2,0,0,0,2,0,2,Lombardia,ITC4
2021-01-13,PF/BT,001874,FONDAZIONE SAN BIAGIO ONLUS,LOM,50-59,0,2,0,1,1,0,0,2,0,2,Lombardia,ITC4
2021-01-13,PF/BT,001874,FONDAZIONE SAN BIAGIO ONLUS,LOM,60-69,1,1,0,0,0,1,1,2,0,2,Lombardia,ITC4
2021-01-13,PF/BT,001874,FONDAZIONE SAN BIAGIO ONLUS,LOM,70-79,1,1,0,0,0,1,1,2,0,2,Lombardia,ITC4
2021-01-13,PF/BT,001874,FONDAZIONE SAN BIAGIO ONLUS,LOM,80-89,1,2,0,0,0,3,0,3,0,3,Lombardia,ITC4
2021-01-13,PF/BT,001905,RSA CASA FAMIGLIA SOLFERINO [327-001905],LOM,20-29,0,2,0,2,0,0,0,2,0,2,Lombardia,ITC4
2021-01-13,PF/BT,001905,RSA CASA FAMIGLIA SOLFERINO [327-001905],LOM,30-39,0,10,0,10,0,0,0,10,0,10,Lombardia,ITC4
2021-01-13,PF/BT,001905,RSA CASA FAMIGLIA SOLFERINO [327-001905],LOM,40-49,0,14,0,14,0,0,0,14,0,14,Lombardia,ITC4
2021-01-13,PF/BT,001905,RSA CASA FAMIGLIA SOLFERINO [327-001905],LOM,50-59,1,11,0,12,0,0,0,12,0,12,Lombardia,ITC4
2021-01-13,PF/BT,001905,RSA CASA FAMIGLIA SOLFERINO [327-001905],LOM,60-69,4,1,0,1,2,2,0,5,0,5,Lombardia,ITC4
2021-01-13,PF/BT,001905,RSA CASA FAMIGLIA SOLFERINO [327-001905],LOM,70-79,2,9,0,0,2,9,0,11,0,11,Lombardia,ITC4
2021-01-13,PF/BT,001905,RSA CASA FAMIGLIA SOLFERINO [327-001905],LOM,80-89,5,26,0,0,0,31,0,31,0,31,Lombardia,ITC4
2021-01-13,PF/BT,001905,RSA CASA FAMIGLIA SOLFERINO [327-001905],LOM,90+,2,21,0,0,0,23,0,23,0,23,Lombardia,ITC4
2021-01-13,PF/BT,001995,"Fondazione ""Tosi/Cippelletti di Rivarolo Mantovano"" Onlus",LOM,20-29,1,1,0,1,1,0,0,2,0,2,Lombardia,ITC4
2021-01-13,PF/BT,001995,"Fondazione ""Tosi/Cippelletti di Rivarolo Mantovano"" Onlus",LOM,30-39,1,1,0,2,0,0,0,2,0,2,Lombardia,ITC4
2021-01-13,PF/BT,001995,"Fondazione ""Tosi/Cippelletti di Rivarolo Mantovano"" Onlus",LOM,40-49,1,3,0,3,1,0,0,4,0,4,Lombardia,ITC4
2021-01-13,PF/BT,001995,"Fondazione ""Tosi/Cippelletti di Rivarolo Mantovano"" Onlus",LOM,50-59,1,10,0,8,3,0,0,11,0,11,Lombardia,ITC4
2021-01-13,PF/BT,001995,"Fondazione ""Tosi/Cippelletti di Rivarolo Mantovano"" Onlus",LOM,60-69,0,2,0,2,0,0,0,2,0,2,Lombardia,ITC4
2021-01-13,PF/BT,00290,LA PICCOLA CASA DEL RIFUGIO,LOM,30-39,2,4,0,6,0,0,0,6,0,6,Lombardia,ITC4
2021-01-13,PF/BT,00290,LA PICCOLA CASA DEL RIFUGIO,LOM,40-49,2,8,0,10,0,0,0,10,0,10,Lombardia,ITC4
2021-01-13,PF/BT,00290,LA PICCOLA CASA DEL RIFUGIO,LOM,50-59,3,18,0,20,1,0,0,21,0,21,Lombardia,ITC4
2021-01-13,PF/BT,00290,LA PICCOLA CASA DEL RIFUGIO,LOM,60-69,1,4,0,5,0,0,0,5,0,5,Lombardia,ITC4
2021-01-13,PF/BT,00290,LA PICCOLA CASA DEL RIFUGIO,LOM,70-79,0,4,0,0,0,4,0,4,0,4,Lombardia,ITC4
2021-01-13,PF/BT,00290,LA PICCOLA CASA DEL RIFUGIO,LOM,80-89,0,7,0,0,0,6,1,7,0,7,Lombardia,ITC4
2021-01-13,PF/BT,00290,LA PICCOLA CASA DEL RIFUGIO,LOM,90+,0,7,0,0,0,7,0,7,0,7,Lombardia,ITC4
2021-01-13,PF/BT,002987,POLIAMBULATORIO OSPEDALE ESINE,LOM,20-29,3,4,0,4,3,0,0,7,0,7,Lombardia,ITC4
2021-01-13,PF/BT,002987,POLIAMBULATORIO OSPEDALE ESINE,LOM,30-39,10,23,0,19,14,0,0,33,0,33,Lombardia,ITC4
2021-01-13,PF/BT,002987,POLIAMBULATORIO OSPEDALE ESINE,LOM,40-49,10,32,0,30,12,0,0,42,0,42,Lombardia,ITC4
2021-01-13,PF/BT,002987,POLIAMBULATORIO OSPEDALE ESINE,LOM,50-59,11,38,0,35,14,0,0,49,0,49,Lombardia,ITC4
2021-01-13,PF/BT,002987,POLIAMBULATORIO OSPEDALE ESINE,LOM,60-69,7,10,0,9,8,0,0,17,0,17,Lombardia,ITC4
2021-01-13,PF/BT,002987,POLIAMBULATORIO OSPEDALE ESINE,LOM,70-79,1,0,0,0,1,0,0,1,0,1,Lombardia,ITC4
2021-01-13,PF/BT,002987,POLIAMBULATORIO OSPEDALE ESINE,LOM,80-89,1,0,0,0,1,0,0,1,0,1,Lombardia,ITC4
2021-01-13,PF/BT,003328,HUB COV CHIARI - P.O. ISEO -  ASST FRANCIACORTA,LOM,20-29,10,11,0,12,9,0,0,21,0,21,Lombardia,ITC4
2021-01-13,PF/BT,003328,HUB COV CHIARI - P.O. ISEO -  ASST FRANCIACORTA,LOM,30-39,16,11,0,14,13,0,0,27,0,27,Lombardia,ITC4
2021-01-13,PF/BT,003328,HUB COV CHIARI - P.O. ISEO -  ASST FRANCIACORTA,LOM,40-49,15,14,0,22,7,0,0,29,0,29,Lombardia,ITC4
2021-01-13,PF/BT,003328,HUB COV CHIARI - P.O. ISEO -  ASST FRANCIACORTA,LOM,50-59,17,18,0,31,4,0,0,35,0,35,Lombardia,ITC4
2021-01-13,PF/BT,003328,HUB COV CHIARI - P.O. ISEO -  ASST FRANCIACORTA,LOM,60-69,16,11,0,26,1,0,0,27,0,27,Lombardia,ITC4
2021-01-13,PF/BT,003328,HUB COV CHIARI - P.O. ISEO -  ASST FRANCIACORTA,LOM,70-79,3,1,0,4,0,0,0,4,0,4,Lombardia,ITC4
2021-01-13,PF/BT,003335,HUB COV CHIARI - P.O. CHIARI ASST FRANCIACORTA,LOM,16-19,1,2,0,3,0,0,0,3,0,3,Lombardia,ITC4
2021-01-13,PF/BT,003335,HUB COV CHIARI - P.O. CHIARI ASST FRANCIACORTA,LOM,20-29,14,12,0,25,1,0,0,26,0,26,Lombardia,ITC4
2021-01-13,PF/BT,003335,HUB COV CHIARI - P.O. CHIARI ASST FRANCIACORTA,LOM,30-39,12,18,0,21,9,0,0,30,0,30,Lombardia,ITC4
2021-01-13,PF/BT,003335,HUB COV CHIARI - P.O. CHIARI ASST FRANCIACORTA,LOM,40-49,14,25,0,26,13,0,0,39,0,39,Lombardia,ITC4
2021-01-13,PF/BT,003335,HUB COV CHIARI - P.O. CHIARI ASST FRANCIACORTA,LOM,50-59,17,31,0,38,10,0,0,48,0,48,Lombardia,ITC4
2021-01-13,PF/BT,003335,HUB COV CHIARI - P.O. CHIARI ASST FRANCIACORTA,LOM,60-69,11,7,0,14,4,0,0,18,0,18,Lombardia,ITC4
2021-01-13,PF/BT,003335,HUB COV CHIARI - P.O. CHIARI ASST FRANCIACORTA,LOM,70-79,3,1,0,4,0,0,0,4,0,4,Lombardia,ITC4
2021-01-13,PF/BT,030017,Istituto clinico Casa di cura Mater Domini -Castellanza,LOM,20-29,3,24,0,19,8,0,0,27,0,27,Lombardia,ITC4
2021-01-13,PF/BT,030017,Istituto clinico Casa di cura Mater Domini -Castellanza,LOM,30-39,10,19,0,27,2,0,0,29,0,29,Lombardia,ITC4
2021-01-13,PF/BT,030017,Istituto clinico Casa di cura Mater Domini -Castellanza,LOM,40-49,14,27,0,38,3,0,0,41,0,41,Lombardia,ITC4
2021-01-13,PF/BT,030017,Istituto clinico Casa di cura Mater Domini -Castellanza,LOM,50-59,11,16,0,23,4,0,0,27,0,27,Lombardia,ITC4
2021-01-13,PF/BT,030017,Istituto clinico Casa di cura Mater Domini -Castellanza,LOM,60-69,5,11,0,10,6,0,0,16,0,16,Lombardia,ITC4
2021-01-13,PF/BT,030017,Istituto clinico Casa di cura Mater Domini -Castellanza,LOM,70-79,3,1,0,4,0,0,0,4,0,4,Lombardia,ITC4
2021-01-13,PF/BT,030030,OSPEDALE VALDUCE-AMBULATORIO VACCINALE COVID,LOM,20-29,0,16,0,16,0,0,0,16,0,16,Lombardia,ITC4
2021-01-13,PF/BT,030030,OSPEDALE VALDUCE-AMBULATORIO VACCINALE COVID,LOM,30-39,5,21,0,25,1,0,0,26,0,26,Lombardia,ITC4
2021-01-13,PF/BT,030030,OSPEDALE VALDUCE-AMBULATORIO VACCINALE COVID,LOM,40-49,3,32,0,35,0,0,0,35,0,35,Lombardia,ITC4
2021-01-13,PF/BT,030030,OSPEDALE VALDUCE-AMBULATORIO VACCINALE COVID,LOM,50-59,12,51,0,54,9,0,0,63,0,63,Lombardia,ITC4
2021-01-13,PF/BT,030030,OSPEDALE VALDUCE-AMBULATORIO VACCINALE COVID,LOM,60-69,12,9,0,21,0,0,0,21,0,21,Lombardia,ITC4
2021-01-13,PF/BT,030030,OSPEDALE VALDUCE-AMBULATORIO VACCINALE COVID,LOM,70-79,0,1,0,0,0,0,1,1,0,1,Lombardia,ITC4
2021-01-13,PF/BT,030037,CASA DI CURA VILLA SAN BENEDETTO,LOM,20-29,0,1,0,1,0,0,0,1,0,1,Lombardia,ITC4
2021-01-13,PF/BT,030037,CASA DI CURA VILLA SAN BENEDETTO,LOM,30-39,0,3,0,3,0,0,0,3,0,3,Lombardia,ITC4
2021-01-13,PF/BT,030037,CASA DI CURA VILLA SAN BENEDETTO,LOM,40-49,1,5,0,5,1,0,0,6,0,6,Lombardia,ITC4
2021-01-13,PF/BT,030037,CASA DI CURA VILLA SAN BENEDETTO,LOM,50-59,1,5,0,5,1,0,0,6,0,6,Lombardia,ITC4
2021-01-13,PF/BT,030037,CASA DI CURA VILLA SAN BENEDETTO,LOM,60-69,1,1,0,2,0,0,0,2,0,2,Lombardia,ITC4
2021-01-13,PF/BT,030066,CV Garbagnate,LOM,20-29,1,7,0,7,1,0,0,8,0,8,Lombardia,ITC4
2021-01-13,PF/BT,030066,CV Garbagnate,LOM,30-39,3,5,0,5,3,0,0,8,0,8,Lombardia,ITC4
2021-01-13,PF/BT,030066,CV Garbagnate,LOM,40-49,5,20,0,22,3,0,0,25,0,25,Lombardia,ITC4
2021-01-13,PF/BT,030066,CV Garbagnate,LOM,50-59,11,92,0,92,11,0,0,103,0,103,Lombardia,ITC4
2021-01-13,PF/BT,030066,CV Garbagnate,LOM,60-69,13,33,0,43,3,0,0,46,0,46,Lombardia,ITC4
2021-01-13,PF/BT,030066,CV Garbagnate,LOM,70-79,1,1,0,2,0,0,0,2,0,2,Lombardia,ITC4
2021-01-13,PF/BT,030068,PUNTO VACCINALE OSPEDALIERO DESIO,LOM,16-19,0,1,0,1,0,0,0,1,0,1,Lombardia,ITC4
2021-01-13,PF/BT,030068,PUNTO VACCINALE OSPEDALIERO DESIO,LOM,20-29,10,11,0,21,0,0,0,21,0,21,Lombardia,ITC4
2021-01-13,PF/BT,030068,PUNTO VACCINALE OSPEDALIERO DESIO,LOM,30-39,9,23,0,27,5,0,0,32,0,32,Lombardia,ITC4
2021-01-13,PF/BT,030068,PUNTO VACCINALE OSPEDALIERO DESIO,LOM,40-49,9,31,0,32,8,0,0,40,0,40,Lombardia,ITC4
2021-01-13,PF/BT,030068,PUNTO VACCINALE OSPEDALIERO DESIO,LOM,50-59,15,60,0,47,28,0,0,75,0,75,Lombardia,ITC4
2021-01-13,PF/BT,030068,PUNTO VACCINALE OSPEDALIERO DESIO,LOM,60-69,7,14,0,15,6,0,0,21,0,21,Lombardia,ITC4
2021-01-13,PF/BT,030068,PUNTO VACCINALE OSPEDALIERO DESIO,LOM,70-79,4,2,0,4,2,0,0,6,0,6,Lombardia,ITC4
2021-01-13,PF/BT,030070,PUNTO VACCINALE OSPEDALIERO CARATE BRIANZA,LOM,20-29,4,6,0,8,2,0,0,10,0,10,Lombardia,ITC4
2021-01-13,PF/BT,030070,PUNTO VACCINALE OSPEDALIERO CARATE BRIANZA,LOM,30-39,7,10,0,13,4,0,0,17,0,17,Lombardia,ITC4
2021-01-13,PF/BT,030070,PUNTO VACCINALE OSPEDALIERO CARATE BRIANZA,LOM,40-49,6,26,0,24,8,0,0,32,0,32,Lombardia,ITC4
2021-01-13,PF/BT,030070,PUNTO VACCINALE OSPEDALIERO CARATE BRIANZA,LOM,50-59,8,30,0,28,10,0,0,38,0,38,Lombardia,ITC4
2021-01-13,PF/BT,030070,PUNTO VACCINALE OSPEDALIERO CARATE BRIANZA,LOM,60-69,7,11,0,15,3,0,0,18,0,18,Lombardia,ITC4
2021-01-13,PF/BT,030070,PUNTO VACCINALE OSPEDALIERO CARATE BRIANZA,LOM,70-79,3,2,0,3,2,0,0,5,0,5,Lombardia,ITC4
2021-01-13,PF/BT,030070,PUNTO VACCINALE OSPEDALIERO CARATE BRIANZA,LOM,80-89,1,1,0,1,1,0,0,2,0,2,Lombardia,ITC4
2021-01-13,PF/BT,030070,PUNTO VACCINALE OSPEDALIERO CARATE BRIANZA,LOM,90+,0,1,0,0,1,0,0,1,0,1,Lombardia,ITC4
2021-01-13,PF/BT,030078,PUNTO VACCINALE OSPEDALIERO VIMERCATE,LOM,20-29,7,11,0,17,1,0,0,18,0,18,Lombardia,ITC4
2021-01-13,PF/BT,030078,PUNTO VACCINALE OSPEDALIERO VIMERCATE,LOM,30-39,7,12,0,13,6,0,0,19,0,19,Lombardia,ITC4
2021-01-13,PF/BT,030078,PUNTO VACCINALE OSPEDALIERO VIMERCATE,LOM,40-49,11,28,0,26,13,0,0,39,0,39,Lombardia,ITC4
2021-01-13,PF/BT,030078,PUNTO VACCINALE OSPEDALIERO VIMERCATE,LOM,50-59,5,41,0,26,20,0,0,46,0,46,Lombardia,ITC4
2021-01-13,PF/BT,030078,PUNTO VACCINALE OSPEDALIERO VIMERCATE,LOM,60-69,16,17,0,26,7,0,0,33,0,33,Lombardia,ITC4
2021-01-13,PF/BT,030078,PUNTO VACCINALE OSPEDALIERO VIMERCATE,LOM,70-79,6,8,0,14,0,0,0,14,0,14,Lombardia,ITC4
2021-01-13,PF/BT,030078,PUNTO VACCINALE OSPEDALIERO VIMERCATE,LOM,80-89,3,0,0,3,0,0,0,3,0,3,Lombardia,ITC4
2021-01-13,PF/BT,030097,ISTITUTO CLINICO CITTA' STUDI - MILANO,LOM,20-29,9,5,0,14,0,0,0,14,0,14,Lombardia,ITC4
2021-01-13,PF/BT,030097,ISTITUTO CLINICO CITTA' STUDI - MILANO,LOM,30-39,6,7,0,12,1,0,0,13,0,13,Lombardia,ITC4
2021-01-13,PF/BT,030097,ISTITUTO CLINICO CITTA' STUDI - MILANO,LOM,40-49,5,22,0,21,6,0,0,27,0,27,Lombardia,ITC4
2021-01-13,PF/BT,030097,ISTITUTO CLINICO CITTA' STUDI - MILANO,LOM,50-59,12,22,0,26,8,0,0,34,0,34,Lombardia,ITC4
2021-01-13,PF/BT,030097,ISTITUTO CLINICO CITTA' STUDI - MILANO,LOM,60-69,6,7,0,11,2,0,0,13,0,13,Lombardia,ITC4
2021-01-13,PF/BT,030097,ISTITUTO CLINICO CITTA' STUDI - MILANO,LOM,70-79,1,0,0,1,0,0,0,1,0,1,Lombardia,ITC4
2021-01-13,PF/BT,030107,ISTITUTI CLINICI ZUCCHI - PRESIDIO DI MONZA,LOM,16-19,0,1,0,1,0,0,0,1,0,1,Lombardia,ITC4
2021-01-13,PF/BT,030107,ISTITUTI CLINICI ZUCCHI - PRESIDIO DI MONZA,LOM,20-29,2,7,0,9,0,0,0,9,0,9,Lombardia,ITC4
2021-01-13,PF/BT,030107,ISTITUTI CLINICI ZUCCHI - PRESIDIO DI MONZA,LOM,30-39,4,3,0,7,0,0,0,7,0,7,Lombardia,ITC4
2021-01-13,PF/BT,030107,ISTITUTI CLINICI ZUCCHI - PRESIDIO DI MONZA,LOM,40-49,2,6,0,8,0,0,0,8,0,8,Lombardia,ITC4
2021-01-13,PF/BT,030107,ISTITUTI CLINICI ZUCCHI - PRESIDIO DI MONZA,LOM,50-59,6,11,0,17,0,0,0,17,0,17,Lombardia,ITC4
2021-01-13,PF/BT,030107,ISTITUTI CLINICI ZUCCHI - PRESIDIO DI MONZA,LOM,60-69,1,2,0,3,0,0,0,3,0,3,Lombardia,ITC4
2021-01-13,PF/BT,030107,ISTITUTI CLINICI ZUCCHI - PRESIDIO DI MONZA,LOM,70-79,2,0,0,2,0,0,0,2,0,2,Lombardia,ITC4
2021-01-13,PF/BT,030107,ISTITUTI CLINICI ZUCCHI - PRESIDIO DI MONZA,LOM,80-89,1,0,0,1,0,0,0,1,0,1,Lombardia,ITC4
2021-01-13,PF/BT,030108,ISTITUTI CLINICI ZUCCHI - PRESIDIO DI CARATE BRIANZA,LOM,16-19,7,4,0,11,0,0,0,11,0,11,Lombardia,ITC4
2021-01-13,PF/BT,030108,ISTITUTI CLINICI ZUCCHI - PRESIDIO DI CARATE BRIANZA,LOM,20-29,22,31,0,53,0,0,0,53,0,53,Lombardia,ITC4
2021-01-13,PF/BT,030108,ISTITUTI CLINICI ZUCCHI - PRESIDIO DI CARATE BRIANZA,LOM,30-39,4,12,0,16,0,0,0,16,0,16,Lombardia,ITC4
2021-01-13,PF/BT,030108,ISTITUTI CLINICI ZUCCHI - PRESIDIO DI CARATE BRIANZA,LOM,40-49,2,8,0,10,0,0,0,10,0,10,Lombardia,ITC4
2021-01-13,PF/BT,030108,ISTITUTI CLINICI ZUCCHI - PRESIDIO DI CARATE BRIANZA,LOM,50-59,3,13,0,16,0,0,0,16,0,16,Lombardia,ITC4
2021-01-13,PF/BT,030108,ISTITUTI CLINICI ZUCCHI - PRESIDIO DI CARATE BRIANZA,LOM,60-69,0,1,0,1,0,0,0,1,0,1,Lombardia,ITC4
2021-01-13,PF/BT,030108,ISTITUTI CLINICI ZUCCHI - PRESIDIO DI CARATE BRIANZA,LOM,70-79,1,0,0,1,0,0,0,1,0,1,Lombardia,ITC4
2021-01-13,PF/BT,030178,ISTITUTO CLINICO CITTA' DI BRESCIA DI ISTITUTI OSPEDALIERI BRESCIANI,LOM,20-29,3,3,0,6,0,0,0,6,0,6,Lombardia,ITC4
2021-01-13,PF/BT,030178,ISTITUTO CLINICO CITTA' DI BRESCIA DI ISTITUTI OSPEDALIERI BRESCIANI,LOM,30-39,2,5,0,5,2,0,0,7,0,7,Lombardia,ITC4
2021-01-13,PF/BT,030178,ISTITUTO CLINICO CITTA' DI BRESCIA DI ISTITUTI OSPEDALIERI BRESCIANI,LOM,40-49,1,6,0,6,1,0,0,7,0,7,Lombardia,ITC4
2021-01-13,PF/BT,030178,ISTITUTO CLINICO CITTA' DI BRESCIA DI ISTITUTI OSPEDALIERI BRESCIANI,LOM,50-59,0,8,0,5,3,0,0,8,0,8,Lombardia,ITC4
2021-01-13,PF/BT,030178,ISTITUTO CLINICO CITTA' DI BRESCIA DI ISTITUTI OSPEDALIERI BRESCIANI,LOM,60-69,1,1,0,1,1,0,0,2,0,2,Lombardia,ITC4
2021-01-13,PF/BT,03019800,ISTITUTO CLINICO BEATO MATTEO,LOM,20-29,0,6,0,6,0,0,0,6,0,6,Lombardia,ITC4
2021-01-13,PF/BT,03019800,ISTITUTO CLINICO BEATO MATTEO,LOM,30-39,0,5,0,5,0,0,0,5,0,5,Lombardia,ITC4
2021-01-13,PF/BT,03019800,ISTITUTO CLINICO BEATO MATTEO,LOM,40-49,3,6,0,9,0,0,0,9,0,9,Lombardia,ITC4
2021-01-13,PF/BT,03019800,ISTITUTO CLINICO BEATO MATTEO,LOM,50-59,1,1,0,2,0,0,0,2,0,2,Lombardia,ITC4
2021-01-13,PF/BT,03019800,ISTITUTO CLINICO BEATO MATTEO,LOM,60-69,1,1,0,2,0,0,0,2,0,2,Lombardia,ITC4
2021-01-13,PF/BT,03020200,ISTITUTO DI CURA CITTA' DI PAVIA,LOM,20-29,0,2,0,2,0,0,0,2,0,2,Lombardia,ITC4
2021-01-13,PF/BT,03020200,ISTITUTO DI CURA CITTA' DI PAVIA,LOM,30-39,2,0,0,2,0,0,0,2,0,2,Lombardia,ITC4
2021-01-13,PF/BT,03020200,ISTITUTO DI CURA CITTA' DI PAVIA,LOM,40-49,1,8,0,9,0,0,0,9,0,9,Lombardia,ITC4
2021-01-13,PF/BT,03020200,ISTITUTO DI CURA CITTA' DI PAVIA,LOM,50-59,3,4,0,7,0,0,0,7,0,7,Lombardia,ITC4
2021-01-13,PF/BT,03020200,ISTITUTO DI CURA CITTA' DI PAVIA,LOM,60-69,2,1,0,3,0,0,0,3,0,3,Lombardia,ITC4
2021-01-13,PF/BT,03020200,ISTITUTO DI CURA CITTA' DI PAVIA,LOM,70-79,1,0,0,1,0,0,0,1,0,1,Lombardia,ITC4
2021-01-13,PF/BT,030295,Fondazione Poliambulanza - Brescia,LOM,20-29,11,19,0,26,4,0,0,30,0,30,Lombardia,ITC4
2021-01-13,PF/BT,030295,Fondazione Poliambulanza - Brescia,LOM,30-39,9,24,0,31,2,0,0,33,0,33,Lombardia,ITC4
2021-01-13,PF/BT,030295,Fondazione Poliambulanza - Brescia,LOM,40-49,12,42,0,45,9,0,0,54,0,54,Lombardia,ITC4
2021-01-13,PF/BT,030295,Fondazione Poliambulanza - Brescia,LOM,50-59,15,26,0,30,11,0,0,41,0,41,Lombardia,ITC4
2021-01-13,PF/BT,030295,Fondazione Poliambulanza - Brescia,LOM,60-69,4,6,0,9,1,0,0,10,0,10,Lombardia,ITC4
2021-01-13,PF/BT,030-322-030032,Istituto Clinico Villa Aprica,LOM,20-29,1,1,0,2,0,0,0,2,0,2,Lombardia,ITC4
2021-01-13,PF/BT,030-322-030032,Istituto Clinico Villa Aprica,LOM,30-39,3,1,0,4,0,0,0,4,0,4,Lombardia,ITC4
2021-01-13,PF/BT,030-322-030032,Istituto Clinico Villa Aprica,LOM,40-49,3,5,0,8,0,0,0,8,0,8,Lombardia,ITC4
2021-01-13,PF/BT,030-322-030032,Istituto Clinico Villa Aprica,LOM,50-59,7,1,0,8,0,0,0,8,0,8,Lombardia,ITC4
2021-01-13,PF/BT,030-322-030032,Istituto Clinico Villa Aprica,LOM,60-69,8,2,0,10,0,0,0,10,0,10,Lombardia,ITC4
2021-01-13,PF/BT,030-322-030032,Istituto Clinico Villa Aprica,LOM,70-79,3,0,0,3,0,0,0,3,0,3,Lombardia,ITC4
2021-01-13,PF/BT,030-322-030032,Istituto Clinico Villa Aprica,LOM,80-89,1,0,0,1,0,0,0,1,0,1,Lombardia,ITC4
2021-01-13,PF/BT,030-322-030347,CASA DI CURA VILLA S.GIUSEPPE-ANZANO DEL PARCO,LOM,20-29,1,0,0,1,0,0,0,1,0,1,Lombardia,ITC4
2021-01-13,PF/BT,030-322-030347,CASA DI CURA VILLA S.GIUSEPPE-ANZANO DEL PARCO,LOM,30-39,5,0,0,5,0,0,0,5,0,5,Lombardia,ITC4
2021-01-13,PF/BT,030-322-030347,CASA DI CURA VILLA S.GIUSEPPE-ANZANO DEL PARCO,LOM,40-49,3,8,0,9,2,0,0,11,0,11,Lombardia,ITC4
2021-01-13,PF/BT,030-322-030347,CASA DI CURA VILLA S.GIUSEPPE-ANZANO DEL PARCO,LOM,50-59,2,3,0,3,2,0,0,5,0,5,Lombardia,ITC4
2021-01-13,PF/BT,030-322-030347,CASA DI CURA VILLA S.GIUSEPPE-ANZANO DEL PARCO,LOM,70-79,2,0,0,2,0,0,0,2,0,2,Lombardia,ITC4
2021-01-13,PF/BT,030324001093 -  030324001116,ISTIT.RIUNITI AIROLDI E MUZZI,LOM,20-29,0,2,0,1,0,0,1,2,0,2,Lombardia,ITC4
2021-01-13,PF/BT,030324001093 -  030324001116,ISTIT.RIUNITI AIROLDI E MUZZI,LOM,30-39,1,2,0,1,0,0,2,3,0,3,Lombardia,ITC4
2021-01-13,PF/BT,030324001093 -  030324001116,ISTIT.RIUNITI AIROLDI E MUZZI,LOM,40-49,0,10,0,8,2,0,0,10,0,10,Lombardia,ITC4
2021-01-13,PF/BT,030324001093 -  030324001116,ISTIT.RIUNITI AIROLDI E MUZZI,LOM,50-59,1,6,0,2,4,1,0,7,0,7,Lombardia,ITC4
2021-01-13,PF/BT,030324001093 -  030324001116,ISTIT.RIUNITI AIROLDI E MUZZI,LOM,60-69,2,2,0,1,1,2,0,4,0,4,Lombardia,ITC4
2021-01-13,PF/BT,030324001093 -  030324001116,ISTIT.RIUNITI AIROLDI E MUZZI,LOM,70-79,6,7,0,1,0,12,0,13,0,13,Lombardia,ITC4
2021-01-13,PF/BT,030324001093 -  030324001116,ISTIT.RIUNITI AIROLDI E MUZZI,LOM,80-89,8,22,0,0,0,30,0,30,0,30,Lombardia,ITC4
2021-01-13,PF/BT,030324001093 -  030324001116,ISTIT.RIUNITI AIROLDI E MUZZI,LOM,90+,5,22,0,0,0,27,0,27,0,27,Lombardia,ITC4
2021-01-13,PF/BT,030-327-001768,FONDAZIONE RSA SONCINO ONLUS,LOM,20-29,1,7,0,5,3,0,0,8,0,8,Lombardia,ITC4
2021-01-13,PF/BT,030-327-001768,FONDAZIONE RSA SONCINO ONLUS,LOM,30-39,2,7,0,6,2,1,0,9,0,9,Lombardia,ITC4
2021-01-13,PF/BT,030-327-001768,FONDAZIONE RSA SONCINO ONLUS,LOM,40-49,6,10,0,10,3,3,0,16,0,16,Lombardia,ITC4
2021-01-13,PF/BT,030-327-001768,FONDAZIONE RSA SONCINO ONLUS,LOM,50-59,9,13,0,12,2,8,0,22,0,22,Lombardia,ITC4
2021-01-13,PF/BT,030-327-001768,FONDAZIONE RSA SONCINO ONLUS,LOM,60-69,5,9,0,3,1,10,0,14,0,14,Lombardia,ITC4
2021-01-13,PF/BT,030-327-001768,FONDAZIONE RSA SONCINO ONLUS,LOM,70-79,4,5,0,0,0,8,1,9,0,9,Lombardia,ITC4
2021-01-13,PF/BT,030-327-001768,FONDAZIONE RSA SONCINO ONLUS,LOM,80-89,3,9,0,0,0,12,0,12,0,12,Lombardia,ITC4
2021-01-13,PF/BT,030-327-001768,FONDAZIONE RSA SONCINO ONLUS,LOM,90+,0,12,0,0,0,12,0,12,0,12,Lombardia,ITC4
2021-01-13,PF/BT,030704,Polo Riabilitativo FFO,LOM,20-29,1,0,0,1,0,0,0,1,0,1,Lombardia,ITC4
2021-01-13,PF/BT,030704,Polo Riabilitativo FFO,LOM,30-39,3,5,0,6,2,0,0,8,0,8,Lombardia,ITC4
2021-01-13,PF/BT,030704,Polo Riabilitativo FFO,LOM,40-49,1,9,0,7,3,0,0,10,0,10,Lombardia,ITC4
2021-01-13,PF/BT,030704,Polo Riabilitativo FFO,LOM,50-59,6,4,0,9,1,0,0,10,0,10,Lombardia,ITC4
2021-01-13,PF/BT,030704,Polo Riabilitativo FFO,LOM,60-69,1,5,0,4,2,0,0,6,0,6,Lombardia,ITC4
2021-01-13,PF/BT,030704,Polo Riabilitativo FFO,LOM,70-79,1,0,0,0,1,0,0,1,0,1,Lombardia,ITC4
2021-01-13,PF/BT,030704,Presidio Ospedaliero CTO,LOM,20-29,5,3,0,3,5,0,0,8,0,8,Lombardia,ITC4
2021-01-13,PF/BT,030704,Presidio Ospedaliero CTO,LOM,30-39,3,9,0,9,3,0,0,12,0,12,Lombardia,ITC4
2021-01-13,PF/BT,030704,Presidio Ospedaliero CTO,LOM,40-49,8,6,0,6,8,0,0,14,0,14,Lombardia,ITC4
2021-01-13,PF/BT,030704,Presidio Ospedaliero CTO,LOM,50-59,8,11,0,8,11,0,0,19,0,19,Lombardia,ITC4
2021-01-13,PF/BT,030704,Presidio Ospedaliero CTO,LOM,60-69,3,3,0,3,3,0,0,6,0,6,Lombardia,ITC4
2021-01-13,PF/BT,030704,Presidio Ospedaliero CTO,LOM,70-79,1,0,0,0,1,0,0,1,0,1,Lombardia,ITC4
2021-01-13,PF/BT,030704,Presidio Ospedaliero G. Pini,LOM,16-19,1,0,0,0,1,0,0,1,0,1,Lombardia,ITC4
2021-01-13,PF/BT,030704,Presidio Ospedaliero G. Pini,LOM,20-29,7,6,0,10,3,0,0,13,0,13,Lombardia,ITC4
2021-01-13,PF/BT,030704,Presidio Ospedaliero G. Pini,LOM,30-39,14,6,0,11,9,0,0,20,0,20,Lombardia,ITC4
2021-01-13,PF/BT,030704,Presidio Ospedaliero G. Pini,LOM,40-49,12,11,0,10,13,0,0,23,0,23,Lombardia,ITC4
2021-01-13,PF/BT,030704,Presidio Ospedaliero G. Pini,LOM,50-59,11,20,0,16,15,0,0,31,0,31,Lombardia,ITC4
2021-01-13,PF/BT,030704,Presidio Ospedaliero G. Pini,LOM,60-69,4,4,0,5,3,0,0,8,0,8,Lombardia,ITC4
2021-01-13,PF/BT,030903,AMB COVID LECCO,LOM,16-19,3,0,0,0,3,0,0,3,0,3,Lombardia,ITC4
2021-01-13,PF/BT,030903,AMB COVID LECCO,LOM,20-29,33,61,0,55,39,0,0,94,0,94,Lombardia,ITC4
2021-01-13,PF/BT,030903,AMB COVID LECCO,LOM,30-39,52,72,0,76,48,0,0,124,0,124,Lombardia,ITC4
2021-01-13,PF/BT,030903,AMB COVID LECCO,LOM,40-49,51,120,0,108,63,0,0,171,0,171,Lombardia,ITC4
2021-01-13,PF/BT,030903,AMB COVID LECCO,LOM,50-59,73,100,0,111,62,0,0,173,0,173,Lombardia,ITC4
2021-01-13,PF/BT,030903,AMB COVID LECCO,LOM,60-69,42,43,0,37,48,0,0,85,0,85,Lombardia,ITC4
2021-01-13,PF/BT,030903,AMB COVID LECCO,LOM,70-79,17,6,0,5,18,0,0,23,0,23,Lombardia,ITC4
2021-01-13,PF/BT,030903,AMB COVID LECCO,LOM,80-89,1,1,0,0,2,0,0,2,0,2,Lombardia,ITC4
2021-01-13,PF/BT,030922,"FOND.IRCCS ""ISTIT.NAZ.LE TUMORI""MILANO",LOM,20-29,8,24,0,17,10,0,5,32,0,32,Lombardia,ITC4
2021-01-13,PF/BT,030922,"FOND.IRCCS ""ISTIT.NAZ.LE TUMORI""MILANO",LOM,30-39,20,23,0,22,16,0,5,43,0,43,Lombardia,ITC4
2021-01-13,PF/BT,030922,"FOND.IRCCS ""ISTIT.NAZ.LE TUMORI""MILANO",LOM,40-49,11,28,0,12,24,0,3,39,0,39,Lombardia,ITC4
2021-01-13,PF/BT,030922,"FOND.IRCCS ""ISTIT.NAZ.LE TUMORI""MILANO",LOM,50-59,28,63,0,34,42,0,15,91,0,91,Lombardia,ITC4
2021-01-13,PF/BT,030922,"FOND.IRCCS ""ISTIT.NAZ.LE TUMORI""MILANO",LOM,60-69,11,22,0,14,15,0,4,33,0,33,Lombardia,ITC4
2021-01-13,PF/BT,030922,"FOND.IRCCS ""ISTIT.NAZ.LE TUMORI""MILANO",LOM,70-79,1,1,0,0,0,0,2,2,0,2,Lombardia,ITC4
2021-01-13,PF/BT,030923,FOND.IRCCS IST.NAZ.NEUROLOGICO C.BESTA-MI,LOM,20-29,0,6,0,4,2,0,0,6,0,6,Lombardia,ITC4
2021-01-13,PF/BT,030923,FOND.IRCCS IST.NAZ.NEUROLOGICO C.BESTA-MI,LOM,30-39,9,19,0,16,6,0,6,28,0,28,Lombardia,ITC4
2021-01-13,PF/BT,030923,FOND.IRCCS IST.NAZ.NEUROLOGICO C.BESTA-MI,LOM,40-49,10,6,0,8,5,0,3,16,0,16,Lombardia,ITC4
2021-01-13,PF/BT,030923,FOND.IRCCS IST.NAZ.NEUROLOGICO C.BESTA-MI,LOM,50-59,11,15,0,13,9,0,4,26,0,26,Lombardia,ITC4
2021-01-13,PF/BT,030923,FOND.IRCCS IST.NAZ.NEUROLOGICO C.BESTA-MI,LOM,60-69,2,3,0,2,0,0,3,5,0,5,Lombardia,ITC4
2021-01-13,PF/BT,030923,FOND.IRCCS IST.NAZ.NEUROLOGICO C.BESTA-MI,LOM,70-79,0,2,0,1,0,0,1,2,0,2,Lombardia,ITC4
2021-01-13,PF/BT,030923,FOND.IRCCS IST.NAZ.NEUROLOGICO C.BESTA-MI,LOM,90+,0,1,0,0,0,0,1,1,0,1,Lombardia,ITC4
2021-01-13,PF/BT,030924,IRCCS POLICLINICO S. MATTEO - PAVIA,LOM,20-29,18,42,0,47,10,0,3,60,0,60,Lombardia,ITC4
2021-01-13,PF/BT,030924,IRCCS POLICLINICO S. MATTEO - PAVIA,LOM,30-39,34,66,0,75,24,0,1,100,0,100,Lombardia,ITC4
2021-01-13,PF/BT,030924,IRCCS POLICLINICO S. MATTEO - PAVIA,LOM,40-49,13,32,0,41,4,0,0,45,0,45,Lombardia,ITC4
2021-01-13,PF/BT,030924,IRCCS POLICLINICO S. MATTEO - PAVIA,LOM,50-59,27,55,0,70,10,0,2,82,0,82,Lombardia,ITC4
2021-01-13,PF/BT,030924,IRCCS POLICLINICO S. MATTEO - PAVIA,LOM,60-69,9,10,0,18,1,0,0,19,0,19,Lombardia,ITC4
2021-01-13,PF/BT,030925,Fondazione IRCCS Ca' Granda Ospedale Maggiore Policlinico,LOM,20-29,10,35,0,42,3,0,0,45,0,45,Lombardia,ITC4
2021-01-13,PF/BT,030925,Fondazione IRCCS Ca' Granda Ospedale Maggiore Policlinico,LOM,30-39,21,52,0,61,12,0,0,73,0,73,Lombardia,ITC4
2021-01-13,PF/BT,030925,Fondazione IRCCS Ca' Granda Ospedale Maggiore Policlinico,LOM,40-49,18,53,0,58,13,0,0,71,0,71,Lombardia,ITC4
2021-01-13,PF/BT,030925,Fondazione IRCCS Ca' Granda Ospedale Maggiore Policlinico,LOM,50-59,25,64,0,65,24,0,0,89,0,89,Lombardia,ITC4
2021-01-13,PF/BT,030925,Fondazione IRCCS Ca' Granda Ospedale Maggiore Policlinico,LOM,60-69,17,19,0,26,10,0,0,36,0,36,Lombardia,ITC4
2021-01-13,PF/BT,030925,Fondazione IRCCS Ca' Granda Ospedale Maggiore Policlinico,LOM,70-79,2,3,0,5,0,0,0,5,0,5,Lombardia,ITC4
2021-01-13,PF/BT,030935,IRCCS    S. RAFFAELE - MILANO,LOM,20-29,3,6,0,9,0,0,0,9,0,9,Lombardia,ITC4
2021-01-13,PF/BT,030935,IRCCS    S. RAFFAELE - MILANO,LOM,30-39,8,12,0,20,0,0,0,20,0,20,Lombardia,ITC4
2021-01-13,PF/BT,030935,IRCCS    S. RAFFAELE - MILANO,LOM,40-49,33,51,0,84,0,0,0,84,0,84,Lombardia,ITC4
2021-01-13,PF/BT,030935,IRCCS    S. RAFFAELE - MILANO,LOM,50-59,36,68,0,104,0,0,0,104,0,104,Lombardia,ITC4
2021-01-13,PF/BT,030935,IRCCS    S. RAFFAELE - MILANO,LOM,60-69,2,6,0,8,0,0,0,8,0,8,Lombardia,ITC4
2021-01-13,PF/BT,030935,IRCCS    S. RAFFAELE - MILANO,LOM,70-79,2,1,0,3,0,0,0,3,0,3,Lombardia,ITC4
2021-01-13,PF/BT,030937,PRO JOVENTUDE DON C. GNOCCHI - MI IRCCS PRIVATO,LOM,20-29,2,7,0,9,0,0,0,9,0,9,Lombardia,ITC4
2021-01-13,PF/BT,030937,PRO JOVENTUDE DON C. GNOCCHI - MI IRCCS PRIVATO,LOM,30-39,4,14,0,18,0,0,0,18,0,18,Lombardia,ITC4
2021-01-13,PF/BT,030937,PRO JOVENTUDE DON C. GNOCCHI - MI IRCCS PRIVATO,LOM,40-49,5,28,0,29,4,0,0,33,0,33,Lombardia,ITC4
2021-01-13,PF/BT,030937,PRO JOVENTUDE DON C. GNOCCHI - MI IRCCS PRIVATO,LOM,50-59,7,29,0,32,4,0,0,36,0,36,Lombardia,ITC4
2021-01-13,PF/BT,030937,PRO JOVENTUDE DON C. GNOCCHI - MI IRCCS PRIVATO,LOM,60-69,3,12,0,12,3,0,0,15,0,15,Lombardia,ITC4
2021-01-13,PF/BT,030937,PRO JOVENTUDE DON C. GNOCCHI - MI IRCCS PRIVATO,LOM,70-79,1,1,0,2,0,0,0,2,0,2,Lombardia,ITC4
2021-01-13,PF/BT,030937,PRO JOVENTUDE DON C. GNOCCHI - MI IRCCS PRIVATO,LOM,80-89,0,1,0,1,0,0,0,1,0,1,Lombardia,ITC4
2021-01-13,PF/BT,030943,Istituto Clinico Humanitas,LOM,16-19,2,8,0,10,0,0,0,10,0,10,Lombardia,ITC4
2021-01-13,PF/BT,030943,Istituto Clinico Humanitas,LOM,20-29,54,83,0,128,9,0,0,137,0,137,Lombardia,ITC4
2021-01-13,PF/BT,030943,Istituto Clinico Humanitas,LOM,30-39,21,15,0,18,18,0,0,36,0,36,Lombardia,ITC4
2021-01-13,PF/BT,030943,Istituto Clinico Humanitas,LOM,40-49,14,24,0,23,15,0,0,38,0,38,Lombardia,ITC4
2021-01-13,PF/BT,030943,Istituto Clinico Humanitas,LOM,50-59,12,20,0,16,16,0,0,32,0,32,Lombardia,ITC4
2021-01-13,PF/BT,030943,Istituto Clinico Humanitas,LOM,60-69,6,7,0,7,5,0,1,13,0,13,Lombardia,ITC4
2021-01-13,PF/BT,030943,Istituto Clinico Humanitas,LOM,70-79,4,0,0,3,1,0,0,4,0,4,Lombardia,ITC4
2021-01-13,PF/BT,030950,IRCCS   S. RAFFAELE TURRO - MILANO,LOM,20-29,0,1,0,1,0,0,0,1,0,1,Lombardia,ITC4
2021-01-13,PF/BT,030950,IRCCS   S. RAFFAELE TURRO - MILANO,LOM,30-39,10,21,0,31,0,0,0,31,0,31,Lombardia,ITC4
2021-01-13,PF/BT,030950,IRCCS   S. RAFFAELE TURRO - MILANO,LOM,40-49,0,10,0,10,0,0,0,10,0,10,Lombardia,ITC4
2021-01-13,PF/BT,030950,IRCCS   S. RAFFAELE TURRO - MILANO,LOM,50-59,1,2,0,3,0,0,0,3,0,3,Lombardia,ITC4
2021-01-13,PF/BT,030950,IRCCS   S. RAFFAELE TURRO - MILANO,LOM,60-69,0,3,0,3,0,0,0,3,0,3,Lombardia,ITC4
2021-01-13,PF/BT,066549,RSA BERNINA,LOM,20-29,0,2,0,2,0,0,0,2,0,2,Lombardia,ITC4
2021-01-13,PF/BT,066549,RSA BERNINA,LOM,30-39,2,4,0,4,2,0,0,6,0,6,Lombardia,ITC4
2021-01-13,PF/BT,066549,RSA BERNINA,LOM,40-49,0,5,0,2,3,0,0,5,0,5,Lombardia,ITC4
2021-01-13,PF/BT,066549,RSA BERNINA,LOM,50-59,0,5,0,4,1,0,0,5,0,5,Lombardia,ITC4
2021-01-13,PF/BT,1142,RSA Casa Madonna della Fiducia,LOM,20-29,1,10,0,11,0,0,0,11,0,11,Lombardia,ITC4
2021-01-13,PF/BT,1142,RSA Casa Madonna della Fiducia,LOM,30-39,2,6,0,4,3,0,1,8,0,8,Lombardia,ITC4
2021-01-13,PF/BT,1142,RSA Casa Madonna della Fiducia,LOM,40-49,3,22,0,23,2,0,0,25,0,25,Lombardia,ITC4
2021-01-13,PF/BT,1142,RSA Casa Madonna della Fiducia,LOM,50-59,1,15,0,14,2,0,0,16,0,16,Lombardia,ITC4
2021-01-13,PF/BT,1142,RSA Casa Madonna della Fiducia,LOM,60-69,1,5,0,5,0,0,1,6,0,6,Lombardia,ITC4
2021-01-13,PF/BT,1156,RSA FONDAZIONE CASA DEL CIECO - CIVATE (LC),LOM,30-39,0,1,0,1,0,0,0,1,0,1,Lombardia,ITC4
2021-01-13,PF/BT,1156,RSA FONDAZIONE CASA DEL CIECO - CIVATE (LC),LOM,40-49,0,3,0,3,0,0,0,3,0,3,Lombardia,ITC4
2021-01-13,PF/BT,1156,RSA FONDAZIONE CASA DEL CIECO - CIVATE (LC),LOM,60-69,2,3,0,0,0,5,0,5,0,5,Lombardia,ITC4
2021-01-13,PF/BT,1156,RSA FONDAZIONE CASA DEL CIECO - CIVATE (LC),LOM,70-79,1,5,0,0,0,6,0,6,0,6,Lombardia,ITC4
2021-01-13,PF/BT,1156,RSA FONDAZIONE CASA DEL CIECO - CIVATE (LC),LOM,80-89,9,17,0,0,0,26,0,26,0,26,Lombardia,ITC4
2021-01-13,PF/BT,1156,RSA FONDAZIONE CASA DEL CIECO - CIVATE (LC),LOM,90+,6,25,0,0,0,31,0,31,0,31,Lombardia,ITC4
2021-01-13,PF/BT,1220,ISTITUTO CLINICO QUARENGHI S.R.L.,LOM,20-29,2,2,0,4,0,0,0,4,0,4,Lombardia,ITC4
2021-01-13,PF/BT,1220,ISTITUTO CLINICO QUARENGHI S.R.L.,LOM,30-39,1,2,0,3,0,0,0,3,0,3,Lombardia,ITC4
2021-01-13,PF/BT,1220,ISTITUTO CLINICO QUARENGHI S.R.L.,LOM,40-49,2,0,0,2,0,0,0,2,0,2,Lombardia,ITC4
2021-01-13,PF/BT,1220,ISTITUTO CLINICO QUARENGHI S.R.L.,LOM,50-59,1,2,0,3,0,0,0,3,0,3,Lombardia,ITC4
2021-01-13,PF/BT,1220,ISTITUTO CLINICO QUARENGHI S.R.L.,LOM,60-69,3,3,0,6,0,0,0,6,0,6,Lombardia,ITC4
2021-01-13,PF/BT,1411,Fondazione Don Stefano Palla Onlus,LOM,20-29,4,4,0,6,2,0,0,8,0,8,Lombardia,ITC4
2021-01-13,PF/BT,1411,Fondazione Don Stefano Palla Onlus,LOM,30-39,7,5,0,9,3,0,0,12,0,12,Lombardia,ITC4
2021-01-13,PF/BT,1411,Fondazione Don Stefano Palla Onlus,LOM,40-49,11,8,0,13,4,0,2,19,0,19,Lombardia,ITC4
2021-01-13,PF/BT,1411,Fondazione Don Stefano Palla Onlus,LOM,50-59,10,6,0,8,3,0,5,16,0,16,Lombardia,ITC4
2021-01-13,PF/BT,1411,Fondazione Don Stefano Palla Onlus,LOM,60-69,8,3,0,3,1,0,7,11,0,11,Lombardia,ITC4
2021-01-13,PF/BT,1411,Fondazione Don Stefano Palla Onlus,LOM,70-79,4,0,0,0,0,0,4,4,0,4,Lombardia,ITC4
2021-01-13,PF/BT,1411,Fondazione Don Stefano Palla Onlus,LOM,80-89,2,0,0,0,0,0,2,2,0,2,Lombardia,ITC4
2021-01-13,PF/BT,1473,CASA DI RIPOSO DON FERDINANDO CREMONA ONLUS,LOM,20-29,3,2,0,5,0,0,0,5,0,5,Lombardia,ITC4
2021-01-13,PF/BT,1473,CASA DI RIPOSO DON FERDINANDO CREMONA ONLUS,LOM,30-39,1,4,0,4,1,0,0,5,0,5,Lombardia,ITC4
2021-01-13,PF/BT,1473,CASA DI RIPOSO DON FERDINANDO CREMONA ONLUS,LOM,40-49,1,12,0,10,3,0,0,13,0,13,Lombardia,ITC4
2021-01-13,PF/BT,1473,CASA DI RIPOSO DON FERDINANDO CREMONA ONLUS,LOM,50-59,2,9,0,5,4,0,2,11,0,11,Lombardia,ITC4
2021-01-13,PF/BT,1473,CASA DI RIPOSO DON FERDINANDO CREMONA ONLUS,LOM,60-69,0,2,0,2,0,0,0,2,0,2,Lombardia,ITC4
2021-01-13,PF/BT,1473,CASA DI RIPOSO DON FERDINANDO CREMONA ONLUS,LOM,70-79,1,1,0,0,0,2,0,2,0,2,Lombardia,ITC4
2021-01-13,PF/BT,1473,CASA DI RIPOSO DON FERDINANDO CREMONA ONLUS,LOM,80-89,2,17,0,0,0,19,0,19,0,19,Lombardia,ITC4
2021-01-13,PF/BT,1473,CASA DI RIPOSO DON FERDINANDO CREMONA ONLUS,LOM,90+,1,8,0,0,0,9,0,9,0,9,Lombardia,ITC4
2021-01-13,PF/BT,1480,"Rsa ""Sorelle Girelli"" Marone (BS)",LOM,60-69,1,0,0,0,0,1,0,1,0,1,Lombardia,ITC4
2021-01-13,PF/BT,1480,"Rsa ""Sorelle Girelli"" Marone (BS)",LOM,70-79,1,1,0,0,0,2,0,2,0,2,Lombardia,ITC4
2021-01-13,PF/BT,1480,"Rsa ""Sorelle Girelli"" Marone (BS)",LOM,80-89,2,5,0,0,0,7,0,7,0,7,Lombardia,ITC4
2021-01-13,PF/BT,1480,"Rsa ""Sorelle Girelli"" Marone (BS)",LOM,90+,1,7,0,0,0,8,0,8,0,8,Lombardia,ITC4
2021-01-13,PF/BT,1544,CENTRO DIURNO RSA CASA INDUSTRIA,LOM,30-39,3,0,0,1,2,0,0,3,0,3,Lombardia,ITC4
2021-01-13,PF/BT,1544,CENTRO DIURNO RSA CASA INDUSTRIA,LOM,40-49,1,2,0,2,1,0,0,3,0,3,Lombardia,ITC4
2021-01-13,PF/BT,1544,CENTRO DIURNO RSA CASA INDUSTRIA,LOM,50-59,0,5,0,3,2,0,0,5,0,5,Lombardia,ITC4
2021-01-13,PF/BT,1544,CENTRO DIURNO RSA CASA INDUSTRIA,LOM,60-69,0,1,0,1,0,0,0,1,0,1,Lombardia,ITC4
2021-01-13,PF/BT,159,PVO COVID OSPEDALI DI MONTICHIARI,LOM,20-29,5,18,0,17,6,0,0,23,0,23,Lombardia,ITC4
2021-01-13,PF/BT,159,PVO COVID OSPEDALI DI MONTICHIARI,LOM,30-39,19,26,0,37,8,0,0,45,0,45,Lombardia,ITC4
2021-01-13,PF/BT,159,PVO COVID OSPEDALI DI MONTICHIARI,LOM,40-49,9,45,0,38,16,0,0,54,0,54,Lombardia,ITC4
2021-01-13,PF/BT,159,PVO COVID OSPEDALI DI MONTICHIARI,LOM,50-59,16,56,0,39,33,0,0,72,0,72,Lombardia,ITC4
2021-01-13,PF/BT,159,PVO COVID OSPEDALI DI MONTICHIARI,LOM,60-69,13,15,0,12,16,0,0,28,0,28,Lombardia,ITC4
2021-01-13,PF/BT,1591,Fondazione O.P. Delbarba Maselli Dandolo ONLUS,LOM,20-29,0,2,0,2,0,0,0,2,0,2,Lombardia,ITC4
2021-01-13,PF/BT,1591,Fondazione O.P. Delbarba Maselli Dandolo ONLUS,LOM,30-39,0,2,0,2,0,0,0,2,0,2,Lombardia,ITC4
2021-01-13,PF/BT,1591,Fondazione O.P. Delbarba Maselli Dandolo ONLUS,LOM,40-49,0,6,0,6,0,0,0,6,0,6,Lombardia,ITC4
2021-01-13,PF/BT,1591,Fondazione O.P. Delbarba Maselli Dandolo ONLUS,LOM,50-59,0,12,0,10,2,0,0,12,0,12,Lombardia,ITC4
2021-01-13,PF/BT,1591,Fondazione O.P. Delbarba Maselli Dandolo ONLUS,LOM,60-69,0,2,0,1,1,0,0,2,0,2,Lombardia,ITC4
2021-01-13,PF/BT,162,PVO COVID OSPEDALI DI GARDONE V.T.,LOM,20-29,1,17,0,10,8,0,0,18,0,18,Lombardia,ITC4
2021-01-13,PF/BT,162,PVO COVID OSPEDALI DI GARDONE V.T.,LOM,30-39,13,24,0,26,11,0,0,37,0,37,Lombardia,ITC4
2021-01-13,PF/BT,162,PVO COVID OSPEDALI DI GARDONE V.T.,LOM,40-49,11,42,0,38,15,0,0,53,0,53,Lombardia,ITC4
2021-01-13,PF/BT,162,PVO COVID OSPEDALI DI GARDONE V.T.,LOM,50-59,28,56,0,36,48,0,0,84,0,84,Lombardia,ITC4
2021-01-13,PF/BT,162,PVO COVID OSPEDALI DI GARDONE V.T.,LOM,60-69,6,11,0,7,10,0,0,17,0,17,Lombardia,ITC4
2021-01-13,PF/BT,162,PVO COVID OSPEDALI DI GARDONE V.T.,LOM,70-79,1,0,0,0,0,0,1,1,0,1,Lombardia,ITC4
2021-01-13,PF/BT,1640, RSA LORENZO E GIANNA ZIROTTI,LOM,60-69,1,1,0,0,0,2,0,2,0,2,Lombardia,ITC4
2021-01-13,PF/BT,1640, RSA LORENZO E GIANNA ZIROTTI,LOM,70-79,3,0,0,0,0,3,0,3,0,3,Lombardia,ITC4
2021-01-13,PF/BT,1640, RSA LORENZO E GIANNA ZIROTTI,LOM,80-89,2,9,0,0,0,11,0,11,0,11,Lombardia,ITC4
2021-01-13,PF/BT,1640, RSA LORENZO E GIANNA ZIROTTI,LOM,90+,1,8,0,0,0,9,0,9,0,9,Lombardia,ITC4
2021-01-13,PF/BT,167,ASST SPEDALI CIVILI AMBULATORIO COVID BRESCIA,LOM,16-19,13,15,0,16,12,0,0,28,0,28,Lombardia,ITC4
2021-01-13,PF/BT,167,ASST SPEDALI CIVILI AMBULATORIO COVID BRESCIA,LOM,20-29,18,25,0,19,24,0,0,43,0,43,Lombardia,ITC4
2021-01-13,PF/BT,167,ASST SPEDALI CIVILI AMBULATORIO COVID BRESCIA,LOM,30-39,16,50,0,29,37,0,0,66,0,66,Lombardia,ITC4
2021-01-13,PF/BT,167,ASST SPEDALI CIVILI AMBULATORIO COVID BRESCIA,LOM,40-49,26,75,0,30,71,0,0,101,0,101,Lombardia,ITC4
2021-01-13,PF/BT,167,ASST SPEDALI CIVILI AMBULATORIO COVID BRESCIA,LOM,50-59,13,19,0,12,20,0,0,32,0,32,Lombardia,ITC4
2021-01-13,PF/BT,1724,Fondazione Casa di Riposo di Ghedi ONLUS,LOM,70-79,2,3,0,0,0,5,0,5,0,5,Lombardia,ITC4
2021-01-13,PF/BT,1724,Fondazione Casa di Riposo di Ghedi ONLUS,LOM,80-89,5,11,0,0,0,16,0,16,0,16,Lombardia,ITC4
2021-01-13,PF/BT,1724,Fondazione Casa di Riposo di Ghedi ONLUS,LOM,90+,3,24,0,0,0,27,0,27,0,27,Lombardia,ITC4
2021-01-13,PF/BT,1739,RSA ARICI SEGA,LOM,20-29,1,3,0,4,0,0,0,4,0,4,Lombardia,ITC4
2021-01-13,PF/BT,1739,RSA ARICI SEGA,LOM,30-39,2,6,0,7,1,0,0,8,0,8,Lombardia,ITC4
2021-01-13,PF/BT,1739,RSA ARICI SEGA,LOM,40-49,0,10,0,8,2,0,0,10,0,10,Lombardia,ITC4
2021-01-13,PF/BT,1739,RSA ARICI SEGA,LOM,50-59,4,7,0,9,2,0,0,11,0,11,Lombardia,ITC4
2021-01-13,PF/BT,1739,RSA ARICI SEGA,LOM,60-69,0,3,0,2,1,0,0,3,0,3,Lombardia,ITC4
2021-01-13,PF/BT,1772,Fondazione Villa Sacro Cuore Coniugi Preyer,LOM,30-39,1,0,0,1,0,0,0,1,0,1,Lombardia,ITC4
2021-01-13,PF/BT,1772,Fondazione Villa Sacro Cuore Coniugi Preyer,LOM,60-69,1,0,0,0,0,1,0,1,0,1,Lombardia,ITC4
2021-01-13,PF/BT,1772,Fondazione Villa Sacro Cuore Coniugi Preyer,LOM,70-79,0,5,0,0,0,5,0,5,0,5,Lombardia,ITC4
2021-01-13,PF/BT,1772,Fondazione Villa Sacro Cuore Coniugi Preyer,LOM,80-89,19,5,0,0,0,24,0,24,0,24,Lombardia,ITC4
2021-01-13,PF/BT,1772,Fondazione Villa Sacro Cuore Coniugi Preyer,LOM,90+,20,3,0,0,0,23,0,23,0,23,Lombardia,ITC4
2021-01-13,PF/BT,179,RSA SANTA GIULIA,LOM,20-29,0,1,0,1,0,0,0,1,0,1,Lombardia,ITC4
2021-01-13,PF/BT,179,RSA SANTA GIULIA,LOM,30-39,0,1,0,1,0,0,0,1,0,1,Lombardia,ITC4
2021-01-13,PF/BT,179,RSA SANTA GIULIA,LOM,50-59,0,1,0,0,0,1,0,1,0,1,Lombardia,ITC4
2021-01-13,PF/BT,179,RSA SANTA GIULIA,LOM,60-69,3,1,0,0,0,4,0,4,0,4,Lombardia,ITC4
2021-01-13,PF/BT,179,RSA SANTA GIULIA,LOM,70-79,0,4,0,0,0,4,0,4,0,4,Lombardia,ITC4
2021-01-13,PF/BT,179,RSA SANTA GIULIA,LOM,80-89,7,20,0,0,0,27,0,27,0,27,Lombardia,ITC4
2021-01-13,PF/BT,179,RSA SANTA GIULIA,LOM,90+,4,16,0,0,0,20,0,20,0,20,Lombardia,ITC4
2021-01-13,PF/BT,1798,FONDAZIONE GIUSEPPINA BRUNENGHI,LOM,20-29,1,4,0,4,1,0,0,5,0,5,Lombardia,ITC4
2021-01-13,PF/BT,1798,FONDAZIONE GIUSEPPINA BRUNENGHI,LOM,30-39,0,7,0,5,2,0,0,7,0,7,Lombardia,ITC4
2021-01-13,PF/BT,1798,FONDAZIONE GIUSEPPINA BRUNENGHI,LOM,40-49,1,12,0,10,3,0,0,13,0,13,Lombardia,ITC4
2021-01-13,PF/BT,1798,FONDAZIONE GIUSEPPINA BRUNENGHI,LOM,50-59,2,16,0,11,7,0,0,18,0,18,Lombardia,ITC4
2021-01-13,PF/BT,1798,FONDAZIONE GIUSEPPINA BRUNENGHI,LOM,60-69,2,2,0,1,2,0,1,4,0,4,Lombardia,ITC4
2021-01-13,PF/BT,1798,FONDAZIONE GIUSEPPINA BRUNENGHI,LOM,70-79,1,0,0,1,0,0,0,1,0,1,Lombardia,ITC4
2021-01-13,PF/BT,1812,ISTITUTO PER ANZIANI ISIDORO CAPPI ONLUS,LOM,20-29,0,1,0,0,1,0,0,1,0,1,Lombardia,ITC4
2021-01-13,PF/BT,1812,ISTITUTO PER ANZIANI ISIDORO CAPPI ONLUS,LOM,30-39,2,1,0,3,0,0,0,3,0,3,Lombardia,ITC4
2021-01-13,PF/BT,1812,ISTITUTO PER ANZIANI ISIDORO CAPPI ONLUS,LOM,40-49,0,3,0,2,1,0,0,3,0,3,Lombardia,ITC4
2021-01-13,PF/BT,1812,ISTITUTO PER ANZIANI ISIDORO CAPPI ONLUS,LOM,50-59,0,8,0,5,3,0,0,8,0,8,Lombardia,ITC4
2021-01-13,PF/BT,1812,ISTITUTO PER ANZIANI ISIDORO CAPPI ONLUS,LOM,60-69,1,5,0,4,1,1,0,6,0,6,Lombardia,ITC4
2021-01-13,PF/BT,1812,ISTITUTO PER ANZIANI ISIDORO CAPPI ONLUS,LOM,70-79,3,4,0,1,0,6,0,7,0,7,Lombardia,ITC4
2021-01-13,PF/BT,1812,ISTITUTO PER ANZIANI ISIDORO CAPPI ONLUS,LOM,80-89,3,9,0,0,0,12,0,12,0,12,Lombardia,ITC4
2021-01-13,PF/BT,1812,ISTITUTO PER ANZIANI ISIDORO CAPPI ONLUS,LOM,90+,2,18,0,0,0,20,0,20,0,20,Lombardia,ITC4
2021-01-13,PF/BT,1824,Fondazione Benefattori Cremaschi - RSA Zurla,LOM,20-29,0,1,0,1,0,0,0,1,0,1,Lombardia,ITC4
2021-01-13,PF/BT,1824,Fondazione Benefattori Cremaschi - RSA Zurla,LOM,30-39,1,3,0,4,0,0,0,4,0,4,Lombardia,ITC4
2021-01-13,PF/BT,1824,Fondazione Benefattori Cremaschi - RSA Zurla,LOM,40-49,1,3,0,4,0,0,0,4,0,4,Lombardia,ITC4
2021-01-13,PF/BT,1824,Fondazione Benefattori Cremaschi - RSA Zurla,LOM,50-59,2,11,0,9,3,1,0,13,0,13,Lombardia,ITC4
2021-01-13,PF/BT,1824,Fondazione Benefattori Cremaschi - RSA Zurla,LOM,60-69,4,3,0,1,2,4,0,7,0,7,Lombardia,ITC4
2021-01-13,PF/BT,1824,Fondazione Benefattori Cremaschi - RSA Zurla,LOM,70-79,2,1,0,0,0,3,0,3,0,3,Lombardia,ITC4
2021-01-13,PF/BT,1824,Fondazione Benefattori Cremaschi - RSA Zurla,LOM,80-89,5,9,0,0,0,14,0,14,0,14,Lombardia,ITC4
2021-01-13,PF/BT,1824,Fondazione Benefattori Cremaschi - RSA Zurla,LOM,90+,3,17,0,0,0,20,0,20,0,20,Lombardia,ITC4
2021-01-13,PF/BT,1827,FONDAZIONE OSPEDALE CAIMI ONLUS,LOM,20-29,3,3,0,2,4,0,0,6,0,6,Lombardia,ITC4
2021-01-13,PF/BT,1827,FONDAZIONE OSPEDALE CAIMI ONLUS,LOM,30-39,2,3,0,4,1,0,0,5,0,5,Lombardia,ITC4
2021-01-13,PF/BT,1827,FONDAZIONE OSPEDALE CAIMI ONLUS,LOM,40-49,2,16,0,11,7,0,0,18,0,18,Lombardia,ITC4
2021-01-13,PF/BT,1827,FONDAZIONE OSPEDALE CAIMI ONLUS,LOM,50-59,2,19,0,13,8,0,0,21,0,21,Lombardia,ITC4
2021-01-13,PF/BT,1827,FONDAZIONE OSPEDALE CAIMI ONLUS,LOM,60-69,1,1,0,2,0,0,0,2,0,2,Lombardia,ITC4
2021-01-13,PF/BT,1827,FONDAZIONE OSPEDALE CAIMI ONLUS,LOM,70-79,1,1,0,1,0,0,1,2,0,2,Lombardia,ITC4
2021-01-13,PF/BT,1842,RSA VILLA AZZURRA,LOM,30-39,1,0,0,1,0,0,0,1,0,1,Lombardia,ITC4
2021-01-13,PF/BT,1842,RSA VILLA AZZURRA,LOM,40-49,0,1,0,1,0,0,0,1,0,1,Lombardia,ITC4
2021-01-13,PF/BT,1842,RSA VILLA AZZURRA,LOM,50-59,1,1,0,1,1,0,0,2,0,2,Lombardia,ITC4
2021-01-13,PF/BT,1842,RSA VILLA AZZURRA,LOM,60-69,1,2,0,1,0,2,0,3,0,3,Lombardia,ITC4
2021-01-13,PF/BT,1842,RSA VILLA AZZURRA,LOM,70-79,4,2,0,0,0,6,0,6,0,6,Lombardia,ITC4
2021-01-13,PF/BT,1842,RSA VILLA AZZURRA,LOM,80-89,1,5,0,0,0,6,0,6,0,6,Lombardia,ITC4
2021-01-13,PF/BT,1842,RSA VILLA AZZURRA,LOM,90+,0,5,0,0,0,5,0,5,0,5,Lombardia,ITC4
2021-01-13,PF/BT,1886,"RSA E. BOVI, PEGOGNAGA",LOM,30-39,1,2,0,3,0,0,0,3,0,3,Lombardia,ITC4
2021-01-13,PF/BT,1886,"RSA E. BOVI, PEGOGNAGA",LOM,40-49,1,2,0,3,0,0,0,3,0,3,Lombardia,ITC4
2021-01-13,PF/BT,1886,"RSA E. BOVI, PEGOGNAGA",LOM,50-59,0,2,0,2,0,0,0,2,0,2,Lombardia,ITC4
2021-01-13,PF/BT,1886,"RSA E. BOVI, PEGOGNAGA",LOM,70-79,2,1,0,0,0,3,0,3,0,3,Lombardia,ITC4
2021-01-13,PF/BT,1886,"RSA E. BOVI, PEGOGNAGA",LOM,80-89,3,13,0,0,0,16,0,16,0,16,Lombardia,ITC4
2021-01-13,PF/BT,1886,"RSA E. BOVI, PEGOGNAGA",LOM,90+,1,20,0,0,0,21,0,21,0,21,Lombardia,ITC4
2021-01-13,PF/BT,1918,RSA CASA ROSANNA,LOM,40-49,0,1,0,1,0,0,0,1,0,1,Lombardia,ITC4
2021-01-13,PF/BT,1918,RSA CASA ROSANNA,LOM,70-79,0,1,0,0,0,1,0,1,0,1,Lombardia,ITC4
2021-01-13,PF/BT,1918,RSA CASA ROSANNA,LOM,80-89,0,4,0,0,0,4,0,4,0,4,Lombardia,ITC4
2021-01-13,PF/BT,1918,RSA CASA ROSANNA,LOM,90+,0,2,0,0,0,2,0,2,0,2,Lombardia,ITC4
2021-01-13,PF/BT,1934,FONDAZIONE BRUNO PARI ONLUS,LOM,30-39,1,0,0,0,1,0,0,1,0,1,Lombardia,ITC4
2021-01-13,PF/BT,1934,FONDAZIONE BRUNO PARI ONLUS,LOM,70-79,0,2,0,0,0,2,0,2,0,2,Lombardia,ITC4
2021-01-13,PF/BT,1934,FONDAZIONE BRUNO PARI ONLUS,LOM,80-89,6,20,0,0,0,26,0,26,0,26,Lombardia,ITC4
2021-01-13,PF/BT,1934,FONDAZIONE BRUNO PARI ONLUS,LOM,90+,0,13,0,0,0,13,0,13,0,13,Lombardia,ITC4
2021-01-13,PF/BT,1946,"FONDAZIONE ""CONTE DR. CARLO CARACCI"" - ONLUS",LOM,30-39,0,1,0,0,1,0,0,1,0,1,Lombardia,ITC4
2021-01-13,PF/BT,1946,"FONDAZIONE ""CONTE DR. CARLO CARACCI"" - ONLUS",LOM,50-59,0,5,0,3,2,0,0,5,0,5,Lombardia,ITC4
2021-01-13,PF/BT,1946,"FONDAZIONE ""CONTE DR. CARLO CARACCI"" - ONLUS",LOM,60-69,0,2,0,0,1,1,0,2,0,2,Lombardia,ITC4
2021-01-13,PF/BT,1946,"FONDAZIONE ""CONTE DR. CARLO CARACCI"" - ONLUS",LOM,70-79,2,0,0,0,0,1,1,2,0,2,Lombardia,ITC4
2021-01-13,PF/BT,1946,"FONDAZIONE ""CONTE DR. CARLO CARACCI"" - ONLUS",LOM,80-89,2,4,0,0,0,6,0,6,0,6,Lombardia,ITC4
2021-01-13,PF/BT,1946,"FONDAZIONE ""CONTE DR. CARLO CARACCI"" - ONLUS",LOM,90+,1,1,0,0,0,2,0,2,0,2,Lombardia,ITC4
2021-01-13,PF/BT,1948,FONDAZIONE SCARPARI FORATTINI ONLUS,LOM,20-29,4,3,0,4,2,0,1,7,0,7,Lombardia,ITC4
2021-01-13,PF/BT,1948,FONDAZIONE SCARPARI FORATTINI ONLUS,LOM,30-39,0,7,0,4,2,0,1,7,0,7,Lombardia,ITC4
2021-01-13,PF/BT,1948,FONDAZIONE SCARPARI FORATTINI ONLUS,LOM,40-49,0,10,0,4,5,0,1,10,0,10,Lombardia,ITC4
2021-01-13,PF/BT,1948,FONDAZIONE SCARPARI FORATTINI ONLUS,LOM,50-59,2,8,0,7,2,0,1,10,0,10,Lombardia,ITC4
2021-01-13,PF/BT,1948,FONDAZIONE SCARPARI FORATTINI ONLUS,LOM,60-69,1,1,0,0,0,0,2,2,0,2,Lombardia,ITC4
2021-01-13,PF/BT,1948,FONDAZIONE SCARPARI FORATTINI ONLUS,LOM,70-79,3,1,0,0,0,4,0,4,0,4,Lombardia,ITC4
2021-01-13,PF/BT,1948,FONDAZIONE SCARPARI FORATTINI ONLUS,LOM,80-89,2,5,0,0,0,7,0,7,0,7,Lombardia,ITC4
2021-01-13,PF/BT,1948,FONDAZIONE SCARPARI FORATTINI ONLUS,LOM,90+,2,5,0,0,0,7,0,7,0,7,Lombardia,ITC4
2021-01-13,PF/BT,1953,RSA BEATA PAOLA,LOM,20-29,1,4,0,4,1,0,0,5,0,5,Lombardia,ITC4
2021-01-13,PF/BT,1953,RSA BEATA PAOLA,LOM,30-39,2,4,0,3,3,0,0,6,0,6,Lombardia,ITC4
2021-01-13,PF/BT,1953,RSA BEATA PAOLA,LOM,40-49,0,4,0,4,0,0,0,4,0,4,Lombardia,ITC4
2021-01-13,PF/BT,1953,RSA BEATA PAOLA,LOM,50-59,1,8,0,3,6,0,0,9,0,9,Lombardia,ITC4
2021-01-13,PF/BT,1953,RSA BEATA PAOLA,LOM,60-69,1,1,0,0,1,1,0,2,0,2,Lombardia,ITC4
2021-01-13,PF/BT,1953,RSA BEATA PAOLA,LOM,70-79,0,3,0,0,0,3,0,3,0,3,Lombardia,ITC4
2021-01-13,PF/BT,1953,RSA BEATA PAOLA,LOM,80-89,2,7,0,0,0,9,0,9,0,9,Lombardia,ITC4
2021-01-13,PF/BT,1953,RSA BEATA PAOLA,LOM,90+,0,4,0,0,0,4,0,4,0,4,Lombardia,ITC4
2021-01-13,PF/BT,1965,RESIDENZA SANITARIA ASSISTENZIALE FONDAZIONE LUIGI BONI ONLUS,LOM,20-29,1,2,0,3,0,0,0,3,0,3,Lombardia,ITC4
2021-01-13,PF/BT,1965,RESIDENZA SANITARIA ASSISTENZIALE FONDAZIONE LUIGI BONI ONLUS,LOM,30-39,0,5,0,5,0,0,0,5,0,5,Lombardia,ITC4
2021-01-13,PF/BT,1965,RESIDENZA SANITARIA ASSISTENZIALE FONDAZIONE LUIGI BONI ONLUS,LOM,40-49,4,7,0,10,1,0,0,11,0,11,Lombardia,ITC4
2021-01-13,PF/BT,1965,RESIDENZA SANITARIA ASSISTENZIALE FONDAZIONE LUIGI BONI ONLUS,LOM,50-59,1,8,0,5,4,0,0,9,0,9,Lombardia,ITC4
2021-01-13,PF/BT,1965,RESIDENZA SANITARIA ASSISTENZIALE FONDAZIONE LUIGI BONI ONLUS,LOM,60-69,0,2,0,0,2,0,0,2,0,2,Lombardia,ITC4
2021-01-13,PF/BT,1975,RSA ZUCCHI-FALCINA,LOM,20-29,0,1,0,1,0,0,0,1,0,1,Lombardia,ITC4
2021-01-13,PF/BT,1975,RSA ZUCCHI-FALCINA,LOM,30-39,1,3,0,4,0,0,0,4,0,4,Lombardia,ITC4
2021-01-13,PF/BT,1975,RSA ZUCCHI-FALCINA,LOM,40-49,0,7,0,5,1,1,0,7,0,7,Lombardia,ITC4
2021-01-13,PF/BT,1975,RSA ZUCCHI-FALCINA,LOM,50-59,3,11,0,6,7,1,0,14,0,14,Lombardia,ITC4
2021-01-13,PF/BT,1975,RSA ZUCCHI-FALCINA,LOM,60-69,1,4,0,3,0,2,0,5,0,5,Lombardia,ITC4
2021-01-13,PF/BT,1975,RSA ZUCCHI-FALCINA,LOM,70-79,13,15,0,0,0,28,0,28,0,28,Lombardia,ITC4
2021-01-13,PF/BT,1975,RSA ZUCCHI-FALCINA,LOM,80-89,9,50,0,0,0,59,0,59,0,59,Lombardia,ITC4
2021-01-13,PF/BT,1975,RSA ZUCCHI-FALCINA,LOM,90+,4,34,0,0,0,38,0,38,0,38,Lombardia,ITC4
2021-01-13,PF/BT,20,cv cremona,LOM,30-39,1,4,0,2,3,0,0,5,0,5,Lombardia,ITC4
2021-01-13,PF/BT,20,cv cremona,LOM,40-49,2,12,0,11,2,0,1,14,0,14,Lombardia,ITC4
2021-01-13,PF/BT,20,cv cremona,LOM,50-59,4,15,0,10,8,1,0,19,0,19,Lombardia,ITC4
2021-01-13,PF/BT,20,cv cremona,LOM,60-69,0,5,0,0,4,1,0,5,0,5,Lombardia,ITC4
2021-01-13,PF/BT,20,cv cremona,LOM,70-79,3,4,0,0,0,6,1,7,0,7,Lombardia,ITC4
2021-01-13,PF/BT,20,cv cremona,LOM,80-89,6,11,0,0,0,17,0,17,0,17,Lombardia,ITC4
2021-01-13,PF/BT,20,cv cremona,LOM,90+,2,9,0,0,0,11,0,11,0,11,Lombardia,ITC4
2021-01-13,PF/BT,2001,RESIDENZA SANITARIA ASSISTITA UNITA' GERIATRICA RIABILITATIVA ONLUS,LOM,20-29,0,1,0,1,0,0,0,1,0,1,Lombardia,ITC4
2021-01-13,PF/BT,2001,RESIDENZA SANITARIA ASSISTITA UNITA' GERIATRICA RIABILITATIVA ONLUS,LOM,50-59,0,2,0,2,0,0,0,2,0,2,Lombardia,ITC4
2021-01-13,PF/BT,2001,RESIDENZA SANITARIA ASSISTITA UNITA' GERIATRICA RIABILITATIVA ONLUS,LOM,60-69,0,1,0,1,0,0,0,1,0,1,Lombardia,ITC4
2021-01-13,PF/BT,2001,RESIDENZA SANITARIA ASSISTITA UNITA' GERIATRICA RIABILITATIVA ONLUS,LOM,90+,0,2,0,0,0,2,0,2,0,2,Lombardia,ITC4
2021-01-13,PF/BT,2054,FONDAZIONE SAN GERMANO ONLUS,LOM,20-29,1,0,0,1,0,0,0,1,0,1,Lombardia,ITC4
2021-01-13,PF/BT,2054,FONDAZIONE SAN GERMANO ONLUS,LOM,30-39,0,3,0,3,0,0,0,3,0,3,Lombardia,ITC4
2021-01-13,PF/BT,2054,FONDAZIONE SAN GERMANO ONLUS,LOM,40-49,1,8,0,9,0,0,0,9,0,9,Lombardia,ITC4
2021-01-13,PF/BT,2054,FONDAZIONE SAN GERMANO ONLUS,LOM,50-59,2,4,0,6,0,0,0,6,0,6,Lombardia,ITC4
2021-01-13,PF/BT,2054,FONDAZIONE SAN GERMANO ONLUS,LOM,60-69,1,2,0,0,0,3,0,3,0,3,Lombardia,ITC4
2021-01-13,PF/BT,2054,FONDAZIONE SAN GERMANO ONLUS,LOM,70-79,3,1,0,0,0,4,0,4,0,4,Lombardia,ITC4
2021-01-13,PF/BT,2054,FONDAZIONE SAN GERMANO ONLUS,LOM,80-89,6,7,0,0,0,13,0,13,0,13,Lombardia,ITC4
2021-01-13,PF/BT,2054,FONDAZIONE SAN GERMANO ONLUS,LOM,90+,1,8,0,0,0,9,0,9,0,9,Lombardia,ITC4
2021-01-13,PF/BT,2104,FONDAZIONE DON CARLO GNOCCHI-SANTA MARIA ALLE FONTI-SALICE TERME,LOM,30-39,1,0,0,0,0,1,0,1,0,1,Lombardia,ITC4
2021-01-13,PF/BT,2104,FONDAZIONE DON CARLO GNOCCHI-SANTA MARIA ALLE FONTI-SALICE TERME,LOM,60-69,1,0,0,0,0,1,0,1,0,1,Lombardia,ITC4
2021-01-13,PF/BT,2104,FONDAZIONE DON CARLO GNOCCHI-SANTA MARIA ALLE FONTI-SALICE TERME,LOM,70-79,2,0,0,0,0,2,0,2,0,2,Lombardia,ITC4
2021-01-13,PF/BT,2104,FONDAZIONE DON CARLO GNOCCHI-SANTA MARIA ALLE FONTI-SALICE TERME,LOM,80-89,5,8,0,0,0,13,0,13,0,13,Lombardia,ITC4
2021-01-13,PF/BT,2104,FONDAZIONE DON CARLO GNOCCHI-SANTA MARIA ALLE FONTI-SALICE TERME,LOM,90+,0,7,0,0,0,7,0,7,0,7,Lombardia,ITC4
2021-01-13,PF/BT,2110,RSA LA TUA CASA,LOM,30-39,2,2,0,3,1,0,0,4,0,4,Lombardia,ITC4
2021-01-13,PF/BT,2110,RSA LA TUA CASA,LOM,40-49,0,5,0,5,0,0,0,5,0,5,Lombardia,ITC4
2021-01-13,PF/BT,2110,RSA LA TUA CASA,LOM,50-59,0,14,0,9,5,0,0,14,0,14,Lombardia,ITC4
2021-01-13,PF/BT,2110,RSA LA TUA CASA,LOM,60-69,0,1,0,1,0,0,0,1,0,1,Lombardia,ITC4
2021-01-13,PF/BT,2110,RSA LA TUA CASA,LOM,70-79,1,0,0,1,0,0,0,1,0,1,Lombardia,ITC4
2021-01-13,PF/BT,2165,RSA Mezzana Bigli,LOM,20-29,0,1,0,1,0,0,0,1,0,1,Lombardia,ITC4
2021-01-13,PF/BT,2165,RSA Mezzana Bigli,LOM,30-39,1,1,0,1,1,0,0,2,0,2,Lombardia,ITC4
2021-01-13,PF/BT,2165,RSA Mezzana Bigli,LOM,50-59,1,7,0,6,2,0,0,8,0,8,Lombardia,ITC4
2021-01-13,PF/BT,2165,RSA Mezzana Bigli,LOM,60-69,0,1,0,0,0,1,0,1,0,1,Lombardia,ITC4
2021-01-13,PF/BT,2227,"Rsa Casa Sacra Famiglia, Pieve Del Cairo (PV)",LOM,20-29,0,2,0,2,0,0,0,2,0,2,Lombardia,ITC4
2021-01-13,PF/BT,2227,"Rsa Casa Sacra Famiglia, Pieve Del Cairo (PV)",LOM,30-39,0,6,0,3,3,0,0,6,0,6,Lombardia,ITC4
2021-01-13,PF/BT,2227,"Rsa Casa Sacra Famiglia, Pieve Del Cairo (PV)",LOM,40-49,1,1,0,1,1,0,0,2,0,2,Lombardia,ITC4
2021-01-13,PF/BT,2227,"Rsa Casa Sacra Famiglia, Pieve Del Cairo (PV)",LOM,50-59,1,7,0,7,1,0,0,8,0,8,Lombardia,ITC4
2021-01-13,PF/BT,2227,"Rsa Casa Sacra Famiglia, Pieve Del Cairo (PV)",LOM,60-69,0,1,0,1,0,0,0,1,0,1,Lombardia,ITC4
2021-01-13,PF/BT,2227,"Rsa Casa Sacra Famiglia, Pieve Del Cairo (PV)",LOM,80-89,0,1,0,0,0,1,0,1,0,1,Lombardia,ITC4
2021-01-13,PF/BT,2227,"Rsa Casa Sacra Famiglia, Pieve Del Cairo (PV)",LOM,90+,0,3,0,0,0,3,0,3,0,3,Lombardia,ITC4
2021-01-13,PF/BT,228,"RSA ""POLO GERIATRICO RIABILITATIVO 1”",LOM,20-29,0,2,0,1,1,0,0,2,0,2,Lombardia,ITC4
2021-01-13,PF/BT,228,"RSA ""POLO GERIATRICO RIABILITATIVO 1”",LOM,30-39,1,1,0,0,2,0,0,2,0,2,Lombardia,ITC4
2021-01-13,PF/BT,228,"RSA ""POLO GERIATRICO RIABILITATIVO 1”",LOM,40-49,0,2,0,0,2,0,0,2,0,2,Lombardia,ITC4
2021-01-13,PF/BT,228,"RSA ""POLO GERIATRICO RIABILITATIVO 1”",LOM,50-59,1,5,0,5,1,0,0,6,0,6,Lombardia,ITC4
2021-01-13,PF/BT,228,"RSA ""POLO GERIATRICO RIABILITATIVO 1”",LOM,70-79,0,5,0,0,0,5,0,5,0,5,Lombardia,ITC4
2021-01-13,PF/BT,228,"RSA ""POLO GERIATRICO RIABILITATIVO 1”",LOM,80-89,1,4,0,0,0,5,0,5,0,5,Lombardia,ITC4
2021-01-13,PF/BT,228,"RSA ""POLO GERIATRICO RIABILITATIVO 1”",LOM,90+,0,5,0,0,0,5,0,5,0,5,Lombardia,ITC4
2021-01-13,PF/BT,24,FONDAZIONE OSPEDALE MARCHESI DI INZAGO,LOM,30-39,0,2,0,2,0,0,0,2,0,2,Lombardia,ITC4
2021-01-13,PF/BT,24,FONDAZIONE OSPEDALE MARCHESI DI INZAGO,LOM,40-49,2,5,0,7,0,0,0,7,0,7,Lombardia,ITC4
2021-01-13,PF/BT,24,FONDAZIONE OSPEDALE MARCHESI DI INZAGO,LOM,50-59,0,3,0,3,0,0,0,3,0,3,Lombardia,ITC4
2021-01-13,PF/BT,270,HOSPICE BEATI CONIUGI MARTIN,LOM,20-29,1,1,0,1,1,0,0,2,0,2,Lombardia,ITC4
2021-01-13,PF/BT,270,HOSPICE BEATI CONIUGI MARTIN,LOM,40-49,0,1,0,1,0,0,0,1,0,1,Lombardia,ITC4
2021-01-13,PF/BT,270,HOSPICE BEATI CONIUGI MARTIN,LOM,50-59,0,1,0,0,1,0,0,1,0,1,Lombardia,ITC4
2021-01-13,PF/BT,270,HOSPICE BEATI CONIUGI MARTIN,LOM,60-69,0,2,0,2,0,0,0,2,0,2,Lombardia,ITC4
2021-01-13,PF/BT,27117,CASA DI RIPOSO MADONNA DELLA NEVE,LOM,20-29,1,1,0,2,0,0,0,2,0,2,Lombardia,ITC4
2021-01-13,PF/BT,27117,CASA DI RIPOSO MADONNA DELLA NEVE,LOM,50-59,0,1,0,0,1,0,0,1,0,1,Lombardia,ITC4
2021-01-13,PF/BT,27117,CASA DI RIPOSO MADONNA DELLA NEVE,LOM,60-69,1,0,0,1,0,0,0,1,0,1,Lombardia,ITC4
2021-01-13,PF/BT,27117,CASA DI RIPOSO MADONNA DELLA NEVE,LOM,70-79,2,0,0,0,1,1,0,2,0,2,Lombardia,ITC4
2021-01-13,PF/BT,27117,CASA DI RIPOSO MADONNA DELLA NEVE,LOM,80-89,1,3,0,0,1,3,0,4,0,4,Lombardia,ITC4
2021-01-13,PF/BT,27117,CASA DI RIPOSO MADONNA DELLA NEVE,LOM,90+,0,2,0,0,0,2,0,2,0,2,Lombardia,ITC4
2021-01-13,PF/BT,2761,FONDAZIONE CA'D'INDUSTRIA LE CAMELIE,LOM,20-29,2,3,0,5,0,0,0,5,0,5,Lombardia,ITC4
2021-01-13,PF/BT,2761,FONDAZIONE CA'D'INDUSTRIA LE CAMELIE,LOM,30-39,1,4,0,5,0,0,0,5,0,5,Lombardia,ITC4
2021-01-13,PF/BT,2761,FONDAZIONE CA'D'INDUSTRIA LE CAMELIE,LOM,40-49,6,11,0,14,3,0,0,17,0,17,Lombardia,ITC4
2021-01-13,PF/BT,2761,FONDAZIONE CA'D'INDUSTRIA LE CAMELIE,LOM,50-59,1,7,0,7,1,0,0,8,0,8,Lombardia,ITC4
2021-01-13,PF/BT,2761,FONDAZIONE CA'D'INDUSTRIA LE CAMELIE,LOM,60-69,1,3,0,4,0,0,0,4,0,4,Lombardia,ITC4
2021-01-13,PF/BT,2761,FONDAZIONE CA'D'INDUSTRIA LE CAMELIE,LOM,70-79,0,1,0,0,0,1,0,1,0,1,Lombardia,ITC4
2021-01-13,PF/BT,2761,FONDAZIONE CA'D'INDUSTRIA LE CAMELIE,LOM,80-89,0,1,0,0,0,1,0,1,0,1,Lombardia,ITC4
2021-01-13,PF/BT,2761,FONDAZIONE CA'D'INDUSTRIA LE CAMELIE,LOM,90+,0,1,0,0,0,1,0,1,0,1,Lombardia,ITC4
2021-01-13,PF/BT,2884,RSA fondazione ferriere e fonderie dongo onlus,LOM,16-19,0,1,0,0,1,0,0,1,0,1,Lombardia,ITC4
2021-01-13,PF/BT,2884,RSA fondazione ferriere e fonderie dongo onlus,LOM,20-29,0,2,0,1,1,0,0,2,0,2,Lombardia,ITC4
2021-01-13,PF/BT,2884,RSA fondazione ferriere e fonderie dongo onlus,LOM,30-39,0,7,0,6,1,0,0,7,0,7,Lombardia,ITC4
2021-01-13,PF/BT,2884,RSA fondazione ferriere e fonderie dongo onlus,LOM,40-49,2,12,0,12,2,0,0,14,0,14,Lombardia,ITC4
2021-01-13,PF/BT,2884,RSA fondazione ferriere e fonderie dongo onlus,LOM,50-59,3,16,0,17,2,0,0,19,0,19,Lombardia,ITC4
2021-01-13,PF/BT,2884,RSA fondazione ferriere e fonderie dongo onlus,LOM,60-69,1,2,0,0,3,0,0,3,0,3,Lombardia,ITC4
2021-01-13,PF/BT,2884,RSA fondazione ferriere e fonderie dongo onlus,LOM,90+,0,2,0,0,0,2,0,2,0,2,Lombardia,ITC4
2021-01-13,PF/BT,3003100,OSPEDALE MORIGGIA PELASCINI - GRAVEDONA,LOM,30-39,2,1,0,3,0,0,0,3,0,3,Lombardia,ITC4
2021-01-13,PF/BT,3003100,OSPEDALE MORIGGIA PELASCINI - GRAVEDONA,LOM,40-49,3,8,0,11,0,0,0,11,0,11,Lombardia,ITC4
2021-01-13,PF/BT,3003100,OSPEDALE MORIGGIA PELASCINI - GRAVEDONA,LOM,50-59,4,7,0,11,0,0,0,11,0,11,Lombardia,ITC4
2021-01-13,PF/BT,3003100,OSPEDALE MORIGGIA PELASCINI - GRAVEDONA,LOM,60-69,2,2,0,4,0,0,0,4,0,4,Lombardia,ITC4
2021-01-13,PF/BT,3003100,OSPEDALE MORIGGIA PELASCINI - GRAVEDONA,LOM,70-79,1,0,0,1,0,0,0,1,0,1,Lombardia,ITC4
2021-01-13,PF/BT,30044,Presidio di Chiavenna,LOM,20-29,0,2,0,1,1,0,0,2,0,2,Lombardia,ITC4
2021-01-13,PF/BT,30044,Presidio di Chiavenna,LOM,30-39,2,8,0,6,4,0,0,10,0,10,Lombardia,ITC4
2021-01-13,PF/BT,30044,Presidio di Chiavenna,LOM,40-49,3,13,0,9,7,0,0,16,0,16,Lombardia,ITC4
2021-01-13,PF/BT,30044,Presidio di Chiavenna,LOM,50-59,14,38,0,45,7,0,0,52,0,52,Lombardia,ITC4
2021-01-13,PF/BT,30044,Presidio di Chiavenna,LOM,60-69,8,7,0,12,3,0,0,15,0,15,Lombardia,ITC4
2021-01-13,PF/BT,30044,Presidio di Chiavenna,LOM,70-79,1,0,0,1,0,0,0,1,0,1,Lombardia,ITC4
2021-01-13,PF/BT,30071,Centro Vaccinale Covid Melzo - ASST Melegnano Martesana,LOM,20-29,16,26,0,36,6,0,0,42,0,42,Lombardia,ITC4
2021-01-13,PF/BT,30071,Centro Vaccinale Covid Melzo - ASST Melegnano Martesana,LOM,30-39,25,16,0,39,2,0,0,41,0,41,Lombardia,ITC4
2021-01-13,PF/BT,30071,Centro Vaccinale Covid Melzo - ASST Melegnano Martesana,LOM,40-49,20,30,0,47,3,0,0,50,0,50,Lombardia,ITC4
2021-01-13,PF/BT,30071,Centro Vaccinale Covid Melzo - ASST Melegnano Martesana,LOM,50-59,27,38,0,56,9,0,0,65,0,65,Lombardia,ITC4
2021-01-13,PF/BT,30071,Centro Vaccinale Covid Melzo - ASST Melegnano Martesana,LOM,60-69,27,23,0,41,9,0,0,50,0,50,Lombardia,ITC4
2021-01-13,PF/BT,30071,Centro Vaccinale Covid Melzo - ASST Melegnano Martesana,LOM,70-79,19,6,0,1,0,0,24,25,0,25,Lombardia,ITC4
2021-01-13,PF/BT,30072,Centro Vaccinale Covid Vizzolo - ASST Melegnano Martesana,LOM,16-19,1,0,0,1,0,0,0,1,0,1,Lombardia,ITC4
2021-01-13,PF/BT,30072,Centro Vaccinale Covid Vizzolo - ASST Melegnano Martesana,LOM,20-29,7,21,0,24,4,0,0,28,0,28,Lombardia,ITC4
2021-01-13,PF/BT,30072,Centro Vaccinale Covid Vizzolo - ASST Melegnano Martesana,LOM,30-39,19,17,0,31,5,0,0,36,0,36,Lombardia,ITC4
2021-01-13,PF/BT,30072,Centro Vaccinale Covid Vizzolo - ASST Melegnano Martesana,LOM,40-49,22,26,0,39,9,0,0,48,0,48,Lombardia,ITC4
2021-01-13,PF/BT,30072,Centro Vaccinale Covid Vizzolo - ASST Melegnano Martesana,LOM,50-59,22,51,0,51,21,0,1,73,0,73,Lombardia,ITC4
2021-01-13,PF/BT,30072,Centro Vaccinale Covid Vizzolo - ASST Melegnano Martesana,LOM,60-69,10,21,0,27,4,0,0,31,0,31,Lombardia,ITC4
2021-01-13,PF/BT,30072,Centro Vaccinale Covid Vizzolo - ASST Melegnano Martesana,LOM,70-79,3,1,0,0,0,0,4,4,0,4,Lombardia,ITC4
2021-01-13,PF/BT,30073,CV Bollate,LOM,16-19,0,2,0,2,0,0,0,2,0,2,Lombardia,ITC4
2021-01-13,PF/BT,30073,CV Bollate,LOM,20-29,8,11,0,19,0,0,0,19,0,19,Lombardia,ITC4
2021-01-13,PF/BT,30073,CV Bollate,LOM,30-39,11,2,0,13,0,0,0,13,0,13,Lombardia,ITC4
2021-01-13,PF/BT,30073,CV Bollate,LOM,40-49,7,5,0,12,0,0,0,12,0,12,Lombardia,ITC4
2021-01-13,PF/BT,30073,CV Bollate,LOM,50-59,10,11,0,21,0,0,0,21,0,21,Lombardia,ITC4
2021-01-13,PF/BT,30073,CV Bollate,LOM,60-69,12,3,0,15,0,0,0,15,0,15,Lombardia,ITC4
2021-01-13,PF/BT,30073,cv rho,LOM,20-29,5,12,0,17,0,0,0,17,0,17,Lombardia,ITC4
2021-01-13,PF/BT,30073,cv rho,LOM,30-39,3,6,0,9,0,0,0,9,0,9,Lombardia,ITC4
2021-01-13,PF/BT,30073,cv rho,LOM,40-49,4,17,0,21,0,0,0,21,0,21,Lombardia,ITC4
2021-01-13,PF/BT,30073,cv rho,LOM,50-59,8,48,0,46,10,0,0,56,0,56,Lombardia,ITC4
2021-01-13,PF/BT,30073,cv rho,LOM,60-69,3,12,0,11,4,0,0,15,0,15,Lombardia,ITC4
2021-01-13,PF/BT,30074,HUB COVID MAGENTA,LOM,20-29,1,7,0,3,5,0,0,8,0,8,Lombardia,ITC4
2021-01-13,PF/BT,30074,HUB COVID MAGENTA,LOM,30-39,6,6,0,6,6,0,0,12,0,12,Lombardia,ITC4
2021-01-13,PF/BT,30074,HUB COVID MAGENTA,LOM,40-49,8,28,0,21,15,0,0,36,0,36,Lombardia,ITC4
2021-01-13,PF/BT,30074,HUB COVID MAGENTA,LOM,50-59,14,45,0,26,33,0,0,59,0,59,Lombardia,ITC4
2021-01-13,PF/BT,30074,HUB COVID MAGENTA,LOM,60-69,5,14,0,9,10,0,0,19,0,19,Lombardia,ITC4
2021-01-13,PF/BT,30074,HUB COVID MAGENTA,LOM,70-79,4,1,0,1,4,0,0,5,0,5,Lombardia,ITC4
2021-01-13,PF/BT,30085,Centro Vaccinale Covid Cernusco - ASST Melegnano Martesana,LOM,20-29,0,7,0,5,2,0,0,7,0,7,Lombardia,ITC4
2021-01-13,PF/BT,30085,Centro Vaccinale Covid Cernusco - ASST Melegnano Martesana,LOM,30-39,4,10,0,13,1,0,0,14,0,14,Lombardia,ITC4
2021-01-13,PF/BT,30085,Centro Vaccinale Covid Cernusco - ASST Melegnano Martesana,LOM,40-49,10,13,0,19,4,0,0,23,0,23,Lombardia,ITC4
2021-01-13,PF/BT,30085,Centro Vaccinale Covid Cernusco - ASST Melegnano Martesana,LOM,50-59,5,22,0,18,9,0,0,27,0,27,Lombardia,ITC4
2021-01-13,PF/BT,30085,Centro Vaccinale Covid Cernusco - ASST Melegnano Martesana,LOM,60-69,5,7,0,7,5,0,0,12,0,12,Lombardia,ITC4
2021-01-13,PF/BT,30096,CASA DI CURA DEL POLICLINICO - MILANO,LOM,30-39,1,4,0,5,0,0,0,5,0,5,Lombardia,ITC4
2021-01-13,PF/BT,30096,CASA DI CURA DEL POLICLINICO - MILANO,LOM,40-49,4,5,0,9,0,0,0,9,0,9,Lombardia,ITC4
2021-01-13,PF/BT,30096,CASA DI CURA DEL POLICLINICO - MILANO,LOM,50-59,0,4,0,4,0,0,0,4,0,4,Lombardia,ITC4
2021-01-13,PF/BT,30096,CASA DI CURA DEL POLICLINICO - MILANO,LOM,60-69,0,1,0,0,1,0,0,1,0,1,Lombardia,ITC4
2021-01-13,PF/BT,30096,CASA DI CURA DEL POLICLINICO - MILANO,LOM,70-79,3,1,0,2,2,0,0,4,0,4,Lombardia,ITC4
2021-01-13,PF/BT,30096,CASA DI CURA DEL POLICLINICO - MILANO,LOM,80-89,1,0,0,0,1,0,0,1,0,1,Lombardia,ITC4
2021-01-13,PF/BT,3014400,CASA DI CURA BEATO PALAZZOLO-BERGAMO,LOM,20-29,1,6,0,6,1,0,0,7,0,7,Lombardia,ITC4
2021-01-13,PF/BT,3014400,CASA DI CURA BEATO PALAZZOLO-BERGAMO,LOM,30-39,4,2,0,5,1,0,0,6,0,6,Lombardia,ITC4
2021-01-13,PF/BT,3014400,CASA DI CURA BEATO PALAZZOLO-BERGAMO,LOM,40-49,4,12,0,13,3,0,0,16,0,16,Lombardia,ITC4
2021-01-13,PF/BT,3014400,CASA DI CURA BEATO PALAZZOLO-BERGAMO,LOM,50-59,5,14,0,17,2,0,0,19,0,19,Lombardia,ITC4
2021-01-13,PF/BT,3014400,CASA DI CURA BEATO PALAZZOLO-BERGAMO,LOM,60-69,3,2,0,4,1,0,0,5,0,5,Lombardia,ITC4
2021-01-13,PF/BT,3014400,CASA DI CURA BEATO PALAZZOLO-BERGAMO,LOM,70-79,1,0,0,1,0,0,0,1,0,1,Lombardia,ITC4
2021-01-13,PF/BT,30156,Centro Vaccinale Covid Desenzano,LOM,20-29,4,10,0,3,0,0,11,14,0,14,Lombardia,ITC4
2021-01-13,PF/BT,30156,Centro Vaccinale Covid Desenzano,LOM,30-39,12,13,0,6,2,0,17,25,0,25,Lombardia,ITC4
2021-01-13,PF/BT,30156,Centro Vaccinale Covid Desenzano,LOM,40-49,14,28,0,11,5,0,26,42,0,42,Lombardia,ITC4
2021-01-13,PF/BT,30156,Centro Vaccinale Covid Desenzano,LOM,50-59,15,23,0,16,6,0,16,38,0,38,Lombardia,ITC4
2021-01-13,PF/BT,30156,Centro Vaccinale Covid Desenzano,LOM,60-69,10,13,0,5,2,0,16,23,0,23,Lombardia,ITC4
2021-01-13,PF/BT,30156,Centro Vaccinale Covid Desenzano,LOM,70-79,5,2,0,1,0,0,6,7,0,7,Lombardia,ITC4
2021-01-13,PF/BT,30157,Centro Vaccinale Covid Gavardo,LOM,20-29,6,11,0,5,2,0,10,17,0,17,Lombardia,ITC4
2021-01-13,PF/BT,30157,Centro Vaccinale Covid Gavardo,LOM,30-39,10,6,0,3,0,0,13,16,0,16,Lombardia,ITC4
2021-01-13,PF/BT,30157,Centro Vaccinale Covid Gavardo,LOM,40-49,8,9,0,4,2,0,11,17,0,17,Lombardia,ITC4
2021-01-13,PF/BT,30157,Centro Vaccinale Covid Gavardo,LOM,50-59,10,9,0,6,3,0,10,19,0,19,Lombardia,ITC4
2021-01-13,PF/BT,30157,Centro Vaccinale Covid Gavardo,LOM,60-69,28,7,0,1,1,0,33,35,0,35,Lombardia,ITC4
2021-01-13,PF/BT,30157,Centro Vaccinale Covid Gavardo,LOM,70-79,3,0,0,2,0,0,1,3,0,3,Lombardia,ITC4
2021-01-13,PF/BT,30157,Centro Vaccinale Covid Gavardo,LOM,80-89,1,0,0,0,0,0,1,1,0,1,Lombardia,ITC4
2021-01-13,PF/BT,30176,ISTITUTO CLINICO S. ANNA di ISTITUTI OSPEDALIERI BRESCIANI S.p.A.,LOM,20-29,0,2,0,2,0,0,0,2,0,2,Lombardia,ITC4
2021-01-13,PF/BT,30176,ISTITUTO CLINICO S. ANNA di ISTITUTI OSPEDALIERI BRESCIANI S.p.A.,LOM,30-39,2,3,0,5,0,0,0,5,0,5,Lombardia,ITC4
2021-01-13,PF/BT,30176,ISTITUTO CLINICO S. ANNA di ISTITUTI OSPEDALIERI BRESCIANI S.p.A.,LOM,40-49,4,7,0,10,1,0,0,11,0,11,Lombardia,ITC4
2021-01-13,PF/BT,30176,ISTITUTO CLINICO S. ANNA di ISTITUTI OSPEDALIERI BRESCIANI S.p.A.,LOM,50-59,6,8,0,13,1,0,0,14,0,14,Lombardia,ITC4
2021-01-13,PF/BT,30176,ISTITUTO CLINICO S. ANNA di ISTITUTI OSPEDALIERI BRESCIANI S.p.A.,LOM,60-69,1,1,0,2,0,0,0,2,0,2,Lombardia,ITC4
2021-01-13,PF/BT,30176,ISTITUTO CLINICO S. ANNA di ISTITUTI OSPEDALIERI BRESCIANI S.p.A.,LOM,70-79,1,0,0,1,0,0,0,1,0,1,Lombardia,ITC4
2021-01-13,PF/BT,30176,ISTITUTO CLINICO S. ANNA di ISTITUTI OSPEDALIERI BRESCIANI S.p.A.,LOM,80-89,1,0,0,1,0,0,0,1,0,1,Lombardia,ITC4
2021-01-13,PF/BT,30184,Centro Vaccinale Covid Manerbio,LOM,16-19,0,1,0,0,0,0,1,1,0,1,Lombardia,ITC4
2021-01-13,PF/BT,30184,Centro Vaccinale Covid Manerbio,LOM,20-29,6,15,0,2,1,0,18,21,0,21,Lombardia,ITC4
2021-01-13,PF/BT,30184,Centro Vaccinale Covid Manerbio,LOM,30-39,6,6,0,2,0,0,10,12,0,12,Lombardia,ITC4
2021-01-13,PF/BT,30184,Centro Vaccinale Covid Manerbio,LOM,40-49,10,17,0,9,2,0,16,27,0,27,Lombardia,ITC4
2021-01-13,PF/BT,30184,Centro Vaccinale Covid Manerbio,LOM,50-59,8,17,0,5,0,0,20,25,0,25,Lombardia,ITC4
2021-01-13,PF/BT,30184,Centro Vaccinale Covid Manerbio,LOM,60-69,15,8,0,2,0,0,21,23,0,23,Lombardia,ITC4
2021-01-13,PF/BT,30184,Centro Vaccinale Covid Manerbio,LOM,70-79,3,2,0,0,0,0,5,5,0,5,Lombardia,ITC4
2021-01-13,PF/BT,30193,Ambulatorio HUB Vigevano,LOM,20-29,3,12,0,10,5,0,0,15,0,15,Lombardia,ITC4
2021-01-13,PF/BT,30193,Ambulatorio HUB Vigevano,LOM,30-39,10,10,0,14,6,0,0,20,0,20,Lombardia,ITC4
2021-01-13,PF/BT,30193,Ambulatorio HUB Vigevano,LOM,40-49,7,20,0,21,6,0,0,27,0,27,Lombardia,ITC4
2021-01-13,PF/BT,30193,Ambulatorio HUB Vigevano,LOM,50-59,11,35,0,29,17,0,0,46,0,46,Lombardia,ITC4
2021-01-13,PF/BT,30193,Ambulatorio HUB Vigevano,LOM,60-69,21,24,0,18,27,0,0,45,0,45,Lombardia,ITC4
2021-01-13,PF/BT,30193,Ambulatorio HUB Vigevano,LOM,70-79,5,2,0,2,5,0,0,7,0,7,Lombardia,ITC4
2021-01-13,PF/BT,30194,AMBULATORIO HUB VOGHERA,LOM,20-29,8,10,0,16,2,0,0,18,0,18,Lombardia,ITC4
2021-01-13,PF/BT,30194,AMBULATORIO HUB VOGHERA,LOM,30-39,12,10,0,15,7,0,0,22,0,22,Lombardia,ITC4
2021-01-13,PF/BT,30194,AMBULATORIO HUB VOGHERA,LOM,40-49,11,23,0,25,9,0,0,34,0,34,Lombardia,ITC4
2021-01-13,PF/BT,30194,AMBULATORIO HUB VOGHERA,LOM,50-59,19,29,0,34,14,0,0,48,0,48,Lombardia,ITC4
2021-01-13,PF/BT,30194,AMBULATORIO HUB VOGHERA,LOM,60-69,7,5,0,6,6,0,0,12,0,12,Lombardia,ITC4
2021-01-13,PF/BT,30194,AMBULATORIO HUB VOGHERA,LOM,70-79,4,0,0,1,3,0,0,4,0,4,Lombardia,ITC4
2021-01-13,PF/BT,30194,Punto vaccinale Territoriale ASST di Pavia,LOM,20-29,2,3,0,4,1,0,0,5,0,5,Lombardia,ITC4
2021-01-13,PF/BT,30194,Punto vaccinale Territoriale ASST di Pavia,LOM,30-39,4,7,0,9,2,0,0,11,0,11,Lombardia,ITC4
2021-01-13,PF/BT,30194,Punto vaccinale Territoriale ASST di Pavia,LOM,40-49,3,6,0,7,2,0,0,9,0,9,Lombardia,ITC4
2021-01-13,PF/BT,30194,Punto vaccinale Territoriale ASST di Pavia,LOM,50-59,10,19,0,15,14,0,0,29,0,29,Lombardia,ITC4
2021-01-13,PF/BT,30194,Punto vaccinale Territoriale ASST di Pavia,LOM,60-69,4,12,0,14,2,0,0,16,0,16,Lombardia,ITC4
2021-01-13,PF/BT,302,Istituto Palazzolo Fondazione Don Carlo Gnocchi,LOM,20-29,7,9,0,16,0,0,0,16,0,16,Lombardia,ITC4
2021-01-13,PF/BT,302,Istituto Palazzolo Fondazione Don Carlo Gnocchi,LOM,30-39,9,8,0,17,0,0,0,17,0,17,Lombardia,ITC4
2021-01-13,PF/BT,302,Istituto Palazzolo Fondazione Don Carlo Gnocchi,LOM,40-49,5,15,0,15,5,0,0,20,0,20,Lombardia,ITC4
2021-01-13,PF/BT,302,Istituto Palazzolo Fondazione Don Carlo Gnocchi,LOM,50-59,10,25,0,28,7,0,0,35,0,35,Lombardia,ITC4
2021-01-13,PF/BT,302,Istituto Palazzolo Fondazione Don Carlo Gnocchi,LOM,60-69,2,6,0,5,3,0,0,8,0,8,Lombardia,ITC4
2021-01-13,PF/BT,30209,OSPEDALE MAGGIORE DI CREMA,LOM,16-19,0,2,0,0,0,0,2,2,0,2,Lombardia,ITC4
2021-01-13,PF/BT,30209,OSPEDALE MAGGIORE DI CREMA,LOM,20-29,12,26,0,26,1,0,11,38,0,38,Lombardia,ITC4
2021-01-13,PF/BT,30209,OSPEDALE MAGGIORE DI CREMA,LOM,30-39,7,19,0,17,3,0,6,26,0,26,Lombardia,ITC4
2021-01-13,PF/BT,30209,OSPEDALE MAGGIORE DI CREMA,LOM,40-49,7,34,0,27,6,0,8,41,0,41,Lombardia,ITC4
2021-01-13,PF/BT,30209,OSPEDALE MAGGIORE DI CREMA,LOM,50-59,14,40,0,26,20,0,8,54,0,54,Lombardia,ITC4
2021-01-13,PF/BT,30209,OSPEDALE MAGGIORE DI CREMA,LOM,60-69,8,8,0,10,4,0,2,16,0,16,Lombardia,ITC4
2021-01-13,PF/BT,30209,OSPEDALE MAGGIORE DI CREMA,LOM,80-89,2,1,0,0,0,0,3,3,0,3,Lombardia,ITC4
2021-01-13,PF/BT,3021800,Casa di Cura san Camillo cremona,LOM,20-29,1,4,0,5,0,0,0,5,0,5,Lombardia,ITC4
2021-01-13,PF/BT,3021800,Casa di Cura san Camillo cremona,LOM,30-39,2,9,0,8,3,0,0,11,0,11,Lombardia,ITC4
2021-01-13,PF/BT,3021800,Casa di Cura san Camillo cremona,LOM,40-49,3,13,0,12,4,0,0,16,0,16,Lombardia,ITC4
2021-01-13,PF/BT,3021800,Casa di Cura san Camillo cremona,LOM,50-59,3,9,0,9,3,0,0,12,0,12,Lombardia,ITC4
2021-01-13,PF/BT,3021800,Casa di Cura san Camillo cremona,LOM,60-69,4,3,0,6,1,0,0,7,0,7,Lombardia,ITC4
2021-01-13,PF/BT,3021800,Casa di Cura san Camillo cremona,LOM,70-79,2,0,0,2,0,0,0,2,0,2,Lombardia,ITC4
2021-01-13,PF/BT,3021800,Casa di Cura san Camillo cremona,LOM,80-89,1,0,0,1,0,0,0,1,0,1,Lombardia,ITC4
2021-01-13,PF/BT,30281,HUB LEGNANO,LOM,20-29,5,12,0,14,3,0,0,17,0,17,Lombardia,ITC4
2021-01-13,PF/BT,30281,HUB LEGNANO,LOM,30-39,14,33,0,39,8,0,0,47,0,47,Lombardia,ITC4
2021-01-13,PF/BT,30281,HUB LEGNANO,LOM,40-49,18,59,0,54,23,0,0,77,0,77,Lombardia,ITC4
2021-01-13,PF/BT,30281,HUB LEGNANO,LOM,50-59,21,106,0,86,41,0,0,127,0,127,Lombardia,ITC4
2021-01-13,PF/BT,30281,HUB LEGNANO,LOM,60-69,12,15,0,23,4,0,0,27,0,27,Lombardia,ITC4
2021-01-13,PF/BT,30321000265,ISTITUTO MONS. LUIGI BIRAGHI,LOM,30-39,0,1,0,1,0,0,0,1,0,1,Lombardia,ITC4
2021-01-13,PF/BT,30321000265,ISTITUTO MONS. LUIGI BIRAGHI,LOM,40-49,1,6,0,7,0,0,0,7,0,7,Lombardia,ITC4
2021-01-13,PF/BT,30321000265,ISTITUTO MONS. LUIGI BIRAGHI,LOM,50-59,1,6,0,7,0,0,0,7,0,7,Lombardia,ITC4
2021-01-13,PF/BT,30321000265,ISTITUTO MONS. LUIGI BIRAGHI,LOM,60-69,0,2,0,2,0,0,0,2,0,2,Lombardia,ITC4
2021-01-13,PF/BT,30321000265,ISTITUTO MONS. LUIGI BIRAGHI,LOM,70-79,0,3,0,2,0,1,0,3,0,3,Lombardia,ITC4
2021-01-13,PF/BT,30321000265,ISTITUTO MONS. LUIGI BIRAGHI,LOM,80-89,3,23,0,0,0,26,0,26,0,26,Lombardia,ITC4
2021-01-13,PF/BT,30321000265,ISTITUTO MONS. LUIGI BIRAGHI,LOM,90+,1,37,0,0,0,38,0,38,0,38,Lombardia,ITC4
2021-01-13,PF/BT,30321000338 - 30321000390,Residenze Assistite maleo (Rsa Mons Trabattoni & RSA L. Corazza) Maleo - Lodi,LOM,30-39,3,5,0,6,2,0,0,8,0,8,Lombardia,ITC4
2021-01-13,PF/BT,30321000338 - 30321000390,Residenze Assistite maleo (Rsa Mons Trabattoni & RSA L. Corazza) Maleo - Lodi,LOM,40-49,0,5,0,5,0,0,0,5,0,5,Lombardia,ITC4
2021-01-13,PF/BT,30321000338 - 30321000390,Residenze Assistite maleo (Rsa Mons Trabattoni & RSA L. Corazza) Maleo - Lodi,LOM,50-59,1,6,0,6,1,0,0,7,0,7,Lombardia,ITC4
2021-01-13,PF/BT,30321000338 - 30321000390,Residenze Assistite maleo (Rsa Mons Trabattoni & RSA L. Corazza) Maleo - Lodi,LOM,60-69,0,2,0,2,0,0,0,2,0,2,Lombardia,ITC4
2021-01-13,PF/BT,30321000338 - 30321000390,Residenze Assistite maleo (Rsa Mons Trabattoni & RSA L. Corazza) Maleo - Lodi,LOM,80-89,0,2,0,0,1,1,0,2,0,2,Lombardia,ITC4
2021-01-13,PF/BT,30322029,Ospedale Religioso Classificato Sacra Famiglia Fatebenefratelli Erba,LOM,20-29,0,14,0,14,0,0,0,14,0,14,Lombardia,ITC4
2021-01-13,PF/BT,30322029,Ospedale Religioso Classificato Sacra Famiglia Fatebenefratelli Erba,LOM,30-39,5,7,0,10,2,0,0,12,0,12,Lombardia,ITC4
2021-01-13,PF/BT,30322029,Ospedale Religioso Classificato Sacra Famiglia Fatebenefratelli Erba,LOM,40-49,7,21,0,25,3,0,0,28,0,28,Lombardia,ITC4
2021-01-13,PF/BT,30322029,Ospedale Religioso Classificato Sacra Famiglia Fatebenefratelli Erba,LOM,50-59,1,8,0,9,0,0,0,9,0,9,Lombardia,ITC4
2021-01-13,PF/BT,30322029,Ospedale Religioso Classificato Sacra Famiglia Fatebenefratelli Erba,LOM,60-69,3,5,0,8,0,0,0,8,0,8,Lombardia,ITC4
2021-01-13,PF/BT,30322029,Ospedale Religioso Classificato Sacra Famiglia Fatebenefratelli Erba,LOM,70-79,1,0,0,1,0,0,0,1,0,1,Lombardia,ITC4
2021-01-13,PF/BT,30326001723,FONDAZIONE DANTE CUSI ONLUS,LOM,70-79,1,0,0,0,0,1,0,1,0,1,Lombardia,ITC4
2021-01-13,PF/BT,30326001723,FONDAZIONE DANTE CUSI ONLUS,LOM,80-89,1,6,0,0,0,7,0,7,0,7,Lombardia,ITC4
2021-01-13,PF/BT,30326001723,FONDAZIONE DANTE CUSI ONLUS,LOM,90+,1,9,0,0,0,10,0,10,0,10,Lombardia,ITC4
2021-01-13,PF/BT,30327001819,RSA I GIRASOLI - VIA M. K. GANDHI N° 1 BORGO VIRGILIO (MN),LOM,20-29,1,1,0,1,1,0,0,2,0,2,Lombardia,ITC4
2021-01-13,PF/BT,30327001819,RSA I GIRASOLI - VIA M. K. GANDHI N° 1 BORGO VIRGILIO (MN),LOM,30-39,1,2,0,2,1,0,0,3,0,3,Lombardia,ITC4
2021-01-13,PF/BT,30327001819,RSA I GIRASOLI - VIA M. K. GANDHI N° 1 BORGO VIRGILIO (MN),LOM,40-49,7,20,0,21,6,0,0,27,0,27,Lombardia,ITC4
2021-01-13,PF/BT,30327001819,RSA I GIRASOLI - VIA M. K. GANDHI N° 1 BORGO VIRGILIO (MN),LOM,50-59,1,17,0,13,5,0,0,18,0,18,Lombardia,ITC4
2021-01-13,PF/BT,30327001819,RSA I GIRASOLI - VIA M. K. GANDHI N° 1 BORGO VIRGILIO (MN),LOM,60-69,1,8,0,7,2,0,0,9,0,9,Lombardia,ITC4
2021-01-13,PF/BT,30327001819,RSA I GIRASOLI - VIA M. K. GANDHI N° 1 BORGO VIRGILIO (MN),LOM,90+,1,0,0,0,0,1,0,1,0,1,Lombardia,ITC4
2021-01-13,PF/BT,3035300,OSPEDALE CIVILE VOLTA MANTOVANA SRL,LOM,20-29,1,4,0,5,0,0,0,5,0,5,Lombardia,ITC4
2021-01-13,PF/BT,3035300,OSPEDALE CIVILE VOLTA MANTOVANA SRL,LOM,30-39,3,7,0,8,2,0,0,10,0,10,Lombardia,ITC4
2021-01-13,PF/BT,3035300,OSPEDALE CIVILE VOLTA MANTOVANA SRL,LOM,40-49,0,5,0,4,1,0,0,5,0,5,Lombardia,ITC4
2021-01-13,PF/BT,3035300,OSPEDALE CIVILE VOLTA MANTOVANA SRL,LOM,50-59,3,3,0,3,2,0,1,6,0,6,Lombardia,ITC4
2021-01-13,PF/BT,3035300,OSPEDALE CIVILE VOLTA MANTOVANA SRL,LOM,60-69,2,1,0,2,0,1,0,3,0,3,Lombardia,ITC4
2021-01-13,PF/BT,3035300,OSPEDALE CIVILE VOLTA MANTOVANA SRL,LOM,70-79,0,1,0,1,0,0,0,1,0,1,Lombardia,ITC4
2021-01-13,PF/BT,3035500,ospedale di suzzara spa,LOM,20-29,4,9,0,11,2,0,0,13,0,13,Lombardia,ITC4
2021-01-13,PF/BT,3035500,ospedale di suzzara spa,LOM,30-39,5,3,0,7,1,0,0,8,0,8,Lombardia,ITC4
2021-01-13,PF/BT,3035500,ospedale di suzzara spa,LOM,40-49,6,8,0,8,6,0,0,14,0,14,Lombardia,ITC4
2021-01-13,PF/BT,3035500,ospedale di suzzara spa,LOM,50-59,3,9,0,6,6,0,0,12,0,12,Lombardia,ITC4
2021-01-13,PF/BT,3035500,ospedale di suzzara spa,LOM,60-69,7,4,0,10,1,0,0,11,0,11,Lombardia,ITC4
2021-01-13,PF/BT,3035500,ospedale di suzzara spa,LOM,70-79,2,0,0,2,0,0,0,2,0,2,Lombardia,ITC4
2021-01-13,PF/BT,3035700,OSPEDALE SAN PELLEGRINO SRL,LOM,20-29,1,5,0,4,2,0,0,6,0,6,Lombardia,ITC4
2021-01-13,PF/BT,3035700,OSPEDALE SAN PELLEGRINO SRL,LOM,30-39,6,6,0,11,1,0,0,12,0,12,Lombardia,ITC4
2021-01-13,PF/BT,3035700,OSPEDALE SAN PELLEGRINO SRL,LOM,40-49,3,10,0,8,4,0,1,13,0,13,Lombardia,ITC4
2021-01-13,PF/BT,3035700,OSPEDALE SAN PELLEGRINO SRL,LOM,50-59,6,8,0,8,4,0,2,14,0,14,Lombardia,ITC4
2021-01-13,PF/BT,3035700,OSPEDALE SAN PELLEGRINO SRL,LOM,60-69,7,0,0,6,1,0,0,7,0,7,Lombardia,ITC4
2021-01-13,PF/BT,3035700,OSPEDALE SAN PELLEGRINO SRL,LOM,70-79,2,0,0,2,0,0,0,2,0,2,Lombardia,ITC4
2021-01-13,PF/BT,30701,ASST GRANDE OSPEDALE METROPOLITANO NIGUARDA,LOM,16-19,3,0,0,0,3,0,0,3,0,3,Lombardia,ITC4
2021-01-13,PF/BT,30701,ASST GRANDE OSPEDALE METROPOLITANO NIGUARDA,LOM,20-29,41,62,0,52,41,0,10,103,0,103,Lombardia,ITC4
2021-01-13,PF/BT,30701,ASST GRANDE OSPEDALE METROPOLITANO NIGUARDA,LOM,30-39,46,68,0,56,46,0,12,114,0,114,Lombardia,ITC4
2021-01-13,PF/BT,30701,ASST GRANDE OSPEDALE METROPOLITANO NIGUARDA,LOM,40-49,62,68,0,53,56,0,21,130,0,130,Lombardia,ITC4
2021-01-13,PF/BT,30701,ASST GRANDE OSPEDALE METROPOLITANO NIGUARDA,LOM,50-59,51,101,0,76,58,0,18,152,0,152,Lombardia,ITC4
2021-01-13,PF/BT,30701,ASST GRANDE OSPEDALE METROPOLITANO NIGUARDA,LOM,60-69,34,26,0,34,16,0,10,60,0,60,Lombardia,ITC4
2021-01-13,PF/BT,30701,ASST GRANDE OSPEDALE METROPOLITANO NIGUARDA,LOM,70-79,4,4,0,4,2,0,2,8,0,8,Lombardia,ITC4
2021-01-13,PF/BT,30718,ASST PAPA GIOVANNI XXIII,LOM,20-29,16,35,0,44,7,0,0,51,0,51,Lombardia,ITC4
2021-01-13,PF/BT,30718,ASST PAPA GIOVANNI XXIII,LOM,30-39,14,51,0,54,11,0,0,65,0,65,Lombardia,ITC4
2021-01-13,PF/BT,30718,ASST PAPA GIOVANNI XXIII,LOM,40-49,13,67,0,71,9,0,0,80,0,80,Lombardia,ITC4
2021-01-13,PF/BT,30718,ASST PAPA GIOVANNI XXIII,LOM,50-59,30,84,0,95,19,0,0,114,0,114,Lombardia,ITC4
2021-01-13,PF/BT,30718,ASST PAPA GIOVANNI XXIII,LOM,60-69,14,17,0,25,6,0,0,31,0,31,Lombardia,ITC4
2021-01-13,PF/BT,30902,Ospedale S.Anna - Como,LOM,16-19,5,21,0,1,11,0,14,26,0,26,Lombardia,ITC4
2021-01-13,PF/BT,30902,Ospedale S.Anna - Como,LOM,20-29,57,132,0,36,90,0,63,189,0,189,Lombardia,ITC4
2021-01-13,PF/BT,30902,Ospedale S.Anna - Como,LOM,30-39,58,50,0,29,75,0,4,108,0,108,Lombardia,ITC4
2021-01-13,PF/BT,30902,Ospedale S.Anna - Como,LOM,40-49,63,81,0,44,100,0,0,144,0,144,Lombardia,ITC4
2021-01-13,PF/BT,30902,Ospedale S.Anna - Como,LOM,50-59,61,126,0,51,136,0,0,187,0,187,Lombardia,ITC4
2021-01-13,PF/BT,30902,Ospedale S.Anna - Como,LOM,60-69,68,40,0,26,82,0,0,108,0,108,Lombardia,ITC4
2021-01-13,PF/BT,30902,Ospedale S.Anna - Como,LOM,70-79,18,13,0,1,30,0,0,31,0,31,Lombardia,ITC4
2021-01-13,PF/BT,30902,Ospedale S.Anna - Como,LOM,80-89,1,4,0,1,4,0,0,5,0,5,Lombardia,ITC4
2021-01-13,PF/BT,30904,ASST VALTELLINA E ALTO LARIO PRESIDIO OSPEDALIERO DI SONDALO,LOM,20-29,3,8,0,10,1,0,0,11,0,11,Lombardia,ITC4
2021-01-13,PF/BT,30904,ASST VALTELLINA E ALTO LARIO PRESIDIO OSPEDALIERO DI SONDALO,LOM,30-39,4,9,0,12,1,0,0,13,0,13,Lombardia,ITC4
2021-01-13,PF/BT,30904,ASST VALTELLINA E ALTO LARIO PRESIDIO OSPEDALIERO DI SONDALO,LOM,40-49,6,11,0,15,2,0,0,17,0,17,Lombardia,ITC4
2021-01-13,PF/BT,30904,ASST VALTELLINA E ALTO LARIO PRESIDIO OSPEDALIERO DI SONDALO,LOM,50-59,23,38,0,33,28,0,0,61,0,61,Lombardia,ITC4
2021-01-13,PF/BT,30904,ASST VALTELLINA E ALTO LARIO PRESIDIO OSPEDALIERO DI SONDALO,LOM,60-69,17,7,0,11,13,0,0,24,0,24,Lombardia,ITC4
2021-01-13,PF/BT,30909,amb covid monza,LOM,16-19,1,9,0,9,1,0,0,10,0,10,Lombardia,ITC4
2021-01-13,PF/BT,30909,amb covid monza,LOM,20-29,73,135,0,187,17,0,4,208,0,208,Lombardia,ITC4
2021-01-13,PF/BT,30909,amb covid monza,LOM,30-39,24,78,0,74,18,0,10,102,0,102,Lombardia,ITC4
2021-01-13,PF/BT,30909,amb covid monza,LOM,40-49,25,102,0,68,34,0,25,127,0,127,Lombardia,ITC4
2021-01-13,PF/BT,30909,amb covid monza,LOM,50-59,48,104,0,89,50,0,13,152,0,152,Lombardia,ITC4
2021-01-13,PF/BT,30909,amb covid monza,LOM,60-69,39,44,0,61,19,0,3,83,0,83,Lombardia,ITC4
2021-01-13,PF/BT,30909,amb covid monza,LOM,70-79,6,5,0,7,2,0,2,11,0,11,Lombardia,ITC4
2021-01-13,PF/BT,30909,amb covid monza,LOM,80-89,1,2,0,3,0,0,0,3,0,3,Lombardia,ITC4
2021-01-13,PF/BT,30933,IRCCS CENTRO MEDICO DI CASTEL GOFFREDO,LOM,20-29,1,3,0,2,2,0,0,4,0,4,Lombardia,ITC4
2021-01-13,PF/BT,30933,IRCCS CENTRO MEDICO DI CASTEL GOFFREDO,LOM,30-39,2,1,0,1,2,0,0,3,0,3,Lombardia,ITC4
2021-01-13,PF/BT,30933,IRCCS CENTRO MEDICO DI CASTEL GOFFREDO,LOM,40-49,5,11,0,6,10,0,0,16,0,16,Lombardia,ITC4
2021-01-13,PF/BT,30933,IRCCS CENTRO MEDICO DI CASTEL GOFFREDO,LOM,50-59,3,8,0,7,4,0,0,11,0,11,Lombardia,ITC4
2021-01-13,PF/BT,30933,IRCCS CENTRO MEDICO DI CASTEL GOFFREDO,LOM,60-69,2,0,0,2,0,0,0,2,0,2,Lombardia,ITC4
2021-01-13,PF/BT,3093400,CENTRO CARDIOLOGICO MONZINO,LOM,20-29,3,7,0,7,3,0,0,10,0,10,Lombardia,ITC4
2021-01-13,PF/BT,3093400,CENTRO CARDIOLOGICO MONZINO,LOM,30-39,12,10,0,15,7,0,0,22,0,22,Lombardia,ITC4
2021-01-13,PF/BT,3093400,CENTRO CARDIOLOGICO MONZINO,LOM,40-49,6,20,0,19,7,0,0,26,0,26,Lombardia,ITC4
2021-01-13,PF/BT,3093400,CENTRO CARDIOLOGICO MONZINO,LOM,50-59,4,21,0,22,3,0,0,25,0,25,Lombardia,ITC4
2021-01-13,PF/BT,3093400,CENTRO CARDIOLOGICO MONZINO,LOM,70-79,1,0,0,1,0,0,0,1,0,1,Lombardia,ITC4
2021-01-13,PF/BT,30941,ISTITUTO EUROPEO DI ONCOLOGIA,LOM,20-29,8,8,0,14,0,0,2,16,0,16,Lombardia,ITC4
2021-01-13,PF/BT,30941,ISTITUTO EUROPEO DI ONCOLOGIA,LOM,30-39,4,3,0,6,0,0,1,7,0,7,Lombardia,ITC4
2021-01-13,PF/BT,30941,ISTITUTO EUROPEO DI ONCOLOGIA,LOM,40-49,23,48,0,70,1,0,0,71,0,71,Lombardia,ITC4
2021-01-13,PF/BT,30941,ISTITUTO EUROPEO DI ONCOLOGIA,LOM,50-59,1,3,0,4,0,0,0,4,0,4,Lombardia,ITC4
2021-01-13,PF/BT,30941,ISTITUTO EUROPEO DI ONCOLOGIA,LOM,60-69,1,0,0,1,0,0,0,1,0,1,Lombardia,ITC4
2021-01-13,PF/BT,3094602,IST.CLINICO S.SIRO SPA-MILANO,LOM,20-29,4,0,0,4,0,0,0,4,0,4,Lombardia,ITC4
2021-01-13,PF/BT,3094602,IST.CLINICO S.SIRO SPA-MILANO,LOM,30-39,4,1,0,5,0,0,0,5,0,5,Lombardia,ITC4
2021-01-13,PF/BT,3094602,IST.CLINICO S.SIRO SPA-MILANO,LOM,40-49,1,2,0,3,0,0,0,3,0,3,Lombardia,ITC4
2021-01-13,PF/BT,3094602,IST.CLINICO S.SIRO SPA-MILANO,LOM,50-59,5,5,0,9,1,0,0,10,0,10,Lombardia,ITC4
2021-01-13,PF/BT,3094602,IST.CLINICO S.SIRO SPA-MILANO,LOM,60-69,3,1,0,4,0,0,0,4,0,4,Lombardia,ITC4
2021-01-13,PF/BT,3094602,IST.CLINICO S.SIRO SPA-MILANO,LOM,70-79,3,0,0,3,0,0,0,3,0,3,Lombardia,ITC4
2021-01-13,PF/BT,3094602,IST.CLINICO S.SIRO SPA-MILANO,LOM,80-89,1,0,0,1,0,0,0,1,0,1,Lombardia,ITC4
2021-01-13,PF/BT,314,RSA SAN GIORGIO,LOM,30-39,2,2,0,4,0,0,0,4,0,4,Lombardia,ITC4
2021-01-13,PF/BT,314,RSA SAN GIORGIO,LOM,40-49,0,3,0,3,0,0,0,3,0,3,Lombardia,ITC4
2021-01-13,PF/BT,314,RSA SAN GIORGIO,LOM,50-59,0,8,0,8,0,0,0,8,0,8,Lombardia,ITC4
2021-01-13,PF/BT,314,RSA SAN GIORGIO,LOM,60-69,0,4,0,4,0,0,0,4,0,4,Lombardia,ITC4
2021-01-13,PF/BT,314,RSA SAN GIORGIO,LOM,70-79,1,0,0,0,0,1,0,1,0,1,Lombardia,ITC4
2021-01-13,PF/BT,314,RSA SAN GIORGIO,LOM,80-89,1,3,0,0,0,4,0,4,0,4,Lombardia,ITC4
2021-01-13,PF/BT,314,RSA SAN GIORGIO,LOM,90+,1,5,0,0,0,6,0,6,0,6,Lombardia,ITC4
2021-01-13,PF/BT,319700,CASA DI CURA VILLA ESPERIA,LOM,20-29,5,3,0,8,0,0,0,8,0,8,Lombardia,ITC4
2021-01-13,PF/BT,319700,CASA DI CURA VILLA ESPERIA,LOM,30-39,5,6,0,10,1,0,0,11,0,11,Lombardia,ITC4
2021-01-13,PF/BT,319700,CASA DI CURA VILLA ESPERIA,LOM,40-49,4,10,0,13,1,0,0,14,0,14,Lombardia,ITC4
2021-01-13,PF/BT,319700,CASA DI CURA VILLA ESPERIA,LOM,50-59,3,9,0,9,3,0,0,12,0,12,Lombardia,ITC4
2021-01-13,PF/BT,319700,CASA DI CURA VILLA ESPERIA,LOM,60-69,0,3,0,2,1,0,0,3,0,3,Lombardia,ITC4
2021-01-13,PF/BT,321000247,RSA GIOVANNI PAOLO II,LOM,20-29,2,3,0,5,0,0,0,5,0,5,Lombardia,ITC4
2021-01-13,PF/BT,321000247,RSA GIOVANNI PAOLO II,LOM,30-39,3,1,0,2,2,0,0,4,0,4,Lombardia,ITC4
2021-01-13,PF/BT,321000247,RSA GIOVANNI PAOLO II,LOM,40-49,1,3,0,2,2,0,0,4,0,4,Lombardia,ITC4
2021-01-13,PF/BT,321000247,RSA GIOVANNI PAOLO II,LOM,50-59,0,2,0,1,1,0,0,2,0,2,Lombardia,ITC4
2021-01-13,PF/BT,321000247,RSA GIOVANNI PAOLO II,LOM,60-69,1,1,0,0,2,0,0,2,0,2,Lombardia,ITC4
2021-01-13,PF/BT,321000286,RSA SANTA LUCIA - MILANO,LOM,20-29,1,0,0,0,1,0,0,1,0,1,Lombardia,ITC4
2021-01-13,PF/BT,321000286,RSA SANTA LUCIA - MILANO,LOM,30-39,1,6,0,5,2,0,0,7,0,7,Lombardia,ITC4
2021-01-13,PF/BT,321000286,RSA SANTA LUCIA - MILANO,LOM,40-49,2,12,0,12,2,0,0,14,0,14,Lombardia,ITC4
2021-01-13,PF/BT,321000286,RSA SANTA LUCIA - MILANO,LOM,50-59,0,6,0,3,3,0,0,6,0,6,Lombardia,ITC4
2021-01-13,PF/BT,321000286,RSA SANTA LUCIA - MILANO,LOM,60-69,0,1,0,1,0,0,0,1,0,1,Lombardia,ITC4
2021-01-13,PF/BT,321000286,RSA SANTA LUCIA - MILANO,LOM,70-79,1,3,0,0,0,4,0,4,0,4,Lombardia,ITC4
2021-01-13,PF/BT,321000286,RSA SANTA LUCIA - MILANO,LOM,80-89,3,5,0,0,0,8,0,8,0,8,Lombardia,ITC4
2021-01-13,PF/BT,321000286,RSA SANTA LUCIA - MILANO,LOM,90+,0,13,0,0,0,13,0,13,0,13,Lombardia,ITC4
2021-01-13,PF/BT,321000289,RSA Casa Famiglia,LOM,20-29,1,2,0,3,0,0,0,3,0,3,Lombardia,ITC4
2021-01-13,PF/BT,321000289,RSA Casa Famiglia,LOM,30-39,4,5,0,5,2,0,2,9,0,9,Lombardia,ITC4
2021-01-13,PF/BT,321000289,RSA Casa Famiglia,LOM,40-49,1,3,0,4,0,0,0,4,0,4,Lombardia,ITC4
2021-01-13,PF/BT,321000289,RSA Casa Famiglia,LOM,50-59,1,1,0,1,1,0,0,2,0,2,Lombardia,ITC4
2021-01-13,PF/BT,321000318,RSA IL NAVIGLIO,LOM,60-69,2,1,0,0,0,3,0,3,0,3,Lombardia,ITC4
2021-01-13,PF/BT,321000318,RSA IL NAVIGLIO,LOM,70-79,2,3,0,0,0,5,0,5,0,5,Lombardia,ITC4
2021-01-13,PF/BT,321000318,RSA IL NAVIGLIO,LOM,80-89,5,22,0,0,0,27,0,27,0,27,Lombardia,ITC4
2021-01-13,PF/BT,321000318,RSA IL NAVIGLIO,LOM,90+,0,7,0,0,0,7,0,7,0,7,Lombardia,ITC4
2021-01-13,PF/BT,321000354 e 321000584,PUNTO VACCINALE RSA CASA PER CONIUGI,LOM,20-29,0,2,0,1,1,0,0,2,0,2,Lombardia,ITC4
2021-01-13,PF/BT,321000354 e 321000584,PUNTO VACCINALE RSA CASA PER CONIUGI,LOM,30-39,1,3,0,3,1,0,0,4,0,4,Lombardia,ITC4
2021-01-13,PF/BT,321000354 e 321000584,PUNTO VACCINALE RSA CASA PER CONIUGI,LOM,40-49,5,2,0,5,2,0,0,7,0,7,Lombardia,ITC4
2021-01-13,PF/BT,321000354 e 321000584,PUNTO VACCINALE RSA CASA PER CONIUGI,LOM,50-59,1,4,0,5,0,0,0,5,0,5,Lombardia,ITC4
2021-01-13,PF/BT,321000373,rsa parco delle cave e baggio,LOM,20-29,2,1,0,3,0,0,0,3,0,3,Lombardia,ITC4
2021-01-13,PF/BT,321000373,rsa parco delle cave e baggio,LOM,30-39,8,4,0,12,0,0,0,12,0,12,Lombardia,ITC4
2021-01-13,PF/BT,321000373,rsa parco delle cave e baggio,LOM,40-49,18,5,0,23,0,0,0,23,0,23,Lombardia,ITC4
2021-01-13,PF/BT,321000373,rsa parco delle cave e baggio,LOM,50-59,3,20,0,23,0,0,0,23,0,23,Lombardia,ITC4
2021-01-13,PF/BT,321000373,rsa parco delle cave e baggio,LOM,60-69,2,1,0,3,0,0,0,3,0,3,Lombardia,ITC4
2021-01-13,PF/BT,321000373,rsa parco delle cave e baggio,LOM,80-89,0,1,0,0,0,1,0,1,0,1,Lombardia,ITC4
2021-01-13,PF/BT,321000373,rsa parco delle cave e baggio,LOM,90+,0,1,0,0,0,1,0,1,0,1,Lombardia,ITC4
2021-01-13,PF/BT,321000532 - 321000533,RSA SACCARDO A e B,LOM,20-29,0,2,0,2,0,0,0,2,0,2,Lombardia,ITC4
2021-01-13,PF/BT,321000532 - 321000533,RSA SACCARDO A e B,LOM,30-39,2,5,0,5,2,0,0,7,0,7,Lombardia,ITC4
2021-01-13,PF/BT,321000532 - 321000533,RSA SACCARDO A e B,LOM,40-49,1,11,0,8,4,0,0,12,0,12,Lombardia,ITC4
2021-01-13,PF/BT,321000532 - 321000533,RSA SACCARDO A e B,LOM,50-59,4,11,0,11,4,0,0,15,0,15,Lombardia,ITC4
2021-01-13,PF/BT,321000532 - 321000533,RSA SACCARDO A e B,LOM,60-69,1,3,0,2,1,1,0,4,0,4,Lombardia,ITC4
2021-01-13,PF/BT,321000532 - 321000533,RSA SACCARDO A e B,LOM,70-79,1,1,0,0,0,2,0,2,0,2,Lombardia,ITC4
2021-01-13,PF/BT,321000532 - 321000533,RSA SACCARDO A e B,LOM,80-89,3,13,0,0,0,16,0,16,0,16,Lombardia,ITC4
2021-01-13,PF/BT,321000532 - 321000533,RSA SACCARDO A e B,LOM,90+,2,6,0,0,0,8,0,8,0,8,Lombardia,ITC4
2021-01-13,PF/BT,32170712,ambulatorio covid SESTO SAN GIOVANNI,LOM,16-19,0,6,0,5,1,0,0,6,0,6,Lombardia,ITC4
2021-01-13,PF/BT,32170712,ambulatorio covid SESTO SAN GIOVANNI,LOM,20-29,11,32,0,35,8,0,0,43,0,43,Lombardia,ITC4
2021-01-13,PF/BT,32170712,ambulatorio covid SESTO SAN GIOVANNI,LOM,30-39,26,30,0,44,12,0,0,56,0,56,Lombardia,ITC4
2021-01-13,PF/BT,32170712,ambulatorio covid SESTO SAN GIOVANNI,LOM,40-49,28,51,0,67,12,0,0,79,0,79,Lombardia,ITC4
2021-01-13,PF/BT,32170712,ambulatorio covid SESTO SAN GIOVANNI,LOM,50-59,42,63,0,80,25,0,0,105,0,105,Lombardia,ITC4
2021-01-13,PF/BT,32170712,ambulatorio covid SESTO SAN GIOVANNI,LOM,60-69,24,25,0,39,10,0,0,49,0,49,Lombardia,ITC4
2021-01-13,PF/BT,32170712,ambulatorio covid SESTO SAN GIOVANNI,LOM,70-79,4,0,0,4,0,0,0,4,0,4,Lombardia,ITC4
2021-01-13,PF/BT,322000722,RSA - CASA CARDINAL G. LERCARO - BODIO LOMNAGO,LOM,20-29,2,2,0,3,1,0,0,4,0,4,Lombardia,ITC4
2021-01-13,PF/BT,322000722,RSA - CASA CARDINAL G. LERCARO - BODIO LOMNAGO,LOM,30-39,0,7,0,3,4,0,0,7,0,7,Lombardia,ITC4
2021-01-13,PF/BT,322000722,RSA - CASA CARDINAL G. LERCARO - BODIO LOMNAGO,LOM,40-49,7,8,0,7,8,0,0,15,0,15,Lombardia,ITC4
2021-01-13,PF/BT,322000722,RSA - CASA CARDINAL G. LERCARO - BODIO LOMNAGO,LOM,50-59,4,15,0,6,13,0,0,19,0,19,Lombardia,ITC4
2021-01-13,PF/BT,322000722,RSA - CASA CARDINAL G. LERCARO - BODIO LOMNAGO,LOM,60-69,1,4,0,2,2,1,0,5,0,5,Lombardia,ITC4
2021-01-13,PF/BT,322000722,RSA - CASA CARDINAL G. LERCARO - BODIO LOMNAGO,LOM,70-79,2,8,0,0,0,10,0,10,0,10,Lombardia,ITC4
2021-01-13,PF/BT,322000722,RSA - CASA CARDINAL G. LERCARO - BODIO LOMNAGO,LOM,80-89,2,13,0,0,0,15,0,15,0,15,Lombardia,ITC4
2021-01-13,PF/BT,322000722,RSA - CASA CARDINAL G. LERCARO - BODIO LOMNAGO,LOM,90+,8,31,0,0,0,39,0,39,0,39,Lombardia,ITC4
2021-01-13,PF/BT,322000797,RSA CENTRO ACCOGLIENZA ANZIANI ONLUS,LOM,60-69,0,1,0,1,0,0,0,1,0,1,Lombardia,ITC4
2021-01-13,PF/BT,322000797,RSA CENTRO ACCOGLIENZA ANZIANI ONLUS,LOM,70-79,3,2,0,0,0,5,0,5,0,5,Lombardia,ITC4
2021-01-13,PF/BT,322000797,RSA CENTRO ACCOGLIENZA ANZIANI ONLUS,LOM,80-89,1,11,0,0,0,12,0,12,0,12,Lombardia,ITC4
2021-01-13,PF/BT,322000797,RSA CENTRO ACCOGLIENZA ANZIANI ONLUS,LOM,90+,2,10,0,0,0,12,0,12,0,12,Lombardia,ITC4
2021-01-13,PF/BT,322000844 - 322000712,Istituto La Provvidenza - UG1 /UG3,LOM,20-29,1,6,0,7,0,0,0,7,0,7,Lombardia,ITC4
2021-01-13,PF/BT,322000844 - 322000712,Istituto La Provvidenza - UG1 /UG3,LOM,30-39,4,20,0,23,1,0,0,24,0,24,Lombardia,ITC4
2021-01-13,PF/BT,322000844 - 322000712,Istituto La Provvidenza - UG1 /UG3,LOM,40-49,6,26,0,20,7,0,5,32,0,32,Lombardia,ITC4
2021-01-13,PF/BT,322000844 - 322000712,Istituto La Provvidenza - UG1 /UG3,LOM,50-59,5,42,0,42,4,0,1,47,0,47,Lombardia,ITC4
2021-01-13,PF/BT,322000844 - 322000712,Istituto La Provvidenza - UG1 /UG3,LOM,60-69,2,8,0,6,2,0,2,10,0,10,Lombardia,ITC4
2021-01-13,PF/BT,322000902,RSA IL MELO,LOM,20-29,0,1,0,1,0,0,0,1,0,1,Lombardia,ITC4
2021-01-13,PF/BT,322000902,RSA IL MELO,LOM,30-39,2,4,0,6,0,0,0,6,0,6,Lombardia,ITC4
2021-01-13,PF/BT,322000902,RSA IL MELO,LOM,40-49,4,9,0,13,0,0,0,13,0,13,Lombardia,ITC4
2021-01-13,PF/BT,322000902,RSA IL MELO,LOM,50-59,0,4,0,4,0,0,0,4,0,4,Lombardia,ITC4
2021-01-13,PF/BT,322000902,RSA IL MELO,LOM,60-69,1,5,0,3,2,1,0,6,0,6,Lombardia,ITC4
2021-01-13,PF/BT,322000902,RSA IL MELO,LOM,70-79,1,1,0,0,0,2,0,2,0,2,Lombardia,ITC4
2021-01-13,PF/BT,322000902,RSA IL MELO,LOM,80-89,3,10,0,0,0,13,0,13,0,13,Lombardia,ITC4
2021-01-13,PF/BT,322000902,RSA IL MELO,LOM,90+,0,9,0,0,0,9,0,9,0,9,Lombardia,ITC4
2021-01-13,PF/BT,322002858,Istituto  Nidasio Galetti,LOM,20-29,1,0,0,1,0,0,0,1,0,1,Lombardia,ITC4
2021-01-13,PF/BT,322002858,Istituto  Nidasio Galetti,LOM,30-39,0,3,0,3,0,0,0,3,0,3,Lombardia,ITC4
2021-01-13,PF/BT,322002858,Istituto  Nidasio Galetti,LOM,40-49,1,5,0,6,0,0,0,6,0,6,Lombardia,ITC4
2021-01-13,PF/BT,322002858,Istituto  Nidasio Galetti,LOM,50-59,0,4,0,4,0,0,0,4,0,4,Lombardia,ITC4
2021-01-13,PF/BT,322002858,Istituto  Nidasio Galetti,LOM,60-69,0,1,0,0,0,1,0,1,0,1,Lombardia,ITC4
2021-01-13,PF/BT,322002858,Istituto  Nidasio Galetti,LOM,70-79,0,13,0,0,0,13,0,13,0,13,Lombardia,ITC4
2021-01-13,PF/BT,322002858,Istituto  Nidasio Galetti,LOM,80-89,0,60,0,0,0,60,0,60,0,60,Lombardia,ITC4
2021-01-13,PF/BT,322002858,Istituto  Nidasio Galetti,LOM,90+,0,26,0,0,0,26,0,26,0,26,Lombardia,ITC4
2021-01-13,PF/BT,32200754,CASA DI RIPOSO BELLORA,LOM,20-29,1,4,0,3,2,0,0,5,0,5,Lombardia,ITC4
2021-01-13,PF/BT,32200754,CASA DI RIPOSO BELLORA,LOM,30-39,2,2,0,4,0,0,0,4,0,4,Lombardia,ITC4
2021-01-13,PF/BT,32200754,CASA DI RIPOSO BELLORA,LOM,40-49,1,18,0,14,5,0,0,19,0,19,Lombardia,ITC4
2021-01-13,PF/BT,32200754,CASA DI RIPOSO BELLORA,LOM,50-59,1,9,0,5,5,0,0,10,0,10,Lombardia,ITC4
2021-01-13,PF/BT,32200754,CASA DI RIPOSO BELLORA,LOM,60-69,0,1,0,1,0,0,0,1,0,1,Lombardia,ITC4
2021-01-13,PF/BT,32200754,CASA DI RIPOSO BELLORA,LOM,70-79,0,1,0,0,0,1,0,1,0,1,Lombardia,ITC4
2021-01-13,PF/BT,32200754,CASA DI RIPOSO BELLORA,LOM,90+,1,1,0,0,0,2,0,2,0,2,Lombardia,ITC4
2021-01-13,PF/BT,32271028,AMBULATORIO COVID OSPEDALE CIRCOLO,LOM,16-19,1,2,0,3,0,0,0,3,0,3,Lombardia,ITC4
2021-01-13,PF/BT,32271028,AMBULATORIO COVID OSPEDALE CIRCOLO,LOM,20-29,20,32,0,52,0,0,0,52,0,52,Lombardia,ITC4
2021-01-13,PF/BT,32271028,AMBULATORIO COVID OSPEDALE CIRCOLO,LOM,30-39,0,35,0,35,0,0,0,35,0,35,Lombardia,ITC4
2021-01-13,PF/BT,32271028,AMBULATORIO COVID OSPEDALE CIRCOLO,LOM,40-49,43,56,0,99,0,0,0,99,0,99,Lombardia,ITC4
2021-01-13,PF/BT,32271028,AMBULATORIO COVID OSPEDALE CIRCOLO,LOM,50-59,57,96,0,153,0,0,0,153,0,153,Lombardia,ITC4
2021-01-13,PF/BT,32271028,AMBULATORIO COVID OSPEDALE CIRCOLO,LOM,60-69,46,46,0,92,0,0,0,92,0,92,Lombardia,ITC4
2021-01-13,PF/BT,32271028,AMBULATORIO COVID OSPEDALE CIRCOLO,LOM,70-79,13,2,0,15,0,0,0,15,0,15,Lombardia,ITC4
2021-01-13,PF/BT,32271028,AMBULATORIO COVID OSPEDALE CIRCOLO,LOM,80-89,0,1,0,1,0,0,0,1,0,1,Lombardia,ITC4
2021-01-13,PF/BT,32271117,ambulatorio covid Saronno,LOM,20-29,2,8,0,10,0,0,0,10,0,10,Lombardia,ITC4
2021-01-13,PF/BT,32271117,ambulatorio covid Saronno,LOM,30-39,2,6,0,8,0,0,0,8,0,8,Lombardia,ITC4
2021-01-13,PF/BT,32271117,ambulatorio covid Saronno,LOM,40-49,9,29,0,38,0,0,0,38,0,38,Lombardia,ITC4
2021-01-13,PF/BT,32271117,ambulatorio covid Saronno,LOM,50-59,9,60,0,69,0,0,0,69,0,69,Lombardia,ITC4
2021-01-13,PF/BT,32271117,ambulatorio covid Saronno,LOM,60-69,0,7,0,7,0,0,0,7,0,7,Lombardia,ITC4
2021-01-13,PF/BT,32271118,ambulatorio covid Busto A.,LOM,20-29,1,9,0,10,0,0,0,10,0,10,Lombardia,ITC4
2021-01-13,PF/BT,32271118,ambulatorio covid Busto A.,LOM,30-39,6,28,0,34,0,0,0,34,0,34,Lombardia,ITC4
2021-01-13,PF/BT,32271118,ambulatorio covid Busto A.,LOM,40-49,9,37,0,46,0,0,0,46,0,46,Lombardia,ITC4
2021-01-13,PF/BT,32271118,ambulatorio covid Busto A.,LOM,50-59,8,97,0,105,0,0,0,105,0,105,Lombardia,ITC4
2021-01-13,PF/BT,32271118,ambulatorio covid Busto A.,LOM,60-69,2,18,0,20,0,0,0,20,0,20,Lombardia,ITC4
2021-01-13,PF/BT,323000904,RSA VILLA MONS.D.ZANI BIENNO (BS),LOM,20-29,0,1,0,1,0,0,0,1,0,1,Lombardia,ITC4
2021-01-13,PF/BT,323000904,RSA VILLA MONS.D.ZANI BIENNO (BS),LOM,40-49,0,4,0,3,1,0,0,4,0,4,Lombardia,ITC4
2021-01-13,PF/BT,323000904,RSA VILLA MONS.D.ZANI BIENNO (BS),LOM,50-59,0,5,0,3,2,0,0,5,0,5,Lombardia,ITC4
2021-01-13,PF/BT,323000904,RSA VILLA MONS.D.ZANI BIENNO (BS),LOM,60-69,0,1,0,1,0,0,0,1,0,1,Lombardia,ITC4
2021-01-13,PF/BT,323000904,RSA VILLA MONS.D.ZANI BIENNO (BS),LOM,70-79,0,1,0,0,0,1,0,1,0,1,Lombardia,ITC4
2021-01-13,PF/BT,323000904,RSA VILLA MONS.D.ZANI BIENNO (BS),LOM,80-89,1,2,0,0,0,3,0,3,0,3,Lombardia,ITC4
2021-01-13,PF/BT,323000904,RSA VILLA MONS.D.ZANI BIENNO (BS),LOM,90+,1,2,0,0,0,3,0,3,0,3,Lombardia,ITC4
2021-01-13,PF/BT,323000952,RSA TOMASO AMBROSETTI - MORBEGNO (SO),LOM,20-29,0,3,0,3,0,0,0,3,0,3,Lombardia,ITC4
2021-01-13,PF/BT,323000952,RSA TOMASO AMBROSETTI - MORBEGNO (SO),LOM,30-39,0,2,0,2,0,0,0,2,0,2,Lombardia,ITC4
2021-01-13,PF/BT,323000952,RSA TOMASO AMBROSETTI - MORBEGNO (SO),LOM,40-49,0,3,0,3,0,0,0,3,0,3,Lombardia,ITC4
2021-01-13,PF/BT,323000952,RSA TOMASO AMBROSETTI - MORBEGNO (SO),LOM,50-59,2,8,0,9,1,0,0,10,0,10,Lombardia,ITC4
2021-01-13,PF/BT,323000952,RSA TOMASO AMBROSETTI - MORBEGNO (SO),LOM,60-69,0,1,0,1,0,0,0,1,0,1,Lombardia,ITC4
2021-01-13,PF/BT,323000962,FONDAZIONE CASA DI RIPOSO S.ORSOLA ONLUS,LOM,20-29,0,1,0,1,0,0,0,1,0,1,Lombardia,ITC4
2021-01-13,PF/BT,323000962,FONDAZIONE CASA DI RIPOSO S.ORSOLA ONLUS,LOM,30-39,0,2,0,2,0,0,0,2,0,2,Lombardia,ITC4
2021-01-13,PF/BT,323000962,FONDAZIONE CASA DI RIPOSO S.ORSOLA ONLUS,LOM,40-49,0,8,0,6,2,0,0,8,0,8,Lombardia,ITC4
2021-01-13,PF/BT,323000962,FONDAZIONE CASA DI RIPOSO S.ORSOLA ONLUS,LOM,50-59,0,7,0,6,1,0,0,7,0,7,Lombardia,ITC4
2021-01-13,PF/BT,323000962,FONDAZIONE CASA DI RIPOSO S.ORSOLA ONLUS,LOM,60-69,1,0,0,0,0,1,0,1,0,1,Lombardia,ITC4
2021-01-13,PF/BT,323000962,FONDAZIONE CASA DI RIPOSO S.ORSOLA ONLUS,LOM,70-79,2,2,0,0,0,4,0,4,0,4,Lombardia,ITC4
2021-01-13,PF/BT,323000962,FONDAZIONE CASA DI RIPOSO S.ORSOLA ONLUS,LOM,80-89,8,11,0,0,0,19,0,19,0,19,Lombardia,ITC4
2021-01-13,PF/BT,323000962,FONDAZIONE CASA DI RIPOSO S.ORSOLA ONLUS,LOM,90+,1,5,0,0,0,6,0,6,0,6,Lombardia,ITC4
2021-01-13,PF/BT,323008561,RSA PAOLO PARAVICINI- MORBEGNO (SO),LOM,20-29,0,3,0,3,0,0,0,3,0,3,Lombardia,ITC4
2021-01-13,PF/BT,323008561,RSA PAOLO PARAVICINI- MORBEGNO (SO),LOM,30-39,0,5,0,4,1,0,0,5,0,5,Lombardia,ITC4
2021-01-13,PF/BT,323008561,RSA PAOLO PARAVICINI- MORBEGNO (SO),LOM,40-49,0,11,0,10,1,0,0,11,0,11,Lombardia,ITC4
2021-01-13,PF/BT,323008561,RSA PAOLO PARAVICINI- MORBEGNO (SO),LOM,50-59,1,2,0,3,0,0,0,3,0,3,Lombardia,ITC4
2021-01-13,PF/BT,3240001118,Fondazione Casa di Riposo Dr. Luigi e Regina Sironi ONLUS,LOM,20-29,3,6,0,7,2,0,0,9,0,9,Lombardia,ITC4
2021-01-13,PF/BT,3240001118,Fondazione Casa di Riposo Dr. Luigi e Regina Sironi ONLUS,LOM,30-39,1,11,0,8,4,0,0,12,0,12,Lombardia,ITC4
2021-01-13,PF/BT,3240001118,Fondazione Casa di Riposo Dr. Luigi e Regina Sironi ONLUS,LOM,40-49,2,8,0,8,2,0,0,10,0,10,Lombardia,ITC4
2021-01-13,PF/BT,3240001118,Fondazione Casa di Riposo Dr. Luigi e Regina Sironi ONLUS,LOM,50-59,1,21,0,15,7,0,0,22,0,22,Lombardia,ITC4
2021-01-13,PF/BT,3240001118,Fondazione Casa di Riposo Dr. Luigi e Regina Sironi ONLUS,LOM,60-69,1,4,0,3,1,0,1,5,0,5,Lombardia,ITC4
2021-01-13,PF/BT,3240001118,Fondazione Casa di Riposo Dr. Luigi e Regina Sironi ONLUS,LOM,70-79,1,1,0,0,0,0,2,2,0,2,Lombardia,ITC4
2021-01-13,PF/BT,324001040,RSA CASA MADONNA DELLA NEVE ONLUS,LOM,20-29,0,4,0,3,1,0,0,4,0,4,Lombardia,ITC4
2021-01-13,PF/BT,324001040,RSA CASA MADONNA DELLA NEVE ONLUS,LOM,30-39,0,1,0,1,0,0,0,1,0,1,Lombardia,ITC4
2021-01-13,PF/BT,324001040,RSA CASA MADONNA DELLA NEVE ONLUS,LOM,40-49,1,8,0,5,3,0,1,9,0,9,Lombardia,ITC4
2021-01-13,PF/BT,324001040,RSA CASA MADONNA DELLA NEVE ONLUS,LOM,50-59,0,3,0,2,1,0,0,3,0,3,Lombardia,ITC4
2021-01-13,PF/BT,324001040,RSA CASA MADONNA DELLA NEVE ONLUS,LOM,60-69,1,2,0,3,0,0,0,3,0,3,Lombardia,ITC4
2021-01-13,PF/BT,324001040,RSA CASA MADONNA DELLA NEVE ONLUS,LOM,80-89,2,9,0,0,0,11,0,11,0,11,Lombardia,ITC4
2021-01-13,PF/BT,324001040,RSA CASA MADONNA DELLA NEVE ONLUS,LOM,90+,0,9,0,0,0,9,0,9,0,9,Lombardia,ITC4
2021-01-13,PF/BT,32500125400,RSA SAN FRANCESCO - BERGAMO,LOM,20-29,1,2,0,3,0,0,0,3,0,3,Lombardia,ITC4
2021-01-13,PF/BT,32500125400,RSA SAN FRANCESCO - BERGAMO,LOM,30-39,0,3,0,3,0,0,0,3,0,3,Lombardia,ITC4
2021-01-13,PF/BT,32500125400,RSA SAN FRANCESCO - BERGAMO,LOM,40-49,1,3,0,4,0,0,0,4,0,4,Lombardia,ITC4
2021-01-13,PF/BT,32500125400,RSA SAN FRANCESCO - BERGAMO,LOM,50-59,0,1,0,1,0,0,0,1,0,1,Lombardia,ITC4
2021-01-13,PF/BT,32500125400,RSA SAN FRANCESCO - BERGAMO,LOM,60-69,0,1,0,1,0,0,0,1,0,1,Lombardia,ITC4
2021-01-13,PF/BT,325001272,RSA SAN SISTO,LOM,20-29,0,2,0,2,0,0,0,2,0,2,Lombardia,ITC4
2021-01-13,PF/BT,325001272,RSA SAN SISTO,LOM,30-39,0,2,0,2,0,0,0,2,0,2,Lombardia,ITC4
2021-01-13,PF/BT,325001272,RSA SAN SISTO,LOM,50-59,1,1,0,0,2,0,0,2,0,2,Lombardia,ITC4
2021-01-13,PF/BT,325001329,"FONDAZIONE P.PICCINELLI ""ONLUS""",LOM,20-29,0,5,0,5,0,0,0,5,0,5,Lombardia,ITC4
2021-01-13,PF/BT,325001329,"FONDAZIONE P.PICCINELLI ""ONLUS""",LOM,30-39,5,6,0,10,1,0,0,11,0,11,Lombardia,ITC4
2021-01-13,PF/BT,325001329,"FONDAZIONE P.PICCINELLI ""ONLUS""",LOM,40-49,4,12,0,12,4,0,0,16,0,16,Lombardia,ITC4
2021-01-13,PF/BT,325001329,"FONDAZIONE P.PICCINELLI ""ONLUS""",LOM,50-59,9,20,0,21,8,0,0,29,0,29,Lombardia,ITC4
2021-01-13,PF/BT,325001329,"FONDAZIONE P.PICCINELLI ""ONLUS""",LOM,60-69,5,5,0,4,4,0,2,10,0,10,Lombardia,ITC4
2021-01-13,PF/BT,325001329,"FONDAZIONE P.PICCINELLI ""ONLUS""",LOM,70-79,1,4,0,0,1,2,2,5,0,5,Lombardia,ITC4
2021-01-13,PF/BT,325001329,"FONDAZIONE P.PICCINELLI ""ONLUS""",LOM,80-89,4,29,0,0,1,7,25,33,0,33,Lombardia,ITC4
2021-01-13,PF/BT,325001329,"FONDAZIONE P.PICCINELLI ""ONLUS""",LOM,90+,0,29,0,0,0,12,17,29,0,29,Lombardia,ITC4
2021-01-13,PF/BT,325001342,CLINICHE GAVAZZENI SPA,LOM,20-29,6,13,0,19,0,0,0,19,0,19,Lombardia,ITC4
2021-01-13,PF/BT,325001342,CLINICHE GAVAZZENI SPA,LOM,30-39,4,12,0,16,0,0,0,16,0,16,Lombardia,ITC4
2021-01-13,PF/BT,325001342,CLINICHE GAVAZZENI SPA,LOM,40-49,5,11,0,16,0,0,0,16,0,16,Lombardia,ITC4
2021-01-13,PF/BT,325001342,CLINICHE GAVAZZENI SPA,LOM,50-59,8,5,0,13,0,0,0,13,0,13,Lombardia,ITC4
2021-01-13,PF/BT,325001342,CLINICHE GAVAZZENI SPA,LOM,60-69,6,1,0,7,0,0,0,7,0,7,Lombardia,ITC4
2021-01-13,PF/BT,325001342,CLINICHE GAVAZZENI SPA,LOM,70-79,1,0,0,1,0,0,0,1,0,1,Lombardia,ITC4
2021-01-13,PF/BT,32503014600,CASA DI CURA SAN FRANCESCO - BERGAMO,LOM,20-29,1,3,0,4,0,0,0,4,0,4,Lombardia,ITC4
2021-01-13,PF/BT,32503014600,CASA DI CURA SAN FRANCESCO - BERGAMO,LOM,30-39,0,7,0,7,0,0,0,7,0,7,Lombardia,ITC4
2021-01-13,PF/BT,32503014600,CASA DI CURA SAN FRANCESCO - BERGAMO,LOM,40-49,1,9,0,10,0,0,0,10,0,10,Lombardia,ITC4
2021-01-13,PF/BT,32503014600,CASA DI CURA SAN FRANCESCO - BERGAMO,LOM,50-59,4,7,0,11,0,0,0,11,0,11,Lombardia,ITC4
2021-01-13,PF/BT,32503014600,CASA DI CURA SAN FRANCESCO - BERGAMO,LOM,60-69,1,1,0,2,0,0,0,2,0,2,Lombardia,ITC4
2021-01-13,PF/BT,32503014600,CASA DI CURA SAN FRANCESCO - BERGAMO,LOM,70-79,1,0,0,1,0,0,0,1,0,1,Lombardia,ITC4
2021-01-13,PF/BT,32572021,Ambulatorio COVID PO Alzano Lombardo,LOM,20-29,4,3,0,7,0,0,0,7,0,7,Lombardia,ITC4
2021-01-13,PF/BT,32572021,Ambulatorio COVID PO Alzano Lombardo,LOM,30-39,4,9,0,13,0,0,0,13,0,13,Lombardia,ITC4
2021-01-13,PF/BT,32572021,Ambulatorio COVID PO Alzano Lombardo,LOM,40-49,4,7,0,11,0,0,0,11,0,11,Lombardia,ITC4
2021-01-13,PF/BT,32572021,Ambulatorio COVID PO Alzano Lombardo,LOM,50-59,8,9,0,17,0,0,0,17,0,17,Lombardia,ITC4
2021-01-13,PF/BT,32572021,Ambulatorio COVID PO Alzano Lombardo,LOM,60-69,6,5,0,11,0,0,0,11,0,11,Lombardia,ITC4
2021-01-13,PF/BT,32572021,Ambulatorio COVID PO Alzano Lombardo,LOM,70-79,1,0,0,1,0,0,0,1,0,1,Lombardia,ITC4
2021-01-13,PF/BT,32572026,AMBULATORIO COVID PIARIO,LOM,20-29,1,2,0,3,0,0,0,3,0,3,Lombardia,ITC4
2021-01-13,PF/BT,32572026,AMBULATORIO COVID PIARIO,LOM,30-39,3,2,0,5,0,0,0,5,0,5,Lombardia,ITC4
2021-01-13,PF/BT,32572026,AMBULATORIO COVID PIARIO,LOM,40-49,1,12,0,13,0,0,0,13,0,13,Lombardia,ITC4
2021-01-13,PF/BT,32572026,AMBULATORIO COVID PIARIO,LOM,50-59,1,6,0,7,0,0,0,7,0,7,Lombardia,ITC4
2021-01-13,PF/BT,32572026,AMBULATORIO COVID PIARIO,LOM,60-69,0,2,0,2,0,0,0,2,0,2,Lombardia,ITC4
2021-01-13,PF/BT,32572027,Ambulatorio COVID SERIATE,LOM,20-29,2,24,0,22,2,0,2,26,0,26,Lombardia,ITC4
2021-01-13,PF/BT,32572027,Ambulatorio COVID SERIATE,LOM,30-39,4,21,0,22,0,0,3,25,0,25,Lombardia,ITC4
2021-01-13,PF/BT,32572027,Ambulatorio COVID SERIATE,LOM,40-49,7,30,0,28,3,0,6,37,0,37,Lombardia,ITC4
2021-01-13,PF/BT,32572027,Ambulatorio COVID SERIATE,LOM,50-59,13,39,0,40,8,0,4,52,0,52,Lombardia,ITC4
2021-01-13,PF/BT,32572027,Ambulatorio COVID SERIATE,LOM,60-69,2,8,0,8,2,0,0,10,0,10,Lombardia,ITC4
2021-01-13,PF/BT,327001818,R.S.A. VILLA MADDALENA,LOM,20-29,1,0,0,0,1,0,0,1,0,1,Lombardia,ITC4
2021-01-13,PF/BT,327001818,R.S.A. VILLA MADDALENA,LOM,30-39,3,3,0,4,2,0,0,6,0,6,Lombardia,ITC4
2021-01-13,PF/BT,327001818,R.S.A. VILLA MADDALENA,LOM,40-49,0,6,0,2,4,0,0,6,0,6,Lombardia,ITC4
2021-01-13,PF/BT,327001818,R.S.A. VILLA MADDALENA,LOM,50-59,2,9,0,6,5,0,0,11,0,11,Lombardia,ITC4
2021-01-13,PF/BT,327001818,R.S.A. VILLA MADDALENA,LOM,60-69,1,2,0,1,1,1,0,3,0,3,Lombardia,ITC4
2021-01-13,PF/BT,327001818,R.S.A. VILLA MADDALENA,LOM,70-79,2,2,0,0,0,4,0,4,0,4,Lombardia,ITC4
2021-01-13,PF/BT,327001818,R.S.A. VILLA MADDALENA,LOM,80-89,1,21,0,0,0,22,0,22,0,22,Lombardia,ITC4
2021-01-13,PF/BT,327001818,R.S.A. VILLA MADDALENA,LOM,90+,2,11,0,0,0,13,0,13,0,13,Lombardia,ITC4
2021-01-13,PF/BT,327001875,RSA Fondazione Pietro Sissa,LOM,20-29,0,3,0,3,0,0,0,3,0,3,Lombardia,ITC4
2021-01-13,PF/BT,327001875,RSA Fondazione Pietro Sissa,LOM,30-39,0,1,0,1,0,0,0,1,0,1,Lombardia,ITC4
2021-01-13,PF/BT,327001875,RSA Fondazione Pietro Sissa,LOM,40-49,0,4,0,2,2,0,0,4,0,4,Lombardia,ITC4
2021-01-13,PF/BT,327001875,RSA Fondazione Pietro Sissa,LOM,50-59,1,4,0,5,0,0,0,5,0,5,Lombardia,ITC4
2021-01-13,PF/BT,327001875,RSA Fondazione Pietro Sissa,LOM,60-69,3,4,0,3,0,2,2,7,0,7,Lombardia,ITC4
2021-01-13,PF/BT,327001875,RSA Fondazione Pietro Sissa,LOM,70-79,6,4,0,0,0,8,2,10,0,10,Lombardia,ITC4
2021-01-13,PF/BT,327001875,RSA Fondazione Pietro Sissa,LOM,80-89,7,8,0,0,0,14,1,15,0,15,Lombardia,ITC4
2021-01-13,PF/BT,327001875,RSA Fondazione Pietro Sissa,LOM,90+,0,9,0,0,0,9,0,9,0,9,Lombardia,ITC4
2021-01-13,PF/BT,327001941,CASA DI RIPOSO GIOVANNI E LUCIANA ARVEDI,LOM,50-59,1,0,0,0,1,0,0,1,0,1,Lombardia,ITC4
2021-01-13,PF/BT,327001941,CASA DI RIPOSO GIOVANNI E LUCIANA ARVEDI,LOM,70-79,3,2,0,0,0,5,0,5,0,5,Lombardia,ITC4
2021-01-13,PF/BT,327001941,CASA DI RIPOSO GIOVANNI E LUCIANA ARVEDI,LOM,80-89,8,9,0,0,0,17,0,17,0,17,Lombardia,ITC4
2021-01-13,PF/BT,327001941,CASA DI RIPOSO GIOVANNI E LUCIANA ARVEDI,LOM,90+,3,22,0,0,0,25,0,25,0,25,Lombardia,ITC4
2021-01-13,PF/BT,327001960,RSA VILLA CARPANEDA,LOM,20-29,0,1,0,1,0,0,0,1,0,1,Lombardia,ITC4
2021-01-13,PF/BT,327001960,RSA VILLA CARPANEDA,LOM,30-39,0,3,0,3,0,0,0,3,0,3,Lombardia,ITC4
2021-01-13,PF/BT,327001960,RSA VILLA CARPANEDA,LOM,40-49,0,6,0,4,2,0,0,6,0,6,Lombardia,ITC4
2021-01-13,PF/BT,327001960,RSA VILLA CARPANEDA,LOM,50-59,0,8,0,6,2,0,0,8,0,8,Lombardia,ITC4
2021-01-13,PF/BT,327001960,RSA VILLA CARPANEDA,LOM,60-69,1,1,0,1,0,1,0,2,0,2,Lombardia,ITC4
2021-01-13,PF/BT,327001960,RSA VILLA CARPANEDA,LOM,70-79,0,2,0,0,0,2,0,2,0,2,Lombardia,ITC4
2021-01-13,PF/BT,327001960,RSA VILLA CARPANEDA,LOM,80-89,0,8,0,0,0,8,0,8,0,8,Lombardia,ITC4
2021-01-13,PF/BT,327001960,RSA VILLA CARPANEDA,LOM,90+,0,8,0,0,0,8,0,8,0,8,Lombardia,ITC4
2021-01-13,PF/BT,327001964,FONDAZIONE OSPEDALE CIVILE DI GONZAGA,LOM,30-39,0,4,0,2,2,0,0,4,0,4,Lombardia,ITC4
2021-01-13,PF/BT,327001964,FONDAZIONE OSPEDALE CIVILE DI GONZAGA,LOM,40-49,0,5,0,5,0,0,0,5,0,5,Lombardia,ITC4
2021-01-13,PF/BT,327001964,FONDAZIONE OSPEDALE CIVILE DI GONZAGA,LOM,50-59,1,9,0,8,2,0,0,10,0,10,Lombardia,ITC4
2021-01-13,PF/BT,327001964,FONDAZIONE OSPEDALE CIVILE DI GONZAGA,LOM,60-69,1,2,0,3,0,0,0,3,0,3,Lombardia,ITC4
2021-01-13,PF/BT,327001964,FONDAZIONE OSPEDALE CIVILE DI GONZAGA,LOM,70-79,1,0,0,1,0,0,0,1,0,1,Lombardia,ITC4
2021-01-13,PF/BT,327001964,FONDAZIONE OSPEDALE CIVILE DI GONZAGA,LOM,90+,1,0,0,0,0,1,0,1,0,1,Lombardia,ITC4
2021-01-13,PF/BT,327003606,RSA RODIGO,LOM,20-29,0,1,0,1,0,0,0,1,0,1,Lombardia,ITC4
2021-01-13,PF/BT,327003606,RSA RODIGO,LOM,30-39,0,3,0,2,0,0,1,3,0,3,Lombardia,ITC4
2021-01-13,PF/BT,327003606,RSA RODIGO,LOM,40-49,0,12,0,10,2,0,0,12,0,12,Lombardia,ITC4
2021-01-13,PF/BT,327003606,RSA RODIGO,LOM,50-59,0,8,0,5,3,0,0,8,0,8,Lombardia,ITC4
2021-01-13,PF/BT,327003606,RSA RODIGO,LOM,60-69,2,0,0,1,0,1,0,2,0,2,Lombardia,ITC4
2021-01-13,PF/BT,327003606,RSA RODIGO,LOM,70-79,3,2,0,0,0,5,0,5,0,5,Lombardia,ITC4
2021-01-13,PF/BT,327003606,RSA RODIGO,LOM,80-89,0,9,0,0,0,9,0,9,0,9,Lombardia,ITC4
2021-01-13,PF/BT,327003606,RSA RODIGO,LOM,90+,1,17,0,0,0,18,0,18,0,18,Lombardia,ITC4
2021-01-13,PF/BT,327004847,RESIDENZA SANITARIA ASSISTENZIALE MORANDO,LOM,40-49,0,2,0,1,1,0,0,2,0,2,Lombardia,ITC4
2021-01-13,PF/BT,327004847,RESIDENZA SANITARIA ASSISTENZIALE MORANDO,LOM,70-79,1,1,0,0,1,1,0,2,0,2,Lombardia,ITC4
2021-01-13,PF/BT,327004847,RESIDENZA SANITARIA ASSISTENZIALE MORANDO,LOM,80-89,2,12,0,0,0,14,0,14,0,14,Lombardia,ITC4
2021-01-13,PF/BT,327004847,RESIDENZA SANITARIA ASSISTENZIALE MORANDO,LOM,90+,0,6,0,0,0,6,0,6,0,6,Lombardia,ITC4
2021-01-13,PF/BT,32772407,CV COVID CREMONA,LOM,20-29,1,0,0,0,0,0,1,1,0,1,Lombardia,ITC4
2021-01-13,PF/BT,32772407,CV COVID CREMONA,LOM,30-39,12,13,0,21,0,0,4,25,0,25,Lombardia,ITC4
2021-01-13,PF/BT,32772407,CV COVID CREMONA,LOM,40-49,16,27,0,33,0,0,10,43,0,43,Lombardia,ITC4
2021-01-13,PF/BT,32772407,CV COVID CREMONA,LOM,50-59,12,39,0,35,1,0,15,51,0,51,Lombardia,ITC4
2021-01-13,PF/BT,32772407,CV COVID CREMONA,LOM,60-69,24,52,0,59,1,0,16,76,0,76,Lombardia,ITC4
2021-01-13,PF/BT,32772407,CV COVID CREMONA,LOM,70-79,11,13,0,17,0,0,7,24,0,24,Lombardia,ITC4
2021-01-13,PF/BT,32772407,CV COVID CREMONA,LOM,80-89,2,0,0,2,0,0,0,2,0,2,Lombardia,ITC4
2021-01-13,PF/BT,328002076,"RSA CENTRO APERTO ""A.CHIESA VISCONTI"" - ROSASCO (PV)",LOM,16-19,1,0,0,0,1,0,0,1,0,1,Lombardia,ITC4
2021-01-13,PF/BT,328002076,"RSA CENTRO APERTO ""A.CHIESA VISCONTI"" - ROSASCO (PV)",LOM,30-39,1,1,0,0,2,0,0,2,0,2,Lombardia,ITC4
2021-01-13,PF/BT,328002076,"RSA CENTRO APERTO ""A.CHIESA VISCONTI"" - ROSASCO (PV)",LOM,40-49,0,4,0,3,1,0,0,4,0,4,Lombardia,ITC4
2021-01-13,PF/BT,328002076,"RSA CENTRO APERTO ""A.CHIESA VISCONTI"" - ROSASCO (PV)",LOM,50-59,3,5,0,8,0,0,0,8,0,8,Lombardia,ITC4
2021-01-13,PF/BT,328002076,"RSA CENTRO APERTO ""A.CHIESA VISCONTI"" - ROSASCO (PV)",LOM,60-69,0,2,0,1,1,0,0,2,0,2,Lombardia,ITC4
2021-01-13,PF/BT,328002076,"RSA CENTRO APERTO ""A.CHIESA VISCONTI"" - ROSASCO (PV)",LOM,70-79,1,2,0,0,0,3,0,3,0,3,Lombardia,ITC4
2021-01-13,PF/BT,328002076,"RSA CENTRO APERTO ""A.CHIESA VISCONTI"" - ROSASCO (PV)",LOM,80-89,1,4,0,0,0,5,0,5,0,5,Lombardia,ITC4
2021-01-13,PF/BT,328002076,"RSA CENTRO APERTO ""A.CHIESA VISCONTI"" - ROSASCO (PV)",LOM,90+,1,8,0,0,0,9,0,9,0,9,Lombardia,ITC4
2021-01-13,PF/BT,347,Fondazione San Giuseppe Moscati,LOM,20-29,2,0,0,2,0,0,0,2,0,2,Lombardia,ITC4
2021-01-13,PF/BT,347,Fondazione San Giuseppe Moscati,LOM,30-39,1,2,0,3,0,0,0,3,0,3,Lombardia,ITC4
2021-01-13,PF/BT,347,Fondazione San Giuseppe Moscati,LOM,40-49,1,3,0,4,0,0,0,4,0,4,Lombardia,ITC4
2021-01-13,PF/BT,347,Fondazione San Giuseppe Moscati,LOM,50-59,4,4,0,5,3,0,0,8,0,8,Lombardia,ITC4
2021-01-13,PF/BT,347,Fondazione San Giuseppe Moscati,LOM,80-89,0,1,0,0,0,0,1,1,0,1,Lombardia,ITC4
2021-01-13,PF/BT,3611,RSD L 'ABBRACCIO,LOM,20-29,0,1,0,0,1,0,0,1,0,1,Lombardia,ITC4
2021-01-13,PF/BT,3611,RSD L 'ABBRACCIO,LOM,30-39,3,4,0,4,2,1,0,7,0,7,Lombardia,ITC4
2021-01-13,PF/BT,3611,RSD L 'ABBRACCIO,LOM,40-49,5,6,0,4,1,6,0,11,0,11,Lombardia,ITC4
2021-01-13,PF/BT,3611,RSD L 'ABBRACCIO,LOM,50-59,6,8,0,4,5,5,0,14,0,14,Lombardia,ITC4
2021-01-13,PF/BT,3611,RSD L 'ABBRACCIO,LOM,60-69,4,0,0,0,1,3,0,4,0,4,Lombardia,ITC4
2021-01-13,PF/BT,3611,RSD L 'ABBRACCIO,LOM,70-79,1,1,0,0,2,0,0,2,0,2,Lombardia,ITC4
2021-01-13,PF/BT,3611,RSD L 'ABBRACCIO,LOM,80-89,1,2,0,0,3,0,0,3,0,3,Lombardia,ITC4
2021-01-13,PF/BT,466,RSA Aquamarina,LOM,20-29,2,1,0,2,1,0,0,3,0,3,Lombardia,ITC4
2021-01-13,PF/BT,466,RSA Aquamarina,LOM,30-39,1,4,0,3,2,0,0,5,0,5,Lombardia,ITC4
2021-01-13,PF/BT,466,RSA Aquamarina,LOM,40-49,2,3,0,5,0,0,0,5,0,5,Lombardia,ITC4
2021-01-13,PF/BT,466,RSA Aquamarina,LOM,50-59,0,4,0,4,0,0,0,4,0,4,Lombardia,ITC4
2021-01-13,PF/BT,466,RSA Aquamarina,LOM,60-69,0,1,0,0,0,1,0,1,0,1,Lombardia,ITC4
2021-01-13,PF/BT,466,RSA Aquamarina,LOM,70-79,0,3,0,0,0,3,0,3,0,3,Lombardia,ITC4
2021-01-13,PF/BT,466,RSA Aquamarina,LOM,80-89,5,15,0,0,0,20,0,20,0,20,Lombardia,ITC4
2021-01-13,PF/BT,466,RSA Aquamarina,LOM,90+,2,7,0,0,0,9,0,9,0,9,Lombardia,ITC4
2021-01-13,PF/BT,467,Maria Lorenzon,LOM,20-29,0,3,0,2,1,0,0,3,0,3,Lombardia,ITC4
2021-01-13,PF/BT,467,Maria Lorenzon,LOM,30-39,5,5,0,8,2,0,0,10,0,10,Lombardia,ITC4
2021-01-13,PF/BT,467,Maria Lorenzon,LOM,40-49,2,11,0,10,3,0,0,13,0,13,Lombardia,ITC4
2021-01-13,PF/BT,467,Maria Lorenzon,LOM,50-59,3,10,0,5,7,1,0,13,0,13,Lombardia,ITC4
2021-01-13,PF/BT,467,Maria Lorenzon,LOM,70-79,1,2,0,0,0,3,0,3,0,3,Lombardia,ITC4
2021-01-13,PF/BT,467,Maria Lorenzon,LOM,80-89,5,4,0,0,0,9,0,9,0,9,Lombardia,ITC4
2021-01-13,PF/BT,467,Maria Lorenzon,LOM,90+,4,15,0,0,0,19,0,19,0,19,Lombardia,ITC4
2021-01-13,PF/BT,521,"RSA ""POLO GERIATRICO RIABILITATIVO 2”",LOM,20-29,1,1,0,1,1,0,0,2,0,2,Lombardia,ITC4
2021-01-13,PF/BT,521,"RSA ""POLO GERIATRICO RIABILITATIVO 2”",LOM,30-39,1,1,0,2,0,0,0,2,0,2,Lombardia,ITC4
2021-01-13,PF/BT,521,"RSA ""POLO GERIATRICO RIABILITATIVO 2”",LOM,40-49,3,1,0,1,3,0,0,4,0,4,Lombardia,ITC4
2021-01-13,PF/BT,521,"RSA ""POLO GERIATRICO RIABILITATIVO 2”",LOM,50-59,1,2,0,1,2,0,0,3,0,3,Lombardia,ITC4
2021-01-13,PF/BT,521,"RSA ""POLO GERIATRICO RIABILITATIVO 2”",LOM,60-69,0,3,0,2,0,1,0,3,0,3,Lombardia,ITC4
2021-01-13,PF/BT,521,"RSA ""POLO GERIATRICO RIABILITATIVO 2”",LOM,70-79,0,1,0,0,0,1,0,1,0,1,Lombardia,ITC4
2021-01-13,PF/BT,521,"RSA ""POLO GERIATRICO RIABILITATIVO 2”",LOM,80-89,3,12,0,0,0,15,0,15,0,15,Lombardia,ITC4
2021-01-13,PF/BT,521,"RSA ""POLO GERIATRICO RIABILITATIVO 2”",LOM,90+,1,8,0,0,0,9,0,9,0,9,Lombardia,ITC4
2021-01-13,PF/BT,558,RSA PIO ALBERGO TRIVULZIO,LOM,20-29,6,10,0,6,10,0,0,16,0,16,Lombardia,ITC4
2021-01-13,PF/BT,558,RSA PIO ALBERGO TRIVULZIO,LOM,30-39,10,6,0,9,7,0,0,16,0,16,Lombardia,ITC4
2021-01-13,PF/BT,558,RSA PIO ALBERGO TRIVULZIO,LOM,40-49,5,8,0,6,7,0,0,13,0,13,Lombardia,ITC4
2021-01-13,PF/BT,558,RSA PIO ALBERGO TRIVULZIO,LOM,50-59,16,11,0,14,13,0,0,27,0,27,Lombardia,ITC4
2021-01-13,PF/BT,558,RSA PIO ALBERGO TRIVULZIO,LOM,60-69,6,6,0,5,7,0,0,12,0,12,Lombardia,ITC4
2021-01-13,PF/BT,616,RSA Residenza Borromea,LOM,20-29,1,1,0,2,0,0,0,2,0,2,Lombardia,ITC4
2021-01-13,PF/BT,616,RSA Residenza Borromea,LOM,30-39,4,1,0,5,0,0,0,5,0,5,Lombardia,ITC4
2021-01-13,PF/BT,616,RSA Residenza Borromea,LOM,40-49,0,5,0,3,2,0,0,5,0,5,Lombardia,ITC4
2021-01-13,PF/BT,616,RSA Residenza Borromea,LOM,50-59,1,4,0,5,0,0,0,5,0,5,Lombardia,ITC4
2021-01-13,PF/BT,616,RSA Residenza Borromea,LOM,60-69,1,1,0,1,0,1,0,2,0,2,Lombardia,ITC4
2021-01-13,PF/BT,616,RSA Residenza Borromea,LOM,70-79,0,1,0,0,0,1,0,1,0,1,Lombardia,ITC4
2021-01-13,PF/BT,616,RSA Residenza Borromea,LOM,80-89,5,7,0,0,0,12,0,12,0,12,Lombardia,ITC4
2021-01-13,PF/BT,616,RSA Residenza Borromea,LOM,90+,3,19,0,0,0,22,0,22,0,22,Lombardia,ITC4
2021-01-13,PF/BT,673,RSA Alfredo  Podestà,LOM,20-29,2,2,0,3,1,0,0,4,0,4,Lombardia,ITC4
2021-01-13,PF/BT,673,RSA Alfredo  Podestà,LOM,30-39,5,6,0,8,3,0,0,11,0,11,Lombardia,ITC4
2021-01-13,PF/BT,673,RSA Alfredo  Podestà,LOM,40-49,2,11,0,10,3,0,0,13,0,13,Lombardia,ITC4
2021-01-13,PF/BT,673,RSA Alfredo  Podestà,LOM,50-59,2,10,0,5,7,0,0,12,0,12,Lombardia,ITC4
2021-01-13,PF/BT,673,RSA Alfredo  Podestà,LOM,60-69,0,3,0,1,1,1,0,3,0,3,Lombardia,ITC4
2021-01-13,PF/BT,673,RSA Alfredo  Podestà,LOM,70-79,0,2,0,0,0,2,0,2,0,2,Lombardia,ITC4
2021-01-13,PF/BT,673,RSA Alfredo  Podestà,LOM,80-89,8,18,0,0,0,26,0,26,0,26,Lombardia,ITC4
2021-01-13,PF/BT,673,RSA Alfredo  Podestà,LOM,90+,5,14,0,0,0,19,0,19,0,19,Lombardia,ITC4
2021-01-13,PF/BT,690548,RSA Fondazione Lucini-Cantù Onlus,LOM,40-49,0,2,0,2,0,0,0,2,0,2,Lombardia,ITC4
2021-01-13,PF/BT,690548,RSA Fondazione Lucini-Cantù Onlus,LOM,50-59,0,2,0,2,0,0,0,2,0,2,Lombardia,ITC4
2021-01-13,PF/BT,690548,RSA Fondazione Lucini-Cantù Onlus,LOM,80-89,0,5,0,0,0,5,0,5,0,5,Lombardia,ITC4
2021-01-13,PF/BT,690548,RSA Fondazione Lucini-Cantù Onlus,LOM,90+,1,2,0,0,0,3,0,3,0,3,Lombardia,ITC4
2021-01-13,PF/BT,697,CASA RIPOSO F.LLI MOLINA P.E.T,LOM,20-29,3,0,0,3,0,0,0,3,0,3,Lombardia,ITC4
2021-01-13,PF/BT,697,CASA RIPOSO F.LLI MOLINA P.E.T,LOM,30-39,1,7,0,7,1,0,0,8,0,8,Lombardia,ITC4
2021-01-13,PF/BT,697,CASA RIPOSO F.LLI MOLINA P.E.T,LOM,40-49,0,10,0,10,0,0,0,10,0,10,Lombardia,ITC4
2021-01-13,PF/BT,697,CASA RIPOSO F.LLI MOLINA P.E.T,LOM,50-59,4,18,0,19,3,0,0,22,0,22,Lombardia,ITC4
2021-01-13,PF/BT,697,CASA RIPOSO F.LLI MOLINA P.E.T,LOM,60-69,0,5,0,4,1,0,0,5,0,5,Lombardia,ITC4
2021-01-13,PF/BT,789,RSA Mario e Rina Molina,LOM,20-29,3,2,0,5,0,0,0,5,0,5,Lombardia,ITC4
2021-01-13,PF/BT,789,RSA Mario e Rina Molina,LOM,30-39,1,1,0,2,0,0,0,2,0,2,Lombardia,ITC4
2021-01-13,PF/BT,789,RSA Mario e Rina Molina,LOM,40-49,2,4,0,6,0,0,0,6,0,6,Lombardia,ITC4
2021-01-13,PF/BT,789,RSA Mario e Rina Molina,LOM,50-59,1,7,0,8,0,0,0,8,0,8,Lombardia,ITC4
2021-01-13,PF/BT,789,RSA Mario e Rina Molina,LOM,60-69,2,1,0,3,0,0,0,3,0,3,Lombardia,ITC4
2021-01-13,PF/BT,789,RSA Mario e Rina Molina,LOM,90+,1,5,0,0,0,6,0,6,0,6,Lombardia,ITC4
2021-01-13,PF/BT,906,FONDAZIONE ONLUS NINJ BECCAGUTTI,LOM,60-69,0,1,0,0,0,1,0,1,0,1,Lombardia,ITC4
2021-01-13,PF/BT,906,FONDAZIONE ONLUS NINJ BECCAGUTTI,LOM,70-79,1,3,0,0,0,4,0,4,0,4,Lombardia,ITC4
2021-01-13,PF/BT,906,FONDAZIONE ONLUS NINJ BECCAGUTTI,LOM,80-89,3,9,0,0,0,12,0,12,0,12,Lombardia,ITC4
2021-01-13,PF/BT,906,FONDAZIONE ONLUS NINJ BECCAGUTTI,LOM,90+,1,18,0,0,0,19,0,19,0,19,Lombardia,ITC4
2021-01-13,PF/BT,907,RSA SANTA MARIA DELLA NEVE,LOM,20-29,0,3,0,3,0,0,0,3,0,3,Lombardia,ITC4
2021-01-13,PF/BT,907,RSA SANTA MARIA DELLA NEVE,LOM,30-39,1,1,0,2,0,0,0,2,0,2,Lombardia,ITC4
2021-01-13,PF/BT,907,RSA SANTA MARIA DELLA NEVE,LOM,40-49,5,13,0,14,3,1,0,18,0,18,Lombardia,ITC4
2021-01-13,PF/BT,907,RSA SANTA MARIA DELLA NEVE,LOM,50-59,4,21,0,16,9,0,0,25,0,25,Lombardia,ITC4
2021-01-13,PF/BT,907,RSA SANTA MARIA DELLA NEVE,LOM,60-69,3,6,0,2,3,4,0,9,0,9,Lombardia,ITC4
2021-01-13,PF/BT,907,RSA SANTA MARIA DELLA NEVE,LOM,70-79,5,6,0,0,0,11,0,11,0,11,Lombardia,ITC4
2021-01-13,PF/BT,907,RSA SANTA MARIA DELLA NEVE,LOM,80-89,6,24,0,0,0,30,0,30,0,30,Lombardia,ITC4
2021-01-13,PF/BT,907,RSA SANTA MARIA DELLA NEVE,LOM,90+,3,7,0,0,0,10,0,10,0,10,Lombardia,ITC4
2021-01-13,PF/BT,933,RSA FONDAZIONE RIZZIERI- PIANCOGNO (BS),LOM,20-29,2,0,0,2,0,0,0,2,0,2,Lombardia,ITC4
2021-01-13,PF/BT,933,RSA FONDAZIONE RIZZIERI- PIANCOGNO (BS),LOM,30-39,1,2,0,3,0,0,0,3,0,3,Lombardia,ITC4
2021-01-13,PF/BT,933,RSA FONDAZIONE RIZZIERI- PIANCOGNO (BS),LOM,40-49,1,10,0,11,0,0,0,11,0,11,Lombardia,ITC4
2021-01-13,PF/BT,933,RSA FONDAZIONE RIZZIERI- PIANCOGNO (BS),LOM,50-59,0,8,0,8,0,0,0,8,0,8,Lombardia,ITC4
2021-01-13,PF/BT,943,R.S.A RESIDENZA ANGELO MAJ FONDAZIONE ONLUS,LOM,20-29,0,2,0,2,0,0,0,2,0,2,Lombardia,ITC4
2021-01-13,PF/BT,943,R.S.A RESIDENZA ANGELO MAJ FONDAZIONE ONLUS,LOM,30-39,1,1,0,2,0,0,0,2,0,2,Lombardia,ITC4
2021-01-13,PF/BT,943,R.S.A RESIDENZA ANGELO MAJ FONDAZIONE ONLUS,LOM,40-49,0,3,0,2,1,0,0,3,0,3,Lombardia,ITC4
2021-01-13,PF/BT,943,R.S.A RESIDENZA ANGELO MAJ FONDAZIONE ONLUS,LOM,50-59,2,2,0,3,0,1,0,4,0,4,Lombardia,ITC4
2021-01-13,PF/BT,943,R.S.A RESIDENZA ANGELO MAJ FONDAZIONE ONLUS,LOM,60-69,1,1,0,0,1,1,0,2,0,2,Lombardia,ITC4
2021-01-13,PF/BT,943,R.S.A RESIDENZA ANGELO MAJ FONDAZIONE ONLUS,LOM,70-79,4,6,0,0,1,9,0,10,0,10,Lombardia,ITC4
2021-01-13,PF/BT,943,R.S.A RESIDENZA ANGELO MAJ FONDAZIONE ONLUS,LOM,80-89,2,22,0,0,0,24,0,24,0,24,Lombardia,ITC4
2021-01-13,PF/BT,943,R.S.A RESIDENZA ANGELO MAJ FONDAZIONE ONLUS,LOM,90+,2,11,0,0,0,13,0,13,0,13,Lombardia,ITC4
2021-01-13,PF/BT,947,I.R.C.C.S. POLICLINICO SAN DONATO,LOM,16-19,0,1,0,1,0,0,0,1,0,1,Lombardia,ITC4
2021-01-13,PF/BT,947,I.R.C.C.S. POLICLINICO SAN DONATO,LOM,20-29,14,52,0,65,1,0,0,66,0,66,Lombardia,ITC4
2021-01-13,PF/BT,947,I.R.C.C.S. POLICLINICO SAN DONATO,LOM,30-39,15,20,0,31,4,0,0,35,0,35,Lombardia,ITC4
2021-01-13,PF/BT,947,I.R.C.C.S. POLICLINICO SAN DONATO,LOM,40-49,8,15,0,20,3,0,0,23,0,23,Lombardia,ITC4
2021-01-13,PF/BT,947,I.R.C.C.S. POLICLINICO SAN DONATO,LOM,50-59,5,12,0,15,2,0,0,17,0,17,Lombardia,ITC4
2021-01-13,PF/BT,947,I.R.C.C.S. POLICLINICO SAN DONATO,LOM,60-69,3,5,0,8,0,0,0,8,0,8,Lombardia,ITC4
2021-01-13,PF/BT,951,CASA DI RIPOSO CITTA' DI CHIAVENNA,LOM,20-29,0,3,0,3,0,0,0,3,0,3,Lombardia,ITC4
2021-01-13,PF/BT,951,CASA DI RIPOSO CITTA' DI CHIAVENNA,LOM,30-39,0,4,0,4,0,0,0,4,0,4,Lombardia,ITC4
2021-01-13,PF/BT,951,CASA DI RIPOSO CITTA' DI CHIAVENNA,LOM,40-49,2,11,0,12,1,0,0,13,0,13,Lombardia,ITC4
2021-01-13,PF/BT,951,CASA DI RIPOSO CITTA' DI CHIAVENNA,LOM,50-59,2,9,0,7,3,1,0,11,0,11,Lombardia,ITC4
2021-01-13,PF/BT,951,CASA DI RIPOSO CITTA' DI CHIAVENNA,LOM,60-69,1,4,0,1,1,2,1,5,0,5,Lombardia,ITC4
2021-01-13,PF/BT,951,CASA DI RIPOSO CITTA' DI CHIAVENNA,LOM,70-79,2,6,0,0,0,8,0,8,0,8,Lombardia,ITC4
2021-01-13,PF/BT,951,CASA DI RIPOSO CITTA' DI CHIAVENNA,LOM,80-89,4,9,0,0,0,13,0,13,0,13,Lombardia,ITC4
2021-01-13,PF/BT,951,CASA DI RIPOSO CITTA' DI CHIAVENNA,LOM,90+,2,13,0,0,0,15,0,15,0,15,Lombardia,ITC4
2021-01-13,PF/BT,953,Fondazione Casa di Riposo Bongioni-Lambertenghi Onlus,LOM,20-29,1,1,0,2,0,0,0,2,0,2,Lombardia,ITC4
2021-01-13,PF/BT,953,Fondazione Casa di Riposo Bongioni-Lambertenghi Onlus,LOM,30-39,1,4,0,5,0,0,0,5,0,5,Lombardia,ITC4
2021-01-13,PF/BT,953,Fondazione Casa di Riposo Bongioni-Lambertenghi Onlus,LOM,40-49,4,15,0,17,2,0,0,19,0,19,Lombardia,ITC4
2021-01-13,PF/BT,953,Fondazione Casa di Riposo Bongioni-Lambertenghi Onlus,LOM,50-59,3,19,0,17,4,1,0,22,0,22,Lombardia,ITC4
2021-01-13,PF/BT,953,Fondazione Casa di Riposo Bongioni-Lambertenghi Onlus,LOM,60-69,2,4,0,5,1,0,0,6,0,6,Lombardia,ITC4
2021-01-13,PF/BT,953,Fondazione Casa di Riposo Bongioni-Lambertenghi Onlus,LOM,80-89,0,3,0,0,0,3,0,3,0,3,Lombardia,ITC4
2021-01-13,PF/BT,953,Fondazione Casa di Riposo Bongioni-Lambertenghi Onlus,LOM,90+,0,3,0,0,0,3,0,3,0,3,Lombardia,ITC4
2021-01-13,PF/BT,980,CASA MADONNA DEL LAVORO,LOM,20-29,0,3,0,3,0,0,0,3,0,3,Lombardia,ITC4
2021-01-13,PF/BT,980,CASA MADONNA DEL LAVORO,LOM,30-39,2,2,0,2,2,0,0,4,0,4,Lombardia,ITC4
2021-01-13,PF/BT,980,CASA MADONNA DEL LAVORO,LOM,40-49,2,9,0,7,4,0,0,11,0,11,Lombardia,ITC4
2021-01-13,PF/BT,980,CASA MADONNA DEL LAVORO,LOM,50-59,1,13,0,11,2,1,0,14,0,14,Lombardia,ITC4
2021-01-13,PF/BT,980,CASA MADONNA DEL LAVORO,LOM,60-69,7,4,0,1,2,8,0,11,0,11,Lombardia,ITC4
2021-01-13,PF/BT,980,CASA MADONNA DEL LAVORO,LOM,70-79,5,2,0,0,0,7,0,7,0,7,Lombardia,ITC4
2021-01-13,PF/BT,980,CASA MADONNA DEL LAVORO,LOM,80-89,9,8,0,0,0,17,0,17,0,17,Lombardia,ITC4
2021-01-13,PF/BT,980,CASA MADONNA DEL LAVORO,LOM,90+,4,10,0,0,0,14,0,14,0,14,Lombardia,ITC4
2021-01-13,PF/BT,Cudes 001064,"RSA VILLA SAN CLEMENTE via Garibaldi 77 - 20852, Villasanta (MB)",LOM,60-69,1,2,0,0,0,3,0,3,0,3,Lombardia,ITC4
2021-01-13,PF/BT,Cudes 001064,"RSA VILLA SAN CLEMENTE via Garibaldi 77 - 20852, Villasanta (MB)",LOM,70-79,0,3,0,0,0,3,0,3,0,3,Lombardia,ITC4
2021-01-13,PF/BT,Cudes 001064,"RSA VILLA SAN CLEMENTE via Garibaldi 77 - 20852, Villasanta (MB)",LOM,80-89,2,21,0,0,0,23,0,23,0,23,Lombardia,ITC4
2021-01-13,PF/BT,Cudes 001064,"RSA VILLA SAN CLEMENTE via Garibaldi 77 - 20852, Villasanta (MB)",LOM,90+,3,16,0,0,0,19,0,19,0,19,Lombardia,ITC4
2021-01-13,PF/BT,HSP11-11 bis,Policlinico San Pietro,LOM,20-29,1,7,0,8,0,0,0,8,0,8,Lombardia,ITC4
2021-01-13,PF/BT,HSP11-11 bis,Policlinico San Pietro,LOM,30-39,4,9,0,13,0,0,0,13,0,13,Lombardia,ITC4
2021-01-13,PF/BT,HSP11-11 bis,Policlinico San Pietro,LOM,40-49,5,11,0,16,0,0,0,16,0,16,Lombardia,ITC4
2021-01-13,PF/BT,HSP11-11 bis,Policlinico San Pietro,LOM,50-59,5,12,0,17,0,0,0,17,0,17,Lombardia,ITC4
2021-01-13,PF/BT,HSP11-11 bis,Policlinico San Pietro,LOM,60-69,9,3,0,12,0,0,0,12,0,12,Lombardia,ITC4
2021-01-13,PF/BT,HSP11-11bis,32170223 HUB COVID SS PAOLO E CARLO - PVO Ospedale San Paolo,LOM,16-19,3,1,0,4,0,0,0,4,0,4,Lombardia,ITC4
2021-01-13,PF/BT,HSP11-11bis,32170223 HUB COVID SS PAOLO E CARLO - PVO Ospedale San Paolo,LOM,20-29,25,26,0,45,6,0,0,51,0,51,Lombardia,ITC4
2021-01-13,PF/BT,HSP11-11bis,32170223 HUB COVID SS PAOLO E CARLO - PVO Ospedale San Paolo,LOM,30-39,18,25,0,34,9,0,0,43,0,43,Lombardia,ITC4
2021-01-13,PF/BT,HSP11-11bis,32170223 HUB COVID SS PAOLO E CARLO - PVO Ospedale San Paolo,LOM,40-49,37,32,0,45,24,0,0,69,0,69,Lombardia,ITC4
2021-01-13,PF/BT,HSP11-11bis,32170223 HUB COVID SS PAOLO E CARLO - PVO Ospedale San Paolo,LOM,50-59,34,41,0,51,24,0,0,75,0,75,Lombardia,ITC4
2021-01-13,PF/BT,HSP11-11bis,32170223 HUB COVID SS PAOLO E CARLO - PVO Ospedale San Paolo,LOM,60-69,22,18,0,34,6,0,0,40,0,40,Lombardia,ITC4
2021-01-13,PF/BT,HSP11-11bis,32170223 HUB COVID SS PAOLO E CARLO - PVO Ospedale San Paolo,LOM,70-79,8,3,0,9,2,0,0,11,0,11,Lombardia,ITC4
2021-01-13,PF/BT,HSP11-11bis,32170224 HUB COVID OSP. SAN CARLO - PVO Ospedale San Carlo,LOM,16-19,0,1,0,0,0,0,1,1,0,1,Lombardia,ITC4
2021-01-13,PF/BT,HSP11-11bis,32170224 HUB COVID OSP. SAN CARLO - PVO Ospedale San Carlo,LOM,20-29,15,22,0,18,2,0,17,37,0,37,Lombardia,ITC4
2021-01-13,PF/BT,HSP11-11bis,32170224 HUB COVID OSP. SAN CARLO - PVO Ospedale San Carlo,LOM,30-39,14,23,0,21,3,0,13,37,0,37,Lombardia,ITC4
2021-01-13,PF/BT,HSP11-11bis,32170224 HUB COVID OSP. SAN CARLO - PVO Ospedale San Carlo,LOM,40-49,29,23,0,22,4,0,26,52,0,52,Lombardia,ITC4
2021-01-13,PF/BT,HSP11-11bis,32170224 HUB COVID OSP. SAN CARLO - PVO Ospedale San Carlo,LOM,50-59,28,70,0,45,14,0,39,98,0,98,Lombardia,ITC4
2021-01-13,PF/BT,HSP11-11bis,32170224 HUB COVID OSP. SAN CARLO - PVO Ospedale San Carlo,LOM,60-69,15,20,0,21,3,0,11,35,0,35,Lombardia,ITC4
2021-01-13,PF/BT,HSP11-11bis,32170224 HUB COVID OSP. SAN CARLO - PVO Ospedale San Carlo,LOM,70-79,5,2,0,3,0,0,4,7,0,7,Lombardia,ITC4
2021-01-13,PF/BT,HSP11-11bis,32170224 HUB COVID OSP. SAN CARLO - PVO Ospedale San Carlo,LOM,80-89,1,0,0,0,0,0,1,1,0,1,Lombardia,ITC4
2021-01-13,PF/BT,HSP11-11bis,Ambulatorio COVID PO Codogno,LOM,20-29,2,4,0,6,0,0,0,6,0,6,Lombardia,ITC4
2021-01-13,PF/BT,HSP11-11bis,Ambulatorio COVID PO Codogno,LOM,30-39,3,3,0,6,0,0,0,6,0,6,Lombardia,ITC4
2021-01-13,PF/BT,HSP11-11bis,Ambulatorio COVID PO Codogno,LOM,40-49,11,25,0,36,0,0,0,36,0,36,Lombardia,ITC4
2021-01-13,PF/BT,HSP11-11bis,Ambulatorio COVID PO Codogno,LOM,50-59,18,37,0,50,5,0,0,55,0,55,Lombardia,ITC4
2021-01-13,PF/BT,HSP11-11bis,Ambulatorio COVID PO Codogno,LOM,60-69,6,6,0,11,1,0,0,12,0,12,Lombardia,ITC4
2021-01-13,PF/BT,HSP11-11bis,Ambulatorio COVID PO Codogno,LOM,70-79,2,2,0,4,0,0,0,4,0,4,Lombardia,ITC4
2021-01-13,PF/BT,HSP11-11bis,Ambulatorio COVID PO Codogno,LOM,80-89,1,0,0,1,0,0,0,1,0,1,Lombardia,ITC4
2021-01-13,PF/BT,HSP11-11bis,Ambulatorio COVID PO LODI,LOM,20-29,15,15,0,22,8,0,0,30,0,30,Lombardia,ITC4
2021-01-13,PF/BT,HSP11-11bis,Ambulatorio COVID PO LODI,LOM,30-39,8,16,0,17,7,0,0,24,0,24,Lombardia,ITC4
2021-01-13,PF/BT,HSP11-11bis,Ambulatorio COVID PO LODI,LOM,40-49,9,31,0,33,7,0,0,40,0,40,Lombardia,ITC4
2021-01-13,PF/BT,HSP11-11bis,Ambulatorio COVID PO LODI,LOM,50-59,16,65,0,51,30,0,0,81,0,81,Lombardia,ITC4
2021-01-13,PF/BT,HSP11-11bis,Ambulatorio COVID PO LODI,LOM,60-69,9,10,0,13,6,0,0,19,0,19,Lombardia,ITC4
2021-01-13,PF/BT,HSP11-11bis,Ambulatorio COVID PO LODI,LOM,70-79,2,0,0,0,2,0,0,2,0,2,Lombardia,ITC4
2021-01-13,PF/BT,HSP11-11bis,Ambulatorio COVID PO LODI  (RSA),LOM,30-39,0,1,0,1,0,0,0,1,0,1,Lombardia,ITC4
2021-01-13,PF/BT,HSP11-11bis,Ambulatorio COVID PO LODI  (RSA),LOM,40-49,0,2,0,2,0,0,0,2,0,2,Lombardia,ITC4
2021-01-13,PF/BT,HSP11-11bis,Ambulatorio COVID PO LODI  (RSA),LOM,50-59,2,2,0,2,0,2,0,4,0,4,Lombardia,ITC4
2021-01-13,PF/BT,HSP11-11bis,Ambulatorio COVID PO LODI  (RSA),LOM,60-69,5,4,0,2,0,7,0,9,0,9,Lombardia,ITC4
2021-01-13,PF/BT,HSP11-11bis,Ambulatorio COVID PO LODI  (RSA),LOM,70-79,6,11,0,0,0,17,0,17,0,17,Lombardia,ITC4
2021-01-13,PF/BT,HSP11-11bis,Ambulatorio COVID PO LODI  (RSA),LOM,80-89,15,62,0,0,0,77,0,77,0,77,Lombardia,ITC4
2021-01-13,PF/BT,HSP11-11bis,Ambulatorio COVID PO LODI  (RSA),LOM,90+,8,48,0,0,0,56,0,56,0,56,Lombardia,ITC4
2021-01-13,PF/BT,HSP11-11bis,AMBULATORIO COVID PO SACCO,LOM,16-19,1,1,0,0,0,0,2,2,0,2,Lombardia,ITC4
2021-01-13,PF/BT,HSP11-11bis,AMBULATORIO COVID PO SACCO,LOM,20-29,37,62,0,72,7,0,20,99,0,99,Lombardia,ITC4
2021-01-13,PF/BT,HSP11-11bis,AMBULATORIO COVID PO SACCO,LOM,30-39,34,57,0,68,8,0,15,91,0,91,Lombardia,ITC4
2021-01-13,PF/BT,HSP11-11bis,AMBULATORIO COVID PO SACCO,LOM,40-49,37,57,0,60,16,0,18,94,0,94,Lombardia,ITC4
2021-01-13,PF/BT,HSP11-11bis,AMBULATORIO COVID PO SACCO,LOM,50-59,63,118,0,113,40,0,28,181,0,181,Lombardia,ITC4
2021-01-13,PF/BT,HSP11-11bis,AMBULATORIO COVID PO SACCO,LOM,60-69,39,44,0,67,10,0,6,83,0,83,Lombardia,ITC4
2021-01-13,PF/BT,HSP11-11bis,AMBULATORIO COVID PO SACCO,LOM,70-79,7,1,0,4,1,0,3,8,0,8,Lombardia,ITC4
2021-01-13,PF/BT,HSP11-11bis,ASST BERGAMO OVEST - OSPEDALE ROMANO DI L.DIA,LOM,16-19,0,3,0,0,0,0,3,3,0,3,Lombardia,ITC4
2021-01-13,PF/BT,HSP11-11bis,ASST BERGAMO OVEST - OSPEDALE ROMANO DI L.DIA,LOM,20-29,9,22,0,3,1,0,27,31,0,31,Lombardia,ITC4
2021-01-13,PF/BT,HSP11-11bis,ASST BERGAMO OVEST - OSPEDALE ROMANO DI L.DIA,LOM,30-39,12,17,0,2,1,0,26,29,0,29,Lombardia,ITC4
2021-01-13,PF/BT,HSP11-11bis,ASST BERGAMO OVEST - OSPEDALE ROMANO DI L.DIA,LOM,40-49,21,8,0,3,4,0,22,29,0,29,Lombardia,ITC4
2021-01-13,PF/BT,HSP11-11bis,ASST BERGAMO OVEST - OSPEDALE ROMANO DI L.DIA,LOM,50-59,13,21,0,5,3,0,26,34,0,34,Lombardia,ITC4
2021-01-13,PF/BT,HSP11-11bis,ASST BERGAMO OVEST - OSPEDALE ROMANO DI L.DIA,LOM,60-69,37,14,0,3,0,0,48,51,0,51,Lombardia,ITC4
2021-01-13,PF/BT,HSP11-11bis,ASST BERGAMO OVEST - OSPEDALE ROMANO DI L.DIA,LOM,70-79,16,11,0,0,0,0,27,27,0,27,Lombardia,ITC4
2021-01-13,PF/BT,HSP11-11bis,ASST BERGAMO OVEST - OSPEDALE TREVIGLIO,LOM,20-29,9,10,0,8,2,0,9,19,0,19,Lombardia,ITC4
2021-01-13,PF/BT,HSP11-11bis,ASST BERGAMO OVEST - OSPEDALE TREVIGLIO,LOM,30-39,23,16,0,20,3,0,16,39,0,39,Lombardia,ITC4
2021-01-13,PF/BT,HSP11-11bis,ASST BERGAMO OVEST - OSPEDALE TREVIGLIO,LOM,40-49,13,24,0,18,6,0,13,37,0,37,Lombardia,ITC4
2021-01-13,PF/BT,HSP11-11bis,ASST BERGAMO OVEST - OSPEDALE TREVIGLIO,LOM,50-59,22,44,0,28,11,0,27,66,0,66,Lombardia,ITC4
2021-01-13,PF/BT,HSP11-11bis,ASST BERGAMO OVEST - OSPEDALE TREVIGLIO,LOM,60-69,11,10,0,8,3,0,10,21,0,21,Lombardia,ITC4
2021-01-13,PF/BT,HSP11-11bis,ASST BERGAMO OVEST - OSPEDALE TREVIGLIO,LOM,70-79,4,0,0,1,0,0,3,4,0,4,Lombardia,ITC4
2021-01-13,PF/BT,HSP11-11bis,ICS Maugeri- Istituto Scientifico di Montescano (Pv),LOM,20-29,2,3,0,5,0,0,0,5,0,5,Lombardia,ITC4
2021-01-13,PF/BT,HSP11-11bis,ICS Maugeri- Istituto Scientifico di Montescano (Pv),LOM,30-39,2,3,0,5,0,0,0,5,0,5,Lombardia,ITC4
2021-01-13,PF/BT,HSP11-11bis,ICS Maugeri- Istituto Scientifico di Montescano (Pv),LOM,40-49,3,11,0,12,2,0,0,14,0,14,Lombardia,ITC4
2021-01-13,PF/BT,HSP11-11bis,ICS Maugeri- Istituto Scientifico di Montescano (Pv),LOM,50-59,5,18,0,21,2,0,0,23,0,23,Lombardia,ITC4
2021-01-13,PF/BT,HSP11-11bis,ICS Maugeri- Istituto Scientifico di Montescano (Pv),LOM,60-69,3,4,0,6,1,0,0,7,0,7,Lombardia,ITC4
2021-01-13,PF/BT,HSP11-11bis,"Policlinico San Marco, Osio Sotto (BG)",LOM,20-29,2,9,0,11,0,0,0,11,0,11,Lombardia,ITC4
2021-01-13,PF/BT,HSP11-11bis,"Policlinico San Marco, Osio Sotto (BG)",LOM,30-39,5,8,0,13,0,0,0,13,0,13,Lombardia,ITC4
2021-01-13,PF/BT,HSP11-11bis,"Policlinico San Marco, Osio Sotto (BG)",LOM,40-49,3,28,0,31,0,0,0,31,0,31,Lombardia,ITC4
2021-01-13,PF/BT,HSP11-11bis,"Policlinico San Marco, Osio Sotto (BG)",LOM,50-59,5,20,0,25,0,0,0,25,0,25,Lombardia,ITC4
2021-01-13,PF/BT,HSP11-11bis,"Policlinico San Marco, Osio Sotto (BG)",LOM,60-69,2,0,0,2,0,0,0,2,0,2,Lombardia,ITC4
2021-01-13,PF/BT,HSP11-11bis,"Policlinico San Marco, Osio Sotto (BG)",LOM,70-79,1,1,0,2,0,0,0,2,0,2,Lombardia,ITC4
2021-01-13,PF/BT,HSP11-11BIS-03010600,CASA DI CURA POLICLINICO DI MONZA-MONZA-,LOM,20-29,1,2,0,3,0,0,0,3,0,3,Lombardia,ITC4
2021-01-13,PF/BT,HSP11-11BIS-03010600,CASA DI CURA POLICLINICO DI MONZA-MONZA-,LOM,30-39,2,4,0,4,1,0,1,6,0,6,Lombardia,ITC4
2021-01-13,PF/BT,HSP11-11BIS-03010600,CASA DI CURA POLICLINICO DI MONZA-MONZA-,LOM,40-49,4,15,0,9,1,0,9,19,0,19,Lombardia,ITC4
2021-01-13,PF/BT,HSP11-11BIS-03010600,CASA DI CURA POLICLINICO DI MONZA-MONZA-,LOM,50-59,7,6,0,4,1,0,8,13,0,13,Lombardia,ITC4
2021-01-13,PF/BT,HSP11-11BIS-03010600,CASA DI CURA POLICLINICO DI MONZA-MONZA-,LOM,60-69,8,0,0,5,0,0,3,8,0,8,Lombardia,ITC4
2021-01-13,PF/BT,HSP11-11BIS-03010600,CASA DI CURA POLICLINICO DI MONZA-MONZA-,LOM,70-79,3,1,0,3,0,0,1,4,0,4,Lombardia,ITC4
2021-01-13,PF/BT,HSP11-11BIS-03010600,CASA DI CURA POLICLINICO DI MONZA-MONZA-,LOM,80-89,1,0,0,0,0,0,1,1,0,1,Lombardia,ITC4
2021-01-13,PF/BT,HUB19,0,LOM,20-29,0,2,0,2,0,0,0,2,0,2,Lombardia,ITC4
2021-01-13,PF/BT,HUB19,0,LOM,30-39,0,2,0,1,1,0,0,2,0,2,Lombardia,ITC4
2021-01-13,PF/BT,HUB19,0,LOM,40-49,0,3,0,3,0,0,0,3,0,3,Lombardia,ITC4
2021-01-13,PF/BT,HUB19,0,LOM,50-59,1,2,0,2,1,0,0,3,0,3,Lombardia,ITC4
2021-01-13,PF/BT,HUB19,0,LOM,60-69,1,0,0,1,0,0,0,1,0,1,Lombardia,ITC4
2021-01-13,PF/BT,HUB19,0,LOM,80-89,0,1,0,0,0,1,0,1,0,1,Lombardia,ITC4
2021-01-13,PF/BT,S09, PII ISTITUTI UNIFICATI ONLUS,LOM,30-39,0,1,0,1,0,0,0,1,0,1,Lombardia,ITC4
2021-01-13,PF/BT,S09, PII ISTITUTI UNIFICATI ONLUS,LOM,40-49,1,6,0,7,0,0,0,7,0,7,Lombardia,ITC4
2021-01-13,PF/BT,S09, PII ISTITUTI UNIFICATI ONLUS,LOM,50-59,1,6,0,6,0,0,1,7,0,7,Lombardia,ITC4
2021-01-13,PF/BT,S09, PII ISTITUTI UNIFICATI ONLUS,LOM,60-69,0,3,0,3,0,0,0,3,0,3,Lombardia,ITC4
2021-01-13,PF/BT,S09,FONDAZIONE PENSIONATO SANNAZZARESE ONLUS,LOM,30-39,0,1,0,0,1,0,0,1,0,1,Lombardia,ITC4
2021-01-13,PF/BT,S09,FONDAZIONE PENSIONATO SANNAZZARESE ONLUS,LOM,40-49,0,8,0,7,1,0,0,8,0,8,Lombardia,ITC4
2021-01-13,PF/BT,S09,FONDAZIONE PENSIONATO SANNAZZARESE ONLUS,LOM,50-59,0,3,0,2,1,0,0,3,0,3,Lombardia,ITC4
2021-01-13,PF/BT,S09,FONDAZIONE PENSIONATO SANNAZZARESE ONLUS,LOM,70-79,0,1,0,0,0,1,0,1,0,1,Lombardia,ITC4
2021-01-13,PF/BT,S09,FONDAZIONE PENSIONATO SANNAZZARESE ONLUS,LOM,80-89,0,6,0,0,0,6,0,6,0,6,Lombardia,ITC4
2021-01-13,PF/BT,S09,FONDAZIONE PENSIONATO SANNAZZARESE ONLUS,LOM,90+,1,4,0,0,0,5,0,5,0,5,Lombardia,ITC4
2021-01-13,PF/BT,STS - 030328002212,RSA PENSIONATO DON ORIONE FUMO,LOM,30-39,0,1,0,1,0,0,0,1,0,1,Lombardia,ITC4
2021-01-13,PF/BT,STS - 030328002212,RSA PENSIONATO DON ORIONE FUMO,LOM,40-49,3,9,0,10,2,0,0,12,0,12,Lombardia,ITC4
2021-01-13,PF/BT,STS - 030328002212,RSA PENSIONATO DON ORIONE FUMO,LOM,50-59,2,1,0,3,0,0,0,3,0,3,Lombardia,ITC4
2021-01-13,PF/BT,STS - 030328002212,RSA PENSIONATO DON ORIONE FUMO,LOM,60-69,0,2,0,2,0,0,0,2,0,2,Lombardia,ITC4
2021-01-13,PF/BT,STS11,0,LOM,90+,0,4,0,0,0,4,0,4,0,4,Lombardia,ITC4
2021-01-13,PF/BT,STS11,ASC CREMONA SOLIDALE,LOM,20-29,3,11,0,10,2,0,2,14,0,14,Lombardia,ITC4
2021-01-13,PF/BT,STS11,ASC CREMONA SOLIDALE,LOM,30-39,4,8,0,10,2,0,0,12,0,12,Lombardia,ITC4
2021-01-13,PF/BT,STS11,ASC CREMONA SOLIDALE,LOM,40-49,8,10,0,13,5,0,0,18,0,18,Lombardia,ITC4
2021-01-13,PF/BT,STS11,ASC CREMONA SOLIDALE,LOM,50-59,8,40,0,42,4,0,2,48,0,48,Lombardia,ITC4
2021-01-13,PF/BT,STS11,ASC CREMONA SOLIDALE,LOM,60-69,5,7,0,7,2,0,3,12,0,12,Lombardia,ITC4
2021-01-13,PF/BT,STS11,ASC CREMONA SOLIDALE,LOM,70-79,3,1,0,0,0,0,4,4,0,4,Lombardia,ITC4
2021-01-13,PF/BT,STS11,AZIENDA SPECIALE DEL COMUNE DI MONTICELLO BRIANZA-CASA DI RIPOSO MONTICELLO (CUDES 001144),LOM,20-29,1,7,0,5,3,0,0,8,0,8,Lombardia,ITC4
2021-01-13,PF/BT,STS11,AZIENDA SPECIALE DEL COMUNE DI MONTICELLO BRIANZA-CASA DI RIPOSO MONTICELLO (CUDES 001144),LOM,30-39,4,6,0,8,2,0,0,10,0,10,Lombardia,ITC4
2021-01-13,PF/BT,STS11,AZIENDA SPECIALE DEL COMUNE DI MONTICELLO BRIANZA-CASA DI RIPOSO MONTICELLO (CUDES 001144),LOM,40-49,2,32,0,25,9,0,0,34,0,34,Lombardia,ITC4
2021-01-13,PF/BT,STS11,AZIENDA SPECIALE DEL COMUNE DI MONTICELLO BRIANZA-CASA DI RIPOSO MONTICELLO (CUDES 001144),LOM,50-59,5,27,0,21,11,0,0,32,0,32,Lombardia,ITC4
2021-01-13,PF/BT,STS11,AZIENDA SPECIALE DEL COMUNE DI MONTICELLO BRIANZA-CASA DI RIPOSO MONTICELLO (CUDES 001144),LOM,60-69,0,5,0,4,1,0,0,5,0,5,Lombardia,ITC4
2021-01-13,PF/BT,STS11,FONDAZIONE IN PARTECIPAZIONE CASA DI RIPOSO VILLA DEL SORRISO ONLUS,LOM,50-59,1,0,0,0,1,0,0,1,0,1,Lombardia,ITC4
2021-01-13,PF/BT,STS11,FONDAZIONE IN PARTECIPAZIONE CASA DI RIPOSO VILLA DEL SORRISO ONLUS,LOM,60-69,1,0,0,0,0,1,0,1,0,1,Lombardia,ITC4
2021-01-13,PF/BT,STS11,FONDAZIONE IN PARTECIPAZIONE CASA DI RIPOSO VILLA DEL SORRISO ONLUS,LOM,70-79,1,3,0,0,0,4,0,4,0,4,Lombardia,ITC4
2021-01-13,PF/BT,STS11,FONDAZIONE IN PARTECIPAZIONE CASA DI RIPOSO VILLA DEL SORRISO ONLUS,LOM,80-89,5,9,0,0,0,14,0,14,0,14,Lombardia,ITC4
2021-01-13,PF/BT,STS11,FONDAZIONE IN PARTECIPAZIONE CASA DI RIPOSO VILLA DEL SORRISO ONLUS,LOM,90+,0,4,0,0,0,4,0,4,0,4,Lombardia,ITC4
2021-01-13,PF/BT,STS11,FONDAZIONE MONS.BENEDNI ONLUS  - MARCARIA,LOM,30-39,1,3,0,4,0,0,0,4,0,4,Lombardia,ITC4
2021-01-13,PF/BT,STS11,FONDAZIONE MONS.BENEDNI ONLUS  - MARCARIA,LOM,40-49,2,11,0,8,5,0,0,13,0,13,Lombardia,ITC4
2021-01-13,PF/BT,STS11,FONDAZIONE MONS.BENEDNI ONLUS  - MARCARIA,LOM,50-59,1,8,0,9,0,0,0,9,0,9,Lombardia,ITC4
2021-01-13,PF/BT,STS11,FONDAZIONE MONS.BENEDNI ONLUS  - MARCARIA,LOM,60-69,1,6,0,4,3,0,0,7,0,7,Lombardia,ITC4
2021-01-13,PF/BT,STS11,FONDAZIONE MONS.BENEDNI ONLUS  - MARCARIA,LOM,70-79,0,1,0,0,0,1,0,1,0,1,Lombardia,ITC4
2021-01-13,PF/BT,STS11,FONDAZIONE MONS.BENEDNI ONLUS  - MARCARIA,LOM,80-89,0,2,0,0,0,2,0,2,0,2,Lombardia,ITC4
2021-01-13,PF/BT,STS11,FONDAZIONE MONS.BENEDNI ONLUS  - MARCARIA,LOM,90+,2,2,0,0,0,4,0,4,0,4,Lombardia,ITC4
2021-01-13,PF/BT,STS11,FONDAZIONE POMPEO E CESARE MAZZOCCHI  ONLUS - COCCAGLIO,LOM,20-29,1,1,0,2,0,0,0,2,0,2,Lombardia,ITC4
2021-01-13,PF/BT,STS11,FONDAZIONE POMPEO E CESARE MAZZOCCHI  ONLUS - COCCAGLIO,LOM,30-39,0,1,0,1,0,0,0,1,0,1,Lombardia,ITC4
2021-01-13,PF/BT,STS11,FONDAZIONE POMPEO E CESARE MAZZOCCHI  ONLUS - COCCAGLIO,LOM,40-49,0,5,0,5,0,0,0,5,0,5,Lombardia,ITC4
2021-01-13,PF/BT,STS11,FONDAZIONE POMPEO E CESARE MAZZOCCHI  ONLUS - COCCAGLIO,LOM,50-59,0,2,0,2,0,0,0,2,0,2,Lombardia,ITC4
2021-01-13,PF/BT,STS11,FONDAZIONE POMPEO E CESARE MAZZOCCHI  ONLUS - COCCAGLIO,LOM,60-69,1,1,0,1,1,0,0,2,0,2,Lombardia,ITC4
2021-01-13,PF/BT,STS11,ISTITUTO GERIATRICO CARLO LOUISA GRASSI ONLUS - VIADANA (MN),LOM,20-29,1,2,0,2,1,0,0,3,0,3,Lombardia,ITC4
2021-01-13,PF/BT,STS11,ISTITUTO GERIATRICO CARLO LOUISA GRASSI ONLUS - VIADANA (MN),LOM,30-39,1,3,0,4,0,0,0,4,0,4,Lombardia,ITC4
2021-01-13,PF/BT,STS11,ISTITUTO GERIATRICO CARLO LOUISA GRASSI ONLUS - VIADANA (MN),LOM,40-49,1,5,0,6,0,0,0,6,0,6,Lombardia,ITC4
2021-01-13,PF/BT,STS11,ISTITUTO GERIATRICO CARLO LOUISA GRASSI ONLUS - VIADANA (MN),LOM,50-59,1,12,0,6,7,0,0,13,0,13,Lombardia,ITC4
2021-01-13,PF/BT,STS11,ISTITUTO GERIATRICO CARLO LOUISA GRASSI ONLUS - VIADANA (MN),LOM,60-69,1,3,0,2,2,0,0,4,0,4,Lombardia,ITC4
2021-01-13,PF/BT,STS11,PVT COVID BRESCIA VIA ACERBI,LOM,20-29,20,35,0,0,2,0,53,55,0,55,Lombardia,ITC4
2021-01-13,PF/BT,STS11,PVT COVID BRESCIA VIA ACERBI,LOM,30-39,22,21,0,1,0,0,42,43,0,43,Lombardia,ITC4
2021-01-13,PF/BT,STS11,PVT COVID BRESCIA VIA ACERBI,LOM,40-49,30,16,0,2,4,0,40,46,0,46,Lombardia,ITC4
2021-01-13,PF/BT,STS11,PVT COVID BRESCIA VIA ACERBI,LOM,50-59,41,33,0,6,5,0,63,74,0,74,Lombardia,ITC4
2021-01-13,PF/BT,STS11,PVT COVID BRESCIA VIA ACERBI,LOM,60-69,36,17,0,7,2,0,44,53,0,53,Lombardia,ITC4
2021-01-13,PF/BT,STS11,PVT COVID BRESCIA VIA ACERBI,LOM,70-79,19,3,0,0,0,0,22,22,0,22,Lombardia,ITC4
2021-01-13,PF/BT,STS11,PVT COVID BRESCIA VIA ACERBI,LOM,80-89,0,1,0,0,0,0,1,1,0,1,Lombardia,ITC4
2021-01-13,PF/BT,STS11,RSA - FOND. CASA DI SOGGIORNO PER ANZIANI,LOM,20-29,3,0,0,2,1,0,0,3,0,3,Lombardia,ITC4
2021-01-13,PF/BT,STS11,RSA - FOND. CASA DI SOGGIORNO PER ANZIANI,LOM,40-49,2,6,0,6,0,0,2,8,0,8,Lombardia,ITC4
2021-01-13,PF/BT,STS11,RSA - FOND. CASA DI SOGGIORNO PER ANZIANI,LOM,50-59,1,8,0,6,2,0,1,9,0,9,Lombardia,ITC4
2021-01-13,PF/BT,STS11,RSA - FOND. CASA DI SOGGIORNO PER ANZIANI,LOM,60-69,1,3,0,2,0,2,0,4,0,4,Lombardia,ITC4
2021-01-13,PF/BT,STS11,RSA - FOND. CASA DI SOGGIORNO PER ANZIANI,LOM,70-79,2,5,0,0,0,7,0,7,0,7,Lombardia,ITC4
2021-01-13,PF/BT,STS11,RSA - FOND. CASA DI SOGGIORNO PER ANZIANI,LOM,80-89,9,28,0,0,0,37,0,37,0,37,Lombardia,ITC4
2021-01-13,PF/BT,STS11,RSA - FOND. CASA DI SOGGIORNO PER ANZIANI,LOM,90+,2,17,0,0,0,19,0,19,0,19,Lombardia,ITC4
2021-01-13,PF/BT,STS11,RSA  FONDAZIONE ANNI SERENI TREVIGLIO CARAVAGGI E FARA GA ONLUS,LOM,60-69,5,0,0,0,0,5,0,5,0,5,Lombardia,ITC4
2021-01-13,PF/BT,STS11,RSA  FONDAZIONE ANNI SERENI TREVIGLIO CARAVAGGI E FARA GA ONLUS,LOM,70-79,3,2,0,0,0,5,0,5,0,5,Lombardia,ITC4
2021-01-13,PF/BT,STS11,RSA  FONDAZIONE ANNI SERENI TREVIGLIO CARAVAGGI E FARA GA ONLUS,LOM,80-89,6,20,0,0,0,26,0,26,0,26,Lombardia,ITC4
2021-01-13,PF/BT,STS11,RSA  FONDAZIONE ANNI SERENI TREVIGLIO CARAVAGGI E FARA GA ONLUS,LOM,90+,0,12,0,0,0,12,0,12,0,12,Lombardia,ITC4
2021-01-13,PF/BT,STS11,"RSA ""BEATO INNOCENZO""",LOM,20-29,0,1,0,1,0,0,0,1,0,1,Lombardia,ITC4
2021-01-13,PF/BT,STS11,"RSA ""BEATO INNOCENZO""",LOM,30-39,1,6,0,6,1,0,0,7,0,7,Lombardia,ITC4
2021-01-13,PF/BT,STS11,"RSA ""BEATO INNOCENZO""",LOM,40-49,0,2,0,2,0,0,0,2,0,2,Lombardia,ITC4
2021-01-13,PF/BT,STS11,"RSA ""BEATO INNOCENZO""",LOM,50-59,0,2,0,1,1,0,0,2,0,2,Lombardia,ITC4
2021-01-13,PF/BT,STS11,"RSA ""BEATO INNOCENZO""",LOM,60-69,2,1,0,0,0,3,0,3,0,3,Lombardia,ITC4
2021-01-13,PF/BT,STS11,"RSA ""BEATO INNOCENZO""",LOM,70-79,3,6,0,0,0,9,0,9,0,9,Lombardia,ITC4
2021-01-13,PF/BT,STS11,"RSA ""BEATO INNOCENZO""",LOM,80-89,3,3,0,0,0,6,0,6,0,6,Lombardia,ITC4
2021-01-13,PF/BT,STS11,"RSA ""BEATO INNOCENZO""",LOM,90+,0,6,0,0,0,6,0,6,0,6,Lombardia,ITC4
2021-01-13,PF/BT,STS11,"RSA ""CASA BEATO LUIGI GUANELLA"" - VIA CAGNOLA, 11 - 20154 MILANO",LOM,20-29,3,5,0,7,1,0,0,8,0,8,Lombardia,ITC4
2021-01-13,PF/BT,STS11,"RSA ""CASA BEATO LUIGI GUANELLA"" - VIA CAGNOLA, 11 - 20154 MILANO",LOM,30-39,5,2,0,6,1,0,0,7,0,7,Lombardia,ITC4
2021-01-13,PF/BT,STS11,"RSA ""CASA BEATO LUIGI GUANELLA"" - VIA CAGNOLA, 11 - 20154 MILANO",LOM,40-49,4,13,0,12,5,0,0,17,0,17,Lombardia,ITC4
2021-01-13,PF/BT,STS11,"RSA ""CASA BEATO LUIGI GUANELLA"" - VIA CAGNOLA, 11 - 20154 MILANO",LOM,50-59,0,18,0,14,4,0,0,18,0,18,Lombardia,ITC4
2021-01-13,PF/BT,STS11,"RSA ""CASA BEATO LUIGI GUANELLA"" - VIA CAGNOLA, 11 - 20154 MILANO",LOM,60-69,1,3,0,3,1,0,0,4,0,4,Lombardia,ITC4
2021-01-13,PF/BT,STS11,RSA CASA PACE,LOM,40-49,0,1,0,1,0,0,0,1,0,1,Lombardia,ITC4
2021-01-13,PF/BT,STS11,RSA CASA PACE,LOM,70-79,0,2,0,0,0,2,0,2,0,2,Lombardia,ITC4
2021-01-13,PF/BT,STS11,RSA CASA PACE,LOM,80-89,0,16,0,0,0,16,0,16,0,16,Lombardia,ITC4
2021-01-13,PF/BT,STS11,RSA CASA PACE,LOM,90+,0,29,0,0,0,29,0,29,0,29,Lombardia,ITC4
2021-01-13,PF/BT,STS11,RSA CAV. PAOLO RIVADOSSI BORNO (BS),LOM,20-29,0,2,0,1,1,0,0,2,0,2,Lombardia,ITC4
2021-01-13,PF/BT,STS11,RSA CAV. PAOLO RIVADOSSI BORNO (BS),LOM,30-39,0,2,0,2,0,0,0,2,0,2,Lombardia,ITC4
2021-01-13,PF/BT,STS11,RSA CAV. PAOLO RIVADOSSI BORNO (BS),LOM,40-49,0,2,0,2,0,0,0,2,0,2,Lombardia,ITC4
2021-01-13,PF/BT,STS11,RSA CAV. PAOLO RIVADOSSI BORNO (BS),LOM,50-59,0,5,0,5,0,0,0,5,0,5,Lombardia,ITC4
2021-01-13,PF/BT,STS11,RSA CAV. PAOLO RIVADOSSI BORNO (BS),LOM,60-69,1,4,0,2,3,0,0,5,0,5,Lombardia,ITC4
2021-01-13,PF/BT,STS11,RSA CAV. PAOLO RIVADOSSI BORNO (BS),LOM,70-79,1,3,0,0,0,4,0,4,0,4,Lombardia,ITC4
2021-01-13,PF/BT,STS11,RSA CAV. PAOLO RIVADOSSI BORNO (BS),LOM,80-89,3,5,0,0,0,8,0,8,0,8,Lombardia,ITC4
2021-01-13,PF/BT,STS11,RSA CAV. PAOLO RIVADOSSI BORNO (BS),LOM,90+,2,5,0,0,0,7,0,7,0,7,Lombardia,ITC4
2021-01-13,PF/BT,STS11,RSA DON GIOVANNI FERRAGLIOMALONNO ONLUS,LOM,20-29,0,2,0,2,0,0,0,2,0,2,Lombardia,ITC4
2021-01-13,PF/BT,STS11,RSA DON GIOVANNI FERRAGLIOMALONNO ONLUS,LOM,30-39,0,1,0,1,0,0,0,1,0,1,Lombardia,ITC4
2021-01-13,PF/BT,STS11,RSA DON GIOVANNI FERRAGLIOMALONNO ONLUS,LOM,40-49,0,3,0,3,0,0,0,3,0,3,Lombardia,ITC4
2021-01-13,PF/BT,STS11,RSA DON GIOVANNI FERRAGLIOMALONNO ONLUS,LOM,50-59,0,5,0,4,0,1,0,5,0,5,Lombardia,ITC4
2021-01-13,PF/BT,STS11,RSA DON GIOVANNI FERRAGLIOMALONNO ONLUS,LOM,60-69,1,0,0,0,0,1,0,1,0,1,Lombardia,ITC4
2021-01-13,PF/BT,STS11,RSA DON GIOVANNI FERRAGLIOMALONNO ONLUS,LOM,70-79,3,5,0,0,0,8,0,8,0,8,Lombardia,ITC4
2021-01-13,PF/BT,STS11,RSA DON GIOVANNI FERRAGLIOMALONNO ONLUS,LOM,80-89,4,14,0,0,0,18,0,18,0,18,Lombardia,ITC4
2021-01-13,PF/BT,STS11,RSA DON GIOVANNI FERRAGLIOMALONNO ONLUS,LOM,90+,0,9,0,0,0,9,0,9,0,9,Lombardia,ITC4
2021-01-13,PF/BT,STS11,RSA SAN FRANCESCO,LOM,30-39,0,1,0,1,0,0,0,1,0,1,Lombardia,ITC4
2021-01-13,PF/BT,STS11,RSA SAN FRANCESCO,LOM,40-49,0,2,0,1,1,0,0,2,0,2,Lombardia,ITC4
2021-01-13,PF/BT,STS11,RSA SAN FRANCESCO,LOM,50-59,0,3,0,2,1,0,0,3,0,3,Lombardia,ITC4
2021-01-13,PF/BT,STS11,RSA SAN FRANCESCO,LOM,60-69,0,3,0,2,1,0,0,3,0,3,Lombardia,ITC4
2021-01-13,PF/BT,STS11,RSA SAN FRANCESCO,LOM,70-79,0,3,0,3,0,0,0,3,0,3,Lombardia,ITC4
2021-01-13,PF/BT,STS11,RSA SAN FRANCESCO,LOM,80-89,0,6,0,0,0,6,0,6,0,6,Lombardia,ITC4
2021-01-13,PF/BT,STS11,RSA SAN FRANCESCO,LOM,90+,0,12,0,0,0,12,0,12,0,12,Lombardia,ITC4
2021-01-13,PF/BT,STS11 000942,PSVR RSA FONDAZIONE ENTE CELERI BRENO,LOM,20-29,0,2,0,2,0,0,0,2,0,2,Lombardia,ITC4
2021-01-13,PF/BT,STS11 000942,PSVR RSA FONDAZIONE ENTE CELERI BRENO,LOM,30-39,0,5,0,4,1,0,0,5,0,5,Lombardia,ITC4
2021-01-13,PF/BT,STS11 000942,PSVR RSA FONDAZIONE ENTE CELERI BRENO,LOM,40-49,0,4,0,4,0,0,0,4,0,4,Lombardia,ITC4
2021-01-13,PF/BT,STS11 000942,PSVR RSA FONDAZIONE ENTE CELERI BRENO,LOM,50-59,1,6,0,5,1,1,0,7,0,7,Lombardia,ITC4
2021-01-13,PF/BT,STS11 000942,PSVR RSA FONDAZIONE ENTE CELERI BRENO,LOM,70-79,5,1,0,0,0,6,0,6,0,6,Lombardia,ITC4
2021-01-13,PF/BT,STS11 000942,PSVR RSA FONDAZIONE ENTE CELERI BRENO,LOM,80-89,2,5,0,0,0,7,0,7,0,7,Lombardia,ITC4
2021-01-13,PF/BT,STS11 000942,PSVR RSA FONDAZIONE ENTE CELERI BRENO,LOM,90+,0,5,0,0,0,5,0,5,0,5,Lombardia,ITC4
2021-01-13,PF/BT,sts11 cudes 002195,R.S.A. ING. SASSI FONDAZIONE  ONLUS,LOM,30-39,1,1,0,2,0,0,0,2,0,2,Lombardia,ITC4
2021-01-13,PF/BT,sts11 cudes 002195,R.S.A. ING. SASSI FONDAZIONE  ONLUS,LOM,40-49,0,3,0,3,0,0,0,3,0,3,Lombardia,ITC4
2021-01-13,PF/BT,sts11 cudes 002195,R.S.A. ING. SASSI FONDAZIONE  ONLUS,LOM,50-59,1,4,0,3,2,0,0,5,0,5,Lombardia,ITC4
2021-01-13,PF/BT,sts11 cudes 002195,R.S.A. ING. SASSI FONDAZIONE  ONLUS,LOM,60-69,1,0,0,0,0,1,0,1,0,1,Lombardia,ITC4
2021-01-13,PF/BT,sts11 cudes 002195,R.S.A. ING. SASSI FONDAZIONE  ONLUS,LOM,70-79,4,7,0,1,0,10,0,11,0,11,Lombardia,ITC4
2021-01-13,PF/BT,sts11 cudes 002195,R.S.A. ING. SASSI FONDAZIONE  ONLUS,LOM,80-89,2,0,0,0,0,2,0,2,0,2,Lombardia,ITC4
2021-01-13,PF/BT,sts11 cudes 002195,R.S.A. ING. SASSI FONDAZIONE  ONLUS,LOM,90+,0,12,0,0,0,12,0,12,0,12,Lombardia,ITC4
2021-01-13,PF/BT,STS11/32170226,AMBULATORIO COVID OSP. MILITARE,LOM,20-29,4,4,0,8,0,0,0,8,0,8,Lombardia,ITC4
2021-01-13,PF/BT,STS11/32170226,AMBULATORIO COVID OSP. MILITARE,LOM,30-39,10,2,0,9,3,0,0,12,0,12,Lombardia,ITC4
2021-01-13,PF/BT,STS11/32170226,AMBULATORIO COVID OSP. MILITARE,LOM,40-49,5,4,0,4,5,0,0,9,0,9,Lombardia,ITC4
2021-01-13,PF/BT,STS11/32170226,AMBULATORIO COVID OSP. MILITARE,LOM,50-59,3,4,0,3,4,0,0,7,0,7,Lombardia,ITC4
2021-01-13,PF/BT,STS24,RSA FONDAZIONE ONLUS MONS. A. MAZZALI (MANTOVA),LOM,30-39,0,4,0,4,0,0,0,4,0,4,Lombardia,ITC4
2021-01-13,PF/BT,STS24,RSA FONDAZIONE ONLUS MONS. A. MAZZALI (MANTOVA),LOM,40-49,2,6,0,6,2,0,0,8,0,8,Lombardia,ITC4
2021-01-13,PF/BT,STS24,RSA FONDAZIONE ONLUS MONS. A. MAZZALI (MANTOVA),LOM,50-59,3,8,0,6,5,0,0,11,0,11,Lombardia,ITC4
2021-01-13,PF/BT,STS24,RSA FONDAZIONE ONLUS MONS. A. MAZZALI (MANTOVA),LOM,60-69,0,1,0,1,0,0,0,1,0,1,Lombardia,ITC4
2021-01-14,PF/BT,"""000916""",CASA RIPOSO CITTA' DI SONDRIO,LOM,20-29,0,1,0,1,0,0,0,1,0,1,Lombardia,ITC4
2021-01-14,PF/BT,"""000916""",CASA RIPOSO CITTA' DI SONDRIO,LOM,30-39,0,4,0,4,0,0,0,4,0,4,Lombardia,ITC4
2021-01-14,PF/BT,"""000916""",CASA RIPOSO CITTA' DI SONDRIO,LOM,40-49,1,9,0,10,0,0,0,10,0,10,Lombardia,ITC4
2021-01-14,PF/BT,"""000916""",CASA RIPOSO CITTA' DI SONDRIO,LOM,50-59,1,9,0,9,1,0,0,10,0,10,Lombardia,ITC4
2021-01-14,PF/BT,"""000916""",CASA RIPOSO CITTA' DI SONDRIO,LOM,60-69,0,4,0,2,0,2,0,4,0,4,Lombardia,ITC4
2021-01-14,PF/BT,"""000916""",CASA RIPOSO CITTA' DI SONDRIO,LOM,70-79,3,2,0,0,0,5,0,5,0,5,Lombardia,ITC4
2021-01-14,PF/BT,"""000916""",CASA RIPOSO CITTA' DI SONDRIO,LOM,80-89,3,17,0,0,0,20,0,20,0,20,Lombardia,ITC4
2021-01-14,PF/BT,"""000916""",CASA RIPOSO CITTA' DI SONDRIO,LOM,90+,0,18,0,0,0,18,0,18,0,18,Lombardia,ITC4
2021-01-14,PF/BT,(03027500/001752),PVO Istituto Clinico San Rocco (Spoke),LOM,20-29,1,4,0,5,0,0,0,5,0,5,Lombardia,ITC4
2021-01-14,PF/BT,(03027500/001752),PVO Istituto Clinico San Rocco (Spoke),LOM,30-39,1,1,0,2,0,0,0,2,0,2,Lombardia,ITC4
2021-01-14,PF/BT,(03027500/001752),PVO Istituto Clinico San Rocco (Spoke),LOM,40-49,3,7,0,6,4,0,0,10,0,10,Lombardia,ITC4
2021-01-14,PF/BT,(03027500/001752),PVO Istituto Clinico San Rocco (Spoke),LOM,50-59,3,2,0,2,3,0,0,5,0,5,Lombardia,ITC4
2021-01-14,PF/BT,(03027500/001752),PVO Istituto Clinico San Rocco (Spoke),LOM,60-69,1,1,0,2,0,0,0,2,0,2,Lombardia,ITC4
2021-01-14,PF/BT,.000250,KOS-CARE SRL - RSA SAN LUCA ANNI AZZURRI VIA SAN LUCA 4 – 20122 – MILANO,LOM,30-39,1,0,0,1,0,0,0,1,0,1,Lombardia,ITC4
2021-01-14,PF/BT,.000250,KOS-CARE SRL - RSA SAN LUCA ANNI AZZURRI VIA SAN LUCA 4 – 20122 – MILANO,LOM,40-49,1,0,0,1,0,0,0,1,0,1,Lombardia,ITC4
2021-01-14,PF/BT,.000250,KOS-CARE SRL - RSA SAN LUCA ANNI AZZURRI VIA SAN LUCA 4 – 20122 – MILANO,LOM,60-69,1,1,0,0,0,2,0,2,0,2,Lombardia,ITC4
2021-01-14,PF/BT,.000250,KOS-CARE SRL - RSA SAN LUCA ANNI AZZURRI VIA SAN LUCA 4 – 20122 – MILANO,LOM,70-79,2,0,0,0,0,2,0,2,0,2,Lombardia,ITC4
2021-01-14,PF/BT,.000250,KOS-CARE SRL - RSA SAN LUCA ANNI AZZURRI VIA SAN LUCA 4 – 20122 – MILANO,LOM,80-89,5,16,0,0,0,21,0,21,0,21,Lombardia,ITC4
2021-01-14,PF/BT,.000250,KOS-CARE SRL - RSA SAN LUCA ANNI AZZURRI VIA SAN LUCA 4 – 20122 – MILANO,LOM,90+,4,23,0,0,0,27,0,27,0,27,Lombardia,ITC4
2021-01-14,PF/BT,.002930,RSA SAN VINCENZO - Gravedona Ed Uniti (CO),LOM,30-39,1,2,0,2,1,0,0,3,0,3,Lombardia,ITC4
2021-01-14,PF/BT,.002930,RSA SAN VINCENZO - Gravedona Ed Uniti (CO),LOM,40-49,0,2,0,1,1,0,0,2,0,2,Lombardia,ITC4
2021-01-14,PF/BT,.002930,RSA SAN VINCENZO - Gravedona Ed Uniti (CO),LOM,50-59,3,3,0,1,2,3,0,6,0,6,Lombardia,ITC4
2021-01-14,PF/BT,.002930,RSA SAN VINCENZO - Gravedona Ed Uniti (CO),LOM,60-69,1,4,0,2,1,2,0,5,0,5,Lombardia,ITC4
2021-01-14,PF/BT,.002930,RSA SAN VINCENZO - Gravedona Ed Uniti (CO),LOM,70-79,3,3,0,0,0,6,0,6,0,6,Lombardia,ITC4
2021-01-14,PF/BT,.002930,RSA SAN VINCENZO - Gravedona Ed Uniti (CO),LOM,80-89,4,7,0,0,0,11,0,11,0,11,Lombardia,ITC4
2021-01-14,PF/BT,.002930,RSA SAN VINCENZO - Gravedona Ed Uniti (CO),LOM,90+,1,2,0,0,0,3,0,3,0,3,Lombardia,ITC4
2021-01-14,PF/BT,.030042,ASST VALTELLINA ALTO LARIO - PRESIDIO OSPEDALIERO DI SONDRIO,LOM,20-29,5,5,0,6,4,0,0,10,0,10,Lombardia,ITC4
2021-01-14,PF/BT,.030042,ASST VALTELLINA ALTO LARIO - PRESIDIO OSPEDALIERO DI SONDRIO,LOM,30-39,10,16,0,17,9,0,0,26,0,26,Lombardia,ITC4
2021-01-14,PF/BT,.030042,ASST VALTELLINA ALTO LARIO - PRESIDIO OSPEDALIERO DI SONDRIO,LOM,40-49,12,31,0,33,10,0,0,43,0,43,Lombardia,ITC4
2021-01-14,PF/BT,.030042,ASST VALTELLINA ALTO LARIO - PRESIDIO OSPEDALIERO DI SONDRIO,LOM,50-59,21,49,0,44,26,0,0,70,0,70,Lombardia,ITC4
2021-01-14,PF/BT,.030042,ASST VALTELLINA ALTO LARIO - PRESIDIO OSPEDALIERO DI SONDRIO,LOM,60-69,12,16,0,19,9,0,0,28,0,28,Lombardia,ITC4
2021-01-14,PF/BT,.030042,ASST VALTELLINA ALTO LARIO - PRESIDIO OSPEDALIERO DI SONDRIO,LOM,70-79,2,1,0,3,0,0,0,3,0,3,Lombardia,ITC4
2021-01-14,PF/BT,0,32170224 HUB COVID OSP. SAN CARLO - PVO Ospedale San Carlo,LOM,16-19,1,0,0,0,0,0,1,1,0,1,Lombardia,ITC4
2021-01-14,PF/BT,0,32170224 HUB COVID OSP. SAN CARLO - PVO Ospedale San Carlo,LOM,20-29,16,28,0,21,3,0,20,44,0,44,Lombardia,ITC4
2021-01-14,PF/BT,0,32170224 HUB COVID OSP. SAN CARLO - PVO Ospedale San Carlo,LOM,30-39,18,28,0,12,5,0,29,46,0,46,Lombardia,ITC4
2021-01-14,PF/BT,0,32170224 HUB COVID OSP. SAN CARLO - PVO Ospedale San Carlo,LOM,40-49,27,48,0,23,6,0,46,75,0,75,Lombardia,ITC4
2021-01-14,PF/BT,0,32170224 HUB COVID OSP. SAN CARLO - PVO Ospedale San Carlo,LOM,50-59,33,65,0,38,17,0,43,98,0,98,Lombardia,ITC4
2021-01-14,PF/BT,0,32170224 HUB COVID OSP. SAN CARLO - PVO Ospedale San Carlo,LOM,60-69,15,25,0,16,4,0,20,40,0,40,Lombardia,ITC4
2021-01-14,PF/BT,0,32170224 HUB COVID OSP. SAN CARLO - PVO Ospedale San Carlo,LOM,70-79,1,1,0,2,0,0,0,2,0,2,Lombardia,ITC4
2021-01-14,PF/BT,0,AMBULATORIO COVID PO LODI - RSA FONDAZIONE MADRE CABRINI ONLUS - Sant'Angelo Lodigiano (LO),LOM,60-69,0,2,0,0,0,2,0,2,0,2,Lombardia,ITC4
2021-01-14,PF/BT,0,AMBULATORIO COVID PO LODI - RSA FONDAZIONE MADRE CABRINI ONLUS - Sant'Angelo Lodigiano (LO),LOM,70-79,9,10,0,0,0,19,0,19,0,19,Lombardia,ITC4
2021-01-14,PF/BT,0,AMBULATORIO COVID PO LODI - RSA FONDAZIONE MADRE CABRINI ONLUS - Sant'Angelo Lodigiano (LO),LOM,80-89,18,44,0,0,0,62,0,62,0,62,Lombardia,ITC4
2021-01-14,PF/BT,0,AMBULATORIO COVID PO LODI - RSA FONDAZIONE MADRE CABRINI ONLUS - Sant'Angelo Lodigiano (LO),LOM,90+,5,30,0,0,0,35,0,35,0,35,Lombardia,ITC4
2021-01-14,PF/BT,0,FONDAZIONE CARISMA BERGAMO,LOM,30-39,1,0,0,0,0,1,0,1,0,1,Lombardia,ITC4
2021-01-14,PF/BT,0,FONDAZIONE CARISMA BERGAMO,LOM,40-49,1,0,0,0,0,1,0,1,0,1,Lombardia,ITC4
2021-01-14,PF/BT,0,FONDAZIONE CARISMA BERGAMO,LOM,50-59,0,1,0,0,0,1,0,1,0,1,Lombardia,ITC4
2021-01-14,PF/BT,0,FONDAZIONE CARISMA BERGAMO,LOM,60-69,7,1,0,0,0,8,0,8,0,8,Lombardia,ITC4
2021-01-14,PF/BT,0,FONDAZIONE CARISMA BERGAMO,LOM,70-79,6,6,0,0,0,12,0,12,0,12,Lombardia,ITC4
2021-01-14,PF/BT,0,FONDAZIONE CARISMA BERGAMO,LOM,80-89,4,18,0,0,0,22,0,22,0,22,Lombardia,ITC4
2021-01-14,PF/BT,0,FONDAZIONE CARISMA BERGAMO,LOM,90+,4,10,0,0,0,14,0,14,0,14,Lombardia,ITC4
2021-01-14,PF/BT,0,Fondazione il Girasole Onlus Somma Lombardo,LOM,20-29,3,2,0,5,0,0,0,5,0,5,Lombardia,ITC4
2021-01-14,PF/BT,0,Fondazione il Girasole Onlus Somma Lombardo,LOM,30-39,5,7,0,12,0,0,0,12,0,12,Lombardia,ITC4
2021-01-14,PF/BT,0,Fondazione il Girasole Onlus Somma Lombardo,LOM,40-49,13,13,0,26,0,0,0,26,0,26,Lombardia,ITC4
2021-01-14,PF/BT,0,Fondazione il Girasole Onlus Somma Lombardo,LOM,50-59,2,4,0,6,0,0,0,6,0,6,Lombardia,ITC4
2021-01-14,PF/BT,0,Fondazione il Girasole Onlus Somma Lombardo,LOM,60-69,1,3,0,4,0,0,0,4,0,4,Lombardia,ITC4
2021-01-14,PF/BT,0,Fondazione il Girasole Onlus Somma Lombardo,LOM,70-79,3,10,0,0,0,13,0,13,0,13,Lombardia,ITC4
2021-01-14,PF/BT,0,Fondazione il Girasole Onlus Somma Lombardo,LOM,80-89,7,30,0,0,0,37,0,37,0,37,Lombardia,ITC4
2021-01-14,PF/BT,0,Fondazione il Girasole Onlus Somma Lombardo,LOM,90+,0,5,0,0,0,5,0,5,0,5,Lombardia,ITC4
2021-01-14,PF/BT,0,Istituto Golgi Abbiategrasso,LOM,20-29,1,2,0,3,0,0,0,3,0,3,Lombardia,ITC4
2021-01-14,PF/BT,0,Istituto Golgi Abbiategrasso,LOM,30-39,8,5,0,13,0,0,0,13,0,13,Lombardia,ITC4
2021-01-14,PF/BT,0,Istituto Golgi Abbiategrasso,LOM,40-49,2,6,0,8,0,0,0,8,0,8,Lombardia,ITC4
2021-01-14,PF/BT,0,Istituto Golgi Abbiategrasso,LOM,50-59,5,21,0,26,0,0,0,26,0,26,Lombardia,ITC4
2021-01-14,PF/BT,0,Istituto Golgi Abbiategrasso,LOM,60-69,4,6,0,10,0,0,0,10,0,10,Lombardia,ITC4
2021-01-14,PF/BT,0,Istituto Redaelli Milano,LOM,20-29,1,5,0,6,0,0,0,6,0,6,Lombardia,ITC4
2021-01-14,PF/BT,0,Istituto Redaelli Milano,LOM,30-39,2,5,0,7,0,0,0,7,0,7,Lombardia,ITC4
2021-01-14,PF/BT,0,Istituto Redaelli Milano,LOM,40-49,2,11,0,13,0,0,0,13,0,13,Lombardia,ITC4
2021-01-14,PF/BT,0,Istituto Redaelli Milano,LOM,50-59,3,22,0,25,0,0,0,25,0,25,Lombardia,ITC4
2021-01-14,PF/BT,0,Istituto Redaelli Milano,LOM,60-69,2,7,0,9,0,0,0,9,0,9,Lombardia,ITC4
2021-01-14,PF/BT,0,OPERA CHARITAS S.ANNA - RSA VILLA ENRICA - ALBONESE (PV),LOM,60-69,0,1,0,0,0,1,0,1,0,1,Lombardia,ITC4
2021-01-14,PF/BT,0,OPERA CHARITAS S.ANNA - RSA VILLA ENRICA - ALBONESE (PV),LOM,70-79,0,3,0,0,0,3,0,3,0,3,Lombardia,ITC4
2021-01-14,PF/BT,0,OPERA CHARITAS S.ANNA - RSA VILLA ENRICA - ALBONESE (PV),LOM,80-89,0,5,0,0,0,5,0,5,0,5,Lombardia,ITC4
2021-01-14,PF/BT,0,OPERA CHARITAS S.ANNA - RSA VILLA ENRICA - ALBONESE (PV),LOM,90+,0,9,0,0,0,9,0,9,0,9,Lombardia,ITC4
2021-01-14,PF/BT,0,RSA Casa San Lorenzo Ardenno,LOM,20-29,0,1,0,1,0,0,0,1,0,1,Lombardia,ITC4
2021-01-14,PF/BT,0,RSA Casa San Lorenzo Ardenno,LOM,30-39,0,2,0,2,0,0,0,2,0,2,Lombardia,ITC4
2021-01-14,PF/BT,0,RSA Casa San Lorenzo Ardenno,LOM,40-49,1,8,0,8,1,0,0,9,0,9,Lombardia,ITC4
2021-01-14,PF/BT,0,RSA Casa San Lorenzo Ardenno,LOM,50-59,0,10,0,8,2,0,0,10,0,10,Lombardia,ITC4
2021-01-14,PF/BT,0,RSA Casa San Lorenzo Ardenno,LOM,60-69,0,2,0,1,1,0,0,2,0,2,Lombardia,ITC4
2021-01-14,PF/BT,0,RSA Casa San Lorenzo Ardenno,LOM,70-79,1,1,0,2,0,0,0,2,0,2,Lombardia,ITC4
2021-01-14,PF/BT,0,RSA Casa San Lorenzo Ardenno,LOM,80-89,1,2,0,0,2,1,0,3,0,3,Lombardia,ITC4
2021-01-14,PF/BT,0,RSA Casa San Lorenzo Ardenno,LOM,90+,0,1,0,0,0,1,0,1,0,1,Lombardia,ITC4
2021-01-14,PF/BT,0,RSA MONSIGNOR BORSIERI,LOM,60-69,0,2,0,0,0,2,0,2,0,2,Lombardia,ITC4
2021-01-14,PF/BT,0,RSA MONSIGNOR BORSIERI,LOM,70-79,2,0,0,0,0,2,0,2,0,2,Lombardia,ITC4
2021-01-14,PF/BT,0,RSA MONSIGNOR BORSIERI,LOM,80-89,0,8,0,0,0,8,0,8,0,8,Lombardia,ITC4
2021-01-14,PF/BT,0,RSA MONSIGNOR BORSIERI,LOM,90+,3,9,0,0,0,12,0,12,0,12,Lombardia,ITC4
2021-01-14,PF/BT,000050,Poliambulatorio IRCSS OSPEDALE SAN LUCA,LOM,20-29,2,3,0,4,1,0,0,5,0,5,Lombardia,ITC4
2021-01-14,PF/BT,000050,Poliambulatorio IRCSS OSPEDALE SAN LUCA,LOM,30-39,7,7,0,13,1,0,0,14,0,14,Lombardia,ITC4
2021-01-14,PF/BT,000050,Poliambulatorio IRCSS OSPEDALE SAN LUCA,LOM,40-49,3,7,0,5,5,0,0,10,0,10,Lombardia,ITC4
2021-01-14,PF/BT,000050,Poliambulatorio IRCSS OSPEDALE SAN LUCA,LOM,50-59,4,12,0,8,8,0,0,16,0,16,Lombardia,ITC4
2021-01-14,PF/BT,000050,Poliambulatorio IRCSS OSPEDALE SAN LUCA,LOM,60-69,1,1,0,2,0,0,0,2,0,2,Lombardia,ITC4
2021-01-14,PF/BT,000050,Poliambulatorio IRCSS OSPEDALE SAN LUCA,LOM,70-79,1,0,0,0,1,0,0,1,0,1,Lombardia,ITC4
2021-01-14,PF/BT,000119,POLIAMBULATORIO IRCSS OSPEDALE SAN MICHELE,LOM,30-39,0,2,0,2,0,0,0,2,0,2,Lombardia,ITC4
2021-01-14,PF/BT,000119,POLIAMBULATORIO IRCSS OSPEDALE SAN MICHELE,LOM,50-59,2,5,0,6,1,0,0,7,0,7,Lombardia,ITC4
2021-01-14,PF/BT,000119,POLIAMBULATORIO IRCSS OSPEDALE SAN MICHELE,LOM,60-69,1,0,0,1,0,0,0,1,0,1,Lombardia,ITC4
2021-01-14,PF/BT,000119,POLIAMBULATORIO IRCSS OSPEDALE SAN MICHELE,LOM,70-79,1,1,0,2,0,0,0,2,0,2,Lombardia,ITC4
2021-01-14,PF/BT,000417,POLIAMBULATORIO IRCCS OSPEDALE CAPITANIO,LOM,20-29,3,6,0,7,2,0,0,9,0,9,Lombardia,ITC4
2021-01-14,PF/BT,000417,POLIAMBULATORIO IRCCS OSPEDALE CAPITANIO,LOM,30-39,2,5,0,6,1,0,0,7,0,7,Lombardia,ITC4
2021-01-14,PF/BT,000417,POLIAMBULATORIO IRCCS OSPEDALE CAPITANIO,LOM,40-49,4,12,0,8,8,0,0,16,0,16,Lombardia,ITC4
2021-01-14,PF/BT,000417,POLIAMBULATORIO IRCCS OSPEDALE CAPITANIO,LOM,50-59,3,10,0,8,5,0,0,13,0,13,Lombardia,ITC4
2021-01-14,PF/BT,000417,POLIAMBULATORIO IRCCS OSPEDALE CAPITANIO,LOM,60-69,0,2,0,1,1,0,0,2,0,2,Lombardia,ITC4
2021-01-14,PF/BT,000417,POLIAMBULATORIO IRCCS OSPEDALE CAPITANIO,LOM,80-89,1,0,0,1,0,0,0,1,0,1,Lombardia,ITC4
2021-01-14,PF/BT,000427,CENTRO DIAGNOSTICO PIOLTELLO,LOM,20-29,1,0,0,1,0,0,0,1,0,1,Lombardia,ITC4
2021-01-14,PF/BT,000427,CENTRO DIAGNOSTICO PIOLTELLO,LOM,30-39,0,6,0,2,4,0,0,6,0,6,Lombardia,ITC4
2021-01-14,PF/BT,000427,CENTRO DIAGNOSTICO PIOLTELLO,LOM,40-49,0,3,0,3,0,0,0,3,0,3,Lombardia,ITC4
2021-01-14,PF/BT,000427,CENTRO DIAGNOSTICO PIOLTELLO,LOM,50-59,1,0,0,1,0,0,0,1,0,1,Lombardia,ITC4
2021-01-14,PF/BT,000427,CENTRO DIAGNOSTICO PIOLTELLO,LOM,60-69,1,0,0,1,0,0,0,1,0,1,Lombardia,ITC4
2021-01-14,PF/BT,000921,FONDAZIONE CASA DI RIPOSO CITTA' DI TIRANO ONLUS,LOM,20-29,0,1,0,1,0,0,0,1,0,1,Lombardia,ITC4
2021-01-14,PF/BT,000921,FONDAZIONE CASA DI RIPOSO CITTA' DI TIRANO ONLUS,LOM,30-39,0,4,0,4,0,0,0,4,0,4,Lombardia,ITC4
2021-01-14,PF/BT,000921,FONDAZIONE CASA DI RIPOSO CITTA' DI TIRANO ONLUS,LOM,40-49,0,7,0,7,0,0,0,7,0,7,Lombardia,ITC4
2021-01-14,PF/BT,000921,FONDAZIONE CASA DI RIPOSO CITTA' DI TIRANO ONLUS,LOM,50-59,0,12,0,12,0,0,0,12,0,12,Lombardia,ITC4
2021-01-14,PF/BT,000921,FONDAZIONE CASA DI RIPOSO CITTA' DI TIRANO ONLUS,LOM,60-69,0,6,0,6,0,0,0,6,0,6,Lombardia,ITC4
2021-01-14,PF/BT,000928,RSA FONDAZIONE VISCONTI VENOSTA GROSIO,LOM,20-29,0,4,0,4,0,0,0,4,0,4,Lombardia,ITC4
2021-01-14,PF/BT,000928,RSA FONDAZIONE VISCONTI VENOSTA GROSIO,LOM,30-39,0,2,0,2,0,0,0,2,0,2,Lombardia,ITC4
2021-01-14,PF/BT,000928,RSA FONDAZIONE VISCONTI VENOSTA GROSIO,LOM,40-49,1,6,0,6,0,1,0,7,0,7,Lombardia,ITC4
2021-01-14,PF/BT,000928,RSA FONDAZIONE VISCONTI VENOSTA GROSIO,LOM,50-59,1,8,0,4,2,3,0,9,0,9,Lombardia,ITC4
2021-01-14,PF/BT,000928,RSA FONDAZIONE VISCONTI VENOSTA GROSIO,LOM,60-69,1,6,0,2,3,2,0,7,0,7,Lombardia,ITC4
2021-01-14,PF/BT,000928,RSA FONDAZIONE VISCONTI VENOSTA GROSIO,LOM,70-79,2,2,0,1,0,3,0,4,0,4,Lombardia,ITC4
2021-01-14,PF/BT,000928,RSA FONDAZIONE VISCONTI VENOSTA GROSIO,LOM,80-89,3,11,0,0,0,14,0,14,0,14,Lombardia,ITC4
2021-01-14,PF/BT,000928,RSA FONDAZIONE VISCONTI VENOSTA GROSIO,LOM,90+,1,12,0,0,0,13,0,13,0,13,Lombardia,ITC4
2021-01-14,PF/BT,000961,RSA BAITA SERENA,LOM,40-49,0,4,0,2,1,1,0,4,0,4,Lombardia,ITC4
2021-01-14,PF/BT,000961,RSA BAITA SERENA,LOM,50-59,1,3,0,2,1,1,0,4,0,4,Lombardia,ITC4
2021-01-14,PF/BT,000961,RSA BAITA SERENA,LOM,70-79,3,2,0,0,0,5,0,5,0,5,Lombardia,ITC4
2021-01-14,PF/BT,000961,RSA BAITA SERENA,LOM,80-89,1,12,0,0,0,13,0,13,0,13,Lombardia,ITC4
2021-01-14,PF/BT,000961,RSA BAITA SERENA,LOM,90+,1,9,0,0,0,10,0,10,0,10,Lombardia,ITC4
2021-01-14,PF/BT,001020,CENTRO DIAGNOSTICO MEDA,LOM,20-29,0,1,0,1,0,0,0,1,0,1,Lombardia,ITC4
2021-01-14,PF/BT,001020,CENTRO DIAGNOSTICO MEDA,LOM,30-39,3,5,0,3,5,0,0,8,0,8,Lombardia,ITC4
2021-01-14,PF/BT,001020,CENTRO DIAGNOSTICO MEDA,LOM,40-49,1,5,0,2,4,0,0,6,0,6,Lombardia,ITC4
2021-01-14,PF/BT,001020,CENTRO DIAGNOSTICO MEDA,LOM,50-59,1,5,0,2,4,0,0,6,0,6,Lombardia,ITC4
2021-01-14,PF/BT,001020,CENTRO DIAGNOSTICO MEDA,LOM,60-69,2,0,0,2,0,0,0,2,0,2,Lombardia,ITC4
2021-01-14,PF/BT,001020,CENTRO DIAGNOSTICO MEDA,LOM,70-79,1,0,0,1,0,0,0,1,0,1,Lombardia,ITC4
2021-01-14,PF/BT,001861,CASA FAMIGLIA PADRE F. SPINELLI DI RIVOLTA D'ADDA,LOM,20-29,0,3,0,2,1,0,0,3,0,3,Lombardia,ITC4
2021-01-14,PF/BT,001861,CASA FAMIGLIA PADRE F. SPINELLI DI RIVOLTA D'ADDA,LOM,30-39,1,5,0,5,1,0,0,6,0,6,Lombardia,ITC4
2021-01-14,PF/BT,001861,CASA FAMIGLIA PADRE F. SPINELLI DI RIVOLTA D'ADDA,LOM,40-49,1,14,0,11,4,0,0,15,0,15,Lombardia,ITC4
2021-01-14,PF/BT,001861,CASA FAMIGLIA PADRE F. SPINELLI DI RIVOLTA D'ADDA,LOM,50-59,1,11,0,9,3,0,0,12,0,12,Lombardia,ITC4
2021-01-14,PF/BT,001861,CASA FAMIGLIA PADRE F. SPINELLI DI RIVOLTA D'ADDA,LOM,70-79,2,0,0,0,0,2,0,2,0,2,Lombardia,ITC4
2021-01-14,PF/BT,001861,CASA FAMIGLIA PADRE F. SPINELLI DI RIVOLTA D'ADDA,LOM,80-89,1,4,0,0,0,5,0,5,0,5,Lombardia,ITC4
2021-01-14,PF/BT,001861,CASA FAMIGLIA PADRE F. SPINELLI DI RIVOLTA D'ADDA,LOM,90+,1,4,0,0,0,5,0,5,0,5,Lombardia,ITC4
2021-01-14,PF/BT,001874,FONDAZIONE SAN BIAGIO ONLUS,LOM,40-49,0,1,0,1,0,0,0,1,0,1,Lombardia,ITC4
2021-01-14,PF/BT,001874,FONDAZIONE SAN BIAGIO ONLUS,LOM,70-79,2,1,0,0,0,3,0,3,0,3,Lombardia,ITC4
2021-01-14,PF/BT,001874,FONDAZIONE SAN BIAGIO ONLUS,LOM,80-89,0,12,0,0,0,12,0,12,0,12,Lombardia,ITC4
2021-01-14,PF/BT,001874,FONDAZIONE SAN BIAGIO ONLUS,LOM,90+,0,8,0,0,0,8,0,8,0,8,Lombardia,ITC4
2021-01-14,PF/BT,001995,"Fondazione ""Tosi/Cippelletti di Rivarolo Mantovano"" Onlus",LOM,60-69,3,0,0,0,0,3,0,3,0,3,Lombardia,ITC4
2021-01-14,PF/BT,001995,"Fondazione ""Tosi/Cippelletti di Rivarolo Mantovano"" Onlus",LOM,70-79,2,2,0,0,0,4,0,4,0,4,Lombardia,ITC4
2021-01-14,PF/BT,001995,"Fondazione ""Tosi/Cippelletti di Rivarolo Mantovano"" Onlus",LOM,80-89,2,14,0,0,0,16,0,16,0,16,Lombardia,ITC4
2021-01-14,PF/BT,001995,"Fondazione ""Tosi/Cippelletti di Rivarolo Mantovano"" Onlus",LOM,90+,2,10,0,0,0,12,0,12,0,12,Lombardia,ITC4
2021-01-14,PF/BT,00290,LA PICCOLA CASA DEL RIFUGIO,LOM,30-39,0,1,0,1,0,0,0,1,0,1,Lombardia,ITC4
2021-01-14,PF/BT,00290,LA PICCOLA CASA DEL RIFUGIO,LOM,40-49,1,0,0,1,0,0,0,1,0,1,Lombardia,ITC4
2021-01-14,PF/BT,00290,LA PICCOLA CASA DEL RIFUGIO,LOM,50-59,5,2,0,6,0,1,0,7,0,7,Lombardia,ITC4
2021-01-14,PF/BT,00290,LA PICCOLA CASA DEL RIFUGIO,LOM,60-69,3,1,0,2,0,2,0,4,0,4,Lombardia,ITC4
2021-01-14,PF/BT,00290,LA PICCOLA CASA DEL RIFUGIO,LOM,70-79,6,3,0,0,0,9,0,9,0,9,Lombardia,ITC4
2021-01-14,PF/BT,00290,LA PICCOLA CASA DEL RIFUGIO,LOM,80-89,16,3,0,0,0,18,1,19,0,19,Lombardia,ITC4
2021-01-14,PF/BT,00290,LA PICCOLA CASA DEL RIFUGIO,LOM,90+,18,1,0,0,0,19,0,19,0,19,Lombardia,ITC4
2021-01-14,PF/BT,002982,POLIAMBULATORI OSP. DI EDOLO,LOM,20-29,2,0,0,1,1,0,0,2,0,2,Lombardia,ITC4
2021-01-14,PF/BT,002982,POLIAMBULATORI OSP. DI EDOLO,LOM,30-39,1,5,0,1,5,0,0,6,0,6,Lombardia,ITC4
2021-01-14,PF/BT,002982,POLIAMBULATORI OSP. DI EDOLO,LOM,40-49,4,25,0,15,14,0,0,29,0,29,Lombardia,ITC4
2021-01-14,PF/BT,002982,POLIAMBULATORI OSP. DI EDOLO,LOM,50-59,2,27,0,15,14,0,0,29,0,29,Lombardia,ITC4
2021-01-14,PF/BT,002982,POLIAMBULATORI OSP. DI EDOLO,LOM,60-69,2,7,0,1,8,0,0,9,0,9,Lombardia,ITC4
2021-01-14,PF/BT,002982,POLIAMBULATORI OSP. DI EDOLO,LOM,80-89,1,0,0,0,1,0,0,1,0,1,Lombardia,ITC4
2021-01-14,PF/BT,002987,POLIAMBULATORIO OSPEDALE ESINE,LOM,20-29,4,7,0,7,4,0,0,11,0,11,Lombardia,ITC4
2021-01-14,PF/BT,002987,POLIAMBULATORIO OSPEDALE ESINE,LOM,30-39,2,7,0,7,2,0,0,9,0,9,Lombardia,ITC4
2021-01-14,PF/BT,002987,POLIAMBULATORIO OSPEDALE ESINE,LOM,40-49,1,12,0,8,5,0,0,13,0,13,Lombardia,ITC4
2021-01-14,PF/BT,002987,POLIAMBULATORIO OSPEDALE ESINE,LOM,50-59,7,17,0,17,7,0,0,24,0,24,Lombardia,ITC4
2021-01-14,PF/BT,002987,POLIAMBULATORIO OSPEDALE ESINE,LOM,60-69,3,4,0,4,3,0,0,7,0,7,Lombardia,ITC4
2021-01-14,PF/BT,002987,POLIAMBULATORIO OSPEDALE ESINE,LOM,70-79,2,0,0,0,2,0,0,2,0,2,Lombardia,ITC4
2021-01-14,PF/BT,003335,HUB COV CHIARI - P.O. CHIARI ASST FRANCIACORTA,LOM,50-59,2,1,0,1,2,0,0,3,0,3,Lombardia,ITC4
2021-01-14,PF/BT,003335,HUB COV CHIARI - P.O. CHIARI ASST FRANCIACORTA,LOM,60-69,3,0,0,2,1,0,0,3,0,3,Lombardia,ITC4
2021-01-14,PF/BT,030 - 322 - 002821,RSA Via Brambilla,LOM,20-29,3,2,0,2,3,0,0,5,0,5,Lombardia,ITC4
2021-01-14,PF/BT,030 - 322 - 002821,RSA Via Brambilla,LOM,30-39,3,5,0,7,1,0,0,8,0,8,Lombardia,ITC4
2021-01-14,PF/BT,030 - 322 - 002821,RSA Via Brambilla,LOM,40-49,1,12,0,9,4,0,0,13,0,13,Lombardia,ITC4
2021-01-14,PF/BT,030 - 322 - 002821,RSA Via Brambilla,LOM,50-59,11,8,0,8,11,0,0,19,0,19,Lombardia,ITC4
2021-01-14,PF/BT,030 - 322 - 002821,RSA Via Brambilla,LOM,60-69,2,1,0,3,0,0,0,3,0,3,Lombardia,ITC4
2021-01-14,PF/BT,030017,Istituto clinico Casa di cura Mater Domini -Castellanza,LOM,20-29,4,24,0,14,14,0,0,28,0,28,Lombardia,ITC4
2021-01-14,PF/BT,030017,Istituto clinico Casa di cura Mater Domini -Castellanza,LOM,30-39,5,27,0,23,9,0,0,32,0,32,Lombardia,ITC4
2021-01-14,PF/BT,030017,Istituto clinico Casa di cura Mater Domini -Castellanza,LOM,40-49,11,34,0,29,16,0,0,45,0,45,Lombardia,ITC4
2021-01-14,PF/BT,030017,Istituto clinico Casa di cura Mater Domini -Castellanza,LOM,50-59,3,20,0,20,3,0,0,23,0,23,Lombardia,ITC4
2021-01-14,PF/BT,030017,Istituto clinico Casa di cura Mater Domini -Castellanza,LOM,60-69,9,6,0,9,6,0,0,15,0,15,Lombardia,ITC4
2021-01-14,PF/BT,030017,Istituto clinico Casa di cura Mater Domini -Castellanza,LOM,70-79,1,0,0,1,0,0,0,1,0,1,Lombardia,ITC4
2021-01-14,PF/BT,030030,OSPEDALE VALDUCE-AMBULATORIO VACCINALE COVID,LOM,20-29,6,19,0,24,1,0,0,25,0,25,Lombardia,ITC4
2021-01-14,PF/BT,030030,OSPEDALE VALDUCE-AMBULATORIO VACCINALE COVID,LOM,30-39,7,20,0,27,0,0,0,27,0,27,Lombardia,ITC4
2021-01-14,PF/BT,030030,OSPEDALE VALDUCE-AMBULATORIO VACCINALE COVID,LOM,40-49,5,34,0,37,2,0,0,39,0,39,Lombardia,ITC4
2021-01-14,PF/BT,030030,OSPEDALE VALDUCE-AMBULATORIO VACCINALE COVID,LOM,50-59,11,44,0,53,2,0,0,55,0,55,Lombardia,ITC4
2021-01-14,PF/BT,030030,OSPEDALE VALDUCE-AMBULATORIO VACCINALE COVID,LOM,60-69,8,6,0,13,0,0,1,14,0,14,Lombardia,ITC4
2021-01-14,PF/BT,030030,OSPEDALE VALDUCE-AMBULATORIO VACCINALE COVID,LOM,70-79,1,1,0,1,0,0,1,2,0,2,Lombardia,ITC4
2021-01-14,PF/BT,030035,C.O.F. LANZO HOSPITAL - ALTA VALLE INTELVI,LOM,20-29,2,1,0,2,1,0,0,3,0,3,Lombardia,ITC4
2021-01-14,PF/BT,030035,C.O.F. LANZO HOSPITAL - ALTA VALLE INTELVI,LOM,30-39,2,2,0,3,1,0,0,4,0,4,Lombardia,ITC4
2021-01-14,PF/BT,030035,C.O.F. LANZO HOSPITAL - ALTA VALLE INTELVI,LOM,40-49,3,5,0,7,1,0,0,8,0,8,Lombardia,ITC4
2021-01-14,PF/BT,030035,C.O.F. LANZO HOSPITAL - ALTA VALLE INTELVI,LOM,50-59,5,6,0,9,2,0,0,11,0,11,Lombardia,ITC4
2021-01-14,PF/BT,030035,C.O.F. LANZO HOSPITAL - ALTA VALLE INTELVI,LOM,60-69,1,1,0,2,0,0,0,2,0,2,Lombardia,ITC4
2021-01-14,PF/BT,030035,C.O.F. LANZO HOSPITAL - ALTA VALLE INTELVI,LOM,70-79,2,0,0,2,0,0,0,2,0,2,Lombardia,ITC4
2021-01-14,PF/BT,030037,CASA DI CURA VILLA SAN BENEDETTO,LOM,20-29,0,1,0,1,0,0,0,1,0,1,Lombardia,ITC4
2021-01-14,PF/BT,030037,CASA DI CURA VILLA SAN BENEDETTO,LOM,30-39,1,5,0,6,0,0,0,6,0,6,Lombardia,ITC4
2021-01-14,PF/BT,030037,CASA DI CURA VILLA SAN BENEDETTO,LOM,40-49,0,4,0,2,2,0,0,4,0,4,Lombardia,ITC4
2021-01-14,PF/BT,030037,CASA DI CURA VILLA SAN BENEDETTO,LOM,50-59,0,3,0,3,0,0,0,3,0,3,Lombardia,ITC4
2021-01-14,PF/BT,030037,CASA DI CURA VILLA SAN BENEDETTO,LOM,60-69,1,3,0,4,0,0,0,4,0,4,Lombardia,ITC4
2021-01-14,PF/BT,030066,CV Garbagnate,LOM,20-29,2,5,0,3,4,0,0,7,0,7,Lombardia,ITC4
2021-01-14,PF/BT,030066,CV Garbagnate,LOM,30-39,7,8,0,13,2,0,0,15,0,15,Lombardia,ITC4
2021-01-14,PF/BT,030066,CV Garbagnate,LOM,40-49,4,8,0,8,4,0,0,12,0,12,Lombardia,ITC4
2021-01-14,PF/BT,030066,CV Garbagnate,LOM,50-59,6,19,0,24,1,0,0,25,0,25,Lombardia,ITC4
2021-01-14,PF/BT,030066,CV Garbagnate,LOM,60-69,3,10,0,9,4,0,0,13,0,13,Lombardia,ITC4
2021-01-14,PF/BT,030068,PUNTO VACCINALE OSPEDALIERO DESIO,LOM,16-19,1,1,0,2,0,0,0,2,0,2,Lombardia,ITC4
2021-01-14,PF/BT,030068,PUNTO VACCINALE OSPEDALIERO DESIO,LOM,20-29,8,11,0,17,2,0,0,19,0,19,Lombardia,ITC4
2021-01-14,PF/BT,030068,PUNTO VACCINALE OSPEDALIERO DESIO,LOM,30-39,7,14,0,17,4,0,0,21,0,21,Lombardia,ITC4
2021-01-14,PF/BT,030068,PUNTO VACCINALE OSPEDALIERO DESIO,LOM,40-49,11,34,0,35,10,0,0,45,0,45,Lombardia,ITC4
2021-01-14,PF/BT,030068,PUNTO VACCINALE OSPEDALIERO DESIO,LOM,50-59,14,58,0,52,20,0,0,72,0,72,Lombardia,ITC4
2021-01-14,PF/BT,030068,PUNTO VACCINALE OSPEDALIERO DESIO,LOM,60-69,13,26,0,32,7,0,0,39,0,39,Lombardia,ITC4
2021-01-14,PF/BT,030068,PUNTO VACCINALE OSPEDALIERO DESIO,LOM,70-79,6,5,0,8,3,0,0,11,0,11,Lombardia,ITC4
2021-01-14,PF/BT,030070,PUNTO VACCINALE OSPEDALIERO CARATE BRIANZA,LOM,20-29,3,6,0,6,3,0,0,9,0,9,Lombardia,ITC4
2021-01-14,PF/BT,030070,PUNTO VACCINALE OSPEDALIERO CARATE BRIANZA,LOM,30-39,3,17,0,16,4,0,0,20,0,20,Lombardia,ITC4
2021-01-14,PF/BT,030070,PUNTO VACCINALE OSPEDALIERO CARATE BRIANZA,LOM,40-49,6,21,0,23,4,0,0,27,0,27,Lombardia,ITC4
2021-01-14,PF/BT,030070,PUNTO VACCINALE OSPEDALIERO CARATE BRIANZA,LOM,50-59,15,43,0,39,19,0,0,58,0,58,Lombardia,ITC4
2021-01-14,PF/BT,030070,PUNTO VACCINALE OSPEDALIERO CARATE BRIANZA,LOM,60-69,8,12,0,16,4,0,0,20,0,20,Lombardia,ITC4
2021-01-14,PF/BT,030070,PUNTO VACCINALE OSPEDALIERO CARATE BRIANZA,LOM,70-79,5,0,0,5,0,0,0,5,0,5,Lombardia,ITC4
2021-01-14,PF/BT,030078,PUNTO VACCINALE OSPEDALIERO VIMERCATE,LOM,16-19,0,1,0,1,0,0,0,1,0,1,Lombardia,ITC4
2021-01-14,PF/BT,030078,PUNTO VACCINALE OSPEDALIERO VIMERCATE,LOM,20-29,4,10,0,14,0,0,0,14,0,14,Lombardia,ITC4
2021-01-14,PF/BT,030078,PUNTO VACCINALE OSPEDALIERO VIMERCATE,LOM,30-39,10,16,0,18,8,0,0,26,0,26,Lombardia,ITC4
2021-01-14,PF/BT,030078,PUNTO VACCINALE OSPEDALIERO VIMERCATE,LOM,40-49,7,31,0,31,7,0,0,38,0,38,Lombardia,ITC4
2021-01-14,PF/BT,030078,PUNTO VACCINALE OSPEDALIERO VIMERCATE,LOM,50-59,11,50,0,33,28,0,0,61,0,61,Lombardia,ITC4
2021-01-14,PF/BT,030078,PUNTO VACCINALE OSPEDALIERO VIMERCATE,LOM,60-69,15,23,0,29,9,0,0,38,0,38,Lombardia,ITC4
2021-01-14,PF/BT,030078,PUNTO VACCINALE OSPEDALIERO VIMERCATE,LOM,70-79,6,4,0,10,0,0,0,10,0,10,Lombardia,ITC4
2021-01-14,PF/BT,030078,PUNTO VACCINALE OSPEDALIERO VIMERCATE,LOM,80-89,1,3,0,3,1,0,0,4,0,4,Lombardia,ITC4
2021-01-14,PF/BT,030097,ISTITUTO CLINICO CITTA' STUDI - MILANO,LOM,20-29,3,9,0,12,0,0,0,12,0,12,Lombardia,ITC4
2021-01-14,PF/BT,030097,ISTITUTO CLINICO CITTA' STUDI - MILANO,LOM,30-39,7,11,0,15,3,0,0,18,0,18,Lombardia,ITC4
2021-01-14,PF/BT,030097,ISTITUTO CLINICO CITTA' STUDI - MILANO,LOM,40-49,8,17,0,20,5,0,0,25,0,25,Lombardia,ITC4
2021-01-14,PF/BT,030097,ISTITUTO CLINICO CITTA' STUDI - MILANO,LOM,50-59,14,12,0,22,4,0,0,26,0,26,Lombardia,ITC4
2021-01-14,PF/BT,030097,ISTITUTO CLINICO CITTA' STUDI - MILANO,LOM,60-69,8,5,0,12,1,0,0,13,0,13,Lombardia,ITC4
2021-01-14,PF/BT,030097,ISTITUTO CLINICO CITTA' STUDI - MILANO,LOM,70-79,2,0,0,2,0,0,0,2,0,2,Lombardia,ITC4
2021-01-14,PF/BT,030107,ISTITUTI CLINICI ZUCCHI - PRESIDIO DI MONZA,LOM,20-29,1,0,0,1,0,0,0,1,0,1,Lombardia,ITC4
2021-01-14,PF/BT,030107,ISTITUTI CLINICI ZUCCHI - PRESIDIO DI MONZA,LOM,30-39,1,0,0,1,0,0,0,1,0,1,Lombardia,ITC4
2021-01-14,PF/BT,030107,ISTITUTI CLINICI ZUCCHI - PRESIDIO DI MONZA,LOM,40-49,0,2,0,2,0,0,0,2,0,2,Lombardia,ITC4
2021-01-14,PF/BT,030107,ISTITUTI CLINICI ZUCCHI - PRESIDIO DI MONZA,LOM,50-59,0,1,0,1,0,0,0,1,0,1,Lombardia,ITC4
2021-01-14,PF/BT,030107,ISTITUTI CLINICI ZUCCHI - PRESIDIO DI MONZA,LOM,60-69,1,0,0,1,0,0,0,1,0,1,Lombardia,ITC4
2021-01-14,PF/BT,030108,ISTITUTI CLINICI ZUCCHI - PRESIDIO DI CARATE BRIANZA,LOM,16-19,5,3,0,8,0,0,0,8,0,8,Lombardia,ITC4
2021-01-14,PF/BT,030108,ISTITUTI CLINICI ZUCCHI - PRESIDIO DI CARATE BRIANZA,LOM,20-29,37,24,0,61,0,0,0,61,0,61,Lombardia,ITC4
2021-01-14,PF/BT,030108,ISTITUTI CLINICI ZUCCHI - PRESIDIO DI CARATE BRIANZA,LOM,30-39,3,2,0,5,0,0,0,5,0,5,Lombardia,ITC4
2021-01-14,PF/BT,030108,ISTITUTI CLINICI ZUCCHI - PRESIDIO DI CARATE BRIANZA,LOM,40-49,0,4,0,4,0,0,0,4,0,4,Lombardia,ITC4
2021-01-14,PF/BT,030108,ISTITUTI CLINICI ZUCCHI - PRESIDIO DI CARATE BRIANZA,LOM,50-59,0,5,0,5,0,0,0,5,0,5,Lombardia,ITC4
2021-01-14,PF/BT,030108,ISTITUTI CLINICI ZUCCHI - PRESIDIO DI CARATE BRIANZA,LOM,60-69,0,1,0,1,0,0,0,1,0,1,Lombardia,ITC4
2021-01-14,PF/BT,030121,Humanitas Mirasole Pio X,LOM,20-29,3,6,0,9,0,0,0,9,0,9,Lombardia,ITC4
2021-01-14,PF/BT,030121,Humanitas Mirasole Pio X,LOM,30-39,4,3,0,7,0,0,0,7,0,7,Lombardia,ITC4
2021-01-14,PF/BT,030121,Humanitas Mirasole Pio X,LOM,40-49,10,6,0,16,0,0,0,16,0,16,Lombardia,ITC4
2021-01-14,PF/BT,030121,Humanitas Mirasole Pio X,LOM,50-59,2,10,0,12,0,0,0,12,0,12,Lombardia,ITC4
2021-01-14,PF/BT,030121,Humanitas Mirasole Pio X,LOM,60-69,6,0,0,6,0,0,0,6,0,6,Lombardia,ITC4
2021-01-14,PF/BT,030121,Humanitas Mirasole Pio X,LOM,70-79,2,1,0,3,0,0,0,3,0,3,Lombardia,ITC4
2021-01-14,PF/BT,030178,ISTITUTO CLINICO CITTA' DI BRESCIA DI ISTITUTI OSPEDALIERI BRESCIANI,LOM,30-39,0,1,0,1,0,0,0,1,0,1,Lombardia,ITC4
2021-01-14,PF/BT,030178,ISTITUTO CLINICO CITTA' DI BRESCIA DI ISTITUTI OSPEDALIERI BRESCIANI,LOM,40-49,5,5,0,9,1,0,0,10,0,10,Lombardia,ITC4
2021-01-14,PF/BT,030178,ISTITUTO CLINICO CITTA' DI BRESCIA DI ISTITUTI OSPEDALIERI BRESCIANI,LOM,50-59,5,3,0,5,3,0,0,8,0,8,Lombardia,ITC4
2021-01-14,PF/BT,030178,ISTITUTO CLINICO CITTA' DI BRESCIA DI ISTITUTI OSPEDALIERI BRESCIANI,LOM,60-69,2,2,0,4,0,0,0,4,0,4,Lombardia,ITC4
2021-01-14,PF/BT,030178,ISTITUTO CLINICO CITTA' DI BRESCIA DI ISTITUTI OSPEDALIERI BRESCIANI,LOM,80-89,1,0,0,1,0,0,0,1,0,1,Lombardia,ITC4
2021-01-14,PF/BT,03019800,ISTITUTO CLINICO BEATO MATTEO,LOM,20-29,2,6,0,8,0,0,0,8,0,8,Lombardia,ITC4
2021-01-14,PF/BT,03019800,ISTITUTO CLINICO BEATO MATTEO,LOM,30-39,1,1,0,2,0,0,0,2,0,2,Lombardia,ITC4
2021-01-14,PF/BT,03019800,ISTITUTO CLINICO BEATO MATTEO,LOM,40-49,8,7,0,12,3,0,0,15,0,15,Lombardia,ITC4
2021-01-14,PF/BT,03019800,ISTITUTO CLINICO BEATO MATTEO,LOM,50-59,5,13,0,17,1,0,0,18,0,18,Lombardia,ITC4
2021-01-14,PF/BT,03019800,ISTITUTO CLINICO BEATO MATTEO,LOM,60-69,7,3,0,8,2,0,0,10,0,10,Lombardia,ITC4
2021-01-14,PF/BT,03019800,ISTITUTO CLINICO BEATO MATTEO,LOM,70-79,1,0,0,1,0,0,0,1,0,1,Lombardia,ITC4
2021-01-14,PF/BT,03020200,ISTITUTO DI CURA CITTA' DI PAVIA,LOM,20-29,1,3,0,4,0,0,0,4,0,4,Lombardia,ITC4
2021-01-14,PF/BT,03020200,ISTITUTO DI CURA CITTA' DI PAVIA,LOM,30-39,1,0,0,1,0,0,0,1,0,1,Lombardia,ITC4
2021-01-14,PF/BT,03020200,ISTITUTO DI CURA CITTA' DI PAVIA,LOM,40-49,1,10,0,10,1,0,0,11,0,11,Lombardia,ITC4
2021-01-14,PF/BT,03020200,ISTITUTO DI CURA CITTA' DI PAVIA,LOM,50-59,0,5,0,5,0,0,0,5,0,5,Lombardia,ITC4
2021-01-14,PF/BT,03020200,ISTITUTO DI CURA CITTA' DI PAVIA,LOM,60-69,2,1,0,1,2,0,0,3,0,3,Lombardia,ITC4
2021-01-14,PF/BT,030295,Fondazione Poliambulanza - Brescia,LOM,20-29,6,19,0,19,6,0,0,25,0,25,Lombardia,ITC4
2021-01-14,PF/BT,030295,Fondazione Poliambulanza - Brescia,LOM,30-39,9,23,0,24,8,0,0,32,0,32,Lombardia,ITC4
2021-01-14,PF/BT,030295,Fondazione Poliambulanza - Brescia,LOM,40-49,25,36,0,42,19,0,0,61,0,61,Lombardia,ITC4
2021-01-14,PF/BT,030295,Fondazione Poliambulanza - Brescia,LOM,50-59,10,31,0,31,10,0,0,41,0,41,Lombardia,ITC4
2021-01-14,PF/BT,030295,Fondazione Poliambulanza - Brescia,LOM,60-69,5,3,0,7,1,0,0,8,0,8,Lombardia,ITC4
2021-01-14,PF/BT,030295,Fondazione Poliambulanza - Brescia,LOM,70-79,0,1,0,0,1,0,0,1,0,1,Lombardia,ITC4
2021-01-14,PF/BT,030321000265,ISTITUTO MONS. LUIGI BIRAGHI,LOM,20-29,1,1,0,2,0,0,0,2,0,2,Lombardia,ITC4
2021-01-14,PF/BT,030321000265,ISTITUTO MONS. LUIGI BIRAGHI,LOM,30-39,0,2,0,2,0,0,0,2,0,2,Lombardia,ITC4
2021-01-14,PF/BT,030321000265,ISTITUTO MONS. LUIGI BIRAGHI,LOM,40-49,0,10,0,9,1,0,0,10,0,10,Lombardia,ITC4
2021-01-14,PF/BT,030321000265,ISTITUTO MONS. LUIGI BIRAGHI,LOM,50-59,1,8,0,9,0,0,0,9,0,9,Lombardia,ITC4
2021-01-14,PF/BT,030321000265,ISTITUTO MONS. LUIGI BIRAGHI,LOM,60-69,0,2,0,2,0,0,0,2,0,2,Lombardia,ITC4
2021-01-14,PF/BT,030321000265,ISTITUTO MONS. LUIGI BIRAGHI,LOM,80-89,1,6,0,0,0,7,0,7,0,7,Lombardia,ITC4
2021-01-14,PF/BT,030321000265,ISTITUTO MONS. LUIGI BIRAGHI,LOM,90+,0,4,0,0,0,4,0,4,0,4,Lombardia,ITC4
2021-01-14,PF/BT,030-322-030032,Istituto Clinico Villa Aprica,LOM,20-29,1,2,0,3,0,0,0,3,0,3,Lombardia,ITC4
2021-01-14,PF/BT,030-322-030032,Istituto Clinico Villa Aprica,LOM,30-39,2,5,0,7,0,0,0,7,0,7,Lombardia,ITC4
2021-01-14,PF/BT,030-322-030032,Istituto Clinico Villa Aprica,LOM,40-49,4,9,0,13,0,0,0,13,0,13,Lombardia,ITC4
2021-01-14,PF/BT,030-322-030032,Istituto Clinico Villa Aprica,LOM,50-59,6,6,0,12,0,0,0,12,0,12,Lombardia,ITC4
2021-01-14,PF/BT,030-322-030032,Istituto Clinico Villa Aprica,LOM,60-69,5,2,0,7,0,0,0,7,0,7,Lombardia,ITC4
2021-01-14,PF/BT,030324001093 -  030324001116,ISTIT.RIUNITI AIROLDI E MUZZI,LOM,20-29,1,7,0,6,1,1,0,8,0,8,Lombardia,ITC4
2021-01-14,PF/BT,030324001093 -  030324001116,ISTIT.RIUNITI AIROLDI E MUZZI,LOM,30-39,0,4,0,3,1,0,0,4,0,4,Lombardia,ITC4
2021-01-14,PF/BT,030324001093 -  030324001116,ISTIT.RIUNITI AIROLDI E MUZZI,LOM,40-49,4,7,0,8,1,0,2,11,0,11,Lombardia,ITC4
2021-01-14,PF/BT,030324001093 -  030324001116,ISTIT.RIUNITI AIROLDI E MUZZI,LOM,50-59,7,11,0,7,6,5,0,18,0,18,Lombardia,ITC4
2021-01-14,PF/BT,030324001093 -  030324001116,ISTIT.RIUNITI AIROLDI E MUZZI,LOM,60-69,5,4,0,2,1,6,0,9,0,9,Lombardia,ITC4
2021-01-14,PF/BT,030324001093 -  030324001116,ISTIT.RIUNITI AIROLDI E MUZZI,LOM,70-79,3,2,0,0,0,5,0,5,0,5,Lombardia,ITC4
2021-01-14,PF/BT,030324001093 -  030324001116,ISTIT.RIUNITI AIROLDI E MUZZI,LOM,80-89,6,18,0,0,0,19,5,24,0,24,Lombardia,ITC4
2021-01-14,PF/BT,030324001093 -  030324001116,ISTIT.RIUNITI AIROLDI E MUZZI,LOM,90+,1,16,0,0,0,17,0,17,0,17,Lombardia,ITC4
2021-01-14,PF/BT,030-327-001768,FONDAZIONE RSA SONCINO ONLUS,LOM,20-29,0,1,0,1,0,0,0,1,0,1,Lombardia,ITC4
2021-01-14,PF/BT,030-327-001768,FONDAZIONE RSA SONCINO ONLUS,LOM,30-39,0,1,0,1,0,0,0,1,0,1,Lombardia,ITC4
2021-01-14,PF/BT,030-327-001768,FONDAZIONE RSA SONCINO ONLUS,LOM,40-49,0,6,0,6,0,0,0,6,0,6,Lombardia,ITC4
2021-01-14,PF/BT,030-327-001768,FONDAZIONE RSA SONCINO ONLUS,LOM,50-59,0,7,0,7,0,0,0,7,0,7,Lombardia,ITC4
2021-01-14,PF/BT,030-327-001768,FONDAZIONE RSA SONCINO ONLUS,LOM,60-69,1,2,0,2,1,0,0,3,0,3,Lombardia,ITC4
2021-01-14,PF/BT,030-327-001768,FONDAZIONE RSA SONCINO ONLUS,LOM,70-79,2,0,0,1,0,1,0,2,0,2,Lombardia,ITC4
2021-01-14,PF/BT,030-327-001768,FONDAZIONE RSA SONCINO ONLUS,LOM,80-89,2,8,0,0,0,10,0,10,0,10,Lombardia,ITC4
2021-01-14,PF/BT,030-327-001768,FONDAZIONE RSA SONCINO ONLUS,LOM,90+,2,4,0,0,0,6,0,6,0,6,Lombardia,ITC4
2021-01-14,PF/BT,030327001899,FONDAZIONE CASA DI RIPOSO DI ASOLA ONLUS,LOM,20-29,0,2,0,2,0,0,0,2,0,2,Lombardia,ITC4
2021-01-14,PF/BT,030327001899,FONDAZIONE CASA DI RIPOSO DI ASOLA ONLUS,LOM,40-49,1,6,0,6,1,0,0,7,0,7,Lombardia,ITC4
2021-01-14,PF/BT,030327001899,FONDAZIONE CASA DI RIPOSO DI ASOLA ONLUS,LOM,50-59,0,8,0,6,2,0,0,8,0,8,Lombardia,ITC4
2021-01-14,PF/BT,030327001899,FONDAZIONE CASA DI RIPOSO DI ASOLA ONLUS,LOM,60-69,3,1,0,1,0,3,0,4,0,4,Lombardia,ITC4
2021-01-14,PF/BT,030327001899,FONDAZIONE CASA DI RIPOSO DI ASOLA ONLUS,LOM,70-79,5,7,0,0,0,12,0,12,0,12,Lombardia,ITC4
2021-01-14,PF/BT,030327001899,FONDAZIONE CASA DI RIPOSO DI ASOLA ONLUS,LOM,80-89,9,30,0,0,0,39,0,39,0,39,Lombardia,ITC4
2021-01-14,PF/BT,030327001899,FONDAZIONE CASA DI RIPOSO DI ASOLA ONLUS,LOM,90+,5,13,0,0,0,18,0,18,0,18,Lombardia,ITC4
2021-01-14,PF/BT,030704,Polo Riabilitativo FFO,LOM,30-39,2,6,0,4,4,0,0,8,0,8,Lombardia,ITC4
2021-01-14,PF/BT,030704,Polo Riabilitativo FFO,LOM,40-49,3,7,0,7,3,0,0,10,0,10,Lombardia,ITC4
2021-01-14,PF/BT,030704,Polo Riabilitativo FFO,LOM,50-59,7,6,0,7,6,0,0,13,0,13,Lombardia,ITC4
2021-01-14,PF/BT,030704,Polo Riabilitativo FFO,LOM,60-69,2,3,0,2,3,0,0,5,0,5,Lombardia,ITC4
2021-01-14,PF/BT,030704,Presidio Ospedaliero CTO,LOM,20-29,0,4,0,3,1,0,0,4,0,4,Lombardia,ITC4
2021-01-14,PF/BT,030704,Presidio Ospedaliero CTO,LOM,30-39,2,3,0,2,3,0,0,5,0,5,Lombardia,ITC4
2021-01-14,PF/BT,030704,Presidio Ospedaliero CTO,LOM,40-49,6,4,0,4,6,0,0,10,0,10,Lombardia,ITC4
2021-01-14,PF/BT,030704,Presidio Ospedaliero CTO,LOM,50-59,4,13,0,6,11,0,0,17,0,17,Lombardia,ITC4
2021-01-14,PF/BT,030704,Presidio Ospedaliero CTO,LOM,60-69,2,4,0,5,1,0,0,6,0,6,Lombardia,ITC4
2021-01-14,PF/BT,030704,Presidio Ospedaliero G. Pini,LOM,20-29,5,4,0,6,3,0,0,9,0,9,Lombardia,ITC4
2021-01-14,PF/BT,030704,Presidio Ospedaliero G. Pini,LOM,30-39,10,4,0,4,10,0,0,14,0,14,Lombardia,ITC4
2021-01-14,PF/BT,030704,Presidio Ospedaliero G. Pini,LOM,40-49,6,16,0,6,16,0,0,22,0,22,Lombardia,ITC4
2021-01-14,PF/BT,030704,Presidio Ospedaliero G. Pini,LOM,50-59,13,23,0,17,19,0,0,36,0,36,Lombardia,ITC4
2021-01-14,PF/BT,030704,Presidio Ospedaliero G. Pini,LOM,60-69,6,9,0,5,10,0,0,15,0,15,Lombardia,ITC4
2021-01-14,PF/BT,030903,AMB COVID LECCO,LOM,16-19,0,3,0,1,2,0,0,3,0,3,Lombardia,ITC4
2021-01-14,PF/BT,030903,AMB COVID LECCO,LOM,20-29,19,55,0,59,15,0,0,74,0,74,Lombardia,ITC4
2021-01-14,PF/BT,030903,AMB COVID LECCO,LOM,30-39,28,71,0,74,25,0,0,99,0,99,Lombardia,ITC4
2021-01-14,PF/BT,030903,AMB COVID LECCO,LOM,40-49,30,125,0,124,31,0,0,155,0,155,Lombardia,ITC4
2021-01-14,PF/BT,030903,AMB COVID LECCO,LOM,50-59,45,156,0,123,78,0,0,201,0,201,Lombardia,ITC4
2021-01-14,PF/BT,030903,AMB COVID LECCO,LOM,60-69,28,31,0,38,21,0,0,59,0,59,Lombardia,ITC4
2021-01-14,PF/BT,030903,AMB COVID LECCO,LOM,70-79,6,7,0,8,5,0,0,13,0,13,Lombardia,ITC4
2021-01-14,PF/BT,030903,AMB COVID LECCO,LOM,80-89,0,1,0,1,0,0,0,1,0,1,Lombardia,ITC4
2021-01-14,PF/BT,030903,AMB COVID LECCO,LOM,90+,1,0,0,1,0,0,0,1,0,1,Lombardia,ITC4
2021-01-14,PF/BT,030922,"FOND.IRCCS ""ISTIT.NAZ.LE TUMORI""MILANO",LOM,16-19,3,1,0,0,0,0,4,4,0,4,Lombardia,ITC4
2021-01-14,PF/BT,030922,"FOND.IRCCS ""ISTIT.NAZ.LE TUMORI""MILANO",LOM,20-29,6,55,0,1,2,0,58,61,0,61,Lombardia,ITC4
2021-01-14,PF/BT,030922,"FOND.IRCCS ""ISTIT.NAZ.LE TUMORI""MILANO",LOM,30-39,8,6,0,5,2,0,7,14,0,14,Lombardia,ITC4
2021-01-14,PF/BT,030922,"FOND.IRCCS ""ISTIT.NAZ.LE TUMORI""MILANO",LOM,40-49,10,16,0,3,12,0,11,26,0,26,Lombardia,ITC4
2021-01-14,PF/BT,030922,"FOND.IRCCS ""ISTIT.NAZ.LE TUMORI""MILANO",LOM,50-59,7,17,0,8,8,0,8,24,0,24,Lombardia,ITC4
2021-01-14,PF/BT,030922,"FOND.IRCCS ""ISTIT.NAZ.LE TUMORI""MILANO",LOM,60-69,4,11,0,1,5,0,9,15,0,15,Lombardia,ITC4
2021-01-14,PF/BT,030922,"FOND.IRCCS ""ISTIT.NAZ.LE TUMORI""MILANO",LOM,70-79,1,4,0,1,0,0,4,5,0,5,Lombardia,ITC4
2021-01-14,PF/BT,030922,"FOND.IRCCS ""ISTIT.NAZ.LE TUMORI""MILANO",LOM,90+,0,1,0,0,0,0,1,1,0,1,Lombardia,ITC4
2021-01-14,PF/BT,030923,FOND.IRCCS IST.NAZ.NEUROLOGICO C.BESTA-MI,LOM,20-29,4,9,0,7,0,0,6,13,0,13,Lombardia,ITC4
2021-01-14,PF/BT,030923,FOND.IRCCS IST.NAZ.NEUROLOGICO C.BESTA-MI,LOM,30-39,1,11,0,9,2,0,1,12,0,12,Lombardia,ITC4
2021-01-14,PF/BT,030923,FOND.IRCCS IST.NAZ.NEUROLOGICO C.BESTA-MI,LOM,40-49,2,9,0,8,1,0,2,11,0,11,Lombardia,ITC4
2021-01-14,PF/BT,030923,FOND.IRCCS IST.NAZ.NEUROLOGICO C.BESTA-MI,LOM,50-59,4,11,0,6,5,0,4,15,0,15,Lombardia,ITC4
2021-01-14,PF/BT,030923,FOND.IRCCS IST.NAZ.NEUROLOGICO C.BESTA-MI,LOM,60-69,0,2,0,1,1,0,0,2,0,2,Lombardia,ITC4
2021-01-14,PF/BT,030923,FOND.IRCCS IST.NAZ.NEUROLOGICO C.BESTA-MI,LOM,70-79,1,0,0,1,0,0,0,1,0,1,Lombardia,ITC4
2021-01-14,PF/BT,030924,IRCCS POLICLINICO S. MATTEO - PAVIA,LOM,20-29,22,43,0,62,3,0,0,65,0,65,Lombardia,ITC4
2021-01-14,PF/BT,030924,IRCCS POLICLINICO S. MATTEO - PAVIA,LOM,30-39,33,52,0,80,5,0,0,85,0,85,Lombardia,ITC4
2021-01-14,PF/BT,030924,IRCCS POLICLINICO S. MATTEO - PAVIA,LOM,40-49,20,66,0,74,9,0,3,86,0,86,Lombardia,ITC4
2021-01-14,PF/BT,030924,IRCCS POLICLINICO S. MATTEO - PAVIA,LOM,50-59,19,43,0,39,21,0,2,62,0,62,Lombardia,ITC4
2021-01-14,PF/BT,030924,IRCCS POLICLINICO S. MATTEO - PAVIA,LOM,60-69,2,5,0,6,1,0,0,7,0,7,Lombardia,ITC4
2021-01-14,PF/BT,030924,IRCCS POLICLINICO S. MATTEO - PAVIA,LOM,70-79,1,0,0,1,0,0,0,1,0,1,Lombardia,ITC4
2021-01-14,PF/BT,030925,Fondazione IRCCS Ca' Granda Ospedale Maggiore Policlinico,LOM,20-29,23,35,0,52,6,0,0,58,0,58,Lombardia,ITC4
2021-01-14,PF/BT,030925,Fondazione IRCCS Ca' Granda Ospedale Maggiore Policlinico,LOM,30-39,27,63,0,86,4,0,0,90,0,90,Lombardia,ITC4
2021-01-14,PF/BT,030925,Fondazione IRCCS Ca' Granda Ospedale Maggiore Policlinico,LOM,40-49,13,54,0,60,7,0,0,67,0,67,Lombardia,ITC4
2021-01-14,PF/BT,030925,Fondazione IRCCS Ca' Granda Ospedale Maggiore Policlinico,LOM,50-59,26,77,0,80,23,0,0,103,0,103,Lombardia,ITC4
2021-01-14,PF/BT,030925,Fondazione IRCCS Ca' Granda Ospedale Maggiore Policlinico,LOM,60-69,20,28,0,41,7,0,0,48,0,48,Lombardia,ITC4
2021-01-14,PF/BT,030925,Fondazione IRCCS Ca' Granda Ospedale Maggiore Policlinico,LOM,70-79,3,1,0,4,0,0,0,4,0,4,Lombardia,ITC4
2021-01-14,PF/BT,030935,IRCCS    S. RAFFAELE - MILANO,LOM,20-29,5,9,0,14,0,0,0,14,0,14,Lombardia,ITC4
2021-01-14,PF/BT,030935,IRCCS    S. RAFFAELE - MILANO,LOM,30-39,7,10,0,17,0,0,0,17,0,17,Lombardia,ITC4
2021-01-14,PF/BT,030935,IRCCS    S. RAFFAELE - MILANO,LOM,40-49,25,71,0,96,0,0,0,96,0,96,Lombardia,ITC4
2021-01-14,PF/BT,030935,IRCCS    S. RAFFAELE - MILANO,LOM,50-59,35,66,0,101,0,0,0,101,0,101,Lombardia,ITC4
2021-01-14,PF/BT,030935,IRCCS    S. RAFFAELE - MILANO,LOM,60-69,7,3,0,10,0,0,0,10,0,10,Lombardia,ITC4
2021-01-14,PF/BT,030937,PRO JOVENTUDE DON C. GNOCCHI - MI IRCCS PRIVATO,LOM,20-29,0,7,0,7,0,0,0,7,0,7,Lombardia,ITC4
2021-01-14,PF/BT,030937,PRO JOVENTUDE DON C. GNOCCHI - MI IRCCS PRIVATO,LOM,30-39,5,12,0,14,3,0,0,17,0,17,Lombardia,ITC4
2021-01-14,PF/BT,030937,PRO JOVENTUDE DON C. GNOCCHI - MI IRCCS PRIVATO,LOM,40-49,8,20,0,18,10,0,0,28,0,28,Lombardia,ITC4
2021-01-14,PF/BT,030937,PRO JOVENTUDE DON C. GNOCCHI - MI IRCCS PRIVATO,LOM,50-59,13,32,0,25,20,0,0,45,0,45,Lombardia,ITC4
2021-01-14,PF/BT,030937,PRO JOVENTUDE DON C. GNOCCHI - MI IRCCS PRIVATO,LOM,60-69,3,14,0,10,7,0,0,17,0,17,Lombardia,ITC4
2021-01-14,PF/BT,030943,Istituto Clinico Humanitas,LOM,16-19,0,1,0,1,0,0,0,1,0,1,Lombardia,ITC4
2021-01-14,PF/BT,030943,Istituto Clinico Humanitas,LOM,20-29,57,76,0,88,45,0,0,133,0,133,Lombardia,ITC4
2021-01-14,PF/BT,030943,Istituto Clinico Humanitas,LOM,30-39,23,26,0,21,27,0,1,49,0,49,Lombardia,ITC4
2021-01-14,PF/BT,030943,Istituto Clinico Humanitas,LOM,40-49,22,34,0,25,31,0,0,56,0,56,Lombardia,ITC4
2021-01-14,PF/BT,030943,Istituto Clinico Humanitas,LOM,50-59,13,22,0,13,22,0,0,35,0,35,Lombardia,ITC4
2021-01-14,PF/BT,030943,Istituto Clinico Humanitas,LOM,60-69,5,10,0,3,8,0,4,15,0,15,Lombardia,ITC4
2021-01-14,PF/BT,030943,Istituto Clinico Humanitas,LOM,70-79,4,4,0,2,1,0,5,8,0,8,Lombardia,ITC4
2021-01-14,PF/BT,030943,Istituto Clinico Humanitas,LOM,80-89,1,1,0,0,0,0,2,2,0,2,Lombardia,ITC4
2021-01-14,PF/BT,030950,IRCCS   S. RAFFAELE TURRO - MILANO,LOM,20-29,8,8,0,16,0,0,0,16,0,16,Lombardia,ITC4
2021-01-14,PF/BT,030950,IRCCS   S. RAFFAELE TURRO - MILANO,LOM,30-39,13,18,0,31,0,0,0,31,0,31,Lombardia,ITC4
2021-01-14,PF/BT,030950,IRCCS   S. RAFFAELE TURRO - MILANO,LOM,40-49,3,2,0,5,0,0,0,5,0,5,Lombardia,ITC4
2021-01-14,PF/BT,030950,IRCCS   S. RAFFAELE TURRO - MILANO,LOM,50-59,1,7,0,8,0,0,0,8,0,8,Lombardia,ITC4
2021-01-14,PF/BT,066549,RSA BERNINA,LOM,20-29,0,2,0,1,1,0,0,2,0,2,Lombardia,ITC4
2021-01-14,PF/BT,066549,RSA BERNINA,LOM,30-39,1,1,0,0,2,0,0,2,0,2,Lombardia,ITC4
2021-01-14,PF/BT,066549,RSA BERNINA,LOM,40-49,0,3,0,2,1,0,0,3,0,3,Lombardia,ITC4
2021-01-14,PF/BT,066549,RSA BERNINA,LOM,70-79,0,5,0,2,3,0,0,5,0,5,Lombardia,ITC4
2021-01-14,PF/BT,1142,RSA Casa Madonna della Fiducia,LOM,50-59,1,0,0,0,0,1,0,1,0,1,Lombardia,ITC4
2021-01-14,PF/BT,1142,RSA Casa Madonna della Fiducia,LOM,60-69,1,2,0,0,0,3,0,3,0,3,Lombardia,ITC4
2021-01-14,PF/BT,1142,RSA Casa Madonna della Fiducia,LOM,70-79,2,4,0,0,0,6,0,6,0,6,Lombardia,ITC4
2021-01-14,PF/BT,1142,RSA Casa Madonna della Fiducia,LOM,80-89,13,37,0,0,0,50,0,50,0,50,Lombardia,ITC4
2021-01-14,PF/BT,1142,RSA Casa Madonna della Fiducia,LOM,90+,4,32,0,0,0,36,0,36,0,36,Lombardia,ITC4
2021-01-14,PF/BT,1200,R.S.A. DON A.BELLANI-MONZA,LOM,70-79,2,3,0,0,0,5,0,5,0,5,Lombardia,ITC4
2021-01-14,PF/BT,1200,R.S.A. DON A.BELLANI-MONZA,LOM,80-89,4,9,0,0,0,13,0,13,0,13,Lombardia,ITC4
2021-01-14,PF/BT,1200,R.S.A. DON A.BELLANI-MONZA,LOM,90+,1,3,0,0,0,4,0,4,0,4,Lombardia,ITC4
2021-01-14,PF/BT,1220,ISTITUTO CLINICO QUARENGHI S.R.L.,LOM,20-29,3,2,0,5,0,0,0,5,0,5,Lombardia,ITC4
2021-01-14,PF/BT,1220,ISTITUTO CLINICO QUARENGHI S.R.L.,LOM,30-39,0,4,0,4,0,0,0,4,0,4,Lombardia,ITC4
2021-01-14,PF/BT,1220,ISTITUTO CLINICO QUARENGHI S.R.L.,LOM,40-49,1,4,0,5,0,0,0,5,0,5,Lombardia,ITC4
2021-01-14,PF/BT,1220,ISTITUTO CLINICO QUARENGHI S.R.L.,LOM,50-59,4,4,0,7,1,0,0,8,0,8,Lombardia,ITC4
2021-01-14,PF/BT,1220,ISTITUTO CLINICO QUARENGHI S.R.L.,LOM,60-69,0,1,0,1,0,0,0,1,0,1,Lombardia,ITC4
2021-01-14,PF/BT,1220,ISTITUTO CLINICO QUARENGHI S.R.L.,LOM,90+,0,1,0,0,0,0,1,1,0,1,Lombardia,ITC4
2021-01-14,PF/BT,1284,FONDAZIONE GIOVANNI CARLO ROTA,LOM,30-39,1,2,0,3,0,0,0,3,0,3,Lombardia,ITC4
2021-01-14,PF/BT,1284,FONDAZIONE GIOVANNI CARLO ROTA,LOM,40-49,0,7,0,7,0,0,0,7,0,7,Lombardia,ITC4
2021-01-14,PF/BT,1284,FONDAZIONE GIOVANNI CARLO ROTA,LOM,50-59,0,2,0,2,0,0,0,2,0,2,Lombardia,ITC4
2021-01-14,PF/BT,1411,Fondazione Don Stefano Palla Onlus,LOM,20-29,0,4,0,4,0,0,0,4,0,4,Lombardia,ITC4
2021-01-14,PF/BT,1411,Fondazione Don Stefano Palla Onlus,LOM,30-39,0,6,0,6,0,0,0,6,0,6,Lombardia,ITC4
2021-01-14,PF/BT,1411,Fondazione Don Stefano Palla Onlus,LOM,40-49,0,8,0,8,0,0,0,8,0,8,Lombardia,ITC4
2021-01-14,PF/BT,1411,Fondazione Don Stefano Palla Onlus,LOM,50-59,1,8,0,9,0,0,0,9,0,9,Lombardia,ITC4
2021-01-14,PF/BT,1411,Fondazione Don Stefano Palla Onlus,LOM,60-69,0,1,0,1,0,0,0,1,0,1,Lombardia,ITC4
2021-01-14,PF/BT,1411,Fondazione Don Stefano Palla Onlus,LOM,80-89,1,1,0,0,0,2,0,2,0,2,Lombardia,ITC4
2021-01-14,PF/BT,1473,CASA DI RIPOSO DON FERDINANDO CREMONA ONLUS,LOM,20-29,0,1,0,1,0,0,0,1,0,1,Lombardia,ITC4
2021-01-14,PF/BT,1473,CASA DI RIPOSO DON FERDINANDO CREMONA ONLUS,LOM,30-39,0,1,0,1,0,0,0,1,0,1,Lombardia,ITC4
2021-01-14,PF/BT,1473,CASA DI RIPOSO DON FERDINANDO CREMONA ONLUS,LOM,40-49,1,3,0,2,1,0,1,4,0,4,Lombardia,ITC4
2021-01-14,PF/BT,1473,CASA DI RIPOSO DON FERDINANDO CREMONA ONLUS,LOM,50-59,2,6,0,7,0,0,1,8,0,8,Lombardia,ITC4
2021-01-14,PF/BT,1473,CASA DI RIPOSO DON FERDINANDO CREMONA ONLUS,LOM,60-69,0,5,0,4,0,1,0,5,0,5,Lombardia,ITC4
2021-01-14,PF/BT,1473,CASA DI RIPOSO DON FERDINANDO CREMONA ONLUS,LOM,70-79,6,4,0,1,0,8,1,10,0,10,Lombardia,ITC4
2021-01-14,PF/BT,1473,CASA DI RIPOSO DON FERDINANDO CREMONA ONLUS,LOM,80-89,1,16,0,0,0,17,0,17,0,17,Lombardia,ITC4
2021-01-14,PF/BT,1473,CASA DI RIPOSO DON FERDINANDO CREMONA ONLUS,LOM,90+,0,14,0,0,0,14,0,14,0,14,Lombardia,ITC4
2021-01-14,PF/BT,1480,"Rsa ""Sorelle Girelli"" Marone (BS)",LOM,70-79,1,0,0,0,0,1,0,1,0,1,Lombardia,ITC4
2021-01-14,PF/BT,1480,"Rsa ""Sorelle Girelli"" Marone (BS)",LOM,80-89,2,6,0,0,0,8,0,8,0,8,Lombardia,ITC4
2021-01-14,PF/BT,1480,"Rsa ""Sorelle Girelli"" Marone (BS)",LOM,90+,1,8,0,0,0,9,0,9,0,9,Lombardia,ITC4
2021-01-14,PF/BT,1585,RSA FEROLDI,LOM,20-29,0,3,0,3,0,0,0,3,0,3,Lombardia,ITC4
2021-01-14,PF/BT,1585,RSA FEROLDI,LOM,30-39,1,7,0,7,1,0,0,8,0,8,Lombardia,ITC4
2021-01-14,PF/BT,1585,RSA FEROLDI,LOM,40-49,0,10,0,7,3,0,0,10,0,10,Lombardia,ITC4
2021-01-14,PF/BT,1585,RSA FEROLDI,LOM,50-59,3,6,0,6,3,0,0,9,0,9,Lombardia,ITC4
2021-01-14,PF/BT,1585,RSA FEROLDI,LOM,60-69,0,6,0,6,0,0,0,6,0,6,Lombardia,ITC4
2021-01-14,PF/BT,1591,Fondazione O.P. Delbarba Maselli Dandolo ONLUS,LOM,20-29,0,1,0,0,1,0,0,1,0,1,Lombardia,ITC4
2021-01-14,PF/BT,1591,Fondazione O.P. Delbarba Maselli Dandolo ONLUS,LOM,30-39,0,3,0,2,1,0,0,3,0,3,Lombardia,ITC4
2021-01-14,PF/BT,1591,Fondazione O.P. Delbarba Maselli Dandolo ONLUS,LOM,40-49,0,8,0,7,1,0,0,8,0,8,Lombardia,ITC4
2021-01-14,PF/BT,1591,Fondazione O.P. Delbarba Maselli Dandolo ONLUS,LOM,50-59,1,1,0,1,1,0,0,2,0,2,Lombardia,ITC4
2021-01-14,PF/BT,1591,Fondazione O.P. Delbarba Maselli Dandolo ONLUS,LOM,60-69,2,0,0,1,1,0,0,2,0,2,Lombardia,ITC4
2021-01-14,PF/BT,1591,Fondazione O.P. Delbarba Maselli Dandolo ONLUS,LOM,70-79,0,1,0,0,1,0,0,1,0,1,Lombardia,ITC4
2021-01-14,PF/BT,1591,Fondazione O.P. Delbarba Maselli Dandolo ONLUS,LOM,80-89,0,4,0,0,4,0,0,4,0,4,Lombardia,ITC4
2021-01-14,PF/BT,1591,Fondazione O.P. Delbarba Maselli Dandolo ONLUS,LOM,90+,1,2,0,0,3,0,0,3,0,3,Lombardia,ITC4
2021-01-14,PF/BT,1626,0,LOM,30-39,0,1,0,1,0,0,0,1,0,1,Lombardia,ITC4
2021-01-14,PF/BT,1626,0,LOM,60-69,2,1,0,1,0,2,0,3,0,3,Lombardia,ITC4
2021-01-14,PF/BT,1626,0,LOM,70-79,1,4,0,0,0,5,0,5,0,5,Lombardia,ITC4
2021-01-14,PF/BT,1626,0,LOM,80-89,4,7,0,0,0,11,0,11,0,11,Lombardia,ITC4
2021-01-14,PF/BT,1626,0,LOM,90+,2,1,0,0,0,3,0,3,0,3,Lombardia,ITC4
2021-01-14,PF/BT,1640, RSA LORENZO E GIANNA ZIROTTI,LOM,40-49,1,0,0,0,0,1,0,1,0,1,Lombardia,ITC4
2021-01-14,PF/BT,1640, RSA LORENZO E GIANNA ZIROTTI,LOM,60-69,1,0,0,0,0,1,0,1,0,1,Lombardia,ITC4
2021-01-14,PF/BT,1640, RSA LORENZO E GIANNA ZIROTTI,LOM,70-79,4,4,0,0,0,8,0,8,0,8,Lombardia,ITC4
2021-01-14,PF/BT,1640, RSA LORENZO E GIANNA ZIROTTI,LOM,80-89,3,11,0,0,0,14,0,14,0,14,Lombardia,ITC4
2021-01-14,PF/BT,1640, RSA LORENZO E GIANNA ZIROTTI,LOM,90+,1,11,0,0,0,12,0,12,0,12,Lombardia,ITC4
2021-01-14,PF/BT,167,ASST SPEDALI CIVILI AMBULATORIO COVID BRESCIA,LOM,20-29,13,46,0,47,12,0,0,59,0,59,Lombardia,ITC4
2021-01-14,PF/BT,167,ASST SPEDALI CIVILI AMBULATORIO COVID BRESCIA,LOM,30-39,32,74,0,80,25,0,1,106,0,106,Lombardia,ITC4
2021-01-14,PF/BT,167,ASST SPEDALI CIVILI AMBULATORIO COVID BRESCIA,LOM,40-49,30,78,0,69,38,0,1,108,0,108,Lombardia,ITC4
2021-01-14,PF/BT,167,ASST SPEDALI CIVILI AMBULATORIO COVID BRESCIA,LOM,50-59,26,123,0,69,80,0,0,149,0,149,Lombardia,ITC4
2021-01-14,PF/BT,167,ASST SPEDALI CIVILI AMBULATORIO COVID BRESCIA,LOM,60-69,21,23,0,27,17,0,0,44,0,44,Lombardia,ITC4
2021-01-14,PF/BT,167,ASST SPEDALI CIVILI AMBULATORIO COVID BRESCIA,LOM,70-79,0,2,0,2,0,0,0,2,0,2,Lombardia,ITC4
2021-01-14,PF/BT,1716,FONDAZIONE CASA DI RIPOSO DI MANERBIO ONLUS,LOM,20-29,0,1,0,1,0,0,0,1,0,1,Lombardia,ITC4
2021-01-14,PF/BT,1716,FONDAZIONE CASA DI RIPOSO DI MANERBIO ONLUS,LOM,30-39,0,2,0,2,0,0,0,2,0,2,Lombardia,ITC4
2021-01-14,PF/BT,1716,FONDAZIONE CASA DI RIPOSO DI MANERBIO ONLUS,LOM,40-49,0,9,0,9,0,0,0,9,0,9,Lombardia,ITC4
2021-01-14,PF/BT,1716,FONDAZIONE CASA DI RIPOSO DI MANERBIO ONLUS,LOM,50-59,0,9,0,9,0,0,0,9,0,9,Lombardia,ITC4
2021-01-14,PF/BT,1716,FONDAZIONE CASA DI RIPOSO DI MANERBIO ONLUS,LOM,60-69,0,3,0,1,0,2,0,3,0,3,Lombardia,ITC4
2021-01-14,PF/BT,1716,FONDAZIONE CASA DI RIPOSO DI MANERBIO ONLUS,LOM,70-79,3,3,0,0,0,6,0,6,0,6,Lombardia,ITC4
2021-01-14,PF/BT,1716,FONDAZIONE CASA DI RIPOSO DI MANERBIO ONLUS,LOM,80-89,3,13,0,0,0,16,0,16,0,16,Lombardia,ITC4
2021-01-14,PF/BT,1716,FONDAZIONE CASA DI RIPOSO DI MANERBIO ONLUS,LOM,90+,1,13,0,0,0,14,0,14,0,14,Lombardia,ITC4
2021-01-14,PF/BT,1717,FONDAZIONE GAMBARA TAVELLI,LOM,20-29,2,2,0,3,1,0,0,4,0,4,Lombardia,ITC4
2021-01-14,PF/BT,1717,FONDAZIONE GAMBARA TAVELLI,LOM,30-39,2,7,0,8,1,0,0,9,0,9,Lombardia,ITC4
2021-01-14,PF/BT,1717,FONDAZIONE GAMBARA TAVELLI,LOM,40-49,7,16,0,18,5,0,0,23,0,23,Lombardia,ITC4
2021-01-14,PF/BT,1717,FONDAZIONE GAMBARA TAVELLI,LOM,50-59,5,32,0,33,4,0,0,37,0,37,Lombardia,ITC4
2021-01-14,PF/BT,1717,FONDAZIONE GAMBARA TAVELLI,LOM,60-69,1,14,0,14,1,0,0,15,0,15,Lombardia,ITC4
2021-01-14,PF/BT,1717,FONDAZIONE GAMBARA TAVELLI,LOM,70-79,2,0,0,1,1,0,0,2,0,2,Lombardia,ITC4
2021-01-14,PF/BT,1724,Fondazione Casa di Riposo di Ghedi ONLUS,LOM,40-49,2,1,0,2,1,0,0,3,0,3,Lombardia,ITC4
2021-01-14,PF/BT,1724,Fondazione Casa di Riposo di Ghedi ONLUS,LOM,60-69,0,2,0,2,0,0,0,2,0,2,Lombardia,ITC4
2021-01-14,PF/BT,1724,Fondazione Casa di Riposo di Ghedi ONLUS,LOM,70-79,2,4,0,0,0,6,0,6,0,6,Lombardia,ITC4
2021-01-14,PF/BT,1724,Fondazione Casa di Riposo di Ghedi ONLUS,LOM,80-89,3,17,0,0,0,20,0,20,0,20,Lombardia,ITC4
2021-01-14,PF/BT,1724,Fondazione Casa di Riposo di Ghedi ONLUS,LOM,90+,1,16,0,0,0,17,0,17,0,17,Lombardia,ITC4
2021-01-14,PF/BT,1739,RSA ARICI SEGA,LOM,20-29,1,1,0,2,0,0,0,2,0,2,Lombardia,ITC4
2021-01-14,PF/BT,1739,RSA ARICI SEGA,LOM,30-39,0,3,0,3,0,0,0,3,0,3,Lombardia,ITC4
2021-01-14,PF/BT,1739,RSA ARICI SEGA,LOM,40-49,0,8,0,5,3,0,0,8,0,8,Lombardia,ITC4
2021-01-14,PF/BT,1739,RSA ARICI SEGA,LOM,50-59,0,14,0,7,7,0,0,14,0,14,Lombardia,ITC4
2021-01-14,PF/BT,1739,RSA ARICI SEGA,LOM,60-69,0,8,0,6,2,0,0,8,0,8,Lombardia,ITC4
2021-01-14,PF/BT,1739,RSA ARICI SEGA,LOM,70-79,1,0,0,1,0,0,0,1,0,1,Lombardia,ITC4
2021-01-14,PF/BT,1772,Fondazione Villa Sacro Cuore Coniugi Preyer,LOM,40-49,0,1,0,1,0,0,0,1,0,1,Lombardia,ITC4
2021-01-14,PF/BT,1772,Fondazione Villa Sacro Cuore Coniugi Preyer,LOM,50-59,1,1,0,0,2,0,0,2,0,2,Lombardia,ITC4
2021-01-14,PF/BT,1772,Fondazione Villa Sacro Cuore Coniugi Preyer,LOM,60-69,1,0,0,0,1,0,0,1,0,1,Lombardia,ITC4
2021-01-14,PF/BT,1772,Fondazione Villa Sacro Cuore Coniugi Preyer,LOM,80-89,3,15,0,0,0,18,0,18,0,18,Lombardia,ITC4
2021-01-14,PF/BT,1772,Fondazione Villa Sacro Cuore Coniugi Preyer,LOM,90+,2,12,0,0,0,14,0,14,0,14,Lombardia,ITC4
2021-01-14,PF/BT,1774,RSA I CICLAMINI,LOM,20-29,1,3,0,4,0,0,0,4,0,4,Lombardia,ITC4
2021-01-14,PF/BT,1774,RSA I CICLAMINI,LOM,30-39,2,5,0,5,2,0,0,7,0,7,Lombardia,ITC4
2021-01-14,PF/BT,1774,RSA I CICLAMINI,LOM,40-49,1,5,0,3,3,0,0,6,0,6,Lombardia,ITC4
2021-01-14,PF/BT,1774,RSA I CICLAMINI,LOM,50-59,1,4,0,3,2,0,0,5,0,5,Lombardia,ITC4
2021-01-14,PF/BT,1774,RSA I CICLAMINI,LOM,60-69,0,2,0,1,1,0,0,2,0,2,Lombardia,ITC4
2021-01-14,PF/BT,179,RSA SANTA GIULIA,LOM,20-29,2,3,0,0,5,0,0,5,0,5,Lombardia,ITC4
2021-01-14,PF/BT,179,RSA SANTA GIULIA,LOM,30-39,3,19,0,13,8,0,1,22,0,22,Lombardia,ITC4
2021-01-14,PF/BT,179,RSA SANTA GIULIA,LOM,40-49,7,30,0,35,0,0,2,37,0,37,Lombardia,ITC4
2021-01-14,PF/BT,179,RSA SANTA GIULIA,LOM,50-59,6,35,0,36,2,1,2,41,0,41,Lombardia,ITC4
2021-01-14,PF/BT,179,RSA SANTA GIULIA,LOM,60-69,0,8,0,7,1,0,0,8,0,8,Lombardia,ITC4
2021-01-14,PF/BT,179,RSA SANTA GIULIA,LOM,70-79,2,0,0,0,0,2,0,2,0,2,Lombardia,ITC4
2021-01-14,PF/BT,179,RSA SANTA GIULIA,LOM,80-89,1,5,0,0,0,6,0,6,0,6,Lombardia,ITC4
2021-01-14,PF/BT,179,RSA SANTA GIULIA,LOM,90+,1,10,0,0,0,11,0,11,0,11,Lombardia,ITC4
2021-01-14,PF/BT,1824,Fondazione Benefattori Cremaschi - RSA Zurla,LOM,20-29,0,5,0,5,0,0,0,5,0,5,Lombardia,ITC4
2021-01-14,PF/BT,1824,Fondazione Benefattori Cremaschi - RSA Zurla,LOM,30-39,1,11,0,9,3,0,0,12,0,12,Lombardia,ITC4
2021-01-14,PF/BT,1824,Fondazione Benefattori Cremaschi - RSA Zurla,LOM,40-49,4,11,0,9,6,0,0,15,0,15,Lombardia,ITC4
2021-01-14,PF/BT,1824,Fondazione Benefattori Cremaschi - RSA Zurla,LOM,50-59,4,16,0,16,4,0,0,20,0,20,Lombardia,ITC4
2021-01-14,PF/BT,1824,Fondazione Benefattori Cremaschi - RSA Zurla,LOM,60-69,2,6,0,5,2,1,0,8,0,8,Lombardia,ITC4
2021-01-14,PF/BT,1824,Fondazione Benefattori Cremaschi - RSA Zurla,LOM,70-79,2,2,0,0,1,3,0,4,0,4,Lombardia,ITC4
2021-01-14,PF/BT,1824,Fondazione Benefattori Cremaschi - RSA Zurla,LOM,80-89,4,13,0,0,0,17,0,17,0,17,Lombardia,ITC4
2021-01-14,PF/BT,1824,Fondazione Benefattori Cremaschi - RSA Zurla,LOM,90+,5,4,0,0,0,9,0,9,0,9,Lombardia,ITC4
2021-01-14,PF/BT,1827,FONDAZIONE OSPEDALE CAIMI ONLUS,LOM,20-29,6,4,0,7,3,0,0,10,0,10,Lombardia,ITC4
2021-01-14,PF/BT,1827,FONDAZIONE OSPEDALE CAIMI ONLUS,LOM,30-39,1,11,0,9,3,0,0,12,0,12,Lombardia,ITC4
2021-01-14,PF/BT,1827,FONDAZIONE OSPEDALE CAIMI ONLUS,LOM,40-49,4,20,0,19,5,0,0,24,0,24,Lombardia,ITC4
2021-01-14,PF/BT,1827,FONDAZIONE OSPEDALE CAIMI ONLUS,LOM,50-59,2,21,0,17,5,0,1,23,0,23,Lombardia,ITC4
2021-01-14,PF/BT,1827,FONDAZIONE OSPEDALE CAIMI ONLUS,LOM,60-69,6,7,0,2,4,0,7,13,0,13,Lombardia,ITC4
2021-01-14,PF/BT,1827,FONDAZIONE OSPEDALE CAIMI ONLUS,LOM,70-79,13,11,0,3,0,17,4,24,0,24,Lombardia,ITC4
2021-01-14,PF/BT,1827,FONDAZIONE OSPEDALE CAIMI ONLUS,LOM,80-89,5,27,0,1,0,31,0,32,0,32,Lombardia,ITC4
2021-01-14,PF/BT,1827,FONDAZIONE OSPEDALE CAIMI ONLUS,LOM,90+,1,5,0,0,0,6,0,6,0,6,Lombardia,ITC4
2021-01-14,PF/BT,1837,RSA NOLLI PIGOLI SESTO ED UNITI,LOM,20-29,0,7,0,6,1,0,0,7,0,7,Lombardia,ITC4
2021-01-14,PF/BT,1837,RSA NOLLI PIGOLI SESTO ED UNITI,LOM,30-39,0,4,0,3,1,0,0,4,0,4,Lombardia,ITC4
2021-01-14,PF/BT,1837,RSA NOLLI PIGOLI SESTO ED UNITI,LOM,40-49,3,12,0,10,5,0,0,15,0,15,Lombardia,ITC4
2021-01-14,PF/BT,1837,RSA NOLLI PIGOLI SESTO ED UNITI,LOM,50-59,6,18,0,17,7,0,0,24,0,24,Lombardia,ITC4
2021-01-14,PF/BT,1837,RSA NOLLI PIGOLI SESTO ED UNITI,LOM,60-69,0,3,0,3,0,0,0,3,0,3,Lombardia,ITC4
2021-01-14,PF/BT,1837,RSA NOLLI PIGOLI SESTO ED UNITI,LOM,70-79,5,4,0,0,0,9,0,9,0,9,Lombardia,ITC4
2021-01-14,PF/BT,1837,RSA NOLLI PIGOLI SESTO ED UNITI,LOM,80-89,3,22,0,0,0,25,0,25,0,25,Lombardia,ITC4
2021-01-14,PF/BT,1837,RSA NOLLI PIGOLI SESTO ED UNITI,LOM,90+,2,21,0,0,0,23,0,23,0,23,Lombardia,ITC4
2021-01-14,PF/BT,1842,RSA VILLA AZZURRA,LOM,50-59,0,2,0,2,0,0,0,2,0,2,Lombardia,ITC4
2021-01-14,PF/BT,1842,RSA VILLA AZZURRA,LOM,60-69,0,1,0,0,0,1,0,1,0,1,Lombardia,ITC4
2021-01-14,PF/BT,1842,RSA VILLA AZZURRA,LOM,70-79,2,1,0,0,0,3,0,3,0,3,Lombardia,ITC4
2021-01-14,PF/BT,1842,RSA VILLA AZZURRA,LOM,80-89,3,2,0,0,0,5,0,5,0,5,Lombardia,ITC4
2021-01-14,PF/BT,1842,RSA VILLA AZZURRA,LOM,90+,1,6,0,0,0,7,0,7,0,7,Lombardia,ITC4
2021-01-14,PF/BT,1872,FONDAZIONE ULDERICO SABBADINI ONLUS,LOM,40-49,0,1,0,1,0,0,0,1,0,1,Lombardia,ITC4
2021-01-14,PF/BT,1872,FONDAZIONE ULDERICO SABBADINI ONLUS,LOM,50-59,1,1,0,1,0,1,0,2,0,2,Lombardia,ITC4
2021-01-14,PF/BT,1872,FONDAZIONE ULDERICO SABBADINI ONLUS,LOM,60-69,1,0,0,0,1,0,0,1,0,1,Lombardia,ITC4
2021-01-14,PF/BT,1872,FONDAZIONE ULDERICO SABBADINI ONLUS,LOM,70-79,3,0,0,1,0,2,0,3,0,3,Lombardia,ITC4
2021-01-14,PF/BT,1872,FONDAZIONE ULDERICO SABBADINI ONLUS,LOM,80-89,3,7,0,0,0,10,0,10,0,10,Lombardia,ITC4
2021-01-14,PF/BT,1872,FONDAZIONE ULDERICO SABBADINI ONLUS,LOM,90+,1,6,0,0,1,6,0,7,0,7,Lombardia,ITC4
2021-01-14,PF/BT,1886,"RSA E. BOVI, PEGOGNAGA",LOM,20-29,0,2,0,1,1,0,0,2,0,2,Lombardia,ITC4
2021-01-14,PF/BT,1886,"RSA E. BOVI, PEGOGNAGA",LOM,30-39,1,6,0,7,0,0,0,7,0,7,Lombardia,ITC4
2021-01-14,PF/BT,1886,"RSA E. BOVI, PEGOGNAGA",LOM,40-49,1,5,0,5,1,0,0,6,0,6,Lombardia,ITC4
2021-01-14,PF/BT,1886,"RSA E. BOVI, PEGOGNAGA",LOM,50-59,0,4,0,3,1,0,0,4,0,4,Lombardia,ITC4
2021-01-14,PF/BT,1886,"RSA E. BOVI, PEGOGNAGA",LOM,60-69,0,1,0,0,0,1,0,1,0,1,Lombardia,ITC4
2021-01-14,PF/BT,1886,"RSA E. BOVI, PEGOGNAGA",LOM,70-79,0,1,0,0,0,1,0,1,0,1,Lombardia,ITC4
2021-01-14,PF/BT,1886,"RSA E. BOVI, PEGOGNAGA",LOM,80-89,2,2,0,0,0,4,0,4,0,4,Lombardia,ITC4
2021-01-14,PF/BT,1886,"RSA E. BOVI, PEGOGNAGA",LOM,90+,2,3,0,0,0,5,0,5,0,5,Lombardia,ITC4
2021-01-14,PF/BT,1894,RSA S.VINCENZO,LOM,20-29,0,1,0,0,1,0,0,1,0,1,Lombardia,ITC4
2021-01-14,PF/BT,1894,RSA S.VINCENZO,LOM,30-39,2,7,0,6,3,0,0,9,0,9,Lombardia,ITC4
2021-01-14,PF/BT,1894,RSA S.VINCENZO,LOM,40-49,2,14,0,13,3,0,0,16,0,16,Lombardia,ITC4
2021-01-14,PF/BT,1894,RSA S.VINCENZO,LOM,50-59,0,13,0,9,4,0,0,13,0,13,Lombardia,ITC4
2021-01-14,PF/BT,1894,RSA S.VINCENZO,LOM,60-69,0,3,0,3,0,0,0,3,0,3,Lombardia,ITC4
2021-01-14,PF/BT,1898,Fondazione Onlus Casa di Riposo Leandra,LOM,40-49,0,1,0,1,0,0,0,1,0,1,Lombardia,ITC4
2021-01-14,PF/BT,1898,Fondazione Onlus Casa di Riposo Leandra,LOM,50-59,0,4,0,4,0,0,0,4,0,4,Lombardia,ITC4
2021-01-14,PF/BT,1898,Fondazione Onlus Casa di Riposo Leandra,LOM,60-69,1,1,0,1,0,1,0,2,0,2,Lombardia,ITC4
2021-01-14,PF/BT,1898,Fondazione Onlus Casa di Riposo Leandra,LOM,70-79,2,3,0,0,0,5,0,5,0,5,Lombardia,ITC4
2021-01-14,PF/BT,1898,Fondazione Onlus Casa di Riposo Leandra,LOM,80-89,5,13,0,0,0,18,0,18,0,18,Lombardia,ITC4
2021-01-14,PF/BT,1898,Fondazione Onlus Casa di Riposo Leandra,LOM,90+,6,12,0,0,0,18,0,18,0,18,Lombardia,ITC4
2021-01-14,PF/BT,1934,FONDAZIONE BRUNO PARI ONLUS,LOM,20-29,1,4,0,4,1,0,0,5,0,5,Lombardia,ITC4
2021-01-14,PF/BT,1934,FONDAZIONE BRUNO PARI ONLUS,LOM,30-39,2,2,0,4,0,0,0,4,0,4,Lombardia,ITC4
2021-01-14,PF/BT,1934,FONDAZIONE BRUNO PARI ONLUS,LOM,40-49,1,2,0,3,0,0,0,3,0,3,Lombardia,ITC4
2021-01-14,PF/BT,1934,FONDAZIONE BRUNO PARI ONLUS,LOM,50-59,2,6,0,7,1,0,0,8,0,8,Lombardia,ITC4
2021-01-14,PF/BT,1934,FONDAZIONE BRUNO PARI ONLUS,LOM,60-69,1,3,0,2,0,2,0,4,0,4,Lombardia,ITC4
2021-01-14,PF/BT,1934,FONDAZIONE BRUNO PARI ONLUS,LOM,70-79,2,3,0,0,0,5,0,5,0,5,Lombardia,ITC4
2021-01-14,PF/BT,1934,FONDAZIONE BRUNO PARI ONLUS,LOM,80-89,3,10,0,0,0,13,0,13,0,13,Lombardia,ITC4
2021-01-14,PF/BT,1934,FONDAZIONE BRUNO PARI ONLUS,LOM,90+,3,15,0,0,0,18,0,18,0,18,Lombardia,ITC4
2021-01-14,PF/BT,1946,"FONDAZIONE ""CONTE DR. CARLO CARACCI"" - ONLUS",LOM,30-39,0,1,0,1,0,0,0,1,0,1,Lombardia,ITC4
2021-01-14,PF/BT,1946,"FONDAZIONE ""CONTE DR. CARLO CARACCI"" - ONLUS",LOM,50-59,0,2,0,1,1,0,0,2,0,2,Lombardia,ITC4
2021-01-14,PF/BT,1946,"FONDAZIONE ""CONTE DR. CARLO CARACCI"" - ONLUS",LOM,60-69,0,1,0,1,0,0,0,1,0,1,Lombardia,ITC4
2021-01-14,PF/BT,1946,"FONDAZIONE ""CONTE DR. CARLO CARACCI"" - ONLUS",LOM,70-79,1,1,0,0,0,2,0,2,0,2,Lombardia,ITC4
2021-01-14,PF/BT,1946,"FONDAZIONE ""CONTE DR. CARLO CARACCI"" - ONLUS",LOM,80-89,0,5,0,0,0,5,0,5,0,5,Lombardia,ITC4
2021-01-14,PF/BT,1946,"FONDAZIONE ""CONTE DR. CARLO CARACCI"" - ONLUS",LOM,90+,1,6,0,0,0,7,0,7,0,7,Lombardia,ITC4
2021-01-14,PF/BT,1963,RSA DUCALE,LOM,40-49,0,5,0,2,3,0,0,5,0,5,Lombardia,ITC4
2021-01-14,PF/BT,1963,RSA DUCALE,LOM,50-59,2,2,0,2,2,0,0,4,0,4,Lombardia,ITC4
2021-01-14,PF/BT,1963,RSA DUCALE,LOM,70-79,1,0,0,0,0,1,0,1,0,1,Lombardia,ITC4
2021-01-14,PF/BT,1963,RSA DUCALE,LOM,80-89,0,4,0,0,0,4,0,4,0,4,Lombardia,ITC4
2021-01-14,PF/BT,1963,RSA DUCALE,LOM,90+,0,4,0,0,0,4,0,4,0,4,Lombardia,ITC4
2021-01-14,PF/BT,1965,RESIDENZA SANITARIA ASSISTENZIALE FONDAZIONE LUIGI BONI ONLUS,LOM,20-29,4,3,0,5,1,0,1,7,0,7,Lombardia,ITC4
2021-01-14,PF/BT,1965,RESIDENZA SANITARIA ASSISTENZIALE FONDAZIONE LUIGI BONI ONLUS,LOM,30-39,1,5,0,4,2,0,0,6,0,6,Lombardia,ITC4
2021-01-14,PF/BT,1965,RESIDENZA SANITARIA ASSISTENZIALE FONDAZIONE LUIGI BONI ONLUS,LOM,40-49,1,12,0,7,6,0,0,13,0,13,Lombardia,ITC4
2021-01-14,PF/BT,1965,RESIDENZA SANITARIA ASSISTENZIALE FONDAZIONE LUIGI BONI ONLUS,LOM,50-59,1,5,0,1,2,0,3,6,0,6,Lombardia,ITC4
2021-01-14,PF/BT,1965,RESIDENZA SANITARIA ASSISTENZIALE FONDAZIONE LUIGI BONI ONLUS,LOM,60-69,0,3,0,1,0,0,2,3,0,3,Lombardia,ITC4
2021-01-14,PF/BT,1965,RESIDENZA SANITARIA ASSISTENZIALE FONDAZIONE LUIGI BONI ONLUS,LOM,70-79,1,0,0,0,0,0,1,1,0,1,Lombardia,ITC4
2021-01-14,PF/BT,1975,RSA ZUCCHI-FALCINA,LOM,16-19,0,1,0,0,1,0,0,1,0,1,Lombardia,ITC4
2021-01-14,PF/BT,1975,RSA ZUCCHI-FALCINA,LOM,20-29,0,2,0,2,0,0,0,2,0,2,Lombardia,ITC4
2021-01-14,PF/BT,1975,RSA ZUCCHI-FALCINA,LOM,30-39,4,3,0,6,1,0,0,7,0,7,Lombardia,ITC4
2021-01-14,PF/BT,1975,RSA ZUCCHI-FALCINA,LOM,40-49,0,6,0,4,2,0,0,6,0,6,Lombardia,ITC4
2021-01-14,PF/BT,1975,RSA ZUCCHI-FALCINA,LOM,50-59,0,13,0,10,3,0,0,13,0,13,Lombardia,ITC4
2021-01-14,PF/BT,1975,RSA ZUCCHI-FALCINA,LOM,60-69,2,5,0,4,1,2,0,7,0,7,Lombardia,ITC4
2021-01-14,PF/BT,1975,RSA ZUCCHI-FALCINA,LOM,70-79,1,2,0,0,0,3,0,3,0,3,Lombardia,ITC4
2021-01-14,PF/BT,1975,RSA ZUCCHI-FALCINA,LOM,80-89,3,2,0,0,0,5,0,5,0,5,Lombardia,ITC4
2021-01-14,PF/BT,1975,RSA ZUCCHI-FALCINA,LOM,90+,0,4,0,0,0,4,0,4,0,4,Lombardia,ITC4
2021-01-14,PF/BT,1991,FONDAZIONE E. GERMANI CENTRO ASSISTENZIALE SANITARIO ONLUS,LOM,20-29,1,3,0,4,0,0,0,4,0,4,Lombardia,ITC4
2021-01-14,PF/BT,1991,FONDAZIONE E. GERMANI CENTRO ASSISTENZIALE SANITARIO ONLUS,LOM,30-39,4,7,0,8,3,0,0,11,0,11,Lombardia,ITC4
2021-01-14,PF/BT,1991,FONDAZIONE E. GERMANI CENTRO ASSISTENZIALE SANITARIO ONLUS,LOM,40-49,3,26,0,20,9,0,0,29,0,29,Lombardia,ITC4
2021-01-14,PF/BT,1991,FONDAZIONE E. GERMANI CENTRO ASSISTENZIALE SANITARIO ONLUS,LOM,50-59,4,29,0,26,7,0,0,33,0,33,Lombardia,ITC4
2021-01-14,PF/BT,1991,FONDAZIONE E. GERMANI CENTRO ASSISTENZIALE SANITARIO ONLUS,LOM,60-69,3,3,0,3,3,0,0,6,0,6,Lombardia,ITC4
2021-01-14,PF/BT,20,cv cremona,LOM,20-29,1,0,0,1,0,0,0,1,0,1,Lombardia,ITC4
2021-01-14,PF/BT,20,cv cremona,LOM,70-79,2,4,0,0,0,6,0,6,0,6,Lombardia,ITC4
2021-01-14,PF/BT,20,cv cremona,LOM,80-89,9,22,0,0,0,31,0,31,0,31,Lombardia,ITC4
2021-01-14,PF/BT,20,cv cremona,LOM,90+,4,30,0,0,0,34,0,34,0,34,Lombardia,ITC4
2021-01-14,PF/BT,2001,RESIDENZA SANITARIA ASSISTITA UNITA' GERIATRICA RIABILITATIVA ONLUS,LOM,20-29,0,1,0,1,0,0,0,1,0,1,Lombardia,ITC4
2021-01-14,PF/BT,2001,RESIDENZA SANITARIA ASSISTITA UNITA' GERIATRICA RIABILITATIVA ONLUS,LOM,30-39,2,0,0,2,0,0,0,2,0,2,Lombardia,ITC4
2021-01-14,PF/BT,2001,RESIDENZA SANITARIA ASSISTITA UNITA' GERIATRICA RIABILITATIVA ONLUS,LOM,40-49,1,4,0,5,0,0,0,5,0,5,Lombardia,ITC4
2021-01-14,PF/BT,2001,RESIDENZA SANITARIA ASSISTITA UNITA' GERIATRICA RIABILITATIVA ONLUS,LOM,50-59,2,3,0,5,0,0,0,5,0,5,Lombardia,ITC4
2021-01-14,PF/BT,2001,RESIDENZA SANITARIA ASSISTITA UNITA' GERIATRICA RIABILITATIVA ONLUS,LOM,60-69,0,1,0,1,0,0,0,1,0,1,Lombardia,ITC4
2021-01-14,PF/BT,2001,RESIDENZA SANITARIA ASSISTITA UNITA' GERIATRICA RIABILITATIVA ONLUS,LOM,80-89,0,9,0,0,0,9,0,9,0,9,Lombardia,ITC4
2021-01-14,PF/BT,2001,RESIDENZA SANITARIA ASSISTITA UNITA' GERIATRICA RIABILITATIVA ONLUS,LOM,90+,1,6,0,0,0,7,0,7,0,7,Lombardia,ITC4
2021-01-14,PF/BT,2022,rsa Villa Mater,LOM,20-29,1,1,0,2,0,0,0,2,0,2,Lombardia,ITC4
2021-01-14,PF/BT,2022,rsa Villa Mater,LOM,30-39,0,8,0,8,0,0,0,8,0,8,Lombardia,ITC4
2021-01-14,PF/BT,2022,rsa Villa Mater,LOM,40-49,1,5,0,5,0,0,1,6,0,6,Lombardia,ITC4
2021-01-14,PF/BT,2022,rsa Villa Mater,LOM,50-59,0,6,0,5,1,0,0,6,0,6,Lombardia,ITC4
2021-01-14,PF/BT,2022,rsa Villa Mater,LOM,60-69,1,5,0,4,0,0,2,6,0,6,Lombardia,ITC4
2021-01-14,PF/BT,2022,rsa Villa Mater,LOM,70-79,0,1,0,0,0,1,0,1,0,1,Lombardia,ITC4
2021-01-14,PF/BT,2022,rsa Villa Mater,LOM,80-89,3,3,0,0,0,6,0,6,0,6,Lombardia,ITC4
2021-01-14,PF/BT,2022,rsa Villa Mater,LOM,90+,0,1,0,0,0,1,0,1,0,1,Lombardia,ITC4
2021-01-14,PF/BT,2034,"FONDAZIONE GALTRUCCO - R.S.A. - Via Mortara , 30 - 27038 ROBBIO (PV)",LOM,30-39,0,1,0,1,0,0,0,1,0,1,Lombardia,ITC4
2021-01-14,PF/BT,2034,"FONDAZIONE GALTRUCCO - R.S.A. - Via Mortara , 30 - 27038 ROBBIO (PV)",LOM,40-49,0,6,0,4,2,0,0,6,0,6,Lombardia,ITC4
2021-01-14,PF/BT,2034,"FONDAZIONE GALTRUCCO - R.S.A. - Via Mortara , 30 - 27038 ROBBIO (PV)",LOM,50-59,1,5,0,5,0,0,1,6,0,6,Lombardia,ITC4
2021-01-14,PF/BT,2034,"FONDAZIONE GALTRUCCO - R.S.A. - Via Mortara , 30 - 27038 ROBBIO (PV)",LOM,60-69,1,2,0,1,0,2,0,3,0,3,Lombardia,ITC4
2021-01-14,PF/BT,2034,"FONDAZIONE GALTRUCCO - R.S.A. - Via Mortara , 30 - 27038 ROBBIO (PV)",LOM,70-79,2,1,0,0,0,3,0,3,0,3,Lombardia,ITC4
2021-01-14,PF/BT,2034,"FONDAZIONE GALTRUCCO - R.S.A. - Via Mortara , 30 - 27038 ROBBIO (PV)",LOM,80-89,2,9,0,0,0,11,0,11,0,11,Lombardia,ITC4
2021-01-14,PF/BT,2034,"FONDAZIONE GALTRUCCO - R.S.A. - Via Mortara , 30 - 27038 ROBBIO (PV)",LOM,90+,3,9,0,0,0,12,0,12,0,12,Lombardia,ITC4
2021-01-14,PF/BT,2054,fondazione san germano onlus RSA,LOM,30-39,0,2,0,2,0,0,0,2,0,2,Lombardia,ITC4
2021-01-14,PF/BT,2054,fondazione san germano onlus RSA,LOM,40-49,0,2,0,2,0,0,0,2,0,2,Lombardia,ITC4
2021-01-14,PF/BT,2054,fondazione san germano onlus RSA,LOM,50-59,1,1,0,1,1,0,0,2,0,2,Lombardia,ITC4
2021-01-14,PF/BT,2104,FONDAZIONE DON CARLO GNOCCHI-SANTA MARIA ALLE FONTI-SALICE TERME,LOM,30-39,1,2,0,3,0,0,0,3,0,3,Lombardia,ITC4
2021-01-14,PF/BT,2104,FONDAZIONE DON CARLO GNOCCHI-SANTA MARIA ALLE FONTI-SALICE TERME,LOM,40-49,2,8,0,8,2,0,0,10,0,10,Lombardia,ITC4
2021-01-14,PF/BT,2104,FONDAZIONE DON CARLO GNOCCHI-SANTA MARIA ALLE FONTI-SALICE TERME,LOM,50-59,2,7,0,8,1,0,0,9,0,9,Lombardia,ITC4
2021-01-14,PF/BT,2104,FONDAZIONE DON CARLO GNOCCHI-SANTA MARIA ALLE FONTI-SALICE TERME,LOM,60-69,1,1,0,1,0,1,0,2,0,2,Lombardia,ITC4
2021-01-14,PF/BT,2104,FONDAZIONE DON CARLO GNOCCHI-SANTA MARIA ALLE FONTI-SALICE TERME,LOM,70-79,3,1,0,0,0,4,0,4,0,4,Lombardia,ITC4
2021-01-14,PF/BT,2104,FONDAZIONE DON CARLO GNOCCHI-SANTA MARIA ALLE FONTI-SALICE TERME,LOM,80-89,1,4,0,0,0,5,0,5,0,5,Lombardia,ITC4
2021-01-14,PF/BT,2104,FONDAZIONE DON CARLO GNOCCHI-SANTA MARIA ALLE FONTI-SALICE TERME,LOM,90+,0,3,0,0,0,3,0,3,0,3,Lombardia,ITC4
2021-01-14,PF/BT,2110,RSA LA TUA CASA,LOM,20-29,0,2,0,2,0,0,0,2,0,2,Lombardia,ITC4
2021-01-14,PF/BT,2110,RSA LA TUA CASA,LOM,30-39,2,1,0,1,2,0,0,3,0,3,Lombardia,ITC4
2021-01-14,PF/BT,2110,RSA LA TUA CASA,LOM,40-49,0,7,0,7,0,0,0,7,0,7,Lombardia,ITC4
2021-01-14,PF/BT,2110,RSA LA TUA CASA,LOM,50-59,0,6,0,3,3,0,0,6,0,6,Lombardia,ITC4
2021-01-14,PF/BT,2110,RSA LA TUA CASA,LOM,60-69,1,1,0,0,1,1,0,2,0,2,Lombardia,ITC4
2021-01-14,PF/BT,2110,RSA LA TUA CASA,LOM,70-79,1,2,0,0,0,3,0,3,0,3,Lombardia,ITC4
2021-01-14,PF/BT,2110,RSA LA TUA CASA,LOM,80-89,3,5,0,0,0,8,0,8,0,8,Lombardia,ITC4
2021-01-14,PF/BT,2110,RSA LA TUA CASA,LOM,90+,2,9,0,0,0,11,0,11,0,11,Lombardia,ITC4
2021-01-14,PF/BT,2153,FONDAZIONE OSPEDALE FAGNANI - GALTRUCCO RSA,LOM,20-29,1,0,0,1,0,0,0,1,0,1,Lombardia,ITC4
2021-01-14,PF/BT,2153,FONDAZIONE OSPEDALE FAGNANI - GALTRUCCO RSA,LOM,40-49,0,7,0,4,3,0,0,7,0,7,Lombardia,ITC4
2021-01-14,PF/BT,2153,FONDAZIONE OSPEDALE FAGNANI - GALTRUCCO RSA,LOM,50-59,0,7,0,3,3,0,1,7,0,7,Lombardia,ITC4
2021-01-14,PF/BT,2153,FONDAZIONE OSPEDALE FAGNANI - GALTRUCCO RSA,LOM,70-79,1,1,0,0,0,0,2,2,0,2,Lombardia,ITC4
2021-01-14,PF/BT,2153,FONDAZIONE OSPEDALE FAGNANI - GALTRUCCO RSA,LOM,80-89,0,1,0,0,0,1,0,1,0,1,Lombardia,ITC4
2021-01-14,PF/BT,2174  (R.S.A.),"Ambulatorio della R.S.A. Mons. L. Novarese (Palestro, PV)",LOM,30-39,1,4,0,4,1,0,0,5,0,5,Lombardia,ITC4
2021-01-14,PF/BT,2174  (R.S.A.),"Ambulatorio della R.S.A. Mons. L. Novarese (Palestro, PV)",LOM,40-49,4,13,0,15,2,0,0,17,0,17,Lombardia,ITC4
2021-01-14,PF/BT,2174  (R.S.A.),"Ambulatorio della R.S.A. Mons. L. Novarese (Palestro, PV)",LOM,50-59,2,9,0,7,4,0,0,11,0,11,Lombardia,ITC4
2021-01-14,PF/BT,2174  (R.S.A.),"Ambulatorio della R.S.A. Mons. L. Novarese (Palestro, PV)",LOM,60-69,1,3,0,3,1,0,0,4,0,4,Lombardia,ITC4
2021-01-14,PF/BT,2174  (R.S.A.),"Ambulatorio della R.S.A. Mons. L. Novarese (Palestro, PV)",LOM,80-89,1,3,0,0,0,4,0,4,0,4,Lombardia,ITC4
2021-01-14,PF/BT,2174  (R.S.A.),"Ambulatorio della R.S.A. Mons. L. Novarese (Palestro, PV)",LOM,90+,0,1,0,0,0,1,0,1,0,1,Lombardia,ITC4
2021-01-14,PF/BT,228,"RSA ""POLO GERIATRICO RIABILITATIVO 1”",LOM,20-29,2,1,0,2,1,0,0,3,0,3,Lombardia,ITC4
2021-01-14,PF/BT,228,"RSA ""POLO GERIATRICO RIABILITATIVO 1”",LOM,30-39,1,3,0,4,0,0,0,4,0,4,Lombardia,ITC4
2021-01-14,PF/BT,228,"RSA ""POLO GERIATRICO RIABILITATIVO 1”",LOM,40-49,1,2,0,1,2,0,0,3,0,3,Lombardia,ITC4
2021-01-14,PF/BT,228,"RSA ""POLO GERIATRICO RIABILITATIVO 1”",LOM,50-59,1,11,0,10,2,0,0,12,0,12,Lombardia,ITC4
2021-01-14,PF/BT,228,"RSA ""POLO GERIATRICO RIABILITATIVO 1”",LOM,60-69,0,2,0,2,0,0,0,2,0,2,Lombardia,ITC4
2021-01-14,PF/BT,228,"RSA ""POLO GERIATRICO RIABILITATIVO 1”",LOM,80-89,0,1,0,0,0,1,0,1,0,1,Lombardia,ITC4
2021-01-14,PF/BT,228,"RSA ""POLO GERIATRICO RIABILITATIVO 1”",LOM,90+,0,1,0,0,0,1,0,1,0,1,Lombardia,ITC4
2021-01-14,PF/BT,270,HOSPICE BEATI CONIUGI MARTIN,LOM,20-29,1,0,0,0,1,0,0,1,0,1,Lombardia,ITC4
2021-01-14,PF/BT,270,HOSPICE BEATI CONIUGI MARTIN,LOM,30-39,1,1,0,1,1,0,0,2,0,2,Lombardia,ITC4
2021-01-14,PF/BT,270,HOSPICE BEATI CONIUGI MARTIN,LOM,40-49,1,2,0,2,1,0,0,3,0,3,Lombardia,ITC4
2021-01-14,PF/BT,270,HOSPICE BEATI CONIUGI MARTIN,LOM,60-69,0,1,0,1,0,0,0,1,0,1,Lombardia,ITC4
2021-01-14,PF/BT,2746,FONDAZIONE RSA GARIBALDI POGLIANI - CAPIAGO INTIMIANO,LOM,40-49,0,1,0,1,0,0,0,1,0,1,Lombardia,ITC4
2021-01-14,PF/BT,2746,FONDAZIONE RSA GARIBALDI POGLIANI - CAPIAGO INTIMIANO,LOM,50-59,0,2,0,2,0,0,0,2,0,2,Lombardia,ITC4
2021-01-14,PF/BT,2746,FONDAZIONE RSA GARIBALDI POGLIANI - CAPIAGO INTIMIANO,LOM,60-69,2,3,0,0,0,5,0,5,0,5,Lombardia,ITC4
2021-01-14,PF/BT,2746,FONDAZIONE RSA GARIBALDI POGLIANI - CAPIAGO INTIMIANO,LOM,70-79,3,1,0,0,0,4,0,4,0,4,Lombardia,ITC4
2021-01-14,PF/BT,2746,FONDAZIONE RSA GARIBALDI POGLIANI - CAPIAGO INTIMIANO,LOM,80-89,4,13,0,0,0,17,0,17,0,17,Lombardia,ITC4
2021-01-14,PF/BT,2746,FONDAZIONE RSA GARIBALDI POGLIANI - CAPIAGO INTIMIANO,LOM,90+,0,13,0,0,0,13,0,13,0,13,Lombardia,ITC4
2021-01-14,PF/BT,2761,FONDAZIONE CA'D'INDUSTRIA LE CAMELIE,LOM,20-29,1,0,0,1,0,0,0,1,0,1,Lombardia,ITC4
2021-01-14,PF/BT,2761,FONDAZIONE CA'D'INDUSTRIA LE CAMELIE,LOM,30-39,3,5,0,6,2,0,0,8,0,8,Lombardia,ITC4
2021-01-14,PF/BT,2761,FONDAZIONE CA'D'INDUSTRIA LE CAMELIE,LOM,40-49,1,9,0,9,1,0,0,10,0,10,Lombardia,ITC4
2021-01-14,PF/BT,2761,FONDAZIONE CA'D'INDUSTRIA LE CAMELIE,LOM,50-59,2,15,0,5,12,0,0,17,0,17,Lombardia,ITC4
2021-01-14,PF/BT,2761,FONDAZIONE CA'D'INDUSTRIA LE CAMELIE,LOM,60-69,0,6,0,2,4,0,0,6,0,6,Lombardia,ITC4
2021-01-14,PF/BT,2884,RSA fondazione ferriere e fonderie dongo onlus,LOM,40-49,0,2,0,2,0,0,0,2,0,2,Lombardia,ITC4
2021-01-14,PF/BT,2884,RSA fondazione ferriere e fonderie dongo onlus,LOM,50-59,0,4,0,2,2,0,0,4,0,4,Lombardia,ITC4
2021-01-14,PF/BT,3002952,"RSA CASA ""SACRO CUORE"" - PIANELLO DEL LARIO (CO)",LOM,20-29,1,0,0,1,0,0,0,1,0,1,Lombardia,ITC4
2021-01-14,PF/BT,3002952,"RSA CASA ""SACRO CUORE"" - PIANELLO DEL LARIO (CO)",LOM,30-39,0,7,0,6,1,0,0,7,0,7,Lombardia,ITC4
2021-01-14,PF/BT,3002952,"RSA CASA ""SACRO CUORE"" - PIANELLO DEL LARIO (CO)",LOM,40-49,1,11,0,9,2,0,1,12,0,12,Lombardia,ITC4
2021-01-14,PF/BT,3002952,"RSA CASA ""SACRO CUORE"" - PIANELLO DEL LARIO (CO)",LOM,50-59,2,14,0,10,6,0,0,16,0,16,Lombardia,ITC4
2021-01-14,PF/BT,3002952,"RSA CASA ""SACRO CUORE"" - PIANELLO DEL LARIO (CO)",LOM,60-69,3,10,0,6,1,2,4,13,0,13,Lombardia,ITC4
2021-01-14,PF/BT,3002952,"RSA CASA ""SACRO CUORE"" - PIANELLO DEL LARIO (CO)",LOM,70-79,0,3,0,0,0,1,2,3,0,3,Lombardia,ITC4
2021-01-14,PF/BT,3002952,"RSA CASA ""SACRO CUORE"" - PIANELLO DEL LARIO (CO)",LOM,80-89,1,12,0,0,0,13,0,13,0,13,Lombardia,ITC4
2021-01-14,PF/BT,3002952,"RSA CASA ""SACRO CUORE"" - PIANELLO DEL LARIO (CO)",LOM,90+,0,10,0,0,0,10,0,10,0,10,Lombardia,ITC4
2021-01-14,PF/BT,3003100,OSPEDALE MORIGGIA PELASCINI - GRAVEDONA,LOM,20-29,1,7,0,8,0,0,0,8,0,8,Lombardia,ITC4
2021-01-14,PF/BT,3003100,OSPEDALE MORIGGIA PELASCINI - GRAVEDONA,LOM,30-39,6,3,0,9,0,0,0,9,0,9,Lombardia,ITC4
2021-01-14,PF/BT,3003100,OSPEDALE MORIGGIA PELASCINI - GRAVEDONA,LOM,40-49,4,8,0,12,0,0,0,12,0,12,Lombardia,ITC4
2021-01-14,PF/BT,3003100,OSPEDALE MORIGGIA PELASCINI - GRAVEDONA,LOM,50-59,5,10,0,15,0,0,0,15,0,15,Lombardia,ITC4
2021-01-14,PF/BT,3003100,OSPEDALE MORIGGIA PELASCINI - GRAVEDONA,LOM,60-69,6,1,0,7,0,0,0,7,0,7,Lombardia,ITC4
2021-01-14,PF/BT,3003100,OSPEDALE MORIGGIA PELASCINI - GRAVEDONA,LOM,70-79,3,0,0,3,0,0,0,3,0,3,Lombardia,ITC4
2021-01-14,PF/BT,30071,Centro Vaccinale Covid Melzo - ASST Melegnano Martesana,LOM,20-29,16,19,0,35,0,0,0,35,0,35,Lombardia,ITC4
2021-01-14,PF/BT,30071,Centro Vaccinale Covid Melzo - ASST Melegnano Martesana,LOM,30-39,27,21,0,46,2,0,0,48,0,48,Lombardia,ITC4
2021-01-14,PF/BT,30071,Centro Vaccinale Covid Melzo - ASST Melegnano Martesana,LOM,40-49,20,27,0,44,3,0,0,47,0,47,Lombardia,ITC4
2021-01-14,PF/BT,30071,Centro Vaccinale Covid Melzo - ASST Melegnano Martesana,LOM,50-59,40,67,0,92,15,0,0,107,0,107,Lombardia,ITC4
2021-01-14,PF/BT,30071,Centro Vaccinale Covid Melzo - ASST Melegnano Martesana,LOM,60-69,34,30,0,47,17,0,0,64,0,64,Lombardia,ITC4
2021-01-14,PF/BT,30071,Centro Vaccinale Covid Melzo - ASST Melegnano Martesana,LOM,70-79,8,4,0,0,0,0,12,12,0,12,Lombardia,ITC4
2021-01-14,PF/BT,30072,Centro Vaccinale Covid Vizzolo - ASST Melegnano Martesana,LOM,20-29,6,16,0,19,3,0,0,22,0,22,Lombardia,ITC4
2021-01-14,PF/BT,30072,Centro Vaccinale Covid Vizzolo - ASST Melegnano Martesana,LOM,30-39,8,18,0,24,2,0,0,26,0,26,Lombardia,ITC4
2021-01-14,PF/BT,30072,Centro Vaccinale Covid Vizzolo - ASST Melegnano Martesana,LOM,40-49,11,27,0,31,7,0,0,38,0,38,Lombardia,ITC4
2021-01-14,PF/BT,30072,Centro Vaccinale Covid Vizzolo - ASST Melegnano Martesana,LOM,50-59,14,29,0,36,7,0,0,43,0,43,Lombardia,ITC4
2021-01-14,PF/BT,30072,Centro Vaccinale Covid Vizzolo - ASST Melegnano Martesana,LOM,60-69,3,15,0,14,4,0,0,18,0,18,Lombardia,ITC4
2021-01-14,PF/BT,30072,Centro Vaccinale Covid Vizzolo - ASST Melegnano Martesana,LOM,70-79,2,1,0,0,0,0,3,3,0,3,Lombardia,ITC4
2021-01-14,PF/BT,30073,CV Bollate,LOM,20-29,7,3,0,6,0,0,4,10,0,10,Lombardia,ITC4
2021-01-14,PF/BT,30073,CV Bollate,LOM,30-39,5,1,0,3,0,0,3,6,0,6,Lombardia,ITC4
2021-01-14,PF/BT,30073,CV Bollate,LOM,40-49,6,2,0,2,0,0,6,8,0,8,Lombardia,ITC4
2021-01-14,PF/BT,30073,CV Bollate,LOM,50-59,7,6,0,7,0,0,6,13,0,13,Lombardia,ITC4
2021-01-14,PF/BT,30073,CV Bollate,LOM,60-69,4,0,0,3,0,0,1,4,0,4,Lombardia,ITC4
2021-01-14,PF/BT,30073,CV Bollate,LOM,70-79,1,0,0,0,0,0,1,1,0,1,Lombardia,ITC4
2021-01-14,PF/BT,30073,cv rho,LOM,20-29,1,13,0,14,0,0,0,14,0,14,Lombardia,ITC4
2021-01-14,PF/BT,30073,cv rho,LOM,30-39,1,5,0,6,0,0,0,6,0,6,Lombardia,ITC4
2021-01-14,PF/BT,30073,cv rho,LOM,40-49,1,11,0,12,0,0,0,12,0,12,Lombardia,ITC4
2021-01-14,PF/BT,30073,cv rho,LOM,50-59,2,12,0,12,2,0,0,14,0,14,Lombardia,ITC4
2021-01-14,PF/BT,30073,cv rho,LOM,60-69,3,5,0,7,1,0,0,8,0,8,Lombardia,ITC4
2021-01-14,PF/BT,30074,HUB COVID MAGENTA,LOM,20-29,1,1,0,1,1,0,0,2,0,2,Lombardia,ITC4
2021-01-14,PF/BT,30074,HUB COVID MAGENTA,LOM,30-39,3,3,0,3,3,0,0,6,0,6,Lombardia,ITC4
2021-01-14,PF/BT,30074,HUB COVID MAGENTA,LOM,40-49,4,19,0,10,13,0,0,23,0,23,Lombardia,ITC4
2021-01-14,PF/BT,30074,HUB COVID MAGENTA,LOM,50-59,11,23,0,5,29,0,0,34,0,34,Lombardia,ITC4
2021-01-14,PF/BT,30074,HUB COVID MAGENTA,LOM,60-69,1,4,0,1,4,0,0,5,0,5,Lombardia,ITC4
2021-01-14,PF/BT,30085,Centro Vaccinale Covid Cernusco - ASST Melegnano Martesana,LOM,20-29,3,4,0,7,0,0,0,7,0,7,Lombardia,ITC4
2021-01-14,PF/BT,30085,Centro Vaccinale Covid Cernusco - ASST Melegnano Martesana,LOM,30-39,6,8,0,12,2,0,0,14,0,14,Lombardia,ITC4
2021-01-14,PF/BT,30085,Centro Vaccinale Covid Cernusco - ASST Melegnano Martesana,LOM,40-49,8,20,0,23,5,0,0,28,0,28,Lombardia,ITC4
2021-01-14,PF/BT,30085,Centro Vaccinale Covid Cernusco - ASST Melegnano Martesana,LOM,50-59,8,24,0,19,13,0,0,32,0,32,Lombardia,ITC4
2021-01-14,PF/BT,30085,Centro Vaccinale Covid Cernusco - ASST Melegnano Martesana,LOM,60-69,5,8,0,10,3,0,0,13,0,13,Lombardia,ITC4
2021-01-14,PF/BT,30085,Centro Vaccinale Covid Cernusco - ASST Melegnano Martesana,LOM,70-79,2,0,0,2,0,0,0,2,0,2,Lombardia,ITC4
2021-01-14,PF/BT,30096,CASA DI CURA DEL POLICLINICO - MILANO,LOM,20-29,0,1,0,1,0,0,0,1,0,1,Lombardia,ITC4
2021-01-14,PF/BT,30096,CASA DI CURA DEL POLICLINICO - MILANO,LOM,30-39,5,6,0,11,0,0,0,11,0,11,Lombardia,ITC4
2021-01-14,PF/BT,30096,CASA DI CURA DEL POLICLINICO - MILANO,LOM,40-49,1,4,0,5,0,0,0,5,0,5,Lombardia,ITC4
2021-01-14,PF/BT,30096,CASA DI CURA DEL POLICLINICO - MILANO,LOM,50-59,1,2,0,3,0,0,0,3,0,3,Lombardia,ITC4
2021-01-14,PF/BT,30096,CASA DI CURA DEL POLICLINICO - MILANO,LOM,60-69,0,2,0,2,0,0,0,2,0,2,Lombardia,ITC4
2021-01-14,PF/BT,30096,CASA DI CURA DEL POLICLINICO - MILANO,LOM,70-79,2,0,0,2,0,0,0,2,0,2,Lombardia,ITC4
2021-01-14,PF/BT,30156,Centro Vaccinale Covid Desenzano,LOM,16-19,0,1,0,0,0,0,1,1,0,1,Lombardia,ITC4
2021-01-14,PF/BT,30156,Centro Vaccinale Covid Desenzano,LOM,20-29,9,14,0,3,0,0,20,23,0,23,Lombardia,ITC4
2021-01-14,PF/BT,30156,Centro Vaccinale Covid Desenzano,LOM,30-39,6,7,0,1,2,0,10,13,0,13,Lombardia,ITC4
2021-01-14,PF/BT,30156,Centro Vaccinale Covid Desenzano,LOM,40-49,13,22,0,1,1,0,33,35,0,35,Lombardia,ITC4
2021-01-14,PF/BT,30156,Centro Vaccinale Covid Desenzano,LOM,50-59,18,31,0,9,1,0,39,49,0,49,Lombardia,ITC4
2021-01-14,PF/BT,30156,Centro Vaccinale Covid Desenzano,LOM,60-69,14,9,0,0,1,0,22,23,0,23,Lombardia,ITC4
2021-01-14,PF/BT,30156,Centro Vaccinale Covid Desenzano,LOM,70-79,3,2,0,0,0,0,5,5,0,5,Lombardia,ITC4
2021-01-14,PF/BT,30156,Centro Vaccinale Covid Desenzano,LOM,80-89,1,0,0,0,1,0,0,1,0,1,Lombardia,ITC4
2021-01-14,PF/BT,30157,Centro Vaccinale Covid Gavardo,LOM,20-29,3,6,0,4,0,0,5,9,0,9,Lombardia,ITC4
2021-01-14,PF/BT,30157,Centro Vaccinale Covid Gavardo,LOM,30-39,4,6,0,5,3,0,2,10,0,10,Lombardia,ITC4
2021-01-14,PF/BT,30157,Centro Vaccinale Covid Gavardo,LOM,40-49,10,11,0,4,5,0,12,21,0,21,Lombardia,ITC4
2021-01-14,PF/BT,30157,Centro Vaccinale Covid Gavardo,LOM,50-59,16,13,0,9,7,0,13,29,0,29,Lombardia,ITC4
2021-01-14,PF/BT,30157,Centro Vaccinale Covid Gavardo,LOM,60-69,22,8,0,6,2,0,22,30,0,30,Lombardia,ITC4
2021-01-14,PF/BT,30157,Centro Vaccinale Covid Gavardo,LOM,70-79,15,0,0,0,0,0,15,15,0,15,Lombardia,ITC4
2021-01-14,PF/BT,30176,ISTITUTO CLINICO S. ANNA di ISTITUTI OSPEDALIERI BRESCIANI S.p.A.,LOM,20-29,4,1,0,5,0,0,0,5,0,5,Lombardia,ITC4
2021-01-14,PF/BT,30176,ISTITUTO CLINICO S. ANNA di ISTITUTI OSPEDALIERI BRESCIANI S.p.A.,LOM,30-39,4,4,0,8,0,0,0,8,0,8,Lombardia,ITC4
2021-01-14,PF/BT,30176,ISTITUTO CLINICO S. ANNA di ISTITUTI OSPEDALIERI BRESCIANI S.p.A.,LOM,40-49,5,7,0,10,2,0,0,12,0,12,Lombardia,ITC4
2021-01-14,PF/BT,30176,ISTITUTO CLINICO S. ANNA di ISTITUTI OSPEDALIERI BRESCIANI S.p.A.,LOM,50-59,3,6,0,8,1,0,0,9,0,9,Lombardia,ITC4
2021-01-14,PF/BT,30176,ISTITUTO CLINICO S. ANNA di ISTITUTI OSPEDALIERI BRESCIANI S.p.A.,LOM,60-69,1,1,0,2,0,0,0,2,0,2,Lombardia,ITC4
2021-01-14,PF/BT,30184,Centro Vaccinale Covid Manerbio,LOM,16-19,1,3,0,1,1,0,2,4,0,4,Lombardia,ITC4
2021-01-14,PF/BT,30184,Centro Vaccinale Covid Manerbio,LOM,20-29,4,9,0,1,1,0,11,13,0,13,Lombardia,ITC4
2021-01-14,PF/BT,30184,Centro Vaccinale Covid Manerbio,LOM,30-39,6,10,0,1,0,0,15,16,0,16,Lombardia,ITC4
2021-01-14,PF/BT,30184,Centro Vaccinale Covid Manerbio,LOM,40-49,9,5,0,1,0,0,13,14,0,14,Lombardia,ITC4
2021-01-14,PF/BT,30184,Centro Vaccinale Covid Manerbio,LOM,50-59,11,21,0,10,3,0,19,32,0,32,Lombardia,ITC4
2021-01-14,PF/BT,30184,Centro Vaccinale Covid Manerbio,LOM,60-69,12,8,0,3,0,0,17,20,0,20,Lombardia,ITC4
2021-01-14,PF/BT,30184,Centro Vaccinale Covid Manerbio,LOM,70-79,2,1,0,0,0,0,3,3,0,3,Lombardia,ITC4
2021-01-14,PF/BT,30191,PVT OSPEDALE S.MARTINO – MEDE,LOM,20-29,0,2,0,2,0,0,0,2,0,2,Lombardia,ITC4
2021-01-14,PF/BT,30191,PVT OSPEDALE S.MARTINO – MEDE,LOM,30-39,1,6,0,5,2,0,0,7,0,7,Lombardia,ITC4
2021-01-14,PF/BT,30191,PVT OSPEDALE S.MARTINO – MEDE,LOM,40-49,0,3,0,1,2,0,0,3,0,3,Lombardia,ITC4
2021-01-14,PF/BT,30191,PVT OSPEDALE S.MARTINO – MEDE,LOM,50-59,3,11,0,10,4,0,0,14,0,14,Lombardia,ITC4
2021-01-14,PF/BT,30191,PVT OSPEDALE S.MARTINO – MEDE,LOM,60-69,4,0,0,3,1,0,0,4,0,4,Lombardia,ITC4
2021-01-14,PF/BT,30193,Ambulatorio HUB Vigevano,LOM,16-19,1,0,0,0,1,0,0,1,0,1,Lombardia,ITC4
2021-01-14,PF/BT,30193,Ambulatorio HUB Vigevano,LOM,20-29,11,11,0,2,20,0,0,22,0,22,Lombardia,ITC4
2021-01-14,PF/BT,30193,Ambulatorio HUB Vigevano,LOM,30-39,3,18,0,10,11,0,0,21,0,21,Lombardia,ITC4
2021-01-14,PF/BT,30193,Ambulatorio HUB Vigevano,LOM,40-49,15,14,0,6,23,0,0,29,0,29,Lombardia,ITC4
2021-01-14,PF/BT,30193,Ambulatorio HUB Vigevano,LOM,50-59,18,36,0,15,39,0,0,54,0,54,Lombardia,ITC4
2021-01-14,PF/BT,30193,Ambulatorio HUB Vigevano,LOM,60-69,14,14,0,0,28,0,0,28,0,28,Lombardia,ITC4
2021-01-14,PF/BT,30193,Ambulatorio HUB Vigevano,LOM,70-79,7,4,0,0,11,0,0,11,0,11,Lombardia,ITC4
2021-01-14,PF/BT,30193,Ambulatorio HUB Vigevano,LOM,80-89,1,0,0,0,1,0,0,1,0,1,Lombardia,ITC4
2021-01-14,PF/BT,30194,AMBULATORIO HUB VOGHERA,LOM,20-29,5,6,0,7,4,0,0,11,0,11,Lombardia,ITC4
2021-01-14,PF/BT,30194,AMBULATORIO HUB VOGHERA,LOM,30-39,8,12,0,10,10,0,0,20,0,20,Lombardia,ITC4
2021-01-14,PF/BT,30194,AMBULATORIO HUB VOGHERA,LOM,40-49,6,13,0,8,11,0,0,19,0,19,Lombardia,ITC4
2021-01-14,PF/BT,30194,AMBULATORIO HUB VOGHERA,LOM,50-59,5,30,0,22,13,0,0,35,0,35,Lombardia,ITC4
2021-01-14,PF/BT,30194,AMBULATORIO HUB VOGHERA,LOM,60-69,8,6,0,4,10,0,0,14,0,14,Lombardia,ITC4
2021-01-14,PF/BT,30194,AMBULATORIO HUB VOGHERA,LOM,70-79,2,1,0,0,3,0,0,3,0,3,Lombardia,ITC4
2021-01-14,PF/BT,30194,Punto vaccinale Territoriale ASST di Pavia,LOM,20-29,5,13,0,18,0,0,0,18,0,18,Lombardia,ITC4
2021-01-14,PF/BT,30194,Punto vaccinale Territoriale ASST di Pavia,LOM,30-39,4,15,0,14,5,0,0,19,0,19,Lombardia,ITC4
2021-01-14,PF/BT,30194,Punto vaccinale Territoriale ASST di Pavia,LOM,40-49,10,8,0,16,2,0,0,18,0,18,Lombardia,ITC4
2021-01-14,PF/BT,30194,Punto vaccinale Territoriale ASST di Pavia,LOM,50-59,4,29,0,25,8,0,0,33,0,33,Lombardia,ITC4
2021-01-14,PF/BT,30194,Punto vaccinale Territoriale ASST di Pavia,LOM,60-69,6,14,0,13,7,0,0,20,0,20,Lombardia,ITC4
2021-01-14,PF/BT,3019700,CASA DI CURA VILLA ESPERIA,LOM,20-29,5,6,0,11,0,0,0,11,0,11,Lombardia,ITC4
2021-01-14,PF/BT,3019700,CASA DI CURA VILLA ESPERIA,LOM,30-39,7,11,0,15,3,0,0,18,0,18,Lombardia,ITC4
2021-01-14,PF/BT,3019700,CASA DI CURA VILLA ESPERIA,LOM,40-49,4,6,0,4,6,0,0,10,0,10,Lombardia,ITC4
2021-01-14,PF/BT,3019700,CASA DI CURA VILLA ESPERIA,LOM,50-59,0,6,0,6,0,0,0,6,0,6,Lombardia,ITC4
2021-01-14,PF/BT,3019700,CASA DI CURA VILLA ESPERIA,LOM,60-69,0,2,0,2,0,0,0,2,0,2,Lombardia,ITC4
2021-01-14,PF/BT,3019700,CASA DI CURA VILLA ESPERIA,LOM,70-79,1,0,0,1,0,0,0,1,0,1,Lombardia,ITC4
2021-01-14,PF/BT,302,Istituto Palazzolo Fondazione Don Carlo Gnocchi,LOM,20-29,3,3,0,5,1,0,0,6,0,6,Lombardia,ITC4
2021-01-14,PF/BT,302,Istituto Palazzolo Fondazione Don Carlo Gnocchi,LOM,30-39,6,9,0,15,0,0,0,15,0,15,Lombardia,ITC4
2021-01-14,PF/BT,302,Istituto Palazzolo Fondazione Don Carlo Gnocchi,LOM,40-49,8,21,0,26,3,0,0,29,0,29,Lombardia,ITC4
2021-01-14,PF/BT,302,Istituto Palazzolo Fondazione Don Carlo Gnocchi,LOM,50-59,4,31,0,33,2,0,0,35,0,35,Lombardia,ITC4
2021-01-14,PF/BT,302,Istituto Palazzolo Fondazione Don Carlo Gnocchi,LOM,60-69,3,8,0,10,1,0,0,11,0,11,Lombardia,ITC4
2021-01-14,PF/BT,30209,OSPEDALE MAGGIORE DI CREMA,LOM,20-29,4,14,0,8,1,0,9,18,0,18,Lombardia,ITC4
2021-01-14,PF/BT,30209,OSPEDALE MAGGIORE DI CREMA,LOM,30-39,10,24,0,21,6,0,7,34,0,34,Lombardia,ITC4
2021-01-14,PF/BT,30209,OSPEDALE MAGGIORE DI CREMA,LOM,40-49,9,40,0,31,7,0,11,49,0,49,Lombardia,ITC4
2021-01-14,PF/BT,30209,OSPEDALE MAGGIORE DI CREMA,LOM,50-59,13,42,0,22,23,0,10,55,0,55,Lombardia,ITC4
2021-01-14,PF/BT,30209,OSPEDALE MAGGIORE DI CREMA,LOM,60-69,14,10,0,10,6,0,8,24,0,24,Lombardia,ITC4
2021-01-14,PF/BT,30209,OSPEDALE MAGGIORE DI CREMA,LOM,70-79,5,1,0,0,0,0,6,6,0,6,Lombardia,ITC4
2021-01-14,PF/BT,3021800,Casa di Cura san Camillo cremona,LOM,20-29,2,4,0,6,0,0,0,6,0,6,Lombardia,ITC4
2021-01-14,PF/BT,3021800,Casa di Cura san Camillo cremona,LOM,30-39,4,7,0,8,3,0,0,11,0,11,Lombardia,ITC4
2021-01-14,PF/BT,3021800,Casa di Cura san Camillo cremona,LOM,40-49,0,10,0,8,2,0,0,10,0,10,Lombardia,ITC4
2021-01-14,PF/BT,3021800,Casa di Cura san Camillo cremona,LOM,50-59,1,14,0,13,2,0,0,15,0,15,Lombardia,ITC4
2021-01-14,PF/BT,3021800,Casa di Cura san Camillo cremona,LOM,60-69,2,1,0,2,0,0,1,3,0,3,Lombardia,ITC4
2021-01-14,PF/BT,3021800,Casa di Cura san Camillo cremona,LOM,70-79,5,0,0,1,0,0,4,5,0,5,Lombardia,ITC4
2021-01-14,PF/BT,3021800,Casa di Cura san Camillo cremona,LOM,80-89,3,0,0,0,0,0,3,3,0,3,Lombardia,ITC4
2021-01-14,PF/BT,3021800,Casa di Cura san Camillo cremona,LOM,90+,1,0,0,0,0,0,1,1,0,1,Lombardia,ITC4
2021-01-14,PF/BT,30281,HUB LEGNANO,LOM,20-29,5,18,0,16,7,0,0,23,0,23,Lombardia,ITC4
2021-01-14,PF/BT,30281,HUB LEGNANO,LOM,30-39,13,18,0,21,10,0,0,31,0,31,Lombardia,ITC4
2021-01-14,PF/BT,30281,HUB LEGNANO,LOM,40-49,8,57,0,36,29,0,0,65,0,65,Lombardia,ITC4
2021-01-14,PF/BT,30281,HUB LEGNANO,LOM,50-59,18,73,0,30,61,0,0,91,0,91,Lombardia,ITC4
2021-01-14,PF/BT,30281,HUB LEGNANO,LOM,60-69,8,17,0,10,15,0,0,25,0,25,Lombardia,ITC4
2021-01-14,PF/BT,30281,HUB LEGNANO,LOM,70-79,1,0,0,0,1,0,0,1,0,1,Lombardia,ITC4
2021-01-14,PF/BT,30322000698,RSA Fondazione G. e G.Ronzoni,LOM,70-79,0,1,0,0,0,1,0,1,0,1,Lombardia,ITC4
2021-01-14,PF/BT,30322000698,RSA Fondazione G. e G.Ronzoni,LOM,80-89,1,3,0,0,0,4,0,4,0,4,Lombardia,ITC4
2021-01-14,PF/BT,30322000698,RSA Fondazione G. e G.Ronzoni,LOM,90+,0,1,0,0,0,1,0,1,0,1,Lombardia,ITC4
2021-01-14,PF/BT,30322029,Ospedale Religioso Classificato Sacra Famiglia Fatebenefratelli Erba,LOM,20-29,3,6,0,8,1,0,0,9,0,9,Lombardia,ITC4
2021-01-14,PF/BT,30322029,Ospedale Religioso Classificato Sacra Famiglia Fatebenefratelli Erba,LOM,30-39,5,11,0,16,0,0,0,16,0,16,Lombardia,ITC4
2021-01-14,PF/BT,30322029,Ospedale Religioso Classificato Sacra Famiglia Fatebenefratelli Erba,LOM,40-49,4,21,0,25,0,0,0,25,0,25,Lombardia,ITC4
2021-01-14,PF/BT,30322029,Ospedale Religioso Classificato Sacra Famiglia Fatebenefratelli Erba,LOM,50-59,9,17,0,24,2,0,0,26,0,26,Lombardia,ITC4
2021-01-14,PF/BT,30322029,Ospedale Religioso Classificato Sacra Famiglia Fatebenefratelli Erba,LOM,60-69,6,1,0,7,0,0,0,7,0,7,Lombardia,ITC4
2021-01-14,PF/BT,30322029,Ospedale Religioso Classificato Sacra Famiglia Fatebenefratelli Erba,LOM,70-79,1,0,0,1,0,0,0,1,0,1,Lombardia,ITC4
2021-01-14,PF/BT,30326001600,FONDAZIONE CASA DI RIPOSO VILLA G.PADOVANI ONLUS,LOM,20-29,0,1,0,1,0,0,0,1,0,1,Lombardia,ITC4
2021-01-14,PF/BT,30326001600,FONDAZIONE CASA DI RIPOSO VILLA G.PADOVANI ONLUS,LOM,30-39,0,3,0,3,0,0,0,3,0,3,Lombardia,ITC4
2021-01-14,PF/BT,30326001600,FONDAZIONE CASA DI RIPOSO VILLA G.PADOVANI ONLUS,LOM,40-49,0,4,0,3,1,0,0,4,0,4,Lombardia,ITC4
2021-01-14,PF/BT,30326001600,FONDAZIONE CASA DI RIPOSO VILLA G.PADOVANI ONLUS,LOM,50-59,1,3,0,3,1,0,0,4,0,4,Lombardia,ITC4
2021-01-14,PF/BT,30326001723,FONDAZIONE DANTE CUSI ONLUS,LOM,60-69,0,1,0,0,0,1,0,1,0,1,Lombardia,ITC4
2021-01-14,PF/BT,30326001723,FONDAZIONE DANTE CUSI ONLUS,LOM,70-79,2,0,0,0,0,2,0,2,0,2,Lombardia,ITC4
2021-01-14,PF/BT,30326001723,FONDAZIONE DANTE CUSI ONLUS,LOM,80-89,2,5,0,0,0,7,0,7,0,7,Lombardia,ITC4
2021-01-14,PF/BT,30326001723,FONDAZIONE DANTE CUSI ONLUS,LOM,90+,0,5,0,0,0,5,0,5,0,5,Lombardia,ITC4
2021-01-14,PF/BT,30327001819,RSA I GIRASOLI - VIA M. K. GANDHI N° 1 BORGO VIRGILIO (MN),LOM,30-39,0,1,0,1,0,0,0,1,0,1,Lombardia,ITC4
2021-01-14,PF/BT,30327001819,RSA I GIRASOLI - VIA M. K. GANDHI N° 1 BORGO VIRGILIO (MN),LOM,40-49,0,1,0,1,0,0,0,1,0,1,Lombardia,ITC4
2021-01-14,PF/BT,30327001819,RSA I GIRASOLI - VIA M. K. GANDHI N° 1 BORGO VIRGILIO (MN),LOM,60-69,1,0,0,0,0,1,0,1,0,1,Lombardia,ITC4
2021-01-14,PF/BT,30327001819,RSA I GIRASOLI - VIA M. K. GANDHI N° 1 BORGO VIRGILIO (MN),LOM,70-79,1,1,0,0,0,2,0,2,0,2,Lombardia,ITC4
2021-01-14,PF/BT,30327001819,RSA I GIRASOLI - VIA M. K. GANDHI N° 1 BORGO VIRGILIO (MN),LOM,80-89,4,9,0,0,0,13,0,13,0,13,Lombardia,ITC4
2021-01-14,PF/BT,30327001819,RSA I GIRASOLI - VIA M. K. GANDHI N° 1 BORGO VIRGILIO (MN),LOM,90+,2,16,0,0,0,18,0,18,0,18,Lombardia,ITC4
2021-01-14,PF/BT,3035300,OSPEDALE CIVILE VOLTA MANTOVANA SRL,LOM,20-29,2,3,0,5,0,0,0,5,0,5,Lombardia,ITC4
2021-01-14,PF/BT,3035300,OSPEDALE CIVILE VOLTA MANTOVANA SRL,LOM,30-39,2,1,0,2,1,0,0,3,0,3,Lombardia,ITC4
2021-01-14,PF/BT,3035300,OSPEDALE CIVILE VOLTA MANTOVANA SRL,LOM,40-49,4,5,0,8,1,0,0,9,0,9,Lombardia,ITC4
2021-01-14,PF/BT,3035300,OSPEDALE CIVILE VOLTA MANTOVANA SRL,LOM,50-59,4,1,0,5,0,0,0,5,0,5,Lombardia,ITC4
2021-01-14,PF/BT,3035300,OSPEDALE CIVILE VOLTA MANTOVANA SRL,LOM,60-69,2,0,0,2,0,0,0,2,0,2,Lombardia,ITC4
2021-01-14,PF/BT,3035500,ospedale di suzzara spa,LOM,20-29,3,8,0,11,0,0,0,11,0,11,Lombardia,ITC4
2021-01-14,PF/BT,3035500,ospedale di suzzara spa,LOM,30-39,5,11,0,12,4,0,0,16,0,16,Lombardia,ITC4
2021-01-14,PF/BT,3035500,ospedale di suzzara spa,LOM,40-49,4,15,0,12,7,0,0,19,0,19,Lombardia,ITC4
2021-01-14,PF/BT,3035500,ospedale di suzzara spa,LOM,50-59,2,5,0,5,2,0,0,7,0,7,Lombardia,ITC4
2021-01-14,PF/BT,3035500,ospedale di suzzara spa,LOM,60-69,4,2,0,5,1,0,0,6,0,6,Lombardia,ITC4
2021-01-14,PF/BT,3035500,ospedale di suzzara spa,LOM,70-79,1,0,0,1,0,0,0,1,0,1,Lombardia,ITC4
2021-01-14,PF/BT,3035700,OSPEDALE SAN PELLEGRINO SRL,LOM,20-29,5,15,0,13,7,0,0,20,0,20,Lombardia,ITC4
2021-01-14,PF/BT,3035700,OSPEDALE SAN PELLEGRINO SRL,LOM,30-39,7,17,0,16,8,0,0,24,0,24,Lombardia,ITC4
2021-01-14,PF/BT,3035700,OSPEDALE SAN PELLEGRINO SRL,LOM,40-49,8,15,0,13,8,0,2,23,0,23,Lombardia,ITC4
2021-01-14,PF/BT,3035700,OSPEDALE SAN PELLEGRINO SRL,LOM,50-59,8,10,0,17,1,0,0,18,0,18,Lombardia,ITC4
2021-01-14,PF/BT,3035700,OSPEDALE SAN PELLEGRINO SRL,LOM,60-69,3,1,0,3,1,0,0,4,0,4,Lombardia,ITC4
2021-01-14,PF/BT,30701,ASST GRANDE OSPEDALE METROPOLITANO NIGUARDA,LOM,16-19,3,1,0,0,4,0,0,4,0,4,Lombardia,ITC4
2021-01-14,PF/BT,30701,ASST GRANDE OSPEDALE METROPOLITANO NIGUARDA,LOM,20-29,30,65,0,37,40,0,18,95,0,95,Lombardia,ITC4
2021-01-14,PF/BT,30701,ASST GRANDE OSPEDALE METROPOLITANO NIGUARDA,LOM,30-39,49,63,0,58,40,0,14,112,0,112,Lombardia,ITC4
2021-01-14,PF/BT,30701,ASST GRANDE OSPEDALE METROPOLITANO NIGUARDA,LOM,40-49,45,64,0,45,52,0,12,109,0,109,Lombardia,ITC4
2021-01-14,PF/BT,30701,ASST GRANDE OSPEDALE METROPOLITANO NIGUARDA,LOM,50-59,73,110,0,91,83,0,9,183,0,183,Lombardia,ITC4
2021-01-14,PF/BT,30701,ASST GRANDE OSPEDALE METROPOLITANO NIGUARDA,LOM,60-69,32,37,0,43,20,0,6,69,0,69,Lombardia,ITC4
2021-01-14,PF/BT,30701,ASST GRANDE OSPEDALE METROPOLITANO NIGUARDA,LOM,70-79,4,0,0,0,0,0,4,4,0,4,Lombardia,ITC4
2021-01-14,PF/BT,30718,ASST PAPA GIOVANNI XXIII,LOM,20-29,7,23,0,29,1,0,0,30,0,30,Lombardia,ITC4
2021-01-14,PF/BT,30718,ASST PAPA GIOVANNI XXIII,LOM,30-39,18,33,0,41,10,0,0,51,0,51,Lombardia,ITC4
2021-01-14,PF/BT,30718,ASST PAPA GIOVANNI XXIII,LOM,40-49,25,78,0,88,15,0,0,103,0,103,Lombardia,ITC4
2021-01-14,PF/BT,30718,ASST PAPA GIOVANNI XXIII,LOM,50-59,23,93,0,84,32,0,0,116,0,116,Lombardia,ITC4
2021-01-14,PF/BT,30718,ASST PAPA GIOVANNI XXIII,LOM,60-69,15,21,0,22,14,0,0,36,0,36,Lombardia,ITC4
2021-01-14,PF/BT,30718,ASST PAPA GIOVANNI XXIII,LOM,70-79,2,0,0,2,0,0,0,2,0,2,Lombardia,ITC4
2021-01-14,PF/BT,30718,ASST PAPA GIOVANNI XXIII,LOM,80-89,1,0,0,1,0,0,0,1,0,1,Lombardia,ITC4
2021-01-14,PF/BT,30902,Ospedale S.Anna - Como,LOM,16-19,2,11,0,1,12,0,0,13,0,13,Lombardia,ITC4
2021-01-14,PF/BT,30902,Ospedale S.Anna - Como,LOM,20-29,36,86,0,14,83,0,25,122,0,122,Lombardia,ITC4
2021-01-14,PF/BT,30902,Ospedale S.Anna - Como,LOM,30-39,53,51,0,25,77,0,2,104,0,104,Lombardia,ITC4
2021-01-14,PF/BT,30902,Ospedale S.Anna - Como,LOM,40-49,61,69,0,15,115,0,0,130,0,130,Lombardia,ITC4
2021-01-14,PF/BT,30902,Ospedale S.Anna - Como,LOM,50-59,70,100,0,46,124,0,0,170,0,170,Lombardia,ITC4
2021-01-14,PF/BT,30902,Ospedale S.Anna - Como,LOM,60-69,63,49,0,16,96,0,0,112,0,112,Lombardia,ITC4
2021-01-14,PF/BT,30902,Ospedale S.Anna - Como,LOM,70-79,23,16,0,7,32,0,0,39,0,39,Lombardia,ITC4
2021-01-14,PF/BT,30904,ASST VALTELLINA E ALTO LARIO PRESIDIO OSPEDALIERO DI SONDALO,LOM,20-29,0,1,0,1,0,0,0,1,0,1,Lombardia,ITC4
2021-01-14,PF/BT,30904,ASST VALTELLINA E ALTO LARIO PRESIDIO OSPEDALIERO DI SONDALO,LOM,30-39,1,5,0,6,0,0,0,6,0,6,Lombardia,ITC4
2021-01-14,PF/BT,30904,ASST VALTELLINA E ALTO LARIO PRESIDIO OSPEDALIERO DI SONDALO,LOM,40-49,1,5,0,5,1,0,0,6,0,6,Lombardia,ITC4
2021-01-14,PF/BT,30904,ASST VALTELLINA E ALTO LARIO PRESIDIO OSPEDALIERO DI SONDALO,LOM,50-59,4,14,0,10,8,0,0,18,0,18,Lombardia,ITC4
2021-01-14,PF/BT,30904,ASST VALTELLINA E ALTO LARIO PRESIDIO OSPEDALIERO DI SONDALO,LOM,60-69,6,5,0,7,4,0,0,11,0,11,Lombardia,ITC4
2021-01-14,PF/BT,30909,amb covid monza,LOM,16-19,4,9,0,12,0,0,1,13,0,13,Lombardia,ITC4
2021-01-14,PF/BT,30909,amb covid monza,LOM,20-29,71,133,0,178,14,0,12,204,0,204,Lombardia,ITC4
2021-01-14,PF/BT,30909,amb covid monza,LOM,30-39,36,64,0,76,14,0,10,100,0,100,Lombardia,ITC4
2021-01-14,PF/BT,30909,amb covid monza,LOM,40-49,32,102,0,90,24,0,20,134,0,134,Lombardia,ITC4
2021-01-14,PF/BT,30909,amb covid monza,LOM,50-59,27,136,0,85,50,0,28,163,0,163,Lombardia,ITC4
2021-01-14,PF/BT,30909,amb covid monza,LOM,60-69,28,38,0,50,11,0,5,66,0,66,Lombardia,ITC4
2021-01-14,PF/BT,30909,amb covid monza,LOM,70-79,9,5,0,12,1,0,1,14,0,14,Lombardia,ITC4
2021-01-14,PF/BT,30909,amb covid monza,LOM,80-89,0,1,0,1,0,0,0,1,0,1,Lombardia,ITC4
2021-01-14,PF/BT,3093400,CENTRO CARDIOLOGICO MONZINO,LOM,20-29,1,1,0,0,2,0,0,2,0,2,Lombardia,ITC4
2021-01-14,PF/BT,3093400,CENTRO CARDIOLOGICO MONZINO,LOM,30-39,4,6,0,7,3,0,0,10,0,10,Lombardia,ITC4
2021-01-14,PF/BT,3093400,CENTRO CARDIOLOGICO MONZINO,LOM,40-49,8,12,0,15,5,0,0,20,0,20,Lombardia,ITC4
2021-01-14,PF/BT,3093400,CENTRO CARDIOLOGICO MONZINO,LOM,50-59,13,21,0,24,10,0,0,34,0,34,Lombardia,ITC4
2021-01-14,PF/BT,3093400,CENTRO CARDIOLOGICO MONZINO,LOM,60-69,4,8,0,7,5,0,0,12,0,12,Lombardia,ITC4
2021-01-14,PF/BT,30941,ISTITUTO EUROPEO DI ONCOLOGIA,LOM,20-29,6,7,0,12,1,0,0,13,0,13,Lombardia,ITC4
2021-01-14,PF/BT,30941,ISTITUTO EUROPEO DI ONCOLOGIA,LOM,30-39,34,50,0,78,6,0,0,84,0,84,Lombardia,ITC4
2021-01-14,PF/BT,30941,ISTITUTO EUROPEO DI ONCOLOGIA,LOM,40-49,10,20,0,16,14,0,0,30,0,30,Lombardia,ITC4
2021-01-14,PF/BT,30941,ISTITUTO EUROPEO DI ONCOLOGIA,LOM,50-59,5,7,0,5,7,0,0,12,0,12,Lombardia,ITC4
2021-01-14,PF/BT,30941,ISTITUTO EUROPEO DI ONCOLOGIA,LOM,60-69,2,1,0,2,1,0,0,3,0,3,Lombardia,ITC4
2021-01-14,PF/BT,3094602,IST.CLINICO S.SIRO SPA-MILANO,LOM,20-29,1,4,0,5,0,0,0,5,0,5,Lombardia,ITC4
2021-01-14,PF/BT,3094602,IST.CLINICO S.SIRO SPA-MILANO,LOM,30-39,5,1,0,5,1,0,0,6,0,6,Lombardia,ITC4
2021-01-14,PF/BT,3094602,IST.CLINICO S.SIRO SPA-MILANO,LOM,40-49,5,7,0,12,0,0,0,12,0,12,Lombardia,ITC4
2021-01-14,PF/BT,3094602,IST.CLINICO S.SIRO SPA-MILANO,LOM,50-59,3,1,0,4,0,0,0,4,0,4,Lombardia,ITC4
2021-01-14,PF/BT,3094602,IST.CLINICO S.SIRO SPA-MILANO,LOM,60-69,1,0,0,1,0,0,0,1,0,1,Lombardia,ITC4
2021-01-14,PF/BT,3094602,IST.CLINICO S.SIRO SPA-MILANO,LOM,70-79,2,0,0,2,0,0,0,2,0,2,Lombardia,ITC4
2021-01-14,PF/BT,314,RSA SAN GIORGIO,LOM,30-39,0,5,0,4,1,0,0,5,0,5,Lombardia,ITC4
2021-01-14,PF/BT,314,RSA SAN GIORGIO,LOM,40-49,0,5,0,4,1,0,0,5,0,5,Lombardia,ITC4
2021-01-14,PF/BT,314,RSA SAN GIORGIO,LOM,50-59,2,5,0,4,2,1,0,7,0,7,Lombardia,ITC4
2021-01-14,PF/BT,314,RSA SAN GIORGIO,LOM,60-69,0,2,0,1,0,1,0,2,0,2,Lombardia,ITC4
2021-01-14,PF/BT,314,RSA SAN GIORGIO,LOM,70-79,0,2,0,0,0,2,0,2,0,2,Lombardia,ITC4
2021-01-14,PF/BT,314,RSA SAN GIORGIO,LOM,80-89,2,10,0,0,0,12,0,12,0,12,Lombardia,ITC4
2021-01-14,PF/BT,314,RSA SAN GIORGIO,LOM,90+,1,20,0,0,0,21,0,21,0,21,Lombardia,ITC4
2021-01-14,PF/BT,321,RSA S.MARIA AL CASTELLO FONDAZIONE DON CARLO GNOCCHI PESSANO CON BORNAGO,LOM,20-29,0,1,0,0,1,0,0,1,0,1,Lombardia,ITC4
2021-01-14,PF/BT,321,RSA S.MARIA AL CASTELLO FONDAZIONE DON CARLO GNOCCHI PESSANO CON BORNAGO,LOM,30-39,2,1,0,3,0,0,0,3,0,3,Lombardia,ITC4
2021-01-14,PF/BT,321,RSA S.MARIA AL CASTELLO FONDAZIONE DON CARLO GNOCCHI PESSANO CON BORNAGO,LOM,40-49,1,3,0,4,0,0,0,4,0,4,Lombardia,ITC4
2021-01-14,PF/BT,321,RSA S.MARIA AL CASTELLO FONDAZIONE DON CARLO GNOCCHI PESSANO CON BORNAGO,LOM,50-59,2,1,0,3,0,0,0,3,0,3,Lombardia,ITC4
2021-01-14,PF/BT,321,RSA S.MARIA AL CASTELLO FONDAZIONE DON CARLO GNOCCHI PESSANO CON BORNAGO,LOM,60-69,1,0,0,1,0,0,0,1,0,1,Lombardia,ITC4
2021-01-14,PF/BT,321000247,RSA GIOVANNI PAOLO II,LOM,20-29,1,2,0,3,0,0,0,3,0,3,Lombardia,ITC4
2021-01-14,PF/BT,321000247,RSA GIOVANNI PAOLO II,LOM,30-39,2,7,0,8,1,0,0,9,0,9,Lombardia,ITC4
2021-01-14,PF/BT,321000247,RSA GIOVANNI PAOLO II,LOM,40-49,1,12,0,10,3,0,0,13,0,13,Lombardia,ITC4
2021-01-14,PF/BT,321000247,RSA GIOVANNI PAOLO II,LOM,50-59,3,10,0,8,5,0,0,13,0,13,Lombardia,ITC4
2021-01-14,PF/BT,321000247,RSA GIOVANNI PAOLO II,LOM,60-69,1,5,0,4,2,0,0,6,0,6,Lombardia,ITC4
2021-01-14,PF/BT,321000247,RSA GIOVANNI PAOLO II,LOM,70-79,0,3,0,0,0,3,0,3,0,3,Lombardia,ITC4
2021-01-14,PF/BT,321000247,RSA GIOVANNI PAOLO II,LOM,80-89,0,14,0,0,0,14,0,14,0,14,Lombardia,ITC4
2021-01-14,PF/BT,321000247,RSA GIOVANNI PAOLO II,LOM,90+,3,20,0,0,0,23,0,23,0,23,Lombardia,ITC4
2021-01-14,PF/BT,321000286,RSA SANTA LUCIA - MILANO,LOM,16-19,1,0,0,0,1,0,0,1,0,1,Lombardia,ITC4
2021-01-14,PF/BT,321000286,RSA SANTA LUCIA - MILANO,LOM,30-39,7,1,0,5,3,0,0,8,0,8,Lombardia,ITC4
2021-01-14,PF/BT,321000286,RSA SANTA LUCIA - MILANO,LOM,40-49,1,4,0,5,0,0,0,5,0,5,Lombardia,ITC4
2021-01-14,PF/BT,321000286,RSA SANTA LUCIA - MILANO,LOM,50-59,0,2,0,2,0,0,0,2,0,2,Lombardia,ITC4
2021-01-14,PF/BT,321000286,RSA SANTA LUCIA - MILANO,LOM,60-69,0,1,0,0,0,1,0,1,0,1,Lombardia,ITC4
2021-01-14,PF/BT,321000286,RSA SANTA LUCIA - MILANO,LOM,70-79,1,1,0,0,0,2,0,2,0,2,Lombardia,ITC4
2021-01-14,PF/BT,321000286,RSA SANTA LUCIA - MILANO,LOM,80-89,6,15,0,0,0,21,0,21,0,21,Lombardia,ITC4
2021-01-14,PF/BT,321000286,RSA SANTA LUCIA - MILANO,LOM,90+,0,15,0,0,0,15,0,15,0,15,Lombardia,ITC4
2021-01-14,PF/BT,321000289,RSA Casa Famiglia,LOM,20-29,1,0,0,1,0,0,0,1,0,1,Lombardia,ITC4
2021-01-14,PF/BT,321000289,RSA Casa Famiglia,LOM,40-49,0,4,0,1,0,0,3,4,0,4,Lombardia,ITC4
2021-01-14,PF/BT,321000289,RSA Casa Famiglia,LOM,50-59,1,4,0,0,0,0,5,5,0,5,Lombardia,ITC4
2021-01-14,PF/BT,321000289,RSA Casa Famiglia,LOM,60-69,1,2,0,0,0,0,3,3,0,3,Lombardia,ITC4
2021-01-14,PF/BT,321000289,RSA Casa Famiglia,LOM,70-79,1,0,0,1,0,0,0,1,0,1,Lombardia,ITC4
2021-01-14,PF/BT,321000318,RSA IL NAVIGLIO,LOM,60-69,1,1,0,0,0,2,0,2,0,2,Lombardia,ITC4
2021-01-14,PF/BT,321000318,RSA IL NAVIGLIO,LOM,70-79,0,5,0,0,0,5,0,5,0,5,Lombardia,ITC4
2021-01-14,PF/BT,321000318,RSA IL NAVIGLIO,LOM,80-89,4,16,0,0,0,20,0,20,0,20,Lombardia,ITC4
2021-01-14,PF/BT,321000318,RSA IL NAVIGLIO,LOM,90+,0,15,0,0,0,15,0,15,0,15,Lombardia,ITC4
2021-01-14,PF/BT,321000354 e 321000584,PUNTO VACCINALE RSA CASA PER CONIUGI,LOM,20-29,0,2,0,0,2,0,0,2,0,2,Lombardia,ITC4
2021-01-14,PF/BT,321000354 e 321000584,PUNTO VACCINALE RSA CASA PER CONIUGI,LOM,40-49,0,2,0,2,0,0,0,2,0,2,Lombardia,ITC4
2021-01-14,PF/BT,321000354 e 321000584,PUNTO VACCINALE RSA CASA PER CONIUGI,LOM,50-59,1,6,0,7,0,0,0,7,0,7,Lombardia,ITC4
2021-01-14,PF/BT,321000354 e 321000584,PUNTO VACCINALE RSA CASA PER CONIUGI,LOM,60-69,1,1,0,1,0,1,0,2,0,2,Lombardia,ITC4
2021-01-14,PF/BT,321000354 e 321000584,PUNTO VACCINALE RSA CASA PER CONIUGI,LOM,70-79,0,1,0,0,0,1,0,1,0,1,Lombardia,ITC4
2021-01-14,PF/BT,321000354 e 321000584,PUNTO VACCINALE RSA CASA PER CONIUGI,LOM,80-89,5,2,0,0,0,7,0,7,0,7,Lombardia,ITC4
2021-01-14,PF/BT,321000354 e 321000584,PUNTO VACCINALE RSA CASA PER CONIUGI,LOM,90+,1,2,0,0,0,3,0,3,0,3,Lombardia,ITC4
2021-01-14,PF/BT,321000373,rsa parco delle cave e baggio,LOM,20-29,0,1,0,1,0,0,0,1,0,1,Lombardia,ITC4
2021-01-14,PF/BT,321000373,rsa parco delle cave e baggio,LOM,30-39,3,7,0,10,0,0,0,10,0,10,Lombardia,ITC4
2021-01-14,PF/BT,321000373,rsa parco delle cave e baggio,LOM,40-49,2,11,0,13,0,0,0,13,0,13,Lombardia,ITC4
2021-01-14,PF/BT,321000373,rsa parco delle cave e baggio,LOM,50-59,4,7,0,11,0,0,0,11,0,11,Lombardia,ITC4
2021-01-14,PF/BT,321000373,rsa parco delle cave e baggio,LOM,60-69,0,2,0,2,0,0,0,2,0,2,Lombardia,ITC4
2021-01-14,PF/BT,321000373,rsa parco delle cave e baggio,LOM,70-79,1,0,0,0,0,1,0,1,0,1,Lombardia,ITC4
2021-01-14,PF/BT,321000373,rsa parco delle cave e baggio,LOM,80-89,0,2,0,0,0,2,0,2,0,2,Lombardia,ITC4
2021-01-14,PF/BT,321000373,rsa parco delle cave e baggio,LOM,90+,0,2,0,0,0,2,0,2,0,2,Lombardia,ITC4
2021-01-14,PF/BT,321000532 - 321000533,RSA SACCARDO A e B,LOM,20-29,2,2,0,2,2,0,0,4,0,4,Lombardia,ITC4
2021-01-14,PF/BT,321000532 - 321000533,RSA SACCARDO A e B,LOM,30-39,6,7,0,10,3,0,0,13,0,13,Lombardia,ITC4
2021-01-14,PF/BT,321000532 - 321000533,RSA SACCARDO A e B,LOM,40-49,2,6,0,7,1,0,0,8,0,8,Lombardia,ITC4
2021-01-14,PF/BT,321000532 - 321000533,RSA SACCARDO A e B,LOM,50-59,6,9,0,13,2,0,0,15,0,15,Lombardia,ITC4
2021-01-14,PF/BT,321000532 - 321000533,RSA SACCARDO A e B,LOM,60-69,1,9,0,6,3,1,0,10,0,10,Lombardia,ITC4
2021-01-14,PF/BT,321000532 - 321000533,RSA SACCARDO A e B,LOM,70-79,6,5,0,0,0,11,0,11,0,11,Lombardia,ITC4
2021-01-14,PF/BT,321000532 - 321000533,RSA SACCARDO A e B,LOM,80-89,12,35,0,0,0,47,0,47,0,47,Lombardia,ITC4
2021-01-14,PF/BT,321000532 - 321000533,RSA SACCARDO A e B,LOM,90+,2,22,0,0,0,24,0,24,0,24,Lombardia,ITC4
2021-01-14,PF/BT,32170712,ambulatorio covid SESTO SAN GIOVANNI,LOM,16-19,1,6,0,4,3,0,0,7,0,7,Lombardia,ITC4
2021-01-14,PF/BT,32170712,ambulatorio covid SESTO SAN GIOVANNI,LOM,20-29,24,29,0,36,17,0,0,53,0,53,Lombardia,ITC4
2021-01-14,PF/BT,32170712,ambulatorio covid SESTO SAN GIOVANNI,LOM,30-39,25,31,0,46,10,0,0,56,0,56,Lombardia,ITC4
2021-01-14,PF/BT,32170712,ambulatorio covid SESTO SAN GIOVANNI,LOM,40-49,26,58,0,52,32,0,0,84,0,84,Lombardia,ITC4
2021-01-14,PF/BT,32170712,ambulatorio covid SESTO SAN GIOVANNI,LOM,50-59,29,81,0,60,50,0,0,110,0,110,Lombardia,ITC4
2021-01-14,PF/BT,32170712,ambulatorio covid SESTO SAN GIOVANNI,LOM,60-69,21,36,0,30,27,0,0,57,0,57,Lombardia,ITC4
2021-01-14,PF/BT,32170712,ambulatorio covid SESTO SAN GIOVANNI,LOM,70-79,6,11,0,10,7,0,0,17,0,17,Lombardia,ITC4
2021-01-14,PF/BT,322000722,RSA - CASA CARDINAL G. LERCARO - BODIO LOMNAGO (VA),LOM,20-29,2,4,0,3,3,0,0,6,0,6,Lombardia,ITC4
2021-01-14,PF/BT,322000722,RSA - CASA CARDINAL G. LERCARO - BODIO LOMNAGO (VA),LOM,30-39,3,3,0,3,3,0,0,6,0,6,Lombardia,ITC4
2021-01-14,PF/BT,322000722,RSA - CASA CARDINAL G. LERCARO - BODIO LOMNAGO (VA),LOM,40-49,1,8,0,5,4,0,0,9,0,9,Lombardia,ITC4
2021-01-14,PF/BT,322000722,RSA - CASA CARDINAL G. LERCARO - BODIO LOMNAGO (VA),LOM,50-59,3,22,0,20,5,0,0,25,0,25,Lombardia,ITC4
2021-01-14,PF/BT,322000722,RSA - CASA CARDINAL G. LERCARO - BODIO LOMNAGO (VA),LOM,60-69,3,5,0,2,2,4,0,8,0,8,Lombardia,ITC4
2021-01-14,PF/BT,322000722,RSA - CASA CARDINAL G. LERCARO - BODIO LOMNAGO (VA),LOM,70-79,4,3,0,0,0,7,0,7,0,7,Lombardia,ITC4
2021-01-14,PF/BT,322000722,RSA - CASA CARDINAL G. LERCARO - BODIO LOMNAGO (VA),LOM,80-89,7,15,0,0,1,21,0,22,0,22,Lombardia,ITC4
2021-01-14,PF/BT,322000722,RSA - CASA CARDINAL G. LERCARO - BODIO LOMNAGO (VA),LOM,90+,3,16,0,0,0,19,0,19,0,19,Lombardia,ITC4
2021-01-14,PF/BT,322000728,RSA CAMELOT,LOM,30-39,1,7,0,5,2,1,0,8,0,8,Lombardia,ITC4
2021-01-14,PF/BT,322000728,RSA CAMELOT,LOM,40-49,4,11,0,8,4,3,0,15,0,15,Lombardia,ITC4
2021-01-14,PF/BT,322000728,RSA CAMELOT,LOM,50-59,6,9,0,6,2,7,0,15,0,15,Lombardia,ITC4
2021-01-14,PF/BT,322000728,RSA CAMELOT,LOM,60-69,4,7,0,4,0,7,0,11,0,11,Lombardia,ITC4
2021-01-14,PF/BT,322000728,RSA CAMELOT,LOM,70-79,3,6,0,0,0,9,0,9,0,9,Lombardia,ITC4
2021-01-14,PF/BT,322000728,RSA CAMELOT,LOM,80-89,2,10,0,0,0,12,0,12,0,12,Lombardia,ITC4
2021-01-14,PF/BT,322000728,RSA CAMELOT,LOM,90+,0,2,0,0,0,2,0,2,0,2,Lombardia,ITC4
2021-01-14,PF/BT,322000754,CASA DI RIPOSO BELLORA,LOM,20-29,0,1,0,1,0,0,0,1,0,1,Lombardia,ITC4
2021-01-14,PF/BT,322000754,CASA DI RIPOSO BELLORA,LOM,30-39,0,5,0,3,2,0,0,5,0,5,Lombardia,ITC4
2021-01-14,PF/BT,322000754,CASA DI RIPOSO BELLORA,LOM,40-49,0,2,0,1,1,0,0,2,0,2,Lombardia,ITC4
2021-01-14,PF/BT,322000754,CASA DI RIPOSO BELLORA,LOM,50-59,0,5,0,3,2,0,0,5,0,5,Lombardia,ITC4
2021-01-14,PF/BT,322000754,CASA DI RIPOSO BELLORA,LOM,60-69,0,1,0,1,0,0,0,1,0,1,Lombardia,ITC4
2021-01-14,PF/BT,322000754,CASA DI RIPOSO BELLORA,LOM,70-79,1,0,0,0,0,1,0,1,0,1,Lombardia,ITC4
2021-01-14,PF/BT,322000754,CASA DI RIPOSO BELLORA,LOM,80-89,2,10,0,0,0,12,0,12,0,12,Lombardia,ITC4
2021-01-14,PF/BT,322000754,CASA DI RIPOSO BELLORA,LOM,90+,0,15,0,0,0,15,0,15,0,15,Lombardia,ITC4
2021-01-14,PF/BT,322000797,RSA CENTRO ACCOGLIENZA ANZIANI ONLUS,LOM,20-29,0,2,0,2,0,0,0,2,0,2,Lombardia,ITC4
2021-01-14,PF/BT,322000797,RSA CENTRO ACCOGLIENZA ANZIANI ONLUS,LOM,30-39,2,3,0,4,1,0,0,5,0,5,Lombardia,ITC4
2021-01-14,PF/BT,322000797,RSA CENTRO ACCOGLIENZA ANZIANI ONLUS,LOM,40-49,2,8,0,9,1,0,0,10,0,10,Lombardia,ITC4
2021-01-14,PF/BT,322000797,RSA CENTRO ACCOGLIENZA ANZIANI ONLUS,LOM,50-59,3,9,0,8,4,0,0,12,0,12,Lombardia,ITC4
2021-01-14,PF/BT,322000797,RSA CENTRO ACCOGLIENZA ANZIANI ONLUS,LOM,60-69,0,3,0,1,0,2,0,3,0,3,Lombardia,ITC4
2021-01-14,PF/BT,322000797,RSA CENTRO ACCOGLIENZA ANZIANI ONLUS,LOM,70-79,1,2,0,0,0,3,0,3,0,3,Lombardia,ITC4
2021-01-14,PF/BT,322000797,RSA CENTRO ACCOGLIENZA ANZIANI ONLUS,LOM,80-89,1,13,0,0,0,14,0,14,0,14,Lombardia,ITC4
2021-01-14,PF/BT,322000797,RSA CENTRO ACCOGLIENZA ANZIANI ONLUS,LOM,90+,1,10,0,0,0,11,0,11,0,11,Lombardia,ITC4
2021-01-14,PF/BT,322000844 - 322000712,Istituto La Provvidenza - UG1 /UG3,LOM,20-29,1,5,0,5,1,0,0,6,0,6,Lombardia,ITC4
2021-01-14,PF/BT,322000844 - 322000712,Istituto La Provvidenza - UG1 /UG3,LOM,30-39,1,13,0,13,0,0,1,14,0,14,Lombardia,ITC4
2021-01-14,PF/BT,322000844 - 322000712,Istituto La Provvidenza - UG1 /UG3,LOM,40-49,3,11,0,10,3,0,1,14,0,14,Lombardia,ITC4
2021-01-14,PF/BT,322000844 - 322000712,Istituto La Provvidenza - UG1 /UG3,LOM,50-59,0,18,0,15,2,0,1,18,0,18,Lombardia,ITC4
2021-01-14,PF/BT,322000844 - 322000712,Istituto La Provvidenza - UG1 /UG3,LOM,60-69,0,5,0,4,1,0,0,5,0,5,Lombardia,ITC4
2021-01-14,PF/BT,322000844 - 322000712,Istituto La Provvidenza - UG1 /UG3,LOM,70-79,1,0,0,0,0,1,0,1,0,1,Lombardia,ITC4
2021-01-14,PF/BT,322000844 - 322000712,Istituto La Provvidenza - UG1 /UG3,LOM,80-89,0,1,0,0,1,0,0,1,0,1,Lombardia,ITC4
2021-01-14,PF/BT,322000844 - 322000712,Istituto La Provvidenza - UG1 /UG3,LOM,90+,1,0,0,0,0,1,0,1,0,1,Lombardia,ITC4
2021-01-14,PF/BT,322000902,RSA IL MELO,LOM,20-29,1,3,0,3,1,0,0,4,0,4,Lombardia,ITC4
2021-01-14,PF/BT,322000902,RSA IL MELO,LOM,30-39,2,3,0,4,1,0,0,5,0,5,Lombardia,ITC4
2021-01-14,PF/BT,322000902,RSA IL MELO,LOM,40-49,1,7,0,7,1,0,0,8,0,8,Lombardia,ITC4
2021-01-14,PF/BT,322000902,RSA IL MELO,LOM,50-59,1,6,0,6,1,0,0,7,0,7,Lombardia,ITC4
2021-01-14,PF/BT,322000902,RSA IL MELO,LOM,60-69,0,2,0,0,2,0,0,2,0,2,Lombardia,ITC4
2021-01-14,PF/BT,322000902,RSA IL MELO,LOM,70-79,0,2,0,0,0,2,0,2,0,2,Lombardia,ITC4
2021-01-14,PF/BT,322000902,RSA IL MELO,LOM,80-89,0,7,0,0,0,7,0,7,0,7,Lombardia,ITC4
2021-01-14,PF/BT,322000902,RSA IL MELO,LOM,90+,0,13,0,0,0,13,0,13,0,13,Lombardia,ITC4
2021-01-14,PF/BT,322002858,Istituto  Nidasio Galetti,LOM,20-29,0,1,0,1,0,0,0,1,0,1,Lombardia,ITC4
2021-01-14,PF/BT,322002858,Istituto  Nidasio Galetti,LOM,30-39,2,5,0,7,0,0,0,7,0,7,Lombardia,ITC4
2021-01-14,PF/BT,322002858,Istituto  Nidasio Galetti,LOM,40-49,1,23,0,23,1,0,0,24,0,24,Lombardia,ITC4
2021-01-14,PF/BT,322002858,Istituto  Nidasio Galetti,LOM,50-59,0,27,0,27,0,0,0,27,0,27,Lombardia,ITC4
2021-01-14,PF/BT,322002858,Istituto  Nidasio Galetti,LOM,60-69,1,6,0,6,1,0,0,7,0,7,Lombardia,ITC4
2021-01-14,PF/BT,32271028,AMBULATORIO COVID OSPEDALE CIRCOLO,LOM,16-19,2,5,0,7,0,0,0,7,0,7,Lombardia,ITC4
2021-01-14,PF/BT,32271028,AMBULATORIO COVID OSPEDALE CIRCOLO,LOM,20-29,27,47,0,74,0,0,0,74,0,74,Lombardia,ITC4
2021-01-14,PF/BT,32271028,AMBULATORIO COVID OSPEDALE CIRCOLO,LOM,30-39,38,41,0,79,0,0,0,79,0,79,Lombardia,ITC4
2021-01-14,PF/BT,32271028,AMBULATORIO COVID OSPEDALE CIRCOLO,LOM,40-49,35,59,0,94,0,0,0,94,0,94,Lombardia,ITC4
2021-01-14,PF/BT,32271028,AMBULATORIO COVID OSPEDALE CIRCOLO,LOM,50-59,47,110,0,157,0,0,0,157,0,157,Lombardia,ITC4
2021-01-14,PF/BT,32271028,AMBULATORIO COVID OSPEDALE CIRCOLO,LOM,60-69,33,44,0,77,0,0,0,77,0,77,Lombardia,ITC4
2021-01-14,PF/BT,32271028,AMBULATORIO COVID OSPEDALE CIRCOLO,LOM,70-79,5,4,0,9,0,0,0,9,0,9,Lombardia,ITC4
2021-01-14,PF/BT,32271028,AMBULATORIO COVID OSPEDALE CIRCOLO,LOM,80-89,0,1,0,1,0,0,0,1,0,1,Lombardia,ITC4
2021-01-14,PF/BT,32271116,ambulatorio covid Gallarate,LOM,16-19,1,1,0,2,0,0,0,2,0,2,Lombardia,ITC4
2021-01-14,PF/BT,32271116,ambulatorio covid Gallarate,LOM,20-29,20,28,0,48,0,0,0,48,0,48,Lombardia,ITC4
2021-01-14,PF/BT,32271116,ambulatorio covid Gallarate,LOM,30-39,24,14,0,38,0,0,0,38,0,38,Lombardia,ITC4
2021-01-14,PF/BT,32271116,ambulatorio covid Gallarate,LOM,40-49,15,37,0,52,0,0,0,52,0,52,Lombardia,ITC4
2021-01-14,PF/BT,32271116,ambulatorio covid Gallarate,LOM,50-59,19,24,0,43,0,0,0,43,0,43,Lombardia,ITC4
2021-01-14,PF/BT,32271116,ambulatorio covid Gallarate,LOM,60-69,11,11,0,22,0,0,0,22,0,22,Lombardia,ITC4
2021-01-14,PF/BT,32271116,ambulatorio covid Gallarate,LOM,70-79,6,3,0,9,0,0,0,9,0,9,Lombardia,ITC4
2021-01-14,PF/BT,32271116,ambulatorio covid Gallarate,LOM,80-89,0,1,0,1,0,0,0,1,0,1,Lombardia,ITC4
2021-01-14,PF/BT,32271117,ambulatorio covid Saronno,LOM,20-29,3,9,0,12,0,0,0,12,0,12,Lombardia,ITC4
2021-01-14,PF/BT,32271117,ambulatorio covid Saronno,LOM,30-39,2,6,0,8,0,0,0,8,0,8,Lombardia,ITC4
2021-01-14,PF/BT,32271117,ambulatorio covid Saronno,LOM,40-49,8,21,0,29,0,0,0,29,0,29,Lombardia,ITC4
2021-01-14,PF/BT,32271117,ambulatorio covid Saronno,LOM,50-59,16,48,0,64,0,0,0,64,0,64,Lombardia,ITC4
2021-01-14,PF/BT,32271117,ambulatorio covid Saronno,LOM,60-69,5,14,0,19,0,0,0,19,0,19,Lombardia,ITC4
2021-01-14,PF/BT,32271118,ambulatorio covid Busto A.,LOM,20-29,8,7,0,15,0,0,0,15,0,15,Lombardia,ITC4
2021-01-14,PF/BT,32271118,ambulatorio covid Busto A.,LOM,30-39,15,17,0,32,0,0,0,32,0,32,Lombardia,ITC4
2021-01-14,PF/BT,32271118,ambulatorio covid Busto A.,LOM,40-49,12,45,0,57,0,0,0,57,0,57,Lombardia,ITC4
2021-01-14,PF/BT,32271118,ambulatorio covid Busto A.,LOM,50-59,37,55,0,92,0,0,0,92,0,92,Lombardia,ITC4
2021-01-14,PF/BT,32271118,ambulatorio covid Busto A.,LOM,60-69,8,18,0,26,0,0,0,26,0,26,Lombardia,ITC4
2021-01-14,PF/BT,323,RSA RONCAGLIA DI CIVO,LOM,20-29,0,8,0,8,0,0,0,8,0,8,Lombardia,ITC4
2021-01-14,PF/BT,323,RSA RONCAGLIA DI CIVO,LOM,30-39,1,5,0,4,2,0,0,6,0,6,Lombardia,ITC4
2021-01-14,PF/BT,323,RSA RONCAGLIA DI CIVO,LOM,40-49,1,8,0,9,0,0,0,9,0,9,Lombardia,ITC4
2021-01-14,PF/BT,323,RSA RONCAGLIA DI CIVO,LOM,50-59,2,7,0,7,2,0,0,9,0,9,Lombardia,ITC4
2021-01-14,PF/BT,323,RSA RONCAGLIA DI CIVO,LOM,60-69,2,2,0,4,0,0,0,4,0,4,Lombardia,ITC4
2021-01-14,PF/BT,323,RSA RONCAGLIA DI CIVO,LOM,70-79,1,3,0,0,0,4,0,4,0,4,Lombardia,ITC4
2021-01-14,PF/BT,323,RSA RONCAGLIA DI CIVO,LOM,80-89,1,13,0,0,0,14,0,14,0,14,Lombardia,ITC4
2021-01-14,PF/BT,323,RSA RONCAGLIA DI CIVO,LOM,90+,0,11,0,0,0,11,0,11,0,11,Lombardia,ITC4
2021-01-14,PF/BT,323000904,RSA VILLA MONS.D.ZANI BIENNO (BS),LOM,20-29,0,1,0,1,0,0,0,1,0,1,Lombardia,ITC4
2021-01-14,PF/BT,323000904,RSA VILLA MONS.D.ZANI BIENNO (BS),LOM,30-39,0,1,0,1,0,0,0,1,0,1,Lombardia,ITC4
2021-01-14,PF/BT,323000904,RSA VILLA MONS.D.ZANI BIENNO (BS),LOM,40-49,1,7,0,7,1,0,0,8,0,8,Lombardia,ITC4
2021-01-14,PF/BT,323000904,RSA VILLA MONS.D.ZANI BIENNO (BS),LOM,50-59,1,1,0,1,1,0,0,2,0,2,Lombardia,ITC4
2021-01-14,PF/BT,323000904,RSA VILLA MONS.D.ZANI BIENNO (BS),LOM,60-69,0,3,0,0,0,2,1,3,0,3,Lombardia,ITC4
2021-01-14,PF/BT,323000904,RSA VILLA MONS.D.ZANI BIENNO (BS),LOM,70-79,0,2,0,0,0,2,0,2,0,2,Lombardia,ITC4
2021-01-14,PF/BT,323000904,RSA VILLA MONS.D.ZANI BIENNO (BS),LOM,80-89,0,5,0,0,0,5,0,5,0,5,Lombardia,ITC4
2021-01-14,PF/BT,323000904,RSA VILLA MONS.D.ZANI BIENNO (BS),LOM,90+,0,2,0,0,0,2,0,2,0,2,Lombardia,ITC4
2021-01-14,PF/BT,323000930,CASA DI RIPOSO DI TALAMONA - ONLUS,LOM,20-29,0,2,0,1,1,0,0,2,0,2,Lombardia,ITC4
2021-01-14,PF/BT,323000930,CASA DI RIPOSO DI TALAMONA - ONLUS,LOM,30-39,0,1,0,1,0,0,0,1,0,1,Lombardia,ITC4
2021-01-14,PF/BT,323000930,CASA DI RIPOSO DI TALAMONA - ONLUS,LOM,40-49,1,5,0,6,0,0,0,6,0,6,Lombardia,ITC4
2021-01-14,PF/BT,323000930,CASA DI RIPOSO DI TALAMONA - ONLUS,LOM,50-59,1,7,0,4,3,0,1,8,0,8,Lombardia,ITC4
2021-01-14,PF/BT,323000930,CASA DI RIPOSO DI TALAMONA - ONLUS,LOM,60-69,1,3,0,1,1,0,2,4,0,4,Lombardia,ITC4
2021-01-14,PF/BT,323000930,CASA DI RIPOSO DI TALAMONA - ONLUS,LOM,70-79,2,0,0,0,0,0,2,2,0,2,Lombardia,ITC4
2021-01-14,PF/BT,323000930,CASA DI RIPOSO DI TALAMONA - ONLUS,LOM,80-89,1,0,0,0,0,0,1,1,0,1,Lombardia,ITC4
2021-01-14,PF/BT,323000937,RSA SAN BENIGNO,LOM,20-29,0,1,0,1,0,0,0,1,0,1,Lombardia,ITC4
2021-01-14,PF/BT,323000937,RSA SAN BENIGNO,LOM,30-39,0,1,0,1,0,0,0,1,0,1,Lombardia,ITC4
2021-01-14,PF/BT,323000937,RSA SAN BENIGNO,LOM,40-49,0,8,0,8,0,0,0,8,0,8,Lombardia,ITC4
2021-01-14,PF/BT,323000937,RSA SAN BENIGNO,LOM,50-59,0,7,0,5,1,1,0,7,0,7,Lombardia,ITC4
2021-01-14,PF/BT,323000937,RSA SAN BENIGNO,LOM,60-69,0,5,0,2,0,3,0,5,0,5,Lombardia,ITC4
2021-01-14,PF/BT,323000937,RSA SAN BENIGNO,LOM,70-79,0,8,0,0,0,8,0,8,0,8,Lombardia,ITC4
2021-01-14,PF/BT,323000937,RSA SAN BENIGNO,LOM,80-89,1,8,0,0,0,7,2,9,0,9,Lombardia,ITC4
2021-01-14,PF/BT,323000937,RSA SAN BENIGNO,LOM,90+,0,9,0,0,0,9,0,9,0,9,Lombardia,ITC4
2021-01-14,PF/BT,323000952,RSA TOMASO AMBROSETTI - MORBEGNO (SO),LOM,20-29,0,1,0,1,0,0,0,1,0,1,Lombardia,ITC4
2021-01-14,PF/BT,323000952,RSA TOMASO AMBROSETTI - MORBEGNO (SO),LOM,30-39,2,3,0,3,2,0,0,5,0,5,Lombardia,ITC4
2021-01-14,PF/BT,323000952,RSA TOMASO AMBROSETTI - MORBEGNO (SO),LOM,40-49,2,4,0,1,5,0,0,6,0,6,Lombardia,ITC4
2021-01-14,PF/BT,323000952,RSA TOMASO AMBROSETTI - MORBEGNO (SO),LOM,50-59,1,9,0,9,1,0,0,10,0,10,Lombardia,ITC4
2021-01-14,PF/BT,323000952,RSA TOMASO AMBROSETTI - MORBEGNO (SO),LOM,60-69,1,1,0,1,0,1,0,2,0,2,Lombardia,ITC4
2021-01-14,PF/BT,323000952,RSA TOMASO AMBROSETTI - MORBEGNO (SO),LOM,70-79,3,3,0,0,0,6,0,6,0,6,Lombardia,ITC4
2021-01-14,PF/BT,323000952,RSA TOMASO AMBROSETTI - MORBEGNO (SO),LOM,80-89,8,13,0,0,0,21,0,21,0,21,Lombardia,ITC4
2021-01-14,PF/BT,323000952,RSA TOMASO AMBROSETTI - MORBEGNO (SO),LOM,90+,0,10,0,0,0,10,0,10,0,10,Lombardia,ITC4
2021-01-14,PF/BT,323008561,RSA PAOLO PARAVICINI- MORBEGNO (SO),LOM,20-29,0,1,0,1,0,0,0,1,0,1,Lombardia,ITC4
2021-01-14,PF/BT,323008561,RSA PAOLO PARAVICINI- MORBEGNO (SO),LOM,30-39,2,5,0,5,2,0,0,7,0,7,Lombardia,ITC4
2021-01-14,PF/BT,323008561,RSA PAOLO PARAVICINI- MORBEGNO (SO),LOM,40-49,1,13,0,12,2,0,0,14,0,14,Lombardia,ITC4
2021-01-14,PF/BT,323008561,RSA PAOLO PARAVICINI- MORBEGNO (SO),LOM,50-59,2,7,0,7,1,1,0,9,0,9,Lombardia,ITC4
2021-01-14,PF/BT,323008561,RSA PAOLO PARAVICINI- MORBEGNO (SO),LOM,60-69,1,3,0,2,0,2,0,4,0,4,Lombardia,ITC4
2021-01-14,PF/BT,323008561,RSA PAOLO PARAVICINI- MORBEGNO (SO),LOM,70-79,2,11,0,0,0,13,0,13,0,13,Lombardia,ITC4
2021-01-14,PF/BT,323008561,RSA PAOLO PARAVICINI- MORBEGNO (SO),LOM,80-89,4,24,0,0,0,28,0,28,0,28,Lombardia,ITC4
2021-01-14,PF/BT,323008561,RSA PAOLO PARAVICINI- MORBEGNO (SO),LOM,90+,9,10,0,0,0,19,0,19,0,19,Lombardia,ITC4
2021-01-14,PF/BT,3240001118,Fondazione Casa di Riposo Dr. Luigi e Regina Sironi ONLUS,LOM,20-29,1,1,0,2,0,0,0,2,0,2,Lombardia,ITC4
2021-01-14,PF/BT,3240001118,Fondazione Casa di Riposo Dr. Luigi e Regina Sironi ONLUS,LOM,40-49,0,5,0,4,1,0,0,5,0,5,Lombardia,ITC4
2021-01-14,PF/BT,3240001118,Fondazione Casa di Riposo Dr. Luigi e Regina Sironi ONLUS,LOM,60-69,0,2,0,1,0,1,0,2,0,2,Lombardia,ITC4
2021-01-14,PF/BT,3240001118,Fondazione Casa di Riposo Dr. Luigi e Regina Sironi ONLUS,LOM,70-79,1,3,0,0,0,4,0,4,0,4,Lombardia,ITC4
2021-01-14,PF/BT,3240001118,Fondazione Casa di Riposo Dr. Luigi e Regina Sironi ONLUS,LOM,80-89,5,25,0,0,0,30,0,30,0,30,Lombardia,ITC4
2021-01-14,PF/BT,3240001118,Fondazione Casa di Riposo Dr. Luigi e Regina Sironi ONLUS,LOM,90+,1,16,0,0,0,17,0,17,0,17,Lombardia,ITC4
2021-01-14,PF/BT,324001190,RSA OPERA PIA MAGISTRIS - VALMADRERA,LOM,60-69,1,0,0,0,0,1,0,1,0,1,Lombardia,ITC4
2021-01-14,PF/BT,324001190,RSA OPERA PIA MAGISTRIS - VALMADRERA,LOM,70-79,0,7,0,0,0,7,0,7,0,7,Lombardia,ITC4
2021-01-14,PF/BT,324001190,RSA OPERA PIA MAGISTRIS - VALMADRERA,LOM,80-89,1,19,0,0,0,20,0,20,0,20,Lombardia,ITC4
2021-01-14,PF/BT,324001190,RSA OPERA PIA MAGISTRIS - VALMADRERA,LOM,90+,4,16,0,0,0,20,0,20,0,20,Lombardia,ITC4
2021-01-14,PF/BT,32500125400,RSA SAN FRANCESCO - BERGAMO,LOM,20-29,0,2,0,2,0,0,0,2,0,2,Lombardia,ITC4
2021-01-14,PF/BT,32500125400,RSA SAN FRANCESCO - BERGAMO,LOM,30-39,1,1,0,2,0,0,0,2,0,2,Lombardia,ITC4
2021-01-14,PF/BT,32500125400,RSA SAN FRANCESCO - BERGAMO,LOM,40-49,0,4,0,4,0,0,0,4,0,4,Lombardia,ITC4
2021-01-14,PF/BT,32500125400,RSA SAN FRANCESCO - BERGAMO,LOM,50-59,0,3,0,3,0,0,0,3,0,3,Lombardia,ITC4
2021-01-14,PF/BT,32500125400,RSA SAN FRANCESCO - BERGAMO,LOM,60-69,0,1,0,1,0,0,0,1,0,1,Lombardia,ITC4
2021-01-14,PF/BT,325001272,RSA SAN SISTO,LOM,40-49,0,2,0,2,0,0,0,2,0,2,Lombardia,ITC4
2021-01-14,PF/BT,325001272,RSA SAN SISTO,LOM,50-59,0,3,0,2,1,0,0,3,0,3,Lombardia,ITC4
2021-01-14,PF/BT,325001272,RSA SAN SISTO,LOM,70-79,1,0,0,1,0,0,0,1,0,1,Lombardia,ITC4
2021-01-14,PF/BT,325001329,"FONDAZIONE PICCINELLI ""ONLUS""",LOM,20-29,0,3,0,2,1,0,0,3,0,3,Lombardia,ITC4
2021-01-14,PF/BT,325001329,"FONDAZIONE PICCINELLI ""ONLUS""",LOM,30-39,1,1,0,1,1,0,0,2,0,2,Lombardia,ITC4
2021-01-14,PF/BT,325001329,"FONDAZIONE PICCINELLI ""ONLUS""",LOM,40-49,2,16,0,18,0,0,0,18,0,18,Lombardia,ITC4
2021-01-14,PF/BT,325001329,"FONDAZIONE PICCINELLI ""ONLUS""",LOM,50-59,0,19,0,19,0,0,0,19,0,19,Lombardia,ITC4
2021-01-14,PF/BT,325001329,"FONDAZIONE PICCINELLI ""ONLUS""",LOM,60-69,2,7,0,4,2,3,0,9,0,9,Lombardia,ITC4
2021-01-14,PF/BT,325001329,"FONDAZIONE PICCINELLI ""ONLUS""",LOM,70-79,5,1,0,0,0,6,0,6,0,6,Lombardia,ITC4
2021-01-14,PF/BT,325001329,"FONDAZIONE PICCINELLI ""ONLUS""",LOM,80-89,8,33,0,0,0,41,0,41,0,41,Lombardia,ITC4
2021-01-14,PF/BT,325001329,"FONDAZIONE PICCINELLI ""ONLUS""",LOM,90+,0,22,0,0,0,22,0,22,0,22,Lombardia,ITC4
2021-01-14,PF/BT,325001342,CLINICHE GAVAZZENI SPA,LOM,20-29,5,15,0,20,0,0,0,20,0,20,Lombardia,ITC4
2021-01-14,PF/BT,325001342,CLINICHE GAVAZZENI SPA,LOM,30-39,10,11,0,21,0,0,0,21,0,21,Lombardia,ITC4
2021-01-14,PF/BT,325001342,CLINICHE GAVAZZENI SPA,LOM,40-49,9,11,0,20,0,0,0,20,0,20,Lombardia,ITC4
2021-01-14,PF/BT,325001342,CLINICHE GAVAZZENI SPA,LOM,50-59,7,7,0,14,0,0,0,14,0,14,Lombardia,ITC4
2021-01-14,PF/BT,325001342,CLINICHE GAVAZZENI SPA,LOM,60-69,4,4,0,8,0,0,0,8,0,8,Lombardia,ITC4
2021-01-14,PF/BT,325001342,CLINICHE GAVAZZENI SPA,LOM,70-79,0,1,0,1,0,0,0,1,0,1,Lombardia,ITC4
2021-01-14,PF/BT,325001360,"CASA DI RIPOSO ""PIATTI-VENANZI"" FONDAZIONE ONLUS VIA SANTA MARIA ELISABETTA, 36 - 24050 PALOSCO (BG)",LOM,20-29,1,0,0,1,0,0,0,1,0,1,Lombardia,ITC4
2021-01-14,PF/BT,325001360,"CASA DI RIPOSO ""PIATTI-VENANZI"" FONDAZIONE ONLUS VIA SANTA MARIA ELISABETTA, 36 - 24050 PALOSCO (BG)",LOM,30-39,0,1,0,1,0,0,0,1,0,1,Lombardia,ITC4
2021-01-14,PF/BT,325001360,"CASA DI RIPOSO ""PIATTI-VENANZI"" FONDAZIONE ONLUS VIA SANTA MARIA ELISABETTA, 36 - 24050 PALOSCO (BG)",LOM,40-49,0,8,0,8,0,0,0,8,0,8,Lombardia,ITC4
2021-01-14,PF/BT,325001360,"CASA DI RIPOSO ""PIATTI-VENANZI"" FONDAZIONE ONLUS VIA SANTA MARIA ELISABETTA, 36 - 24050 PALOSCO (BG)",LOM,50-59,2,11,0,13,0,0,0,13,0,13,Lombardia,ITC4
2021-01-14,PF/BT,325001360,"CASA DI RIPOSO ""PIATTI-VENANZI"" FONDAZIONE ONLUS VIA SANTA MARIA ELISABETTA, 36 - 24050 PALOSCO (BG)",LOM,60-69,1,6,0,6,1,0,0,7,0,7,Lombardia,ITC4
2021-01-14,PF/BT,325001360,"CASA DI RIPOSO ""PIATTI-VENANZI"" FONDAZIONE ONLUS VIA SANTA MARIA ELISABETTA, 36 - 24050 PALOSCO (BG)",LOM,70-79,1,0,0,0,0,1,0,1,0,1,Lombardia,ITC4
2021-01-14,PF/BT,325001360,"CASA DI RIPOSO ""PIATTI-VENANZI"" FONDAZIONE ONLUS VIA SANTA MARIA ELISABETTA, 36 - 24050 PALOSCO (BG)",LOM,80-89,0,2,0,0,0,2,0,2,0,2,Lombardia,ITC4
2021-01-14,PF/BT,325001360,"CASA DI RIPOSO ""PIATTI-VENANZI"" FONDAZIONE ONLUS VIA SANTA MARIA ELISABETTA, 36 - 24050 PALOSCO (BG)",LOM,90+,1,8,0,0,0,9,0,9,0,9,Lombardia,ITC4
2021-01-14,PF/BT,32503014600,CASA DI CURA SAN FRANCESCO - BERGAMO,LOM,20-29,1,6,0,7,0,0,0,7,0,7,Lombardia,ITC4
2021-01-14,PF/BT,32503014600,CASA DI CURA SAN FRANCESCO - BERGAMO,LOM,30-39,4,3,0,7,0,0,0,7,0,7,Lombardia,ITC4
2021-01-14,PF/BT,32503014600,CASA DI CURA SAN FRANCESCO - BERGAMO,LOM,40-49,0,3,0,3,0,0,0,3,0,3,Lombardia,ITC4
2021-01-14,PF/BT,32503014600,CASA DI CURA SAN FRANCESCO - BERGAMO,LOM,50-59,2,8,0,10,0,0,0,10,0,10,Lombardia,ITC4
2021-01-14,PF/BT,32503014600,CASA DI CURA SAN FRANCESCO - BERGAMO,LOM,60-69,4,1,0,5,0,0,0,5,0,5,Lombardia,ITC4
2021-01-14,PF/BT,32503014600,CASA DI CURA SAN FRANCESCO - BERGAMO,LOM,70-79,2,0,0,2,0,0,0,2,0,2,Lombardia,ITC4
2021-01-14,PF/BT,3257021,AMBULATORIO COVID P.O. ALZANO,LOM,20-29,5,4,0,7,0,0,2,9,0,9,Lombardia,ITC4
2021-01-14,PF/BT,3257021,AMBULATORIO COVID P.O. ALZANO,LOM,30-39,4,8,0,12,0,0,0,12,0,12,Lombardia,ITC4
2021-01-14,PF/BT,3257021,AMBULATORIO COVID P.O. ALZANO,LOM,40-49,4,7,0,11,0,0,0,11,0,11,Lombardia,ITC4
2021-01-14,PF/BT,3257021,AMBULATORIO COVID P.O. ALZANO,LOM,50-59,14,18,0,32,0,0,0,32,0,32,Lombardia,ITC4
2021-01-14,PF/BT,3257021,AMBULATORIO COVID P.O. ALZANO,LOM,60-69,6,5,0,11,0,0,0,11,0,11,Lombardia,ITC4
2021-01-14,PF/BT,3257021,AMBULATORIO COVID P.O. ALZANO,LOM,70-79,1,0,0,1,0,0,0,1,0,1,Lombardia,ITC4
2021-01-14,PF/BT,32572026,AMBULATORIO COVID PIARIO,LOM,20-29,1,4,0,5,0,0,0,5,0,5,Lombardia,ITC4
2021-01-14,PF/BT,32572026,AMBULATORIO COVID PIARIO,LOM,30-39,1,3,0,4,0,0,0,4,0,4,Lombardia,ITC4
2021-01-14,PF/BT,32572026,AMBULATORIO COVID PIARIO,LOM,40-49,0,7,0,7,0,0,0,7,0,7,Lombardia,ITC4
2021-01-14,PF/BT,32572026,AMBULATORIO COVID PIARIO,LOM,50-59,1,11,0,12,0,0,0,12,0,12,Lombardia,ITC4
2021-01-14,PF/BT,32572026,AMBULATORIO COVID PIARIO,LOM,60-69,1,1,0,2,0,0,0,2,0,2,Lombardia,ITC4
2021-01-14,PF/BT,32572027,Ambulatorio COVID SERIATE,LOM,16-19,1,0,0,0,0,0,1,1,0,1,Lombardia,ITC4
2021-01-14,PF/BT,32572027,Ambulatorio COVID SERIATE,LOM,20-29,7,11,0,13,3,0,2,18,0,18,Lombardia,ITC4
2021-01-14,PF/BT,32572027,Ambulatorio COVID SERIATE,LOM,30-39,5,15,0,14,3,0,3,20,0,20,Lombardia,ITC4
2021-01-14,PF/BT,32572027,Ambulatorio COVID SERIATE,LOM,40-49,10,25,0,22,5,0,8,35,0,35,Lombardia,ITC4
2021-01-14,PF/BT,32572027,Ambulatorio COVID SERIATE,LOM,50-59,10,51,0,48,11,0,2,61,0,61,Lombardia,ITC4
2021-01-14,PF/BT,32572027,Ambulatorio COVID SERIATE,LOM,60-69,5,4,0,7,2,0,0,9,0,9,Lombardia,ITC4
2021-01-14,PF/BT,327001818,R.S.A. VILLA MADDALENA,LOM,30-39,0,2,0,1,1,0,0,2,0,2,Lombardia,ITC4
2021-01-14,PF/BT,327001818,R.S.A. VILLA MADDALENA,LOM,40-49,1,1,0,1,1,0,0,2,0,2,Lombardia,ITC4
2021-01-14,PF/BT,327001818,R.S.A. VILLA MADDALENA,LOM,50-59,1,6,0,6,1,0,0,7,0,7,Lombardia,ITC4
2021-01-14,PF/BT,327001818,R.S.A. VILLA MADDALENA,LOM,70-79,1,2,0,0,1,2,0,3,0,3,Lombardia,ITC4
2021-01-14,PF/BT,327001818,R.S.A. VILLA MADDALENA,LOM,80-89,2,9,0,0,0,11,0,11,0,11,Lombardia,ITC4
2021-01-14,PF/BT,327001818,R.S.A. VILLA MADDALENA,LOM,90+,1,10,0,0,0,11,0,11,0,11,Lombardia,ITC4
2021-01-14,PF/BT,327001941,CASA DI RIPOSO GIOVANNI E LUCIANA ARVEDI,LOM,30-39,0,1,0,1,0,0,0,1,0,1,Lombardia,ITC4
2021-01-14,PF/BT,327001941,CASA DI RIPOSO GIOVANNI E LUCIANA ARVEDI,LOM,40-49,0,1,0,0,1,0,0,1,0,1,Lombardia,ITC4
2021-01-14,PF/BT,327001941,CASA DI RIPOSO GIOVANNI E LUCIANA ARVEDI,LOM,70-79,1,0,0,0,0,1,0,1,0,1,Lombardia,ITC4
2021-01-14,PF/BT,327001941,CASA DI RIPOSO GIOVANNI E LUCIANA ARVEDI,LOM,80-89,0,1,0,0,0,1,0,1,0,1,Lombardia,ITC4
2021-01-14,PF/BT,327001941,CASA DI RIPOSO GIOVANNI E LUCIANA ARVEDI,LOM,90+,1,1,0,0,0,2,0,2,0,2,Lombardia,ITC4
2021-01-14,PF/BT,327001960,RSA VILLA CARPANEDA,LOM,30-39,0,4,0,3,1,0,0,4,0,4,Lombardia,ITC4
2021-01-14,PF/BT,327001960,RSA VILLA CARPANEDA,LOM,40-49,4,2,0,5,0,0,1,6,0,6,Lombardia,ITC4
2021-01-14,PF/BT,327001960,RSA VILLA CARPANEDA,LOM,50-59,1,3,0,3,1,0,0,4,0,4,Lombardia,ITC4
2021-01-14,PF/BT,327001960,RSA VILLA CARPANEDA,LOM,60-69,1,1,0,1,0,1,0,2,0,2,Lombardia,ITC4
2021-01-14,PF/BT,327001960,RSA VILLA CARPANEDA,LOM,70-79,3,7,0,0,0,9,1,10,0,10,Lombardia,ITC4
2021-01-14,PF/BT,327001960,RSA VILLA CARPANEDA,LOM,80-89,7,6,0,0,0,13,0,13,0,13,Lombardia,ITC4
2021-01-14,PF/BT,327001960,RSA VILLA CARPANEDA,LOM,90+,2,15,0,0,0,17,0,17,0,17,Lombardia,ITC4
2021-01-14,PF/BT,327001964,FONDAZIONE OSPEDALE CIVILE DI GONZAGA,LOM,20-29,0,2,0,1,1,0,0,2,0,2,Lombardia,ITC4
2021-01-14,PF/BT,327001964,FONDAZIONE OSPEDALE CIVILE DI GONZAGA,LOM,30-39,0,1,0,1,0,0,0,1,0,1,Lombardia,ITC4
2021-01-14,PF/BT,327001964,FONDAZIONE OSPEDALE CIVILE DI GONZAGA,LOM,40-49,1,8,0,5,4,0,0,9,0,9,Lombardia,ITC4
2021-01-14,PF/BT,327001964,FONDAZIONE OSPEDALE CIVILE DI GONZAGA,LOM,50-59,0,5,0,4,1,0,0,5,0,5,Lombardia,ITC4
2021-01-14,PF/BT,327001964,FONDAZIONE OSPEDALE CIVILE DI GONZAGA,LOM,60-69,1,0,0,0,1,0,0,1,0,1,Lombardia,ITC4
2021-01-14,PF/BT,327001964,FONDAZIONE OSPEDALE CIVILE DI GONZAGA,LOM,80-89,3,2,0,0,0,5,0,5,0,5,Lombardia,ITC4
2021-01-14,PF/BT,327001964,FONDAZIONE OSPEDALE CIVILE DI GONZAGA,LOM,90+,0,1,0,0,0,1,0,1,0,1,Lombardia,ITC4
2021-01-14,PF/BT,327002005,RSA EMANUELE E GIUSEPPINA CORDIOLI MARMIROLO,LOM,20-29,1,2,0,3,0,0,0,3,0,3,Lombardia,ITC4
2021-01-14,PF/BT,327002005,RSA EMANUELE E GIUSEPPINA CORDIOLI MARMIROLO,LOM,30-39,1,1,0,2,0,0,0,2,0,2,Lombardia,ITC4
2021-01-14,PF/BT,327002005,RSA EMANUELE E GIUSEPPINA CORDIOLI MARMIROLO,LOM,40-49,0,1,0,1,0,0,0,1,0,1,Lombardia,ITC4
2021-01-14,PF/BT,327002005,RSA EMANUELE E GIUSEPPINA CORDIOLI MARMIROLO,LOM,50-59,0,4,0,4,0,0,0,4,0,4,Lombardia,ITC4
2021-01-14,PF/BT,327002005,RSA EMANUELE E GIUSEPPINA CORDIOLI MARMIROLO,LOM,60-69,0,2,0,2,0,0,0,2,0,2,Lombardia,ITC4
2021-01-14,PF/BT,327003606,RSA RODIGO,LOM,20-29,2,1,0,3,0,0,0,3,0,3,Lombardia,ITC4
2021-01-14,PF/BT,327003606,RSA RODIGO,LOM,40-49,0,4,0,4,0,0,0,4,0,4,Lombardia,ITC4
2021-01-14,PF/BT,327003606,RSA RODIGO,LOM,50-59,0,11,0,10,1,0,0,11,0,11,Lombardia,ITC4
2021-01-14,PF/BT,327003606,RSA RODIGO,LOM,60-69,0,4,0,4,0,0,0,4,0,4,Lombardia,ITC4
2021-01-14,PF/BT,32772407,CV COVID CREMONA,LOM,20-29,0,1,0,0,0,0,1,1,0,1,Lombardia,ITC4
2021-01-14,PF/BT,32772407,CV COVID CREMONA,LOM,30-39,20,28,0,10,0,0,38,48,0,48,Lombardia,ITC4
2021-01-14,PF/BT,32772407,CV COVID CREMONA,LOM,40-49,9,24,0,17,0,0,16,33,0,33,Lombardia,ITC4
2021-01-14,PF/BT,32772407,CV COVID CREMONA,LOM,50-59,11,21,0,18,0,0,14,32,0,32,Lombardia,ITC4
2021-01-14,PF/BT,32772407,CV COVID CREMONA,LOM,60-69,6,34,0,22,5,0,13,40,0,40,Lombardia,ITC4
2021-01-14,PF/BT,32772407,CV COVID CREMONA,LOM,70-79,4,7,0,9,0,0,2,11,0,11,Lombardia,ITC4
2021-01-14,PF/BT,32772407,CV COVID CREMONA,LOM,80-89,2,1,0,3,0,0,0,3,0,3,Lombardia,ITC4
2021-01-14,PF/BT,328002013,R.S.A. VILLA CHIARA,LOM,30-39,0,5,0,5,0,0,0,5,0,5,Lombardia,ITC4
2021-01-14,PF/BT,328002013,R.S.A. VILLA CHIARA,LOM,40-49,0,2,0,2,0,0,0,2,0,2,Lombardia,ITC4
2021-01-14,PF/BT,328002013,R.S.A. VILLA CHIARA,LOM,50-59,2,2,0,3,0,1,0,4,0,4,Lombardia,ITC4
2021-01-14,PF/BT,328002013,R.S.A. VILLA CHIARA,LOM,60-69,6,1,0,0,0,7,0,7,0,7,Lombardia,ITC4
2021-01-14,PF/BT,328002013,R.S.A. VILLA CHIARA,LOM,70-79,6,1,0,0,1,6,0,7,0,7,Lombardia,ITC4
2021-01-14,PF/BT,328002013,R.S.A. VILLA CHIARA,LOM,80-89,1,2,0,0,0,3,0,3,0,3,Lombardia,ITC4
2021-01-14,PF/BT,328002013,R.S.A. VILLA CHIARA,LOM,90+,1,1,0,0,0,2,0,2,0,2,Lombardia,ITC4
2021-01-14,PF/BT,328002047,"""RSA F.lli Carnevale di Gambolò""",LOM,20-29,1,2,0,3,0,0,0,3,0,3,Lombardia,ITC4
2021-01-14,PF/BT,328002047,"""RSA F.lli Carnevale di Gambolò""",LOM,30-39,1,3,0,4,0,0,0,4,0,4,Lombardia,ITC4
2021-01-14,PF/BT,328002047,"""RSA F.lli Carnevale di Gambolò""",LOM,40-49,1,6,0,4,3,0,0,7,0,7,Lombardia,ITC4
2021-01-14,PF/BT,328002047,"""RSA F.lli Carnevale di Gambolò""",LOM,50-59,2,11,0,8,5,0,0,13,0,13,Lombardia,ITC4
2021-01-14,PF/BT,328002047,"""RSA F.lli Carnevale di Gambolò""",LOM,60-69,1,2,0,0,2,1,0,3,0,3,Lombardia,ITC4
2021-01-14,PF/BT,347,Fondazione San Giuseppe Moscati,LOM,20-29,2,0,0,2,0,0,0,2,0,2,Lombardia,ITC4
2021-01-14,PF/BT,347,Fondazione San Giuseppe Moscati,LOM,30-39,1,4,0,4,1,0,0,5,0,5,Lombardia,ITC4
2021-01-14,PF/BT,347,Fondazione San Giuseppe Moscati,LOM,40-49,1,3,0,4,0,0,0,4,0,4,Lombardia,ITC4
2021-01-14,PF/BT,347,Fondazione San Giuseppe Moscati,LOM,50-59,4,6,0,5,5,0,0,10,0,10,Lombardia,ITC4
2021-01-14,PF/BT,347,Fondazione San Giuseppe Moscati,LOM,60-69,1,1,0,2,0,0,0,2,0,2,Lombardia,ITC4
2021-01-14,PF/BT,347,Fondazione San Giuseppe Moscati,LOM,70-79,0,1,0,0,0,1,0,1,0,1,Lombardia,ITC4
2021-01-14,PF/BT,467,Maria Lorenzon,LOM,40-49,0,2,0,2,0,0,0,2,0,2,Lombardia,ITC4
2021-01-14,PF/BT,467,Maria Lorenzon,LOM,50-59,0,2,0,2,0,0,0,2,0,2,Lombardia,ITC4
2021-01-14,PF/BT,467,Maria Lorenzon,LOM,70-79,4,3,0,0,0,7,0,7,0,7,Lombardia,ITC4
2021-01-14,PF/BT,467,Maria Lorenzon,LOM,80-89,2,16,0,0,0,18,0,18,0,18,Lombardia,ITC4
2021-01-14,PF/BT,467,Maria Lorenzon,LOM,90+,4,17,0,0,0,21,0,21,0,21,Lombardia,ITC4
2021-01-14,PF/BT,521,"RSA ""POLO GERIATRICO RIABILITATIVO 2”",LOM,20-29,0,2,0,2,0,0,0,2,0,2,Lombardia,ITC4
2021-01-14,PF/BT,521,"RSA ""POLO GERIATRICO RIABILITATIVO 2”",LOM,30-39,1,2,0,1,2,0,0,3,0,3,Lombardia,ITC4
2021-01-14,PF/BT,521,"RSA ""POLO GERIATRICO RIABILITATIVO 2”",LOM,40-49,2,4,0,5,1,0,0,6,0,6,Lombardia,ITC4
2021-01-14,PF/BT,521,"RSA ""POLO GERIATRICO RIABILITATIVO 2”",LOM,50-59,0,6,0,6,0,0,0,6,0,6,Lombardia,ITC4
2021-01-14,PF/BT,521,"RSA ""POLO GERIATRICO RIABILITATIVO 2”",LOM,60-69,3,3,0,2,3,1,0,6,0,6,Lombardia,ITC4
2021-01-14,PF/BT,521,"RSA ""POLO GERIATRICO RIABILITATIVO 2”",LOM,70-79,2,0,0,0,0,2,0,2,0,2,Lombardia,ITC4
2021-01-14,PF/BT,521,"RSA ""POLO GERIATRICO RIABILITATIVO 2”",LOM,80-89,2,8,0,0,0,10,0,10,0,10,Lombardia,ITC4
2021-01-14,PF/BT,521,"RSA ""POLO GERIATRICO RIABILITATIVO 2”",LOM,90+,0,4,0,0,0,4,0,4,0,4,Lombardia,ITC4
2021-01-14,PF/BT,558,RSA PIO ALBERGO TRIVULZIO,LOM,20-29,5,11,0,15,1,0,0,16,0,16,Lombardia,ITC4
2021-01-14,PF/BT,558,RSA PIO ALBERGO TRIVULZIO,LOM,30-39,11,11,0,13,9,0,0,22,0,22,Lombardia,ITC4
2021-01-14,PF/BT,558,RSA PIO ALBERGO TRIVULZIO,LOM,40-49,11,11,0,12,10,0,0,22,0,22,Lombardia,ITC4
2021-01-14,PF/BT,558,RSA PIO ALBERGO TRIVULZIO,LOM,50-59,8,17,0,14,11,0,0,25,0,25,Lombardia,ITC4
2021-01-14,PF/BT,558,RSA PIO ALBERGO TRIVULZIO,LOM,60-69,5,5,0,4,6,0,0,10,0,10,Lombardia,ITC4
2021-01-14,PF/BT,558,RSA PIO ALBERGO TRIVULZIO,LOM,70-79,1,0,0,1,0,0,0,1,0,1,Lombardia,ITC4
2021-01-14,PF/BT,673,RSA Alfredo  Podestà,LOM,30-39,0,1,0,1,0,0,0,1,0,1,Lombardia,ITC4
2021-01-14,PF/BT,673,RSA Alfredo  Podestà,LOM,40-49,1,1,0,1,1,0,0,2,0,2,Lombardia,ITC4
2021-01-14,PF/BT,673,RSA Alfredo  Podestà,LOM,50-59,3,4,0,2,2,3,0,7,0,7,Lombardia,ITC4
2021-01-14,PF/BT,673,RSA Alfredo  Podestà,LOM,60-69,2,1,0,1,0,2,0,3,0,3,Lombardia,ITC4
2021-01-14,PF/BT,673,RSA Alfredo  Podestà,LOM,70-79,0,1,0,0,0,1,0,1,0,1,Lombardia,ITC4
2021-01-14,PF/BT,673,RSA Alfredo  Podestà,LOM,80-89,3,10,0,0,0,13,0,13,0,13,Lombardia,ITC4
2021-01-14,PF/BT,673,RSA Alfredo  Podestà,LOM,90+,3,10,0,0,0,13,0,13,0,13,Lombardia,ITC4
2021-01-14,PF/BT,690548,RSA Fondazione Lucini-Cantù Onlus,LOM,20-29,0,1,0,1,0,0,0,1,0,1,Lombardia,ITC4
2021-01-14,PF/BT,690548,RSA Fondazione Lucini-Cantù Onlus,LOM,40-49,0,1,0,1,0,0,0,1,0,1,Lombardia,ITC4
2021-01-14,PF/BT,690548,RSA Fondazione Lucini-Cantù Onlus,LOM,50-59,0,1,0,1,0,0,0,1,0,1,Lombardia,ITC4
2021-01-14,PF/BT,690548,RSA Fondazione Lucini-Cantù Onlus,LOM,60-69,0,1,0,1,0,0,0,1,0,1,Lombardia,ITC4
2021-01-14,PF/BT,690548,RSA Fondazione Lucini-Cantù Onlus,LOM,70-79,0,1,0,0,0,1,0,1,0,1,Lombardia,ITC4
2021-01-14,PF/BT,690548,RSA Fondazione Lucini-Cantù Onlus,LOM,80-89,0,5,0,0,0,5,0,5,0,5,Lombardia,ITC4
2021-01-14,PF/BT,690548,RSA Fondazione Lucini-Cantù Onlus,LOM,90+,1,1,0,0,0,2,0,2,0,2,Lombardia,ITC4
2021-01-14,PF/BT,697,CASA RIPOSO F.LLI MOLINA P.E.T,LOM,20-29,0,4,0,3,1,0,0,4,0,4,Lombardia,ITC4
2021-01-14,PF/BT,697,CASA RIPOSO F.LLI MOLINA P.E.T,LOM,30-39,2,7,0,7,2,0,0,9,0,9,Lombardia,ITC4
2021-01-14,PF/BT,697,CASA RIPOSO F.LLI MOLINA P.E.T,LOM,40-49,2,14,0,12,4,0,0,16,0,16,Lombardia,ITC4
2021-01-14,PF/BT,697,CASA RIPOSO F.LLI MOLINA P.E.T,LOM,50-59,4,12,0,14,2,0,0,16,0,16,Lombardia,ITC4
2021-01-14,PF/BT,697,CASA RIPOSO F.LLI MOLINA P.E.T,LOM,60-69,1,2,0,3,0,0,0,3,0,3,Lombardia,ITC4
2021-01-14,PF/BT,906,FONDAZIONE ONLUS NINJ BECCAGUTTI,LOM,20-29,0,6,0,4,2,0,0,6,0,6,Lombardia,ITC4
2021-01-14,PF/BT,906,FONDAZIONE ONLUS NINJ BECCAGUTTI,LOM,30-39,0,4,0,4,0,0,0,4,0,4,Lombardia,ITC4
2021-01-14,PF/BT,906,FONDAZIONE ONLUS NINJ BECCAGUTTI,LOM,40-49,1,9,0,9,1,0,0,10,0,10,Lombardia,ITC4
2021-01-14,PF/BT,906,FONDAZIONE ONLUS NINJ BECCAGUTTI,LOM,50-59,0,10,0,9,1,0,0,10,0,10,Lombardia,ITC4
2021-01-14,PF/BT,907,RSA SANTA MARIA DELLA NEVE,LOM,20-29,3,4,0,5,2,0,0,7,0,7,Lombardia,ITC4
2021-01-14,PF/BT,907,RSA SANTA MARIA DELLA NEVE,LOM,30-39,1,2,0,2,1,0,0,3,0,3,Lombardia,ITC4
2021-01-14,PF/BT,907,RSA SANTA MARIA DELLA NEVE,LOM,40-49,0,7,0,6,1,0,0,7,0,7,Lombardia,ITC4
2021-01-14,PF/BT,907,RSA SANTA MARIA DELLA NEVE,LOM,50-59,3,18,0,11,10,0,0,21,0,21,Lombardia,ITC4
2021-01-14,PF/BT,907,RSA SANTA MARIA DELLA NEVE,LOM,60-69,9,2,0,1,7,3,0,11,0,11,Lombardia,ITC4
2021-01-14,PF/BT,907,RSA SANTA MARIA DELLA NEVE,LOM,70-79,9,6,0,1,3,11,0,15,0,15,Lombardia,ITC4
2021-01-14,PF/BT,907,RSA SANTA MARIA DELLA NEVE,LOM,80-89,4,17,0,0,2,19,0,21,0,21,Lombardia,ITC4
2021-01-14,PF/BT,907,RSA SANTA MARIA DELLA NEVE,LOM,90+,0,5,0,0,0,5,0,5,0,5,Lombardia,ITC4
2021-01-14,PF/BT,922,CASA DI RIPOSO G.M. VENZOLI,LOM,20-29,0,4,0,3,1,0,0,4,0,4,Lombardia,ITC4
2021-01-14,PF/BT,922,CASA DI RIPOSO G.M. VENZOLI,LOM,30-39,0,2,0,2,0,0,0,2,0,2,Lombardia,ITC4
2021-01-14,PF/BT,922,CASA DI RIPOSO G.M. VENZOLI,LOM,40-49,3,14,0,14,3,0,0,17,0,17,Lombardia,ITC4
2021-01-14,PF/BT,922,CASA DI RIPOSO G.M. VENZOLI,LOM,50-59,1,8,0,7,2,0,0,9,0,9,Lombardia,ITC4
2021-01-14,PF/BT,922,CASA DI RIPOSO G.M. VENZOLI,LOM,60-69,2,5,0,4,0,3,0,7,0,7,Lombardia,ITC4
2021-01-14,PF/BT,922,CASA DI RIPOSO G.M. VENZOLI,LOM,70-79,1,2,0,0,0,3,0,3,0,3,Lombardia,ITC4
2021-01-14,PF/BT,922,CASA DI RIPOSO G.M. VENZOLI,LOM,80-89,4,13,0,0,0,17,0,17,0,17,Lombardia,ITC4
2021-01-14,PF/BT,922,CASA DI RIPOSO G.M. VENZOLI,LOM,90+,1,12,0,0,0,13,0,13,0,13,Lombardia,ITC4
2021-01-14,PF/BT,933,RSA FONDAZIONE RIZZIERI- PIANCOGNO (BS),LOM,20-29,0,3,0,3,0,0,0,3,0,3,Lombardia,ITC4
2021-01-14,PF/BT,933,RSA FONDAZIONE RIZZIERI- PIANCOGNO (BS),LOM,30-39,0,9,0,9,0,0,0,9,0,9,Lombardia,ITC4
2021-01-14,PF/BT,933,RSA FONDAZIONE RIZZIERI- PIANCOGNO (BS),LOM,40-49,0,12,0,12,0,0,0,12,0,12,Lombardia,ITC4
2021-01-14,PF/BT,933,RSA FONDAZIONE RIZZIERI- PIANCOGNO (BS),LOM,50-59,2,13,0,15,0,0,0,15,0,15,Lombardia,ITC4
2021-01-14,PF/BT,933,RSA FONDAZIONE RIZZIERI- PIANCOGNO (BS),LOM,60-69,0,3,0,3,0,0,0,3,0,3,Lombardia,ITC4
2021-01-14,PF/BT,943,R.S.A RESIDENZA ANGELO MAJ FONDAZIONE ONLUS,LOM,20-29,0,1,0,1,0,0,0,1,0,1,Lombardia,ITC4
2021-01-14,PF/BT,943,R.S.A RESIDENZA ANGELO MAJ FONDAZIONE ONLUS,LOM,30-39,1,1,0,2,0,0,0,2,0,2,Lombardia,ITC4
2021-01-14,PF/BT,943,R.S.A RESIDENZA ANGELO MAJ FONDAZIONE ONLUS,LOM,40-49,1,0,0,0,1,0,0,1,0,1,Lombardia,ITC4
2021-01-14,PF/BT,943,R.S.A RESIDENZA ANGELO MAJ FONDAZIONE ONLUS,LOM,50-59,1,0,0,0,0,1,0,1,0,1,Lombardia,ITC4
2021-01-14,PF/BT,943,R.S.A RESIDENZA ANGELO MAJ FONDAZIONE ONLUS,LOM,60-69,3,4,0,1,2,4,0,7,0,7,Lombardia,ITC4
2021-01-14,PF/BT,943,R.S.A RESIDENZA ANGELO MAJ FONDAZIONE ONLUS,LOM,70-79,4,2,0,0,2,4,0,6,0,6,Lombardia,ITC4
2021-01-14,PF/BT,943,R.S.A RESIDENZA ANGELO MAJ FONDAZIONE ONLUS,LOM,80-89,4,21,0,0,0,25,0,25,0,25,Lombardia,ITC4
2021-01-14,PF/BT,943,R.S.A RESIDENZA ANGELO MAJ FONDAZIONE ONLUS,LOM,90+,0,11,0,0,0,11,0,11,0,11,Lombardia,ITC4
2021-01-14,PF/BT,947,I.R.C.C.S. POLICLINICO SAN DONATO,LOM,20-29,8,17,0,24,1,0,0,25,0,25,Lombardia,ITC4
2021-01-14,PF/BT,947,I.R.C.C.S. POLICLINICO SAN DONATO,LOM,30-39,8,13,0,17,4,0,0,21,0,21,Lombardia,ITC4
2021-01-14,PF/BT,947,I.R.C.C.S. POLICLINICO SAN DONATO,LOM,40-49,5,17,0,17,5,0,0,22,0,22,Lombardia,ITC4
2021-01-14,PF/BT,947,I.R.C.C.S. POLICLINICO SAN DONATO,LOM,50-59,4,22,0,16,10,0,0,26,0,26,Lombardia,ITC4
2021-01-14,PF/BT,947,I.R.C.C.S. POLICLINICO SAN DONATO,LOM,60-69,4,3,0,1,6,0,0,7,0,7,Lombardia,ITC4
2021-01-14,PF/BT,947,I.R.C.C.S. POLICLINICO SAN DONATO,LOM,70-79,0,1,0,0,1,0,0,1,0,1,Lombardia,ITC4
2021-01-14,PF/BT,953,Fondazione Casa di Riposo Bongioni-Lambertenghi Onlus,LOM,50-59,0,1,0,0,1,0,0,1,0,1,Lombardia,ITC4
2021-01-14,PF/BT,953,Fondazione Casa di Riposo Bongioni-Lambertenghi Onlus,LOM,60-69,1,1,0,0,0,1,1,2,0,2,Lombardia,ITC4
2021-01-14,PF/BT,953,Fondazione Casa di Riposo Bongioni-Lambertenghi Onlus,LOM,70-79,5,3,0,0,0,6,2,8,0,8,Lombardia,ITC4
2021-01-14,PF/BT,953,Fondazione Casa di Riposo Bongioni-Lambertenghi Onlus,LOM,80-89,2,14,0,0,0,16,0,16,0,16,Lombardia,ITC4
2021-01-14,PF/BT,953,Fondazione Casa di Riposo Bongioni-Lambertenghi Onlus,LOM,90+,0,9,0,0,0,9,0,9,0,9,Lombardia,ITC4
2021-01-14,PF/BT,980,CASA MADONNA DEL LAVORO,LOM,20-29,0,1,0,1,0,0,0,1,0,1,Lombardia,ITC4
2021-01-14,PF/BT,980,CASA MADONNA DEL LAVORO,LOM,30-39,0,2,0,2,0,0,0,2,0,2,Lombardia,ITC4
2021-01-14,PF/BT,980,CASA MADONNA DEL LAVORO,LOM,40-49,0,6,0,4,2,0,0,6,0,6,Lombardia,ITC4
2021-01-14,PF/BT,980,CASA MADONNA DEL LAVORO,LOM,50-59,0,9,0,7,2,0,0,9,0,9,Lombardia,ITC4
2021-01-14,PF/BT,980,CASA MADONNA DEL LAVORO,LOM,60-69,0,1,0,0,1,0,0,1,0,1,Lombardia,ITC4
2021-01-14,PF/BT,HSP11-11 bis,Policlinico San Pietro,LOM,20-29,1,10,0,11,0,0,0,11,0,11,Lombardia,ITC4
2021-01-14,PF/BT,HSP11-11 bis,Policlinico San Pietro,LOM,30-39,1,12,0,13,0,0,0,13,0,13,Lombardia,ITC4
2021-01-14,PF/BT,HSP11-11 bis,Policlinico San Pietro,LOM,40-49,2,23,0,25,0,0,0,25,0,25,Lombardia,ITC4
2021-01-14,PF/BT,HSP11-11 bis,Policlinico San Pietro,LOM,50-59,5,19,0,24,0,0,0,24,0,24,Lombardia,ITC4
2021-01-14,PF/BT,HSP11-11 bis,Policlinico San Pietro,LOM,60-69,3,1,0,4,0,0,0,4,0,4,Lombardia,ITC4
2021-01-14,PF/BT,HSP11-11bis,32170223 HUB COVID SS PAOLO E CARLO - PVO Ospedale San Paolo,LOM,16-19,1,2,0,3,0,0,0,3,0,3,Lombardia,ITC4
2021-01-14,PF/BT,HSP11-11bis,32170223 HUB COVID SS PAOLO E CARLO - PVO Ospedale San Paolo,LOM,20-29,25,26,0,43,8,0,0,51,0,51,Lombardia,ITC4
2021-01-14,PF/BT,HSP11-11bis,32170223 HUB COVID SS PAOLO E CARLO - PVO Ospedale San Paolo,LOM,30-39,13,30,0,30,13,0,0,43,0,43,Lombardia,ITC4
2021-01-14,PF/BT,HSP11-11bis,32170223 HUB COVID SS PAOLO E CARLO - PVO Ospedale San Paolo,LOM,40-49,38,38,0,43,33,0,0,76,0,76,Lombardia,ITC4
2021-01-14,PF/BT,HSP11-11bis,32170223 HUB COVID SS PAOLO E CARLO - PVO Ospedale San Paolo,LOM,50-59,37,47,0,47,37,0,0,84,0,84,Lombardia,ITC4
2021-01-14,PF/BT,HSP11-11bis,32170223 HUB COVID SS PAOLO E CARLO - PVO Ospedale San Paolo,LOM,60-69,14,26,0,26,14,0,0,40,0,40,Lombardia,ITC4
2021-01-14,PF/BT,HSP11-11bis,32170223 HUB COVID SS PAOLO E CARLO - PVO Ospedale San Paolo,LOM,70-79,2,1,0,3,0,0,0,3,0,3,Lombardia,ITC4
2021-01-14,PF/BT,HSP11-11bis,Ambulatorio COVID PO - BEVILACQUA OPERATORI,LOM,30-39,0,2,0,2,0,0,0,2,0,2,Lombardia,ITC4
2021-01-14,PF/BT,HSP11-11bis,Ambulatorio COVID PO - BEVILACQUA OPERATORI,LOM,40-49,0,5,0,2,3,0,0,5,0,5,Lombardia,ITC4
2021-01-14,PF/BT,HSP11-11bis,Ambulatorio COVID PO - BEVILACQUA OPERATORI,LOM,50-59,0,13,0,9,4,0,0,13,0,13,Lombardia,ITC4
2021-01-14,PF/BT,HSP11-11bis,Ambulatorio COVID PO - BEVILACQUA OPERATORI,LOM,60-69,1,2,0,3,0,0,0,3,0,3,Lombardia,ITC4
2021-01-14,PF/BT,HSP11-11bis,Ambulatorio COVID PO - BEVILACQUA OPERATORI,LOM,70-79,2,0,0,1,1,0,0,2,0,2,Lombardia,ITC4
2021-01-14,PF/BT,HSP11-11bis,Ambulatorio COVID PO Codogno,LOM,20-29,0,1,0,1,0,0,0,1,0,1,Lombardia,ITC4
2021-01-14,PF/BT,HSP11-11bis,Ambulatorio COVID PO Codogno,LOM,30-39,1,2,0,2,1,0,0,3,0,3,Lombardia,ITC4
2021-01-14,PF/BT,HSP11-11bis,Ambulatorio COVID PO Codogno,LOM,40-49,2,10,0,11,1,0,0,12,0,12,Lombardia,ITC4
2021-01-14,PF/BT,HSP11-11bis,Ambulatorio COVID PO Codogno,LOM,50-59,4,23,0,24,3,0,0,27,0,27,Lombardia,ITC4
2021-01-14,PF/BT,HSP11-11bis,Ambulatorio COVID PO Codogno,LOM,60-69,1,4,0,4,1,0,0,5,0,5,Lombardia,ITC4
2021-01-14,PF/BT,HSP11-11bis,Ambulatorio COVID PO LODI,LOM,20-29,5,10,0,15,0,0,0,15,0,15,Lombardia,ITC4
2021-01-14,PF/BT,HSP11-11bis,Ambulatorio COVID PO LODI,LOM,30-39,9,21,0,26,4,0,0,30,0,30,Lombardia,ITC4
2021-01-14,PF/BT,HSP11-11bis,Ambulatorio COVID PO LODI,LOM,40-49,7,31,0,27,11,0,0,38,0,38,Lombardia,ITC4
2021-01-14,PF/BT,HSP11-11bis,Ambulatorio COVID PO LODI,LOM,50-59,13,34,0,36,11,0,0,47,0,47,Lombardia,ITC4
2021-01-14,PF/BT,HSP11-11bis,Ambulatorio COVID PO LODI,LOM,60-69,6,8,0,11,3,0,0,14,0,14,Lombardia,ITC4
2021-01-14,PF/BT,HSP11-11bis,Ambulatorio COVID PO LODI - OSPEDALE DEI POVERI - OSPITI,LOM,60-69,1,2,0,0,0,3,0,3,0,3,Lombardia,ITC4
2021-01-14,PF/BT,HSP11-11bis,Ambulatorio COVID PO LODI - OSPEDALE DEI POVERI - OSPITI,LOM,70-79,0,5,0,0,0,5,0,5,0,5,Lombardia,ITC4
2021-01-14,PF/BT,HSP11-11bis,Ambulatorio COVID PO LODI - OSPEDALE DEI POVERI - OSPITI,LOM,80-89,1,32,0,0,0,33,0,33,0,33,Lombardia,ITC4
2021-01-14,PF/BT,HSP11-11bis,Ambulatorio COVID PO LODI - OSPEDALE DEI POVERI - OSPITI,LOM,90+,0,15,0,0,0,15,0,15,0,15,Lombardia,ITC4
2021-01-14,PF/BT,HSP11-11bis,Ambulatorio COVID PO LODI - RSA OSPEDALE DEI POVERI - OPERATORI,LOM,16-19,1,0,0,0,1,0,0,1,0,1,Lombardia,ITC4
2021-01-14,PF/BT,HSP11-11bis,Ambulatorio COVID PO LODI - RSA OSPEDALE DEI POVERI - OPERATORI,LOM,20-29,0,1,0,1,0,0,0,1,0,1,Lombardia,ITC4
2021-01-14,PF/BT,HSP11-11bis,Ambulatorio COVID PO LODI - RSA OSPEDALE DEI POVERI - OPERATORI,LOM,30-39,1,3,0,4,0,0,0,4,0,4,Lombardia,ITC4
2021-01-14,PF/BT,HSP11-11bis,Ambulatorio COVID PO LODI - RSA OSPEDALE DEI POVERI - OPERATORI,LOM,40-49,1,8,0,9,0,0,0,9,0,9,Lombardia,ITC4
2021-01-14,PF/BT,HSP11-11bis,Ambulatorio COVID PO LODI - RSA OSPEDALE DEI POVERI - OPERATORI,LOM,50-59,5,12,0,17,0,0,0,17,0,17,Lombardia,ITC4
2021-01-14,PF/BT,HSP11-11bis,Ambulatorio COVID PO LODI - RSA OSPEDALE DEI POVERI - OPERATORI,LOM,60-69,0,3,0,3,0,0,0,3,0,3,Lombardia,ITC4
2021-01-14,PF/BT,HSP11-11bis,Ambulatorio COVID PO LODI - RSA OSPEDALE DEI POVERI - OPERATORI,LOM,70-79,2,0,0,2,0,0,0,2,0,2,Lombardia,ITC4
2021-01-14,PF/BT,HSP11-11bis,Ambulatorio COVID PO LODI - RSA SANTA  CHIARA,LOM,40-49,0,1,0,0,0,0,1,1,0,1,Lombardia,ITC4
2021-01-14,PF/BT,HSP11-11bis,Ambulatorio COVID PO LODI - RSA SANTA  CHIARA,LOM,50-59,2,1,0,0,0,1,2,3,0,3,Lombardia,ITC4
2021-01-14,PF/BT,HSP11-11bis,Ambulatorio COVID PO LODI - RSA SANTA  CHIARA,LOM,60-69,1,1,0,0,0,2,0,2,0,2,Lombardia,ITC4
2021-01-14,PF/BT,HSP11-11bis,Ambulatorio COVID PO LODI - RSA SANTA  CHIARA,LOM,70-79,4,6,0,0,0,7,3,10,0,10,Lombardia,ITC4
2021-01-14,PF/BT,HSP11-11bis,Ambulatorio COVID PO LODI - RSA SANTA  CHIARA,LOM,80-89,3,23,0,0,0,26,0,26,0,26,Lombardia,ITC4
2021-01-14,PF/BT,HSP11-11bis,Ambulatorio COVID PO LODI - RSA SANTA  CHIARA,LOM,90+,1,17,0,0,0,17,1,18,0,18,Lombardia,ITC4
2021-01-14,PF/BT,HSP11-11bis,Ambulatorio COVID PO LODI - RSA SANTA TERESA,LOM,60-69,1,1,0,0,0,2,0,2,0,2,Lombardia,ITC4
2021-01-14,PF/BT,HSP11-11bis,Ambulatorio COVID PO LODI - RSA SANTA TERESA,LOM,70-79,0,4,0,0,0,4,0,4,0,4,Lombardia,ITC4
2021-01-14,PF/BT,HSP11-11bis,Ambulatorio COVID PO LODI - RSA SANTA TERESA,LOM,80-89,3,18,0,0,0,21,0,21,0,21,Lombardia,ITC4
2021-01-14,PF/BT,HSP11-11bis,Ambulatorio COVID PO LODI - RSA SANTA TERESA,LOM,90+,0,14,0,0,0,14,0,14,0,14,Lombardia,ITC4
2021-01-14,PF/BT,HSP11-11bis,Ambulatorio COVID PO LODI - RSAS DE PETRI,LOM,20-29,6,21,0,0,0,27,0,27,0,27,Lombardia,ITC4
2021-01-14,PF/BT,HSP11-11bis,Ambulatorio COVID PO LODI - RSAS DE PETRI,LOM,30-39,1,25,0,0,0,26,0,26,0,26,Lombardia,ITC4
2021-01-14,PF/BT,HSP11-11bis,Ambulatorio COVID PO LODI - RSAS DE PETRI,LOM,40-49,13,66,0,0,0,79,0,79,0,79,Lombardia,ITC4
2021-01-14,PF/BT,HSP11-11bis,Ambulatorio COVID PO LODI - RSAS DE PETRI,LOM,50-59,16,72,0,0,0,88,0,88,0,88,Lombardia,ITC4
2021-01-14,PF/BT,HSP11-11bis,Ambulatorio COVID PO LODI - RSAS DE PETRI,LOM,60-69,8,17,0,0,0,25,0,25,0,25,Lombardia,ITC4
2021-01-14,PF/BT,HSP11-11bis,Ambulatorio COVID PO LODI - RSAS DE PETRI,LOM,70-79,1,0,0,0,0,1,0,1,0,1,Lombardia,ITC4
2021-01-14,PF/BT,HSP11-11bis,Ambulatorio COVID PO Lodi - Servizio Vaccinazioni,LOM,30-39,0,2,0,2,0,0,0,2,0,2,Lombardia,ITC4
2021-01-14,PF/BT,HSP11-11bis,Ambulatorio COVID PO Lodi - Servizio Vaccinazioni,LOM,40-49,0,4,0,4,0,0,0,4,0,4,Lombardia,ITC4
2021-01-14,PF/BT,HSP11-11bis,Ambulatorio COVID PO Lodi - Servizio Vaccinazioni,LOM,50-59,1,5,0,5,1,0,0,6,0,6,Lombardia,ITC4
2021-01-14,PF/BT,HSP11-11bis,Ambulatorio COVID PO LODI- RSA BEVILACQUA OSPITI,LOM,40-49,1,0,0,0,0,1,0,1,0,1,Lombardia,ITC4
2021-01-14,PF/BT,HSP11-11bis,Ambulatorio COVID PO LODI- RSA BEVILACQUA OSPITI,LOM,70-79,4,2,0,0,0,6,0,6,0,6,Lombardia,ITC4
2021-01-14,PF/BT,HSP11-11bis,Ambulatorio COVID PO LODI- RSA BEVILACQUA OSPITI,LOM,80-89,2,19,0,0,0,21,0,21,0,21,Lombardia,ITC4
2021-01-14,PF/BT,HSP11-11bis,Ambulatorio COVID PO LODI- RSA BEVILACQUA OSPITI,LOM,90+,1,8,0,0,0,9,0,9,0,9,Lombardia,ITC4
2021-01-14,PF/BT,HSP11-11bis,AMBULATORIO COVID PO SACCO,LOM,16-19,4,0,0,1,0,0,3,4,0,4,Lombardia,ITC4
2021-01-14,PF/BT,HSP11-11bis,AMBULATORIO COVID PO SACCO,LOM,20-29,36,55,0,44,7,0,40,91,0,91,Lombardia,ITC4
2021-01-14,PF/BT,HSP11-11bis,AMBULATORIO COVID PO SACCO,LOM,30-39,31,56,0,61,13,0,13,87,0,87,Lombardia,ITC4
2021-01-14,PF/BT,HSP11-11bis,AMBULATORIO COVID PO SACCO,LOM,40-49,44,65,0,59,18,0,32,109,0,109,Lombardia,ITC4
2021-01-14,PF/BT,HSP11-11bis,AMBULATORIO COVID PO SACCO,LOM,50-59,63,100,0,94,48,0,21,163,0,163,Lombardia,ITC4
2021-01-14,PF/BT,HSP11-11bis,AMBULATORIO COVID PO SACCO,LOM,60-69,36,43,0,49,10,0,20,79,0,79,Lombardia,ITC4
2021-01-14,PF/BT,HSP11-11bis,AMBULATORIO COVID PO SACCO,LOM,70-79,4,2,0,2,0,0,4,6,0,6,Lombardia,ITC4
2021-01-14,PF/BT,HSP11-11bis,ASST BERGAMO OVEST - OSPEDALE ROMANO DI L.DIA,LOM,16-19,0,2,0,0,0,0,2,2,0,2,Lombardia,ITC4
2021-01-14,PF/BT,HSP11-11bis,ASST BERGAMO OVEST - OSPEDALE ROMANO DI L.DIA,LOM,20-29,3,10,0,5,0,0,8,13,0,13,Lombardia,ITC4
2021-01-14,PF/BT,HSP11-11bis,ASST BERGAMO OVEST - OSPEDALE ROMANO DI L.DIA,LOM,30-39,3,5,0,2,1,0,5,8,0,8,Lombardia,ITC4
2021-01-14,PF/BT,HSP11-11bis,ASST BERGAMO OVEST - OSPEDALE ROMANO DI L.DIA,LOM,40-49,2,10,0,6,0,0,6,12,0,12,Lombardia,ITC4
2021-01-14,PF/BT,HSP11-11bis,ASST BERGAMO OVEST - OSPEDALE ROMANO DI L.DIA,LOM,50-59,8,15,0,10,4,0,9,23,0,23,Lombardia,ITC4
2021-01-14,PF/BT,HSP11-11bis,ASST BERGAMO OVEST - OSPEDALE ROMANO DI L.DIA,LOM,60-69,7,6,0,3,0,0,10,13,0,13,Lombardia,ITC4
2021-01-14,PF/BT,HSP11-11bis,ASST BERGAMO OVEST - OSPEDALE ROMANO DI L.DIA,LOM,70-79,8,5,0,0,0,0,13,13,0,13,Lombardia,ITC4
2021-01-14,PF/BT,HSP11-11bis,ASST BERGAMO OVEST - OSPEDALE TREVIGLIO,LOM,20-29,6,7,0,5,1,0,7,13,0,13,Lombardia,ITC4
2021-01-14,PF/BT,HSP11-11bis,ASST BERGAMO OVEST - OSPEDALE TREVIGLIO,LOM,30-39,9,19,0,15,4,0,9,28,0,28,Lombardia,ITC4
2021-01-14,PF/BT,HSP11-11bis,ASST BERGAMO OVEST - OSPEDALE TREVIGLIO,LOM,40-49,17,27,0,25,12,0,7,44,0,44,Lombardia,ITC4
2021-01-14,PF/BT,HSP11-11bis,ASST BERGAMO OVEST - OSPEDALE TREVIGLIO,LOM,50-59,11,38,0,31,14,0,4,49,0,49,Lombardia,ITC4
2021-01-14,PF/BT,HSP11-11bis,ASST BERGAMO OVEST - OSPEDALE TREVIGLIO,LOM,60-69,7,13,0,13,3,0,4,20,0,20,Lombardia,ITC4
2021-01-14,PF/BT,HSP11-11bis,ASST BERGAMO OVEST - OSPEDALE TREVIGLIO,LOM,70-79,1,0,0,0,0,0,1,1,0,1,Lombardia,ITC4
2021-01-14,PF/BT,HSP11-11bis,ASST BERGAMO OVEST - OSPEDALE TREVIGLIO,LOM,80-89,1,0,0,0,0,0,1,1,0,1,Lombardia,ITC4
2021-01-14,PF/BT,HSP11-11bis,CASA DI CURA SAN CAMILLO - BRESCIA,LOM,20-29,2,2,0,4,0,0,0,4,0,4,Lombardia,ITC4
2021-01-14,PF/BT,HSP11-11bis,CASA DI CURA SAN CAMILLO - BRESCIA,LOM,30-39,2,9,0,8,3,0,0,11,0,11,Lombardia,ITC4
2021-01-14,PF/BT,HSP11-11bis,CASA DI CURA SAN CAMILLO - BRESCIA,LOM,40-49,7,19,0,21,3,0,2,26,0,26,Lombardia,ITC4
2021-01-14,PF/BT,HSP11-11bis,CASA DI CURA SAN CAMILLO - BRESCIA,LOM,50-59,10,25,0,21,11,0,3,35,0,35,Lombardia,ITC4
2021-01-14,PF/BT,HSP11-11bis,CASA DI CURA SAN CAMILLO - BRESCIA,LOM,60-69,9,5,0,11,3,0,0,14,0,14,Lombardia,ITC4
2021-01-14,PF/BT,HSP11-11bis,CASA DI CURA SAN CAMILLO - BRESCIA,LOM,70-79,1,3,0,1,0,0,3,4,0,4,Lombardia,ITC4
2021-01-14,PF/BT,HSP11-11bis,CASA DI CURA SAN CAMILLO - BRESCIA,LOM,80-89,0,2,0,0,0,0,2,2,0,2,Lombardia,ITC4
2021-01-14,PF/BT,HSP11-11bis,ICS Maugeri- Istituto Scientifico di Montescano (Pv),LOM,20-29,3,1,0,4,0,0,0,4,0,4,Lombardia,ITC4
2021-01-14,PF/BT,HSP11-11bis,ICS Maugeri- Istituto Scientifico di Montescano (Pv),LOM,30-39,1,2,0,3,0,0,0,3,0,3,Lombardia,ITC4
2021-01-14,PF/BT,HSP11-11bis,ICS Maugeri- Istituto Scientifico di Montescano (Pv),LOM,40-49,3,12,0,15,0,0,0,15,0,15,Lombardia,ITC4
2021-01-14,PF/BT,HSP11-11bis,ICS Maugeri- Istituto Scientifico di Montescano (Pv),LOM,50-59,3,24,0,23,4,0,0,27,0,27,Lombardia,ITC4
2021-01-14,PF/BT,HSP11-11bis,ICS Maugeri- Istituto Scientifico di Montescano (Pv),LOM,60-69,3,2,0,4,1,0,0,5,0,5,Lombardia,ITC4
2021-01-14,PF/BT,HSP11-11bis,"Policlinico San Marco, Osio Sotto (BG)",LOM,20-29,6,7,0,13,0,0,0,13,0,13,Lombardia,ITC4
2021-01-14,PF/BT,HSP11-11bis,"Policlinico San Marco, Osio Sotto (BG)",LOM,30-39,6,17,0,23,0,0,0,23,0,23,Lombardia,ITC4
2021-01-14,PF/BT,HSP11-11bis,"Policlinico San Marco, Osio Sotto (BG)",LOM,40-49,5,31,0,33,3,0,0,36,0,36,Lombardia,ITC4
2021-01-14,PF/BT,HSP11-11bis,"Policlinico San Marco, Osio Sotto (BG)",LOM,50-59,4,22,0,23,3,0,0,26,0,26,Lombardia,ITC4
2021-01-14,PF/BT,HSP11-11bis,"Policlinico San Marco, Osio Sotto (BG)",LOM,60-69,3,2,0,5,0,0,0,5,0,5,Lombardia,ITC4
2021-01-14,PF/BT,HSP11-11bis,"Policlinico San Marco, Osio Sotto (BG)",LOM,70-79,3,2,0,4,1,0,0,5,0,5,Lombardia,ITC4
2021-01-14,PF/BT,HSP11-11BIS-03010600,CASA DI CURA POLICLINICO DI MONZA-MONZA-,LOM,20-29,5,2,0,4,1,0,2,7,0,7,Lombardia,ITC4
2021-01-14,PF/BT,HSP11-11BIS-03010600,CASA DI CURA POLICLINICO DI MONZA-MONZA-,LOM,30-39,2,4,0,0,3,0,3,6,0,6,Lombardia,ITC4
2021-01-14,PF/BT,HSP11-11BIS-03010600,CASA DI CURA POLICLINICO DI MONZA-MONZA-,LOM,40-49,4,5,0,3,3,0,3,9,0,9,Lombardia,ITC4
2021-01-14,PF/BT,HSP11-11BIS-03010600,CASA DI CURA POLICLINICO DI MONZA-MONZA-,LOM,50-59,3,10,0,4,7,0,2,13,0,13,Lombardia,ITC4
2021-01-14,PF/BT,HSP11-11BIS-03010600,CASA DI CURA POLICLINICO DI MONZA-MONZA-,LOM,70-79,1,0,0,0,0,0,1,1,0,1,Lombardia,ITC4
2021-01-14,PF/BT,S09, PII ISTITUTI UNIFICATI ONLUS,LOM,30-39,1,3,0,4,0,0,0,4,0,4,Lombardia,ITC4
2021-01-14,PF/BT,S09, PII ISTITUTI UNIFICATI ONLUS,LOM,40-49,0,1,0,0,0,0,1,1,0,1,Lombardia,ITC4
2021-01-14,PF/BT,S09, PII ISTITUTI UNIFICATI ONLUS,LOM,50-59,1,5,0,6,0,0,0,6,0,6,Lombardia,ITC4
2021-01-14,PF/BT,S09, PII ISTITUTI UNIFICATI ONLUS,LOM,60-69,0,1,0,1,0,0,0,1,0,1,Lombardia,ITC4
2021-01-14,PF/BT,S09,FONDAZIONE PENSIONATO SANNAZZARESE ONLUS,LOM,30-39,0,2,0,1,1,0,0,2,0,2,Lombardia,ITC4
2021-01-14,PF/BT,S09,FONDAZIONE PENSIONATO SANNAZZARESE ONLUS,LOM,50-59,0,6,0,6,0,0,0,6,0,6,Lombardia,ITC4
2021-01-14,PF/BT,S09,FONDAZIONE PENSIONATO SANNAZZARESE ONLUS,LOM,60-69,0,4,0,3,1,0,0,4,0,4,Lombardia,ITC4
2021-01-14,PF/BT,S09,FONDAZIONE PENSIONATO SANNAZZARESE ONLUS,LOM,80-89,1,7,0,0,0,8,0,8,0,8,Lombardia,ITC4
2021-01-14,PF/BT,S09,FONDAZIONE PENSIONATO SANNAZZARESE ONLUS,LOM,90+,0,4,0,0,0,4,0,4,0,4,Lombardia,ITC4
2021-01-14,PF/BT,S09,SAN FRANCESCO,LOM,20-29,1,1,0,2,0,0,0,2,0,2,Lombardia,ITC4
2021-01-14,PF/BT,S09,SAN FRANCESCO,LOM,30-39,4,3,0,5,2,0,0,7,0,7,Lombardia,ITC4
2021-01-14,PF/BT,S09,SAN FRANCESCO,LOM,40-49,0,5,0,3,2,0,0,5,0,5,Lombardia,ITC4
2021-01-14,PF/BT,S09,SAN FRANCESCO,LOM,50-59,0,4,0,4,0,0,0,4,0,4,Lombardia,ITC4
2021-01-14,PF/BT,S-09,FONDAZIONE CONTE FRANCO CELLA DI RIVARA ONLUS R.S.A. DI ARENA PO,LOM,30-39,2,3,0,5,0,0,0,5,0,5,Lombardia,ITC4
2021-01-14,PF/BT,S-09,FONDAZIONE CONTE FRANCO CELLA DI RIVARA ONLUS R.S.A. DI ARENA PO,LOM,40-49,0,6,0,5,1,0,0,6,0,6,Lombardia,ITC4
2021-01-14,PF/BT,S-09,FONDAZIONE CONTE FRANCO CELLA DI RIVARA ONLUS R.S.A. DI ARENA PO,LOM,50-59,1,10,0,10,1,0,0,11,0,11,Lombardia,ITC4
2021-01-14,PF/BT,S-09,FONDAZIONE CONTE FRANCO CELLA DI RIVARA ONLUS R.S.A. DI ARENA PO,LOM,60-69,0,2,0,2,0,0,0,2,0,2,Lombardia,ITC4
2021-01-14,PF/BT,S-09,FONDAZIONE CONTE FRANCO CELLA DI RIVARA ONLUS R.S.A. DI BRONI,LOM,30-39,1,8,0,8,1,0,0,9,0,9,Lombardia,ITC4
2021-01-14,PF/BT,S-09,FONDAZIONE CONTE FRANCO CELLA DI RIVARA ONLUS R.S.A. DI BRONI,LOM,40-49,2,17,0,19,0,0,0,19,0,19,Lombardia,ITC4
2021-01-14,PF/BT,S-09,FONDAZIONE CONTE FRANCO CELLA DI RIVARA ONLUS R.S.A. DI BRONI,LOM,50-59,2,14,0,14,2,0,0,16,0,16,Lombardia,ITC4
2021-01-14,PF/BT,S-09,FONDAZIONE CONTE FRANCO CELLA DI RIVARA ONLUS R.S.A. DI BRONI,LOM,60-69,4,6,0,9,1,0,0,10,0,10,Lombardia,ITC4
2021-01-14,PF/BT,STS11,ASC CREMONA SOLIDALE,LOM,20-29,8,5,0,9,2,0,2,13,0,13,Lombardia,ITC4
2021-01-14,PF/BT,STS11,ASC CREMONA SOLIDALE,LOM,30-39,8,11,0,13,5,0,1,19,0,19,Lombardia,ITC4
2021-01-14,PF/BT,STS11,ASC CREMONA SOLIDALE,LOM,40-49,3,29,0,28,4,0,0,32,0,32,Lombardia,ITC4
2021-01-14,PF/BT,STS11,ASC CREMONA SOLIDALE,LOM,50-59,8,27,0,27,8,0,0,35,0,35,Lombardia,ITC4
2021-01-14,PF/BT,STS11,ASC CREMONA SOLIDALE,LOM,60-69,2,10,0,6,2,0,4,12,0,12,Lombardia,ITC4
2021-01-14,PF/BT,STS11,ASC CREMONA SOLIDALE,LOM,70-79,3,0,0,0,0,0,3,3,0,3,Lombardia,ITC4
2021-01-14,PF/BT,STS11,CASA DI RIPOSO CARLO E ELISA FRIGERIO BRIVIO,LOM,50-59,1,0,0,0,0,1,0,1,0,1,Lombardia,ITC4
2021-01-14,PF/BT,STS11,CASA DI RIPOSO CARLO E ELISA FRIGERIO BRIVIO,LOM,60-69,1,7,0,0,0,8,0,8,0,8,Lombardia,ITC4
2021-01-14,PF/BT,STS11,CASA DI RIPOSO CARLO E ELISA FRIGERIO BRIVIO,LOM,70-79,7,7,0,0,0,14,0,14,0,14,Lombardia,ITC4
2021-01-14,PF/BT,STS11,CASA DI RIPOSO CARLO E ELISA FRIGERIO BRIVIO,LOM,80-89,12,32,0,0,0,44,0,44,0,44,Lombardia,ITC4
2021-01-14,PF/BT,STS11,CASA DI RIPOSO CARLO E ELISA FRIGERIO BRIVIO,LOM,90+,3,20,0,0,0,23,0,23,0,23,Lombardia,ITC4
2021-01-14,PF/BT,STS11,CASA DI RIPOSO COSTANTE PATRIZI ONLUS,LOM,30-39,0,1,0,0,1,0,0,1,0,1,Lombardia,ITC4
2021-01-14,PF/BT,STS11,CASA DI RIPOSO COSTANTE PATRIZI ONLUS,LOM,40-49,1,9,0,8,2,0,0,10,0,10,Lombardia,ITC4
2021-01-14,PF/BT,STS11,CASA DI RIPOSO COSTANTE PATRIZI ONLUS,LOM,50-59,1,6,0,4,3,0,0,7,0,7,Lombardia,ITC4
2021-01-14,PF/BT,STS11,CASA DI RIPOSO COSTANTE PATRIZI ONLUS,LOM,80-89,6,3,0,0,0,9,0,9,0,9,Lombardia,ITC4
2021-01-14,PF/BT,STS11,CASA DI RIPOSO COSTANTE PATRIZI ONLUS,LOM,90+,1,8,0,0,0,9,0,9,0,9,Lombardia,ITC4
2021-01-14,PF/BT,STS11,CASA DI RIPOSO MANDELLO LARIO,LOM,70-79,5,3,0,0,0,8,0,8,0,8,Lombardia,ITC4
2021-01-14,PF/BT,STS11,CASA DI RIPOSO MANDELLO LARIO,LOM,80-89,6,7,0,0,0,13,0,13,0,13,Lombardia,ITC4
2021-01-14,PF/BT,STS11,CASA DI RIPOSO MANDELLO LARIO,LOM,90+,4,10,0,0,0,14,0,14,0,14,Lombardia,ITC4
2021-01-14,PF/BT,STS11,FONDAZIONE IN PARTECIPAZIONE CASA DI RIPOSO VILLA DEL SORRISO ONLUS,LOM,20-29,0,2,0,2,0,0,0,2,0,2,Lombardia,ITC4
2021-01-14,PF/BT,STS11,FONDAZIONE IN PARTECIPAZIONE CASA DI RIPOSO VILLA DEL SORRISO ONLUS,LOM,30-39,0,4,0,3,1,0,0,4,0,4,Lombardia,ITC4
2021-01-14,PF/BT,STS11,FONDAZIONE IN PARTECIPAZIONE CASA DI RIPOSO VILLA DEL SORRISO ONLUS,LOM,40-49,1,8,0,7,2,0,0,9,0,9,Lombardia,ITC4
2021-01-14,PF/BT,STS11,FONDAZIONE IN PARTECIPAZIONE CASA DI RIPOSO VILLA DEL SORRISO ONLUS,LOM,50-59,1,14,0,12,3,0,0,15,0,15,Lombardia,ITC4
2021-01-14,PF/BT,STS11,FONDAZIONE IN PARTECIPAZIONE CASA DI RIPOSO VILLA DEL SORRISO ONLUS,LOM,60-69,1,1,0,0,2,0,0,2,0,2,Lombardia,ITC4
2021-01-14,PF/BT,STS11,FONDAZIONE IN PARTECIPAZIONE CASA DI RIPOSO VILLA DEL SORRISO ONLUS,LOM,70-79,0,4,0,0,0,4,0,4,0,4,Lombardia,ITC4
2021-01-14,PF/BT,STS11,FONDAZIONE IN PARTECIPAZIONE CASA DI RIPOSO VILLA DEL SORRISO ONLUS,LOM,80-89,0,6,0,0,0,6,0,6,0,6,Lombardia,ITC4
2021-01-14,PF/BT,STS11,FONDAZIONE POMPEO E CESARE MAZZOCCHI  ONLUS - COCCAGLIO,LOM,20-29,0,1,0,1,0,0,0,1,0,1,Lombardia,ITC4
2021-01-14,PF/BT,STS11,FONDAZIONE POMPEO E CESARE MAZZOCCHI  ONLUS - COCCAGLIO,LOM,30-39,0,5,0,3,2,0,0,5,0,5,Lombardia,ITC4
2021-01-14,PF/BT,STS11,FONDAZIONE POMPEO E CESARE MAZZOCCHI  ONLUS - COCCAGLIO,LOM,40-49,0,3,0,3,0,0,0,3,0,3,Lombardia,ITC4
2021-01-14,PF/BT,STS11,FONDAZIONE POMPEO E CESARE MAZZOCCHI  ONLUS - COCCAGLIO,LOM,50-59,0,2,0,1,1,0,0,2,0,2,Lombardia,ITC4
2021-01-14,PF/BT,STS11,FONDAZIONE POMPEO E CESARE MAZZOCCHI  ONLUS - COCCAGLIO,LOM,60-69,0,1,0,1,0,0,0,1,0,1,Lombardia,ITC4
2021-01-14,PF/BT,STS11,HOSPICE PONTEVICO (BS),LOM,20-29,2,1,0,3,0,0,0,3,0,3,Lombardia,ITC4
2021-01-14,PF/BT,STS11,HOSPICE PONTEVICO (BS),LOM,30-39,1,1,0,2,0,0,0,2,0,2,Lombardia,ITC4
2021-01-14,PF/BT,STS11,HOSPICE PONTEVICO (BS),LOM,40-49,1,7,0,8,0,0,0,8,0,8,Lombardia,ITC4
2021-01-14,PF/BT,STS11,HOSPICE PONTEVICO (BS),LOM,50-59,1,3,0,4,0,0,0,4,0,4,Lombardia,ITC4
2021-01-14,PF/BT,STS11,HOSPICE PONTEVICO (BS),LOM,60-69,1,0,0,1,0,0,0,1,0,1,Lombardia,ITC4
2021-01-14,PF/BT,STS11,ISTITUTO GERIATRICO CARLO LOUISA GRASSI ONLUS - VIADANA (MN),LOM,20-29,2,0,0,1,1,0,0,2,0,2,Lombardia,ITC4
2021-01-14,PF/BT,STS11,ISTITUTO GERIATRICO CARLO LOUISA GRASSI ONLUS - VIADANA (MN),LOM,30-39,0,5,0,4,1,0,0,5,0,5,Lombardia,ITC4
2021-01-14,PF/BT,STS11,ISTITUTO GERIATRICO CARLO LOUISA GRASSI ONLUS - VIADANA (MN),LOM,40-49,0,5,0,4,1,0,0,5,0,5,Lombardia,ITC4
2021-01-14,PF/BT,STS11,ISTITUTO GERIATRICO CARLO LOUISA GRASSI ONLUS - VIADANA (MN),LOM,50-59,1,13,0,10,4,0,0,14,0,14,Lombardia,ITC4
2021-01-14,PF/BT,STS11,ISTITUTO GERIATRICO CARLO LOUISA GRASSI ONLUS - VIADANA (MN),LOM,60-69,1,6,0,3,1,3,0,7,0,7,Lombardia,ITC4
2021-01-14,PF/BT,STS11,ISTITUTO GERIATRICO CARLO LOUISA GRASSI ONLUS - VIADANA (MN),LOM,70-79,2,2,0,0,0,4,0,4,0,4,Lombardia,ITC4
2021-01-14,PF/BT,STS11,ISTITUTO GERIATRICO CARLO LOUISA GRASSI ONLUS - VIADANA (MN),LOM,80-89,3,10,0,0,0,13,0,13,0,13,Lombardia,ITC4
2021-01-14,PF/BT,STS11,ISTITUTO GERIATRICO CARLO LOUISA GRASSI ONLUS - VIADANA (MN),LOM,90+,4,7,0,0,0,11,0,11,0,11,Lombardia,ITC4
2021-01-14,PF/BT,STS11,PVT COVID BRESCIA VIA ACERBI,LOM,20-29,6,9,0,4,2,0,9,15,0,15,Lombardia,ITC4
2021-01-14,PF/BT,STS11,PVT COVID BRESCIA VIA ACERBI,LOM,30-39,6,20,0,12,4,0,10,26,0,26,Lombardia,ITC4
2021-01-14,PF/BT,STS11,PVT COVID BRESCIA VIA ACERBI,LOM,40-49,15,18,0,10,7,0,16,33,0,33,Lombardia,ITC4
2021-01-14,PF/BT,STS11,PVT COVID BRESCIA VIA ACERBI,LOM,50-59,21,36,0,14,19,0,24,57,0,57,Lombardia,ITC4
2021-01-14,PF/BT,STS11,PVT COVID BRESCIA VIA ACERBI,LOM,60-69,32,5,0,2,1,0,34,37,0,37,Lombardia,ITC4
2021-01-14,PF/BT,STS11,PVT COVID BRESCIA VIA ACERBI,LOM,70-79,17,4,0,1,0,0,20,21,0,21,Lombardia,ITC4
2021-01-14,PF/BT,STS11,PVT COVID BRESCIA VIA ACERBI,LOM,80-89,2,1,0,0,0,0,3,3,0,3,Lombardia,ITC4
2021-01-14,PF/BT,STS11,RSA,LOM,16-19,7,46,0,31,3,19,0,53,0,53,Lombardia,ITC4
2021-01-14,PF/BT,STS11,RSA - FOND. CASA DI SOGGIORNO PER ANZIANI ONLUS,LOM,20-29,1,3,0,3,1,0,0,4,0,4,Lombardia,ITC4
2021-01-14,PF/BT,STS11,RSA - FOND. CASA DI SOGGIORNO PER ANZIANI ONLUS,LOM,30-39,1,0,0,1,0,0,0,1,0,1,Lombardia,ITC4
2021-01-14,PF/BT,STS11,RSA - FOND. CASA DI SOGGIORNO PER ANZIANI ONLUS,LOM,40-49,3,8,0,9,2,0,0,11,0,11,Lombardia,ITC4
2021-01-14,PF/BT,STS11,RSA - FOND. CASA DI SOGGIORNO PER ANZIANI ONLUS,LOM,50-59,0,11,0,10,1,0,0,11,0,11,Lombardia,ITC4
2021-01-14,PF/BT,STS11,RSA - FOND. CASA DI SOGGIORNO PER ANZIANI ONLUS,LOM,60-69,0,2,0,1,0,0,1,2,0,2,Lombardia,ITC4
2021-01-14,PF/BT,STS11,RSA - FOND. CASA DI SOGGIORNO PER ANZIANI ONLUS,LOM,80-89,1,0,0,0,0,1,0,1,0,1,Lombardia,ITC4
2021-01-14,PF/BT,STS11,RSA  FONDAZIONE ANNI SERENI TREVIGLIO CARAVAGGI E FARA GA ONLUS,LOM,20-29,1,2,0,3,0,0,0,3,0,3,Lombardia,ITC4
2021-01-14,PF/BT,STS11,RSA  FONDAZIONE ANNI SERENI TREVIGLIO CARAVAGGI E FARA GA ONLUS,LOM,30-39,1,1,0,1,1,0,0,2,0,2,Lombardia,ITC4
2021-01-14,PF/BT,STS11,RSA  FONDAZIONE ANNI SERENI TREVIGLIO CARAVAGGI E FARA GA ONLUS,LOM,40-49,0,3,0,3,0,0,0,3,0,3,Lombardia,ITC4
2021-01-14,PF/BT,STS11,RSA  FONDAZIONE ANNI SERENI TREVIGLIO CARAVAGGI E FARA GA ONLUS,LOM,50-59,4,5,0,6,3,0,0,9,0,9,Lombardia,ITC4
2021-01-14,PF/BT,STS11,RSA  FONDAZIONE ANNI SERENI TREVIGLIO CARAVAGGI E FARA GA ONLUS,LOM,60-69,2,4,0,2,0,4,0,6,0,6,Lombardia,ITC4
2021-01-14,PF/BT,STS11,RSA  FONDAZIONE ANNI SERENI TREVIGLIO CARAVAGGI E FARA GA ONLUS,LOM,70-79,4,0,0,0,0,4,0,4,0,4,Lombardia,ITC4
2021-01-14,PF/BT,STS11,RSA  FONDAZIONE ANNI SERENI TREVIGLIO CARAVAGGI E FARA GA ONLUS,LOM,80-89,0,11,0,0,0,11,0,11,0,11,Lombardia,ITC4
2021-01-14,PF/BT,STS11,RSA  FONDAZIONE ANNI SERENI TREVIGLIO CARAVAGGI E FARA GA ONLUS,LOM,90+,1,9,0,0,0,10,0,10,0,10,Lombardia,ITC4
2021-01-14,PF/BT,STS11,"RSA ""BEATO INNOCENZO""",LOM,20-29,0,1,0,1,0,0,0,1,0,1,Lombardia,ITC4
2021-01-14,PF/BT,STS11,"RSA ""BEATO INNOCENZO""",LOM,30-39,1,3,0,2,1,0,1,4,0,4,Lombardia,ITC4
2021-01-14,PF/BT,STS11,"RSA ""BEATO INNOCENZO""",LOM,40-49,0,4,0,4,0,0,0,4,0,4,Lombardia,ITC4
2021-01-14,PF/BT,STS11,"RSA ""BEATO INNOCENZO""",LOM,50-59,0,3,0,3,0,0,0,3,0,3,Lombardia,ITC4
2021-01-14,PF/BT,STS11,"RSA ""BEATO INNOCENZO""",LOM,60-69,1,2,0,0,0,3,0,3,0,3,Lombardia,ITC4
2021-01-14,PF/BT,STS11,"RSA ""BEATO INNOCENZO""",LOM,70-79,2,3,0,0,0,4,1,5,0,5,Lombardia,ITC4
2021-01-14,PF/BT,STS11,"RSA ""BEATO INNOCENZO""",LOM,80-89,0,2,0,0,0,2,0,2,0,2,Lombardia,ITC4
2021-01-14,PF/BT,STS11,"RSA ""BEATO INNOCENZO""",LOM,90+,0,2,0,0,0,2,0,2,0,2,Lombardia,ITC4
2021-01-14,PF/BT,STS11,"RSA ""CASA BEATO LUIGI GUANELLA"" - VIA CAGNOLA, 11 - 20154 MILANO",LOM,20-29,1,2,0,1,2,0,0,3,0,3,Lombardia,ITC4
2021-01-14,PF/BT,STS11,"RSA ""CASA BEATO LUIGI GUANELLA"" - VIA CAGNOLA, 11 - 20154 MILANO",LOM,30-39,3,1,0,4,0,0,0,4,0,4,Lombardia,ITC4
2021-01-14,PF/BT,STS11,"RSA ""CASA BEATO LUIGI GUANELLA"" - VIA CAGNOLA, 11 - 20154 MILANO",LOM,40-49,2,16,0,12,6,0,0,18,0,18,Lombardia,ITC4
2021-01-14,PF/BT,STS11,"RSA ""CASA BEATO LUIGI GUANELLA"" - VIA CAGNOLA, 11 - 20154 MILANO",LOM,50-59,3,14,0,16,1,0,0,17,0,17,Lombardia,ITC4
2021-01-14,PF/BT,STS11,"RSA ""CASA BEATO LUIGI GUANELLA"" - VIA CAGNOLA, 11 - 20154 MILANO",LOM,60-69,0,5,0,3,2,0,0,5,0,5,Lombardia,ITC4
2021-01-14,PF/BT,STS11,"RSA ""CASA BEATO LUIGI GUANELLA"" - VIA CAGNOLA, 11 - 20154 MILANO",LOM,70-79,1,0,0,1,0,0,0,1,0,1,Lombardia,ITC4
2021-01-14,PF/BT,STS11,"RSA ""CASA BEATO LUIGI GUANELLA"" - VIA CAGNOLA, 11 - 20154 MILANO",LOM,80-89,0,2,0,0,0,2,0,2,0,2,Lombardia,ITC4
2021-01-14,PF/BT,STS11,"RSA ""CASA BEATO LUIGI GUANELLA"" - VIA CAGNOLA, 11 - 20154 MILANO",LOM,90+,0,2,0,0,0,2,0,2,0,2,Lombardia,ITC4
2021-01-14,PF/BT,STS11,RSA CAV. PAOLO RIVADOSSI BORNO (BS),LOM,20-29,0,2,0,2,0,0,0,2,0,2,Lombardia,ITC4
2021-01-14,PF/BT,STS11,RSA CAV. PAOLO RIVADOSSI BORNO (BS),LOM,40-49,0,6,0,6,0,0,0,6,0,6,Lombardia,ITC4
2021-01-14,PF/BT,STS11,RSA CAV. PAOLO RIVADOSSI BORNO (BS),LOM,50-59,1,3,0,2,1,1,0,4,0,4,Lombardia,ITC4
2021-01-14,PF/BT,STS11,RSA CAV. PAOLO RIVADOSSI BORNO (BS),LOM,60-69,4,0,0,0,0,4,0,4,0,4,Lombardia,ITC4
2021-01-14,PF/BT,STS11,RSA CAV. PAOLO RIVADOSSI BORNO (BS),LOM,70-79,4,2,0,0,0,6,0,6,0,6,Lombardia,ITC4
2021-01-14,PF/BT,STS11,RSA CAV. PAOLO RIVADOSSI BORNO (BS),LOM,80-89,2,4,0,0,0,6,0,6,0,6,Lombardia,ITC4
2021-01-14,PF/BT,STS11,RSA CAV. PAOLO RIVADOSSI BORNO (BS),LOM,90+,2,6,0,0,0,8,0,8,0,8,Lombardia,ITC4
2021-01-14,PF/BT,STS11 - 000939,0,LOM,20-29,0,4,0,4,0,0,0,4,0,4,Lombardia,ITC4
2021-01-14,PF/BT,STS11 - 000939,0,LOM,30-39,0,3,0,3,0,0,0,3,0,3,Lombardia,ITC4
2021-01-14,PF/BT,STS11 - 000939,0,LOM,40-49,0,6,0,6,0,0,0,6,0,6,Lombardia,ITC4
2021-01-14,PF/BT,STS11 - 000939,0,LOM,50-59,1,12,0,10,3,0,0,13,0,13,Lombardia,ITC4
2021-01-14,PF/BT,STS11 - 000939,0,LOM,60-69,0,2,0,1,0,1,0,2,0,2,Lombardia,ITC4
2021-01-14,PF/BT,STS11 - 000939,0,LOM,70-79,0,10,0,0,0,10,0,10,0,10,Lombardia,ITC4
2021-01-14,PF/BT,STS11 - 000939,0,LOM,80-89,0,13,0,0,0,13,0,13,0,13,Lombardia,ITC4
2021-01-14,PF/BT,STS11 - 000939,0,LOM,90+,0,9,0,0,0,9,0,9,0,9,Lombardia,ITC4
2021-01-14,PF/BT,STS11 - 000939,CASA DI RIPOSO CORTI NEMESIO,LOM,20-29,0,4,0,4,0,0,0,4,0,4,Lombardia,ITC4
2021-01-14,PF/BT,STS11 - 000939,CASA DI RIPOSO CORTI NEMESIO,LOM,30-39,0,3,0,3,0,0,0,3,0,3,Lombardia,ITC4
2021-01-14,PF/BT,STS11 - 000939,CASA DI RIPOSO CORTI NEMESIO,LOM,40-49,0,6,0,6,0,0,0,6,0,6,Lombardia,ITC4
2021-01-14,PF/BT,STS11 - 000939,CASA DI RIPOSO CORTI NEMESIO,LOM,50-59,1,12,0,10,3,0,0,13,0,13,Lombardia,ITC4
2021-01-14,PF/BT,STS11 - 000939,CASA DI RIPOSO CORTI NEMESIO,LOM,60-69,0,2,0,1,0,1,0,2,0,2,Lombardia,ITC4
2021-01-14,PF/BT,STS11 - 000939,CASA DI RIPOSO CORTI NEMESIO,LOM,70-79,4,6,0,0,0,10,0,10,0,10,Lombardia,ITC4
2021-01-14,PF/BT,STS11 - 000939,CASA DI RIPOSO CORTI NEMESIO,LOM,80-89,7,6,0,0,0,13,0,13,0,13,Lombardia,ITC4
2021-01-14,PF/BT,STS11 - 000939,CASA DI RIPOSO CORTI NEMESIO,LOM,90+,2,7,0,0,0,9,0,9,0,9,Lombardia,ITC4
2021-01-14,PF/BT,STS11  002035,RSA Fondazione Bellinie Silva,LOM,20-29,0,1,0,1,0,0,0,1,0,1,Lombardia,ITC4
2021-01-14,PF/BT,STS11  002035,RSA Fondazione Bellinie Silva,LOM,30-39,0,2,0,1,1,0,0,2,0,2,Lombardia,ITC4
2021-01-14,PF/BT,STS11  002035,RSA Fondazione Bellinie Silva,LOM,40-49,0,2,0,2,0,0,0,2,0,2,Lombardia,ITC4
2021-01-14,PF/BT,STS11  002035,RSA Fondazione Bellinie Silva,LOM,50-59,1,9,0,9,1,0,0,10,0,10,Lombardia,ITC4
2021-01-14,PF/BT,STS11  002035,RSA Fondazione Bellinie Silva,LOM,60-69,0,8,0,4,4,0,0,8,0,8,Lombardia,ITC4
2021-01-14,PF/BT,STS11  002035,RSA Fondazione Bellinie Silva,LOM,70-79,1,0,0,0,0,1,0,1,0,1,Lombardia,ITC4
2021-01-14,PF/BT,STS11  002035,RSA Fondazione Bellinie Silva,LOM,80-89,0,1,0,0,0,1,0,1,0,1,Lombardia,ITC4
2021-01-14,PF/BT,STS11  002035,RSA Fondazione Bellinie Silva,LOM,90+,0,5,0,0,0,5,0,5,0,5,Lombardia,ITC4
2021-01-14,PF/BT,STS11 000942,PSVR RSA FONDAZIONE ENTE CELERI BRENO,LOM,30-39,0,1,0,1,0,0,0,1,0,1,Lombardia,ITC4
2021-01-14,PF/BT,STS11 000942,PSVR RSA FONDAZIONE ENTE CELERI BRENO,LOM,40-49,0,5,0,5,0,0,0,5,0,5,Lombardia,ITC4
2021-01-14,PF/BT,STS11 000942,PSVR RSA FONDAZIONE ENTE CELERI BRENO,LOM,50-59,0,6,0,3,2,1,0,6,0,6,Lombardia,ITC4
2021-01-14,PF/BT,STS11 000942,PSVR RSA FONDAZIONE ENTE CELERI BRENO,LOM,60-69,1,2,0,1,0,2,0,3,0,3,Lombardia,ITC4
2021-01-14,PF/BT,STS11 000942,PSVR RSA FONDAZIONE ENTE CELERI BRENO,LOM,70-79,2,1,0,0,0,3,0,3,0,3,Lombardia,ITC4
2021-01-14,PF/BT,STS11 000942,PSVR RSA FONDAZIONE ENTE CELERI BRENO,LOM,80-89,0,2,0,0,0,2,0,2,0,2,Lombardia,ITC4
2021-01-14,PF/BT,STS11 000942,PSVR RSA FONDAZIONE ENTE CELERI BRENO,LOM,90+,0,4,0,0,0,4,0,4,0,4,Lombardia,ITC4
2021-01-14,PF/BT,sts11 cudes 002195,R.S.A. ING. SASSI FONDAZIONE  ONLUS,LOM,20-29,0,1,0,0,1,0,0,1,0,1,Lombardia,ITC4
2021-01-14,PF/BT,sts11 cudes 002195,R.S.A. ING. SASSI FONDAZIONE  ONLUS,LOM,30-39,1,0,0,1,0,0,0,1,0,1,Lombardia,ITC4
2021-01-14,PF/BT,sts11 cudes 002195,R.S.A. ING. SASSI FONDAZIONE  ONLUS,LOM,40-49,0,5,0,5,0,0,0,5,0,5,Lombardia,ITC4
2021-01-14,PF/BT,sts11 cudes 002195,R.S.A. ING. SASSI FONDAZIONE  ONLUS,LOM,50-59,1,1,0,1,1,0,0,2,0,2,Lombardia,ITC4
2021-01-14,PF/BT,sts11 cudes 002195,R.S.A. ING. SASSI FONDAZIONE  ONLUS,LOM,60-69,1,2,0,3,0,0,0,3,0,3,Lombardia,ITC4
2021-01-14,PF/BT,sts11 cudes 002195,R.S.A. ING. SASSI FONDAZIONE  ONLUS,LOM,70-79,0,1,0,0,0,1,0,1,0,1,Lombardia,ITC4
2021-01-14,PF/BT,sts11 cudes 002195,R.S.A. ING. SASSI FONDAZIONE  ONLUS,LOM,80-89,2,4,0,0,0,6,0,6,0,6,Lombardia,ITC4
2021-01-14,PF/BT,sts11 cudes 002195,R.S.A. ING. SASSI FONDAZIONE  ONLUS,LOM,90+,1,4,0,0,0,5,0,5,0,5,Lombardia,ITC4
2021-01-14,PF/BT,STS11/32170226,32170226  030321  030702 AMBULATORIO COVID OSP. MILITARE  015146,LOM,20-29,1,0,0,1,0,0,0,1,0,1,Lombardia,ITC4
2021-01-14,PF/BT,STS11/32170226,32170226  030321  030702 AMBULATORIO COVID OSP. MILITARE  015146,LOM,30-39,2,0,0,2,0,0,0,2,0,2,Lombardia,ITC4
2021-01-14,PF/BT,STS11/32170226,32170226  030321  030702 AMBULATORIO COVID OSP. MILITARE  015146,LOM,40-49,1,0,0,0,1,0,0,1,0,1,Lombardia,ITC4
2021-01-14,PF/BT,STS11/32170226,32170226  030321  030702 AMBULATORIO COVID OSP. MILITARE  015146,LOM,50-59,2,0,0,1,1,0,0,2,0,2,Lombardia,ITC4
2021-01-14,PF/BT,STS11-001144,AZIENDA SPECIALE DEL COMUNE DI MONTICELLO BRIANZA-CASA DI RIPOSO MONTICELLO (CUDES 001144),LOM,40-49,1,1,0,2,0,0,0,2,0,2,Lombardia,ITC4
2021-01-14,PF/BT,STS11-001144,AZIENDA SPECIALE DEL COMUNE DI MONTICELLO BRIANZA-CASA DI RIPOSO MONTICELLO (CUDES 001144),LOM,50-59,0,1,0,0,0,1,0,1,0,1,Lombardia,ITC4
2021-01-14,PF/BT,STS11-001144,AZIENDA SPECIALE DEL COMUNE DI MONTICELLO BRIANZA-CASA DI RIPOSO MONTICELLO (CUDES 001144),LOM,60-69,4,1,0,0,1,4,0,5,0,5,Lombardia,ITC4
2021-01-14,PF/BT,STS11-001144,AZIENDA SPECIALE DEL COMUNE DI MONTICELLO BRIANZA-CASA DI RIPOSO MONTICELLO (CUDES 001144),LOM,70-79,7,7,0,0,0,14,0,14,0,14,Lombardia,ITC4
2021-01-14,PF/BT,STS11-001144,AZIENDA SPECIALE DEL COMUNE DI MONTICELLO BRIANZA-CASA DI RIPOSO MONTICELLO (CUDES 001144),LOM,80-89,13,44,0,0,0,57,0,57,0,57,Lombardia,ITC4
2021-01-14,PF/BT,STS11-001144,AZIENDA SPECIALE DEL COMUNE DI MONTICELLO BRIANZA-CASA DI RIPOSO MONTICELLO (CUDES 001144),LOM,90+,5,23,0,0,0,28,0,28,0,28,Lombardia,ITC4
2021-01-14,PF/BT,STS24,RSA FONDAZIONE ONLUS MONS. A. MAZZALI (MANTOVA),LOM,20-29,0,2,0,2,0,0,0,2,0,2,Lombardia,ITC4
2021-01-14,PF/BT,STS24,RSA FONDAZIONE ONLUS MONS. A. MAZZALI (MANTOVA),LOM,30-39,0,4,0,3,1,0,0,4,0,4,Lombardia,ITC4
2021-01-14,PF/BT,STS24,RSA FONDAZIONE ONLUS MONS. A. MAZZALI (MANTOVA),LOM,40-49,0,6,0,6,0,0,0,6,0,6,Lombardia,ITC4
2021-01-14,PF/BT,STS24,RSA FONDAZIONE ONLUS MONS. A. MAZZALI (MANTOVA),LOM,50-59,1,5,0,5,1,0,0,6,0,6,Lombardia,ITC4
2021-01-14,PF/BT,STS24,RSA FONDAZIONE ONLUS MONS. A. MAZZALI (MANTOVA),LOM,60-69,2,3,0,3,2,0,0,5,0,5,Lombardia,ITC4
2021-01-14,PF/BT,STS24,RSA FONDAZIONE ONLUS MONS. A. MAZZALI (MANTOVA),LOM,70-79,1,0,0,0,1,0,0,1,0,1,Lombardia,ITC4
2021-01-15,PF/BT,"""000916""",CASA RIPOSO CITTA' DI SONDRIO,LOM,20-29,1,1,0,2,0,0,0,2,0,2,Lombardia,ITC4
2021-01-15,PF/BT,"""000916""",CASA RIPOSO CITTA' DI SONDRIO,LOM,30-39,1,1,0,1,1,0,0,2,0,2,Lombardia,ITC4
2021-01-15,PF/BT,"""000916""",CASA RIPOSO CITTA' DI SONDRIO,LOM,40-49,3,19,0,19,1,0,2,22,0,22,Lombardia,ITC4
2021-01-15,PF/BT,"""000916""",CASA RIPOSO CITTA' DI SONDRIO,LOM,50-59,1,18,0,16,2,0,1,19,0,19,Lombardia,ITC4
2021-01-15,PF/BT,"""000916""",CASA RIPOSO CITTA' DI SONDRIO,LOM,60-69,1,9,0,5,0,0,5,10,0,10,Lombardia,ITC4
2021-01-15,PF/BT,"""000916""",CASA RIPOSO CITTA' DI SONDRIO,LOM,70-79,2,9,0,0,0,3,8,11,0,11,Lombardia,ITC4
2021-01-15,PF/BT,"""000916""",CASA RIPOSO CITTA' DI SONDRIO,LOM,80-89,4,7,0,0,0,9,2,11,0,11,Lombardia,ITC4
2021-01-15,PF/BT,"""000916""",CASA RIPOSO CITTA' DI SONDRIO,LOM,90+,1,6,0,0,0,7,0,7,0,7,Lombardia,ITC4
2021-01-15,PF/BT,(03027500/001752),PVO Istituto Clinico San Rocco (Spoke),LOM,20-29,1,2,0,3,0,0,0,3,0,3,Lombardia,ITC4
2021-01-15,PF/BT,(03027500/001752),PVO Istituto Clinico San Rocco (Spoke),LOM,30-39,1,3,0,3,1,0,0,4,0,4,Lombardia,ITC4
2021-01-15,PF/BT,(03027500/001752),PVO Istituto Clinico San Rocco (Spoke),LOM,40-49,0,7,0,7,0,0,0,7,0,7,Lombardia,ITC4
2021-01-15,PF/BT,(03027500/001752),PVO Istituto Clinico San Rocco (Spoke),LOM,50-59,1,7,0,6,2,0,0,8,0,8,Lombardia,ITC4
2021-01-15,PF/BT,(03027500/001752),PVO Istituto Clinico San Rocco (Spoke),LOM,60-69,3,3,0,5,1,0,0,6,0,6,Lombardia,ITC4
2021-01-15,PF/BT,(03027500/001752),PVO Istituto Clinico San Rocco (Spoke),LOM,70-79,2,0,0,2,0,0,0,2,0,2,Lombardia,ITC4
2021-01-15,PF/BT,.000250,KOS-CARE SRL - RSA SAN LUCA ANNI AZZURRI VIA SAN LUCA 4 – 20122 – MILANO,LOM,20-29,1,0,0,1,0,0,0,1,0,1,Lombardia,ITC4
2021-01-15,PF/BT,.000250,KOS-CARE SRL - RSA SAN LUCA ANNI AZZURRI VIA SAN LUCA 4 – 20122 – MILANO,LOM,30-39,1,1,0,1,1,0,0,2,0,2,Lombardia,ITC4
2021-01-15,PF/BT,.000250,KOS-CARE SRL - RSA SAN LUCA ANNI AZZURRI VIA SAN LUCA 4 – 20122 – MILANO,LOM,40-49,1,3,0,3,1,0,0,4,0,4,Lombardia,ITC4
2021-01-15,PF/BT,.000250,KOS-CARE SRL - RSA SAN LUCA ANNI AZZURRI VIA SAN LUCA 4 – 20122 – MILANO,LOM,50-59,0,4,0,1,3,0,0,4,0,4,Lombardia,ITC4
2021-01-15,PF/BT,.000250,KOS-CARE SRL - RSA SAN LUCA ANNI AZZURRI VIA SAN LUCA 4 – 20122 – MILANO,LOM,60-69,0,1,0,1,0,0,0,1,0,1,Lombardia,ITC4
2021-01-15,PF/BT,.002930,RSA SAN VINCENZO - Gravedona Ed Uniti (CO),LOM,20-29,0,2,0,2,0,0,0,2,0,2,Lombardia,ITC4
2021-01-15,PF/BT,.002930,RSA SAN VINCENZO - Gravedona Ed Uniti (CO),LOM,30-39,1,2,0,2,1,0,0,3,0,3,Lombardia,ITC4
2021-01-15,PF/BT,.002930,RSA SAN VINCENZO - Gravedona Ed Uniti (CO),LOM,40-49,0,4,0,4,0,0,0,4,0,4,Lombardia,ITC4
2021-01-15,PF/BT,.002930,RSA SAN VINCENZO - Gravedona Ed Uniti (CO),LOM,50-59,0,7,0,6,1,0,0,7,0,7,Lombardia,ITC4
2021-01-15,PF/BT,.002930,RSA SAN VINCENZO - Gravedona Ed Uniti (CO),LOM,60-69,1,1,0,2,0,0,0,2,0,2,Lombardia,ITC4
2021-01-15,PF/BT,.030042,ASST VALTELLINA ALTO LARIO - PRESIDIO OSPEDALIERO DI SONDRIO,LOM,16-19,0,1,0,1,0,0,0,1,0,1,Lombardia,ITC4
2021-01-15,PF/BT,.030042,ASST VALTELLINA ALTO LARIO - PRESIDIO OSPEDALIERO DI SONDRIO,LOM,20-29,11,13,0,22,2,0,0,24,0,24,Lombardia,ITC4
2021-01-15,PF/BT,.030042,ASST VALTELLINA ALTO LARIO - PRESIDIO OSPEDALIERO DI SONDRIO,LOM,30-39,18,15,0,29,4,0,0,33,0,33,Lombardia,ITC4
2021-01-15,PF/BT,.030042,ASST VALTELLINA ALTO LARIO - PRESIDIO OSPEDALIERO DI SONDRIO,LOM,40-49,23,23,0,41,5,0,0,46,0,46,Lombardia,ITC4
2021-01-15,PF/BT,.030042,ASST VALTELLINA ALTO LARIO - PRESIDIO OSPEDALIERO DI SONDRIO,LOM,50-59,24,37,0,45,16,0,0,61,0,61,Lombardia,ITC4
2021-01-15,PF/BT,.030042,ASST VALTELLINA ALTO LARIO - PRESIDIO OSPEDALIERO DI SONDRIO,LOM,60-69,12,12,0,21,3,0,0,24,0,24,Lombardia,ITC4
2021-01-15,PF/BT,.030042,ASST VALTELLINA ALTO LARIO - PRESIDIO OSPEDALIERO DI SONDRIO,LOM,70-79,2,0,0,2,0,0,0,2,0,2,Lombardia,ITC4
2021-01-15,PF/BT,.030042,ASST VALTELLINA ALTO LARIO - PRESIDIO OSPEDALIERO DI SONDRIO,LOM,80-89,0,1,0,1,0,0,0,1,0,1,Lombardia,ITC4
2021-01-15,PF/BT,0,0,LOM,20-29,3,11,0,13,0,0,1,14,0,14,Lombardia,ITC4
2021-01-15,PF/BT,0,0,LOM,30-39,1,16,0,16,1,0,0,17,0,17,Lombardia,ITC4
2021-01-15,PF/BT,0,0,LOM,40-49,3,25,0,22,2,0,4,28,0,28,Lombardia,ITC4
2021-01-15,PF/BT,0,0,LOM,50-59,6,37,0,33,4,3,3,43,0,43,Lombardia,ITC4
2021-01-15,PF/BT,0,0,LOM,60-69,4,10,0,11,2,0,1,14,0,14,Lombardia,ITC4
2021-01-15,PF/BT,0,0,LOM,70-79,1,5,0,0,0,6,0,6,0,6,Lombardia,ITC4
2021-01-15,PF/BT,0,0,LOM,80-89,3,29,0,0,0,32,0,32,0,32,Lombardia,ITC4
2021-01-15,PF/BT,0,0,LOM,90+,1,7,0,0,0,8,0,8,0,8,Lombardia,ITC4
2021-01-15,PF/BT,0,FONDAZIONE CARISMA BERGAMO,LOM,60-69,4,1,0,0,0,5,0,5,0,5,Lombardia,ITC4
2021-01-15,PF/BT,0,FONDAZIONE CARISMA BERGAMO,LOM,70-79,5,2,0,0,0,7,0,7,0,7,Lombardia,ITC4
2021-01-15,PF/BT,0,FONDAZIONE CARISMA BERGAMO,LOM,80-89,2,10,0,0,0,12,0,12,0,12,Lombardia,ITC4
2021-01-15,PF/BT,0,FONDAZIONE CARISMA BERGAMO,LOM,90+,0,8,0,0,0,8,0,8,0,8,Lombardia,ITC4
2021-01-15,PF/BT,0,Istituto Camillo Golgi Abbiategrasso,LOM,20-29,1,2,0,3,0,0,0,3,0,3,Lombardia,ITC4
2021-01-15,PF/BT,0,Istituto Camillo Golgi Abbiategrasso,LOM,30-39,5,6,0,11,0,0,0,11,0,11,Lombardia,ITC4
2021-01-15,PF/BT,0,Istituto Camillo Golgi Abbiategrasso,LOM,40-49,5,11,0,16,0,0,0,16,0,16,Lombardia,ITC4
2021-01-15,PF/BT,0,Istituto Camillo Golgi Abbiategrasso,LOM,50-59,0,13,0,13,0,0,0,13,0,13,Lombardia,ITC4
2021-01-15,PF/BT,0,Istituto Camillo Golgi Abbiategrasso,LOM,60-69,4,1,0,5,0,0,0,5,0,5,Lombardia,ITC4
2021-01-15,PF/BT,0,"Istituto Geriatrico ""P. Redaelli"" sede di Vimodorne",LOM,20-29,1,2,0,3,0,0,0,3,0,3,Lombardia,ITC4
2021-01-15,PF/BT,0,"Istituto Geriatrico ""P. Redaelli"" sede di Vimodorne",LOM,30-39,3,6,0,9,0,0,0,9,0,9,Lombardia,ITC4
2021-01-15,PF/BT,0,"Istituto Geriatrico ""P. Redaelli"" sede di Vimodorne",LOM,40-49,5,12,0,17,0,0,0,17,0,17,Lombardia,ITC4
2021-01-15,PF/BT,0,"Istituto Geriatrico ""P. Redaelli"" sede di Vimodorne",LOM,50-59,2,12,0,14,0,0,0,14,0,14,Lombardia,ITC4
2021-01-15,PF/BT,0,"Istituto Geriatrico ""P. Redaelli"" sede di Vimodorne",LOM,60-69,3,7,0,10,0,0,0,10,0,10,Lombardia,ITC4
2021-01-15,PF/BT,0,"Istituto Geriatrico ""P. Redaelli"" sede di Vimodorne",LOM,90+,0,1,0,1,0,0,0,1,0,1,Lombardia,ITC4
2021-01-15,PF/BT,0,Istituto Redaelli Milano,LOM,20-29,3,5,0,8,0,0,0,8,0,8,Lombardia,ITC4
2021-01-15,PF/BT,0,Istituto Redaelli Milano,LOM,30-39,5,7,0,12,0,0,0,12,0,12,Lombardia,ITC4
2021-01-15,PF/BT,0,Istituto Redaelli Milano,LOM,40-49,4,11,0,15,0,0,0,15,0,15,Lombardia,ITC4
2021-01-15,PF/BT,0,Istituto Redaelli Milano,LOM,50-59,2,18,0,20,0,0,0,20,0,20,Lombardia,ITC4
2021-01-15,PF/BT,0,Istituto Redaelli Milano,LOM,60-69,1,4,0,5,0,0,0,5,0,5,Lombardia,ITC4
2021-01-15,PF/BT,0,OPERA CHARITAS S.ANNA - RSA VILLA ENRICA - ALBONESE (PV),LOM,30-39,1,1,0,2,0,0,0,2,0,2,Lombardia,ITC4
2021-01-15,PF/BT,0,OPERA CHARITAS S.ANNA - RSA VILLA ENRICA - ALBONESE (PV),LOM,40-49,0,2,0,2,0,0,0,2,0,2,Lombardia,ITC4
2021-01-15,PF/BT,0,OPERA CHARITAS S.ANNA - RSA VILLA ENRICA - ALBONESE (PV),LOM,50-59,1,1,0,2,0,0,0,2,0,2,Lombardia,ITC4
2021-01-15,PF/BT,0,OPERA CHARITAS S.ANNA - RSA VILLA ENRICA - ALBONESE (PV),LOM,80-89,0,3,0,0,0,3,0,3,0,3,Lombardia,ITC4
2021-01-15,PF/BT,0,OPERA CHARITAS S.ANNA - RSA VILLA ENRICA - ALBONESE (PV),LOM,90+,0,3,0,0,0,3,0,3,0,3,Lombardia,ITC4
2021-01-15,PF/BT,0,"RSA “ISTITUTO GERIATRICO MILANESE""",LOM,20-29,0,3,0,3,0,0,0,3,0,3,Lombardia,ITC4
2021-01-15,PF/BT,0,"RSA “ISTITUTO GERIATRICO MILANESE""",LOM,30-39,12,10,0,17,5,0,0,22,0,22,Lombardia,ITC4
2021-01-15,PF/BT,0,"RSA “ISTITUTO GERIATRICO MILANESE""",LOM,40-49,10,19,0,29,0,0,0,29,0,29,Lombardia,ITC4
2021-01-15,PF/BT,0,"RSA “ISTITUTO GERIATRICO MILANESE""",LOM,50-59,2,15,0,10,7,0,0,17,0,17,Lombardia,ITC4
2021-01-15,PF/BT,0,"RSA “ISTITUTO GERIATRICO MILANESE""",LOM,60-69,1,0,0,1,0,0,0,1,0,1,Lombardia,ITC4
2021-01-15,PF/BT,0,RSA Casa San Lorenzo Ardenno,LOM,50-59,0,2,0,0,0,2,0,2,0,2,Lombardia,ITC4
2021-01-15,PF/BT,0,RSA Casa San Lorenzo Ardenno,LOM,60-69,0,3,0,0,0,3,0,3,0,3,Lombardia,ITC4
2021-01-15,PF/BT,0,RSA Casa San Lorenzo Ardenno,LOM,70-79,0,8,0,1,0,7,0,8,0,8,Lombardia,ITC4
2021-01-15,PF/BT,0,RSA Casa San Lorenzo Ardenno,LOM,80-89,0,10,0,0,0,10,0,10,0,10,Lombardia,ITC4
2021-01-15,PF/BT,0,RSA Casa San Lorenzo Ardenno,LOM,90+,0,7,0,0,0,7,0,7,0,7,Lombardia,ITC4
2021-01-15,PF/BT,000050,Poliambulatorio IRCSS OSPEDALE SAN LUCA,LOM,20-29,5,9,0,8,6,0,0,14,0,14,Lombardia,ITC4
2021-01-15,PF/BT,000050,Poliambulatorio IRCSS OSPEDALE SAN LUCA,LOM,30-39,10,26,0,20,16,0,0,36,0,36,Lombardia,ITC4
2021-01-15,PF/BT,000050,Poliambulatorio IRCSS OSPEDALE SAN LUCA,LOM,40-49,8,28,0,17,19,0,0,36,0,36,Lombardia,ITC4
2021-01-15,PF/BT,000050,Poliambulatorio IRCSS OSPEDALE SAN LUCA,LOM,50-59,15,22,0,19,18,0,0,37,0,37,Lombardia,ITC4
2021-01-15,PF/BT,000050,Poliambulatorio IRCSS OSPEDALE SAN LUCA,LOM,60-69,2,12,0,7,7,0,0,14,0,14,Lombardia,ITC4
2021-01-15,PF/BT,000050,Poliambulatorio IRCSS OSPEDALE SAN LUCA,LOM,70-79,1,0,0,1,0,0,0,1,0,1,Lombardia,ITC4
2021-01-15,PF/BT,000119,POLIAMBULATORIO IRCSS OSPEDALE SAN MICHELE,LOM,20-29,0,3,0,1,2,0,0,3,0,3,Lombardia,ITC4
2021-01-15,PF/BT,000119,POLIAMBULATORIO IRCSS OSPEDALE SAN MICHELE,LOM,30-39,2,3,0,1,4,0,0,5,0,5,Lombardia,ITC4
2021-01-15,PF/BT,000119,POLIAMBULATORIO IRCSS OSPEDALE SAN MICHELE,LOM,40-49,4,3,0,4,3,0,0,7,0,7,Lombardia,ITC4
2021-01-15,PF/BT,000119,POLIAMBULATORIO IRCSS OSPEDALE SAN MICHELE,LOM,50-59,3,10,0,8,5,0,0,13,0,13,Lombardia,ITC4
2021-01-15,PF/BT,000119,POLIAMBULATORIO IRCSS OSPEDALE SAN MICHELE,LOM,60-69,4,3,0,6,1,0,0,7,0,7,Lombardia,ITC4
2021-01-15,PF/BT,000119,POLIAMBULATORIO IRCSS OSPEDALE SAN MICHELE,LOM,70-79,0,1,0,1,0,0,0,1,0,1,Lombardia,ITC4
2021-01-15,PF/BT,000417,POLIAMBULATORIO IRCCS OSPEDALE CAPITANIO,LOM,20-29,1,4,0,5,0,0,0,5,0,5,Lombardia,ITC4
2021-01-15,PF/BT,000417,POLIAMBULATORIO IRCCS OSPEDALE CAPITANIO,LOM,30-39,2,3,0,5,0,0,0,5,0,5,Lombardia,ITC4
2021-01-15,PF/BT,000417,POLIAMBULATORIO IRCCS OSPEDALE CAPITANIO,LOM,40-49,3,3,0,6,0,0,0,6,0,6,Lombardia,ITC4
2021-01-15,PF/BT,000417,POLIAMBULATORIO IRCCS OSPEDALE CAPITANIO,LOM,50-59,3,3,0,5,1,0,0,6,0,6,Lombardia,ITC4
2021-01-15,PF/BT,000417,POLIAMBULATORIO IRCCS OSPEDALE CAPITANIO,LOM,60-69,1,1,0,2,0,0,0,2,0,2,Lombardia,ITC4
2021-01-15,PF/BT,000427,CENTRO DIAGNOSTICO PIOLTELLO,LOM,20-29,0,1,0,1,0,0,0,1,0,1,Lombardia,ITC4
2021-01-15,PF/BT,000427,CENTRO DIAGNOSTICO PIOLTELLO,LOM,30-39,1,2,0,2,1,0,0,3,0,3,Lombardia,ITC4
2021-01-15,PF/BT,000427,CENTRO DIAGNOSTICO PIOLTELLO,LOM,40-49,3,3,0,5,1,0,0,6,0,6,Lombardia,ITC4
2021-01-15,PF/BT,000427,CENTRO DIAGNOSTICO PIOLTELLO,LOM,50-59,1,1,0,1,1,0,0,2,0,2,Lombardia,ITC4
2021-01-15,PF/BT,000500,RSA MONSIGNOR BICCHIERAI 2,LOM,80-89,2,1,0,0,0,3,0,3,0,3,Lombardia,ITC4
2021-01-15,PF/BT,000500,RSA MONSIGNOR BICCHIERAI 2,LOM,90+,0,2,0,0,0,2,0,2,0,2,Lombardia,ITC4
2021-01-15,PF/BT,000542,RSA MONSIGNOR BICCHIERAI 1,LOM,80-89,1,0,0,0,0,1,0,1,0,1,Lombardia,ITC4
2021-01-15,PF/BT,000913,RSA BELLAVISTA SONDALO,LOM,30-39,1,2,0,2,1,0,0,3,0,3,Lombardia,ITC4
2021-01-15,PF/BT,000913,RSA BELLAVISTA SONDALO,LOM,40-49,2,4,0,2,4,0,0,6,0,6,Lombardia,ITC4
2021-01-15,PF/BT,000913,RSA BELLAVISTA SONDALO,LOM,50-59,1,4,0,3,2,0,0,5,0,5,Lombardia,ITC4
2021-01-15,PF/BT,000913,RSA BELLAVISTA SONDALO,LOM,60-69,2,2,0,2,2,0,0,4,0,4,Lombardia,ITC4
2021-01-15,PF/BT,000913,RSA BELLAVISTA SONDALO,LOM,80-89,1,6,0,0,0,7,0,7,0,7,Lombardia,ITC4
2021-01-15,PF/BT,000913,RSA BELLAVISTA SONDALO,LOM,90+,1,4,0,0,0,5,0,5,0,5,Lombardia,ITC4
2021-01-15,PF/BT,000928,RSA FONDAZIONE VISCONTI VENOSTA GROSIO,LOM,40-49,0,2,0,2,0,0,0,2,0,2,Lombardia,ITC4
2021-01-15,PF/BT,000928,RSA FONDAZIONE VISCONTI VENOSTA GROSIO,LOM,50-59,0,5,0,5,0,0,0,5,0,5,Lombardia,ITC4
2021-01-15,PF/BT,000928,RSA FONDAZIONE VISCONTI VENOSTA GROSIO,LOM,60-69,1,1,0,0,0,2,0,2,0,2,Lombardia,ITC4
2021-01-15,PF/BT,000928,RSA FONDAZIONE VISCONTI VENOSTA GROSIO,LOM,70-79,2,2,0,0,0,4,0,4,0,4,Lombardia,ITC4
2021-01-15,PF/BT,000928,RSA FONDAZIONE VISCONTI VENOSTA GROSIO,LOM,80-89,1,7,0,0,0,8,0,8,0,8,Lombardia,ITC4
2021-01-15,PF/BT,000928,RSA FONDAZIONE VISCONTI VENOSTA GROSIO,LOM,90+,0,3,0,0,0,3,0,3,0,3,Lombardia,ITC4
2021-01-15,PF/BT,000961,RSA BAITA SERENA,LOM,20-29,0,1,0,1,0,0,0,1,0,1,Lombardia,ITC4
2021-01-15,PF/BT,000961,RSA BAITA SERENA,LOM,30-39,1,1,0,2,0,0,0,2,0,2,Lombardia,ITC4
2021-01-15,PF/BT,000961,RSA BAITA SERENA,LOM,40-49,1,11,0,6,6,0,0,12,0,12,Lombardia,ITC4
2021-01-15,PF/BT,000961,RSA BAITA SERENA,LOM,50-59,3,9,0,6,6,0,0,12,0,12,Lombardia,ITC4
2021-01-15,PF/BT,000961,RSA BAITA SERENA,LOM,60-69,0,2,0,2,0,0,0,2,0,2,Lombardia,ITC4
2021-01-15,PF/BT,000961,RSA BAITA SERENA,LOM,70-79,0,1,0,0,0,1,0,1,0,1,Lombardia,ITC4
2021-01-15,PF/BT,001020,CENTRO DIAGNOSTICO MEDA,LOM,20-29,2,2,0,3,1,0,0,4,0,4,Lombardia,ITC4
2021-01-15,PF/BT,001020,CENTRO DIAGNOSTICO MEDA,LOM,30-39,0,5,0,0,5,0,0,5,0,5,Lombardia,ITC4
2021-01-15,PF/BT,001020,CENTRO DIAGNOSTICO MEDA,LOM,40-49,1,6,0,3,4,0,0,7,0,7,Lombardia,ITC4
2021-01-15,PF/BT,001020,CENTRO DIAGNOSTICO MEDA,LOM,50-59,0,4,0,2,2,0,0,4,0,4,Lombardia,ITC4
2021-01-15,PF/BT,001020,CENTRO DIAGNOSTICO MEDA,LOM,60-69,1,2,0,2,1,0,0,3,0,3,Lombardia,ITC4
2021-01-15,PF/BT,001020,CENTRO DIAGNOSTICO MEDA,LOM,70-79,1,0,0,1,0,0,0,1,0,1,Lombardia,ITC4
2021-01-15,PF/BT,001534,"Fondazione ""Martinelli-Granata-Piantoni"" Onlus",LOM,20-29,0,1,0,1,0,0,0,1,0,1,Lombardia,ITC4
2021-01-15,PF/BT,001534,"Fondazione ""Martinelli-Granata-Piantoni"" Onlus",LOM,30-39,0,1,0,1,0,0,0,1,0,1,Lombardia,ITC4
2021-01-15,PF/BT,001534,"Fondazione ""Martinelli-Granata-Piantoni"" Onlus",LOM,50-59,0,1,0,1,0,0,0,1,0,1,Lombardia,ITC4
2021-01-15,PF/BT,001534,"Fondazione ""Martinelli-Granata-Piantoni"" Onlus",LOM,60-69,0,1,0,0,0,1,0,1,0,1,Lombardia,ITC4
2021-01-15,PF/BT,001534,"Fondazione ""Martinelli-Granata-Piantoni"" Onlus",LOM,70-79,0,1,0,0,0,1,0,1,0,1,Lombardia,ITC4
2021-01-15,PF/BT,001655,"FONDAZIONE DI CURA ""CITTA' DI GARDONE VALTROMPIA - ONLUS""",LOM,20-29,0,3,0,2,1,0,0,3,0,3,Lombardia,ITC4
2021-01-15,PF/BT,001655,"FONDAZIONE DI CURA ""CITTA' DI GARDONE VALTROMPIA - ONLUS""",LOM,30-39,3,7,0,6,4,0,0,10,0,10,Lombardia,ITC4
2021-01-15,PF/BT,001655,"FONDAZIONE DI CURA ""CITTA' DI GARDONE VALTROMPIA - ONLUS""",LOM,40-49,2,18,0,15,5,0,0,20,0,20,Lombardia,ITC4
2021-01-15,PF/BT,001655,"FONDAZIONE DI CURA ""CITTA' DI GARDONE VALTROMPIA - ONLUS""",LOM,50-59,1,14,0,9,6,0,0,15,0,15,Lombardia,ITC4
2021-01-15,PF/BT,001839,FONDAZIONE OSPEDALE DELLA CARITA' CASA DI RIPOSO ONLUS,LOM,60-69,2,6,0,0,0,8,0,8,0,8,Lombardia,ITC4
2021-01-15,PF/BT,001839,FONDAZIONE OSPEDALE DELLA CARITA' CASA DI RIPOSO ONLUS,LOM,70-79,12,16,0,0,0,28,0,28,0,28,Lombardia,ITC4
2021-01-15,PF/BT,001839,FONDAZIONE OSPEDALE DELLA CARITA' CASA DI RIPOSO ONLUS,LOM,80-89,9,80,0,0,0,89,0,89,0,89,Lombardia,ITC4
2021-01-15,PF/BT,001839,FONDAZIONE OSPEDALE DELLA CARITA' CASA DI RIPOSO ONLUS,LOM,90+,12,85,0,0,0,97,0,97,0,97,Lombardia,ITC4
2021-01-15,PF/BT,001861,CASA FAMIGLIA PADRE F. SPINELLI DI RIVOLTA D'ADDA,LOM,20-29,0,3,0,3,0,0,0,3,0,3,Lombardia,ITC4
2021-01-15,PF/BT,001861,CASA FAMIGLIA PADRE F. SPINELLI DI RIVOLTA D'ADDA,LOM,40-49,3,2,0,4,0,0,1,5,0,5,Lombardia,ITC4
2021-01-15,PF/BT,001861,CASA FAMIGLIA PADRE F. SPINELLI DI RIVOLTA D'ADDA,LOM,50-59,0,9,0,7,2,0,0,9,0,9,Lombardia,ITC4
2021-01-15,PF/BT,001861,CASA FAMIGLIA PADRE F. SPINELLI DI RIVOLTA D'ADDA,LOM,60-69,2,0,0,1,0,1,0,2,0,2,Lombardia,ITC4
2021-01-15,PF/BT,001861,CASA FAMIGLIA PADRE F. SPINELLI DI RIVOLTA D'ADDA,LOM,70-79,1,1,0,0,0,2,0,2,0,2,Lombardia,ITC4
2021-01-15,PF/BT,001861,CASA FAMIGLIA PADRE F. SPINELLI DI RIVOLTA D'ADDA,LOM,80-89,2,4,0,0,0,6,0,6,0,6,Lombardia,ITC4
2021-01-15,PF/BT,001861,CASA FAMIGLIA PADRE F. SPINELLI DI RIVOLTA D'ADDA,LOM,90+,0,3,0,0,0,3,0,3,0,3,Lombardia,ITC4
2021-01-15,PF/BT,001874,FONDAZIONE SAN BIAGIO ONLUS,LOM,40-49,0,1,0,0,0,0,1,1,0,1,Lombardia,ITC4
2021-01-15,PF/BT,001874,FONDAZIONE SAN BIAGIO ONLUS,LOM,50-59,2,1,0,0,0,0,3,3,0,3,Lombardia,ITC4
2021-01-15,PF/BT,001874,FONDAZIONE SAN BIAGIO ONLUS,LOM,60-69,0,1,0,0,0,0,1,1,0,1,Lombardia,ITC4
2021-01-15,PF/BT,001874,FONDAZIONE SAN BIAGIO ONLUS,LOM,70-79,1,0,0,0,0,1,0,1,0,1,Lombardia,ITC4
2021-01-15,PF/BT,001995,"Fondazione ""Tosi/Cippelletti di Rivarolo Mantovano"" Onlus",LOM,50-59,1,1,0,1,0,0,1,2,0,2,Lombardia,ITC4
2021-01-15,PF/BT,001995,"Fondazione ""Tosi/Cippelletti di Rivarolo Mantovano"" Onlus",LOM,70-79,0,3,0,0,0,3,0,3,0,3,Lombardia,ITC4
2021-01-15,PF/BT,001995,"Fondazione ""Tosi/Cippelletti di Rivarolo Mantovano"" Onlus",LOM,80-89,2,7,0,0,0,9,0,9,0,9,Lombardia,ITC4
2021-01-15,PF/BT,001995,"Fondazione ""Tosi/Cippelletti di Rivarolo Mantovano"" Onlus",LOM,90+,1,8,0,0,0,9,0,9,0,9,Lombardia,ITC4
2021-01-15,PF/BT,00290,LA PICCOLA CASA DEL RIFUGIO,LOM,30-39,1,0,0,1,0,0,0,1,0,1,Lombardia,ITC4
2021-01-15,PF/BT,00290,LA PICCOLA CASA DEL RIFUGIO,LOM,40-49,0,1,0,1,0,0,0,1,0,1,Lombardia,ITC4
2021-01-15,PF/BT,00290,LA PICCOLA CASA DEL RIFUGIO,LOM,50-59,1,3,0,2,0,2,0,4,0,4,Lombardia,ITC4
2021-01-15,PF/BT,00290,LA PICCOLA CASA DEL RIFUGIO,LOM,60-69,5,10,0,1,1,13,0,15,0,15,Lombardia,ITC4
2021-01-15,PF/BT,00290,LA PICCOLA CASA DEL RIFUGIO,LOM,70-79,1,20,0,0,0,21,0,21,0,21,Lombardia,ITC4
2021-01-15,PF/BT,00290,LA PICCOLA CASA DEL RIFUGIO,LOM,80-89,2,12,0,0,0,14,0,14,0,14,Lombardia,ITC4
2021-01-15,PF/BT,00290,LA PICCOLA CASA DEL RIFUGIO,LOM,90+,0,4,0,0,0,4,0,4,0,4,Lombardia,ITC4
2021-01-15,PF/BT,002987,POLIAMBULATORIO OSPEDALE ESINE,LOM,20-29,3,7,0,5,5,0,0,10,0,10,Lombardia,ITC4
2021-01-15,PF/BT,002987,POLIAMBULATORIO OSPEDALE ESINE,LOM,30-39,0,4,0,4,0,0,0,4,0,4,Lombardia,ITC4
2021-01-15,PF/BT,002987,POLIAMBULATORIO OSPEDALE ESINE,LOM,40-49,7,4,0,0,11,0,0,11,0,11,Lombardia,ITC4
2021-01-15,PF/BT,002987,POLIAMBULATORIO OSPEDALE ESINE,LOM,50-59,4,7,0,6,5,0,0,11,0,11,Lombardia,ITC4
2021-01-15,PF/BT,002987,POLIAMBULATORIO OSPEDALE ESINE,LOM,60-69,7,3,0,3,7,0,0,10,0,10,Lombardia,ITC4
2021-01-15,PF/BT,002987,POLIAMBULATORIO OSPEDALE ESINE,LOM,70-79,2,0,0,0,2,0,0,2,0,2,Lombardia,ITC4
2021-01-15,PF/BT,003328,HUB COV CHIARI - P.O. ISEO -  ASST FRANCIACORTA,LOM,16-19,0,1,0,1,0,0,0,1,0,1,Lombardia,ITC4
2021-01-15,PF/BT,003328,HUB COV CHIARI - P.O. ISEO -  ASST FRANCIACORTA,LOM,20-29,10,10,0,20,0,0,0,20,0,20,Lombardia,ITC4
2021-01-15,PF/BT,003328,HUB COV CHIARI - P.O. ISEO -  ASST FRANCIACORTA,LOM,30-39,8,7,0,10,5,0,0,15,0,15,Lombardia,ITC4
2021-01-15,PF/BT,003328,HUB COV CHIARI - P.O. ISEO -  ASST FRANCIACORTA,LOM,40-49,17,17,0,24,10,0,0,34,0,34,Lombardia,ITC4
2021-01-15,PF/BT,003328,HUB COV CHIARI - P.O. ISEO -  ASST FRANCIACORTA,LOM,50-59,20,23,0,23,20,0,0,43,0,43,Lombardia,ITC4
2021-01-15,PF/BT,003328,HUB COV CHIARI - P.O. ISEO -  ASST FRANCIACORTA,LOM,60-69,19,5,0,18,6,0,0,24,0,24,Lombardia,ITC4
2021-01-15,PF/BT,003328,HUB COV CHIARI - P.O. ISEO -  ASST FRANCIACORTA,LOM,70-79,4,1,0,5,0,0,0,5,0,5,Lombardia,ITC4
2021-01-15,PF/BT,003328,HUB COV CHIARI - P.O. ISEO -  ASST FRANCIACORTA,LOM,80-89,1,1,0,2,0,0,0,2,0,2,Lombardia,ITC4
2021-01-15,PF/BT,003335,HUB COV CHIARI - P.O. CHIARI ASST FRANCIACORTA,LOM,20-29,3,14,0,13,4,0,0,17,0,17,Lombardia,ITC4
2021-01-15,PF/BT,003335,HUB COV CHIARI - P.O. CHIARI ASST FRANCIACORTA,LOM,30-39,11,20,0,29,2,0,0,31,0,31,Lombardia,ITC4
2021-01-15,PF/BT,003335,HUB COV CHIARI - P.O. CHIARI ASST FRANCIACORTA,LOM,40-49,8,31,0,32,7,0,0,39,0,39,Lombardia,ITC4
2021-01-15,PF/BT,003335,HUB COV CHIARI - P.O. CHIARI ASST FRANCIACORTA,LOM,50-59,12,34,0,31,15,0,0,46,0,46,Lombardia,ITC4
2021-01-15,PF/BT,003335,HUB COV CHIARI - P.O. CHIARI ASST FRANCIACORTA,LOM,60-69,19,9,0,22,6,0,0,28,0,28,Lombardia,ITC4
2021-01-15,PF/BT,003335,HUB COV CHIARI - P.O. CHIARI ASST FRANCIACORTA,LOM,70-79,6,1,0,7,0,0,0,7,0,7,Lombardia,ITC4
2021-01-15,PF/BT,003567,RSA BUONOMO CACCIAMATTA 1836 TAVERNOLA BERGAMASCA,LOM,20-29,1,7,0,8,0,0,0,8,0,8,Lombardia,ITC4
2021-01-15,PF/BT,003567,RSA BUONOMO CACCIAMATTA 1836 TAVERNOLA BERGAMASCA,LOM,30-39,2,1,0,2,1,0,0,3,0,3,Lombardia,ITC4
2021-01-15,PF/BT,003567,RSA BUONOMO CACCIAMATTA 1836 TAVERNOLA BERGAMASCA,LOM,40-49,0,13,0,10,3,0,0,13,0,13,Lombardia,ITC4
2021-01-15,PF/BT,003567,RSA BUONOMO CACCIAMATTA 1836 TAVERNOLA BERGAMASCA,LOM,50-59,3,8,0,6,3,2,0,11,0,11,Lombardia,ITC4
2021-01-15,PF/BT,003567,RSA BUONOMO CACCIAMATTA 1836 TAVERNOLA BERGAMASCA,LOM,60-69,2,1,0,1,1,1,0,3,0,3,Lombardia,ITC4
2021-01-15,PF/BT,003567,RSA BUONOMO CACCIAMATTA 1836 TAVERNOLA BERGAMASCA,LOM,70-79,5,2,0,0,2,5,0,7,0,7,Lombardia,ITC4
2021-01-15,PF/BT,003567,RSA BUONOMO CACCIAMATTA 1836 TAVERNOLA BERGAMASCA,LOM,80-89,1,11,0,0,0,12,0,12,0,12,Lombardia,ITC4
2021-01-15,PF/BT,003567,RSA BUONOMO CACCIAMATTA 1836 TAVERNOLA BERGAMASCA,LOM,90+,0,3,0,0,0,3,0,3,0,3,Lombardia,ITC4
2021-01-15,PF/BT,030017,Istituto clinico Casa di cura Mater Domini -Castellanza,LOM,20-29,6,23,0,12,17,0,0,29,0,29,Lombardia,ITC4
2021-01-15,PF/BT,030017,Istituto clinico Casa di cura Mater Domini -Castellanza,LOM,30-39,17,25,0,17,25,0,0,42,0,42,Lombardia,ITC4
2021-01-15,PF/BT,030017,Istituto clinico Casa di cura Mater Domini -Castellanza,LOM,40-49,8,25,0,15,18,0,0,33,0,33,Lombardia,ITC4
2021-01-15,PF/BT,030017,Istituto clinico Casa di cura Mater Domini -Castellanza,LOM,50-59,11,31,0,15,27,0,0,42,0,42,Lombardia,ITC4
2021-01-15,PF/BT,030017,Istituto clinico Casa di cura Mater Domini -Castellanza,LOM,60-69,13,10,0,11,12,0,0,23,0,23,Lombardia,ITC4
2021-01-15,PF/BT,030017,Istituto clinico Casa di cura Mater Domini -Castellanza,LOM,70-79,7,2,0,6,3,0,0,9,0,9,Lombardia,ITC4
2021-01-15,PF/BT,030017,Istituto clinico Casa di cura Mater Domini -Castellanza,LOM,80-89,1,1,0,0,2,0,0,2,0,2,Lombardia,ITC4
2021-01-15,PF/BT,030035,C.O.F. LANZO HOSPITAL - ALTA VALLE INTELVI,LOM,50-59,1,1,0,2,0,0,0,2,0,2,Lombardia,ITC4
2021-01-15,PF/BT,030035,C.O.F. LANZO HOSPITAL - ALTA VALLE INTELVI,LOM,60-69,1,1,0,2,0,0,0,2,0,2,Lombardia,ITC4
2021-01-15,PF/BT,030035,C.O.F. LANZO HOSPITAL - ALTA VALLE INTELVI,LOM,70-79,1,0,0,1,0,0,0,1,0,1,Lombardia,ITC4
2021-01-15,PF/BT,030035,C.O.F. LANZO HOSPITAL - ALTA VALLE INTELVI,LOM,80-89,1,0,0,1,0,0,0,1,0,1,Lombardia,ITC4
2021-01-15,PF/BT,030066,CV Garbagnate,LOM,20-29,1,6,0,5,2,0,0,7,0,7,Lombardia,ITC4
2021-01-15,PF/BT,030066,CV Garbagnate,LOM,30-39,3,6,0,6,3,0,0,9,0,9,Lombardia,ITC4
2021-01-15,PF/BT,030066,CV Garbagnate,LOM,40-49,4,14,0,14,4,0,0,18,0,18,Lombardia,ITC4
2021-01-15,PF/BT,030066,CV Garbagnate,LOM,50-59,12,59,0,58,13,0,0,71,0,71,Lombardia,ITC4
2021-01-15,PF/BT,030066,CV Garbagnate,LOM,60-69,9,18,0,20,7,0,0,27,0,27,Lombardia,ITC4
2021-01-15,PF/BT,030068,PUNTO VACCINALE OSPEDALIERO DESIO,LOM,16-19,0,2,0,2,0,0,0,2,0,2,Lombardia,ITC4
2021-01-15,PF/BT,030068,PUNTO VACCINALE OSPEDALIERO DESIO,LOM,20-29,6,15,0,17,4,0,0,21,0,21,Lombardia,ITC4
2021-01-15,PF/BT,030068,PUNTO VACCINALE OSPEDALIERO DESIO,LOM,30-39,13,27,0,30,10,0,0,40,0,40,Lombardia,ITC4
2021-01-15,PF/BT,030068,PUNTO VACCINALE OSPEDALIERO DESIO,LOM,40-49,18,44,0,47,15,0,0,62,0,62,Lombardia,ITC4
2021-01-15,PF/BT,030068,PUNTO VACCINALE OSPEDALIERO DESIO,LOM,50-59,22,61,0,50,33,0,0,83,0,83,Lombardia,ITC4
2021-01-15,PF/BT,030068,PUNTO VACCINALE OSPEDALIERO DESIO,LOM,60-69,10,16,0,19,7,0,0,26,0,26,Lombardia,ITC4
2021-01-15,PF/BT,030068,PUNTO VACCINALE OSPEDALIERO DESIO,LOM,70-79,1,0,0,1,0,0,0,1,0,1,Lombardia,ITC4
2021-01-15,PF/BT,030070,PUNTO VACCINALE OSPEDALIERO CARATE BRIANZA,LOM,16-19,1,1,0,2,0,0,0,2,0,2,Lombardia,ITC4
2021-01-15,PF/BT,030070,PUNTO VACCINALE OSPEDALIERO CARATE BRIANZA,LOM,20-29,5,4,0,7,2,0,0,9,0,9,Lombardia,ITC4
2021-01-15,PF/BT,030070,PUNTO VACCINALE OSPEDALIERO CARATE BRIANZA,LOM,30-39,12,9,0,16,5,0,0,21,0,21,Lombardia,ITC4
2021-01-15,PF/BT,030070,PUNTO VACCINALE OSPEDALIERO CARATE BRIANZA,LOM,40-49,8,38,0,35,11,0,0,46,0,46,Lombardia,ITC4
2021-01-15,PF/BT,030070,PUNTO VACCINALE OSPEDALIERO CARATE BRIANZA,LOM,50-59,13,50,0,46,16,0,1,63,0,63,Lombardia,ITC4
2021-01-15,PF/BT,030070,PUNTO VACCINALE OSPEDALIERO CARATE BRIANZA,LOM,60-69,4,12,0,14,2,0,0,16,0,16,Lombardia,ITC4
2021-01-15,PF/BT,030070,PUNTO VACCINALE OSPEDALIERO CARATE BRIANZA,LOM,70-79,1,0,0,1,0,0,0,1,0,1,Lombardia,ITC4
2021-01-15,PF/BT,030078,PUNTO VACCINALE OSPEDALIERO VIMERCATE,LOM,16-19,1,2,0,3,0,0,0,3,0,3,Lombardia,ITC4
2021-01-15,PF/BT,030078,PUNTO VACCINALE OSPEDALIERO VIMERCATE,LOM,20-29,4,12,0,15,0,0,1,16,0,16,Lombardia,ITC4
2021-01-15,PF/BT,030078,PUNTO VACCINALE OSPEDALIERO VIMERCATE,LOM,30-39,10,23,0,21,12,0,0,33,0,33,Lombardia,ITC4
2021-01-15,PF/BT,030078,PUNTO VACCINALE OSPEDALIERO VIMERCATE,LOM,40-49,10,32,0,29,13,0,0,42,0,42,Lombardia,ITC4
2021-01-15,PF/BT,030078,PUNTO VACCINALE OSPEDALIERO VIMERCATE,LOM,50-59,15,47,0,36,26,0,0,62,0,62,Lombardia,ITC4
2021-01-15,PF/BT,030078,PUNTO VACCINALE OSPEDALIERO VIMERCATE,LOM,60-69,13,19,0,22,10,0,0,32,0,32,Lombardia,ITC4
2021-01-15,PF/BT,030078,PUNTO VACCINALE OSPEDALIERO VIMERCATE,LOM,70-79,4,6,0,10,0,0,0,10,0,10,Lombardia,ITC4
2021-01-15,PF/BT,030097,ISTITUTO CLINICO CITTA' STUDI - MILANO,LOM,20-29,4,7,0,11,0,0,0,11,0,11,Lombardia,ITC4
2021-01-15,PF/BT,030097,ISTITUTO CLINICO CITTA' STUDI - MILANO,LOM,30-39,15,11,0,25,1,0,0,26,0,26,Lombardia,ITC4
2021-01-15,PF/BT,030097,ISTITUTO CLINICO CITTA' STUDI - MILANO,LOM,40-49,12,14,0,21,5,0,0,26,0,26,Lombardia,ITC4
2021-01-15,PF/BT,030097,ISTITUTO CLINICO CITTA' STUDI - MILANO,LOM,50-59,18,8,0,18,8,0,0,26,0,26,Lombardia,ITC4
2021-01-15,PF/BT,030097,ISTITUTO CLINICO CITTA' STUDI - MILANO,LOM,60-69,3,3,0,5,1,0,0,6,0,6,Lombardia,ITC4
2021-01-15,PF/BT,030097,ISTITUTO CLINICO CITTA' STUDI - MILANO,LOM,70-79,0,1,0,1,0,0,0,1,0,1,Lombardia,ITC4
2021-01-15,PF/BT,030121,Humanitas Mirasole Pio X,LOM,20-29,2,3,0,5,0,0,0,5,0,5,Lombardia,ITC4
2021-01-15,PF/BT,030121,Humanitas Mirasole Pio X,LOM,30-39,4,5,0,9,0,0,0,9,0,9,Lombardia,ITC4
2021-01-15,PF/BT,030121,Humanitas Mirasole Pio X,LOM,40-49,5,10,0,15,0,0,0,15,0,15,Lombardia,ITC4
2021-01-15,PF/BT,030121,Humanitas Mirasole Pio X,LOM,50-59,3,12,0,15,0,0,0,15,0,15,Lombardia,ITC4
2021-01-15,PF/BT,030121,Humanitas Mirasole Pio X,LOM,60-69,4,3,0,7,0,0,0,7,0,7,Lombardia,ITC4
2021-01-15,PF/BT,030121,Humanitas Mirasole Pio X,LOM,70-79,3,0,0,3,0,0,0,3,0,3,Lombardia,ITC4
2021-01-15,PF/BT,030178,ISTITUTO CLINICO CITTA' DI BRESCIA DI ISTITUTI OSPEDALIERI BRESCIANI,LOM,20-29,3,2,0,5,0,0,0,5,0,5,Lombardia,ITC4
2021-01-15,PF/BT,030178,ISTITUTO CLINICO CITTA' DI BRESCIA DI ISTITUTI OSPEDALIERI BRESCIANI,LOM,30-39,5,2,0,7,0,0,0,7,0,7,Lombardia,ITC4
2021-01-15,PF/BT,030178,ISTITUTO CLINICO CITTA' DI BRESCIA DI ISTITUTI OSPEDALIERI BRESCIANI,LOM,40-49,4,7,0,11,0,0,0,11,0,11,Lombardia,ITC4
2021-01-15,PF/BT,030178,ISTITUTO CLINICO CITTA' DI BRESCIA DI ISTITUTI OSPEDALIERI BRESCIANI,LOM,50-59,6,6,0,11,1,0,0,12,0,12,Lombardia,ITC4
2021-01-15,PF/BT,030178,ISTITUTO CLINICO CITTA' DI BRESCIA DI ISTITUTI OSPEDALIERI BRESCIANI,LOM,60-69,1,0,0,1,0,0,0,1,0,1,Lombardia,ITC4
2021-01-15,PF/BT,03019800,ISTITUTO CLINICO BEATO MATTEO,LOM,20-29,3,6,0,9,0,0,0,9,0,9,Lombardia,ITC4
2021-01-15,PF/BT,03019800,ISTITUTO CLINICO BEATO MATTEO,LOM,30-39,3,5,0,7,1,0,0,8,0,8,Lombardia,ITC4
2021-01-15,PF/BT,03019800,ISTITUTO CLINICO BEATO MATTEO,LOM,40-49,7,12,0,16,3,0,0,19,0,19,Lombardia,ITC4
2021-01-15,PF/BT,03019800,ISTITUTO CLINICO BEATO MATTEO,LOM,50-59,6,9,0,10,5,0,0,15,0,15,Lombardia,ITC4
2021-01-15,PF/BT,03019800,ISTITUTO CLINICO BEATO MATTEO,LOM,60-69,4,4,0,8,0,0,0,8,0,8,Lombardia,ITC4
2021-01-15,PF/BT,03019800,ISTITUTO CLINICO BEATO MATTEO,LOM,70-79,1,0,0,1,0,0,0,1,0,1,Lombardia,ITC4
2021-01-15,PF/BT,03020200,ISTITUTO DI CURA CITTA' DI PAVIA,LOM,20-29,1,3,0,4,0,0,0,4,0,4,Lombardia,ITC4
2021-01-15,PF/BT,03020200,ISTITUTO DI CURA CITTA' DI PAVIA,LOM,30-39,0,1,0,1,0,0,0,1,0,1,Lombardia,ITC4
2021-01-15,PF/BT,03020200,ISTITUTO DI CURA CITTA' DI PAVIA,LOM,40-49,3,1,0,4,0,0,0,4,0,4,Lombardia,ITC4
2021-01-15,PF/BT,03020200,ISTITUTO DI CURA CITTA' DI PAVIA,LOM,50-59,2,7,0,9,0,0,0,9,0,9,Lombardia,ITC4
2021-01-15,PF/BT,03020200,ISTITUTO DI CURA CITTA' DI PAVIA,LOM,60-69,1,5,0,6,0,0,0,6,0,6,Lombardia,ITC4
2021-01-15,PF/BT,030295,Fondazione Poliambulanza - Brescia,LOM,16-19,1,1,0,0,2,0,0,2,0,2,Lombardia,ITC4
2021-01-15,PF/BT,030295,Fondazione Poliambulanza - Brescia,LOM,20-29,9,13,0,17,5,0,0,22,0,22,Lombardia,ITC4
2021-01-15,PF/BT,030295,Fondazione Poliambulanza - Brescia,LOM,30-39,14,22,0,27,9,0,0,36,0,36,Lombardia,ITC4
2021-01-15,PF/BT,030295,Fondazione Poliambulanza - Brescia,LOM,40-49,13,39,0,39,13,0,0,52,0,52,Lombardia,ITC4
2021-01-15,PF/BT,030295,Fondazione Poliambulanza - Brescia,LOM,50-59,10,39,0,33,16,0,0,49,0,49,Lombardia,ITC4
2021-01-15,PF/BT,030295,Fondazione Poliambulanza - Brescia,LOM,60-69,4,2,0,5,1,0,0,6,0,6,Lombardia,ITC4
2021-01-15,PF/BT,030295,Fondazione Poliambulanza - Brescia,LOM,70-79,1,0,0,1,0,0,0,1,0,1,Lombardia,ITC4
2021-01-15,PF/BT,030-322-002821,FONDAZIONE CA' D'INDUSTRIA ONLUS,LOM,40-49,1,0,0,1,0,0,0,1,0,1,Lombardia,ITC4
2021-01-15,PF/BT,030-322-002821,FONDAZIONE CA' D'INDUSTRIA ONLUS,LOM,60-69,1,1,0,0,0,2,0,2,0,2,Lombardia,ITC4
2021-01-15,PF/BT,030-322-002821,FONDAZIONE CA' D'INDUSTRIA ONLUS,LOM,70-79,0,4,0,0,0,4,0,4,0,4,Lombardia,ITC4
2021-01-15,PF/BT,030-322-002821,FONDAZIONE CA' D'INDUSTRIA ONLUS,LOM,80-89,3,14,0,0,0,17,0,17,0,17,Lombardia,ITC4
2021-01-15,PF/BT,030-322-002821,FONDAZIONE CA' D'INDUSTRIA ONLUS,LOM,90+,4,20,0,0,0,24,0,24,0,24,Lombardia,ITC4
2021-01-15,PF/BT,030-322-002913,RSA SACRO CUORE,LOM,20-29,0,2,0,2,0,0,0,2,0,2,Lombardia,ITC4
2021-01-15,PF/BT,030-322-002913,RSA SACRO CUORE,LOM,30-39,1,5,0,4,2,0,0,6,0,6,Lombardia,ITC4
2021-01-15,PF/BT,030-322-002913,RSA SACRO CUORE,LOM,40-49,4,4,0,6,1,1,0,8,0,8,Lombardia,ITC4
2021-01-15,PF/BT,030-322-002913,RSA SACRO CUORE,LOM,50-59,3,5,0,7,0,1,0,8,0,8,Lombardia,ITC4
2021-01-15,PF/BT,030-322-002913,RSA SACRO CUORE,LOM,60-69,3,4,0,1,0,6,0,7,0,7,Lombardia,ITC4
2021-01-15,PF/BT,030-322-002913,RSA SACRO CUORE,LOM,70-79,3,5,0,1,0,7,0,8,0,8,Lombardia,ITC4
2021-01-15,PF/BT,030-322-002913,RSA SACRO CUORE,LOM,80-89,3,13,0,0,0,16,0,16,0,16,Lombardia,ITC4
2021-01-15,PF/BT,030-322-002913,RSA SACRO CUORE,LOM,90+,1,4,0,0,0,5,0,5,0,5,Lombardia,ITC4
2021-01-15,PF/BT,030324001093 -  030324001116,ISTIT.RIUNITI AIROLDI E MUZZI,LOM,20-29,1,1,0,1,0,0,1,2,0,2,Lombardia,ITC4
2021-01-15,PF/BT,030324001093 -  030324001116,ISTIT.RIUNITI AIROLDI E MUZZI,LOM,30-39,1,5,0,2,0,0,4,6,0,6,Lombardia,ITC4
2021-01-15,PF/BT,030324001093 -  030324001116,ISTIT.RIUNITI AIROLDI E MUZZI,LOM,40-49,3,6,0,6,1,0,2,9,0,9,Lombardia,ITC4
2021-01-15,PF/BT,030324001093 -  030324001116,ISTIT.RIUNITI AIROLDI E MUZZI,LOM,50-59,1,11,0,9,0,1,2,12,0,12,Lombardia,ITC4
2021-01-15,PF/BT,030324001093 -  030324001116,ISTIT.RIUNITI AIROLDI E MUZZI,LOM,60-69,3,0,0,0,0,0,3,3,0,3,Lombardia,ITC4
2021-01-15,PF/BT,030324001093 -  030324001116,ISTIT.RIUNITI AIROLDI E MUZZI,LOM,70-79,1,1,0,0,0,1,1,2,0,2,Lombardia,ITC4
2021-01-15,PF/BT,030324001093 -  030324001116,ISTIT.RIUNITI AIROLDI E MUZZI,LOM,80-89,1,1,0,0,0,2,0,2,0,2,Lombardia,ITC4
2021-01-15,PF/BT,030-327-001768,FONDAZIONE RSA SONCINO ONLUS,LOM,20-29,1,2,0,3,0,0,0,3,0,3,Lombardia,ITC4
2021-01-15,PF/BT,030-327-001768,FONDAZIONE RSA SONCINO ONLUS,LOM,30-39,0,3,0,3,0,0,0,3,0,3,Lombardia,ITC4
2021-01-15,PF/BT,030-327-001768,FONDAZIONE RSA SONCINO ONLUS,LOM,40-49,2,8,0,8,1,0,1,10,0,10,Lombardia,ITC4
2021-01-15,PF/BT,030-327-001768,FONDAZIONE RSA SONCINO ONLUS,LOM,50-59,2,5,0,4,3,0,0,7,0,7,Lombardia,ITC4
2021-01-15,PF/BT,030-327-001768,FONDAZIONE RSA SONCINO ONLUS,LOM,60-69,0,1,0,1,0,0,0,1,0,1,Lombardia,ITC4
2021-01-15,PF/BT,030327001899,FONDAZIONE CASA DI RIPOSO DI ASOLA ONLUS,LOM,20-29,0,2,0,2,0,0,0,2,0,2,Lombardia,ITC4
2021-01-15,PF/BT,030327001899,FONDAZIONE CASA DI RIPOSO DI ASOLA ONLUS,LOM,30-39,0,3,0,3,0,0,0,3,0,3,Lombardia,ITC4
2021-01-15,PF/BT,030327001899,FONDAZIONE CASA DI RIPOSO DI ASOLA ONLUS,LOM,40-49,1,6,0,5,2,0,0,7,0,7,Lombardia,ITC4
2021-01-15,PF/BT,030327001899,FONDAZIONE CASA DI RIPOSO DI ASOLA ONLUS,LOM,50-59,3,15,0,13,5,0,0,18,0,18,Lombardia,ITC4
2021-01-15,PF/BT,030327001899,FONDAZIONE CASA DI RIPOSO DI ASOLA ONLUS,LOM,60-69,4,7,0,4,2,5,0,11,0,11,Lombardia,ITC4
2021-01-15,PF/BT,030327001899,FONDAZIONE CASA DI RIPOSO DI ASOLA ONLUS,LOM,70-79,4,2,0,0,1,5,0,6,0,6,Lombardia,ITC4
2021-01-15,PF/BT,030327001899,FONDAZIONE CASA DI RIPOSO DI ASOLA ONLUS,LOM,80-89,0,9,0,0,0,9,0,9,0,9,Lombardia,ITC4
2021-01-15,PF/BT,030327001899,FONDAZIONE CASA DI RIPOSO DI ASOLA ONLUS,LOM,90+,0,4,0,0,0,4,0,4,0,4,Lombardia,ITC4
2021-01-15,PF/BT,030704,Polo Riabilitativo FFO,LOM,16-19,1,0,0,0,1,0,0,1,0,1,Lombardia,ITC4
2021-01-15,PF/BT,030704,Polo Riabilitativo FFO,LOM,20-29,2,4,0,3,3,0,0,6,0,6,Lombardia,ITC4
2021-01-15,PF/BT,030704,Polo Riabilitativo FFO,LOM,30-39,6,3,0,4,5,0,0,9,0,9,Lombardia,ITC4
2021-01-15,PF/BT,030704,Polo Riabilitativo FFO,LOM,40-49,1,7,0,5,3,0,0,8,0,8,Lombardia,ITC4
2021-01-15,PF/BT,030704,Polo Riabilitativo FFO,LOM,50-59,5,3,0,6,2,0,0,8,0,8,Lombardia,ITC4
2021-01-15,PF/BT,030704,Polo Riabilitativo FFO,LOM,60-69,1,3,0,4,0,0,0,4,0,4,Lombardia,ITC4
2021-01-15,PF/BT,030704,Presidio Ospedaliero CTO,LOM,20-29,1,1,0,1,1,0,0,2,0,2,Lombardia,ITC4
2021-01-15,PF/BT,030704,Presidio Ospedaliero CTO,LOM,30-39,3,1,0,2,2,0,0,4,0,4,Lombardia,ITC4
2021-01-15,PF/BT,030704,Presidio Ospedaliero CTO,LOM,40-49,1,5,0,5,1,0,0,6,0,6,Lombardia,ITC4
2021-01-15,PF/BT,030704,Presidio Ospedaliero CTO,LOM,50-59,6,6,0,6,6,0,0,12,0,12,Lombardia,ITC4
2021-01-15,PF/BT,030704,Presidio Ospedaliero CTO,LOM,60-69,2,4,0,5,1,0,0,6,0,6,Lombardia,ITC4
2021-01-15,PF/BT,030704,Presidio Ospedaliero G. Pini,LOM,20-29,6,5,0,5,6,0,0,11,0,11,Lombardia,ITC4
2021-01-15,PF/BT,030704,Presidio Ospedaliero G. Pini,LOM,30-39,8,10,0,10,8,0,0,18,0,18,Lombardia,ITC4
2021-01-15,PF/BT,030704,Presidio Ospedaliero G. Pini,LOM,40-49,8,12,0,11,9,0,0,20,0,20,Lombardia,ITC4
2021-01-15,PF/BT,030704,Presidio Ospedaliero G. Pini,LOM,50-59,16,26,0,22,20,0,0,42,0,42,Lombardia,ITC4
2021-01-15,PF/BT,030704,Presidio Ospedaliero G. Pini,LOM,60-69,3,2,0,3,2,0,0,5,0,5,Lombardia,ITC4
2021-01-15,PF/BT,030903,AMB COVID LECCO,LOM,16-19,1,0,0,1,0,0,0,1,0,1,Lombardia,ITC4
2021-01-15,PF/BT,030903,AMB COVID LECCO,LOM,20-29,32,20,0,43,3,0,6,52,0,52,Lombardia,ITC4
2021-01-15,PF/BT,030903,AMB COVID LECCO,LOM,30-39,48,20,0,57,7,0,4,68,0,68,Lombardia,ITC4
2021-01-15,PF/BT,030903,AMB COVID LECCO,LOM,40-49,86,34,0,82,32,0,6,120,0,120,Lombardia,ITC4
2021-01-15,PF/BT,030903,AMB COVID LECCO,LOM,50-59,102,52,0,104,34,0,16,154,0,154,Lombardia,ITC4
2021-01-15,PF/BT,030903,AMB COVID LECCO,LOM,60-69,27,35,0,42,15,3,2,62,0,62,Lombardia,ITC4
2021-01-15,PF/BT,030903,AMB COVID LECCO,LOM,70-79,8,17,0,4,10,11,0,25,0,25,Lombardia,ITC4
2021-01-15,PF/BT,030903,AMB COVID LECCO,LOM,80-89,7,35,0,3,1,38,0,42,0,42,Lombardia,ITC4
2021-01-15,PF/BT,030903,AMB COVID LECCO,LOM,90+,3,23,0,0,1,25,0,26,0,26,Lombardia,ITC4
2021-01-15,PF/BT,030922,"FOND.IRCCS ""ISTIT.NAZ.LE TUMORI""MILANO",LOM,20-29,2,7,0,2,1,0,6,9,0,9,Lombardia,ITC4
2021-01-15,PF/BT,030922,"FOND.IRCCS ""ISTIT.NAZ.LE TUMORI""MILANO",LOM,30-39,16,17,0,4,8,0,21,33,0,33,Lombardia,ITC4
2021-01-15,PF/BT,030922,"FOND.IRCCS ""ISTIT.NAZ.LE TUMORI""MILANO",LOM,40-49,19,33,0,6,7,0,39,52,0,52,Lombardia,ITC4
2021-01-15,PF/BT,030922,"FOND.IRCCS ""ISTIT.NAZ.LE TUMORI""MILANO",LOM,50-59,22,43,0,15,13,0,37,65,0,65,Lombardia,ITC4
2021-01-15,PF/BT,030922,"FOND.IRCCS ""ISTIT.NAZ.LE TUMORI""MILANO",LOM,60-69,6,19,0,5,4,0,16,25,0,25,Lombardia,ITC4
2021-01-15,PF/BT,030922,"FOND.IRCCS ""ISTIT.NAZ.LE TUMORI""MILANO",LOM,70-79,2,4,0,0,0,0,6,6,0,6,Lombardia,ITC4
2021-01-15,PF/BT,030922,"FOND.IRCCS ""ISTIT.NAZ.LE TUMORI""MILANO",LOM,80-89,1,0,0,0,0,0,1,1,0,1,Lombardia,ITC4
2021-01-15,PF/BT,030922,"FOND.IRCCS ""ISTIT.NAZ.LE TUMORI""MILANO",LOM,90+,1,0,0,0,0,0,1,1,0,1,Lombardia,ITC4
2021-01-15,PF/BT,030924,IRCCS POLICLINICO S. MATTEO - PAVIA,LOM,16-19,1,0,0,0,0,0,1,1,0,1,Lombardia,ITC4
2021-01-15,PF/BT,030924,IRCCS POLICLINICO S. MATTEO - PAVIA,LOM,20-29,13,20,0,29,4,0,0,33,0,33,Lombardia,ITC4
2021-01-15,PF/BT,030924,IRCCS POLICLINICO S. MATTEO - PAVIA,LOM,30-39,14,33,0,41,4,0,2,47,0,47,Lombardia,ITC4
2021-01-15,PF/BT,030924,IRCCS POLICLINICO S. MATTEO - PAVIA,LOM,40-49,31,52,0,56,26,0,1,83,0,83,Lombardia,ITC4
2021-01-15,PF/BT,030924,IRCCS POLICLINICO S. MATTEO - PAVIA,LOM,50-59,31,70,0,76,21,0,4,101,0,101,Lombardia,ITC4
2021-01-15,PF/BT,030924,IRCCS POLICLINICO S. MATTEO - PAVIA,LOM,60-69,12,27,0,31,5,0,3,39,0,39,Lombardia,ITC4
2021-01-15,PF/BT,030924,IRCCS POLICLINICO S. MATTEO - PAVIA,LOM,70-79,1,0,0,0,1,0,0,1,0,1,Lombardia,ITC4
2021-01-15,PF/BT,030925,Fondazione IRCCS Ca' Granda Ospedale Maggiore Policlinico,LOM,16-19,0,1,0,0,1,0,0,1,0,1,Lombardia,ITC4
2021-01-15,PF/BT,030925,Fondazione IRCCS Ca' Granda Ospedale Maggiore Policlinico,LOM,20-29,13,37,0,46,4,0,0,50,0,50,Lombardia,ITC4
2021-01-15,PF/BT,030925,Fondazione IRCCS Ca' Granda Ospedale Maggiore Policlinico,LOM,30-39,15,49,0,54,10,0,0,64,0,64,Lombardia,ITC4
2021-01-15,PF/BT,030925,Fondazione IRCCS Ca' Granda Ospedale Maggiore Policlinico,LOM,40-49,33,44,0,56,21,0,0,77,0,77,Lombardia,ITC4
2021-01-15,PF/BT,030925,Fondazione IRCCS Ca' Granda Ospedale Maggiore Policlinico,LOM,50-59,28,93,0,91,30,0,0,121,0,121,Lombardia,ITC4
2021-01-15,PF/BT,030925,Fondazione IRCCS Ca' Granda Ospedale Maggiore Policlinico,LOM,60-69,11,24,0,24,11,0,0,35,0,35,Lombardia,ITC4
2021-01-15,PF/BT,030925,Fondazione IRCCS Ca' Granda Ospedale Maggiore Policlinico,LOM,70-79,0,2,0,1,1,0,0,2,0,2,Lombardia,ITC4
2021-01-15,PF/BT,030935,IRCCS    S. RAFFAELE - MILANO,LOM,20-29,7,13,0,20,0,0,0,20,0,20,Lombardia,ITC4
2021-01-15,PF/BT,030935,IRCCS    S. RAFFAELE - MILANO,LOM,30-39,9,12,0,21,0,0,0,21,0,21,Lombardia,ITC4
2021-01-15,PF/BT,030935,IRCCS    S. RAFFAELE - MILANO,LOM,40-49,29,75,0,104,0,0,0,104,0,104,Lombardia,ITC4
2021-01-15,PF/BT,030935,IRCCS    S. RAFFAELE - MILANO,LOM,50-59,23,61,0,84,0,0,0,84,0,84,Lombardia,ITC4
2021-01-15,PF/BT,030935,IRCCS    S. RAFFAELE - MILANO,LOM,60-69,4,7,0,11,0,0,0,11,0,11,Lombardia,ITC4
2021-01-15,PF/BT,030937,PRO JOVENTUDE DON C. GNOCCHI - MI IRCCS PRIVATO,LOM,20-29,3,14,0,14,3,0,0,17,0,17,Lombardia,ITC4
2021-01-15,PF/BT,030937,PRO JOVENTUDE DON C. GNOCCHI - MI IRCCS PRIVATO,LOM,30-39,7,14,0,16,5,0,0,21,0,21,Lombardia,ITC4
2021-01-15,PF/BT,030937,PRO JOVENTUDE DON C. GNOCCHI - MI IRCCS PRIVATO,LOM,40-49,10,12,0,9,13,0,0,22,0,22,Lombardia,ITC4
2021-01-15,PF/BT,030937,PRO JOVENTUDE DON C. GNOCCHI - MI IRCCS PRIVATO,LOM,50-59,12,29,0,15,26,0,0,41,0,41,Lombardia,ITC4
2021-01-15,PF/BT,030937,PRO JOVENTUDE DON C. GNOCCHI - MI IRCCS PRIVATO,LOM,60-69,4,8,0,4,8,0,0,12,0,12,Lombardia,ITC4
2021-01-15,PF/BT,030937,PRO JOVENTUDE DON C. GNOCCHI - MI IRCCS PRIVATO,LOM,70-79,1,0,0,1,0,0,0,1,0,1,Lombardia,ITC4
2021-01-15,PF/BT,030943,Istituto Clinico Humanitas,LOM,20-29,43,79,0,98,24,0,0,122,0,122,Lombardia,ITC4
2021-01-15,PF/BT,030943,Istituto Clinico Humanitas,LOM,30-39,16,24,0,21,19,0,0,40,0,40,Lombardia,ITC4
2021-01-15,PF/BT,030943,Istituto Clinico Humanitas,LOM,40-49,16,31,0,24,22,0,1,47,0,47,Lombardia,ITC4
2021-01-15,PF/BT,030943,Istituto Clinico Humanitas,LOM,50-59,13,17,0,11,19,0,0,30,0,30,Lombardia,ITC4
2021-01-15,PF/BT,030943,Istituto Clinico Humanitas,LOM,60-69,4,5,0,4,4,0,1,9,0,9,Lombardia,ITC4
2021-01-15,PF/BT,030943,Istituto Clinico Humanitas,LOM,70-79,3,0,0,2,0,0,1,3,0,3,Lombardia,ITC4
2021-01-15,PF/BT,066549,RSA BERNINA,LOM,20-29,0,1,0,1,0,0,0,1,0,1,Lombardia,ITC4
2021-01-15,PF/BT,066549,RSA BERNINA,LOM,40-49,0,6,0,4,2,0,0,6,0,6,Lombardia,ITC4
2021-01-15,PF/BT,066549,RSA BERNINA,LOM,50-59,0,3,0,3,0,0,0,3,0,3,Lombardia,ITC4
2021-01-15,PF/BT,066549,RSA BERNINA,LOM,60-69,0,1,0,0,1,0,0,1,0,1,Lombardia,ITC4
2021-01-15,PF/BT,066549,RSA BERNINA,LOM,80-89,1,0,0,0,0,1,0,1,0,1,Lombardia,ITC4
2021-01-15,PF/BT,1284,FONDAZIONE GIOVANNI CARLO ROTA,LOM,16-19,1,1,0,0,2,0,0,2,0,2,Lombardia,ITC4
2021-01-15,PF/BT,1284,FONDAZIONE GIOVANNI CARLO ROTA,LOM,20-29,0,1,0,1,0,0,0,1,0,1,Lombardia,ITC4
2021-01-15,PF/BT,1284,FONDAZIONE GIOVANNI CARLO ROTA,LOM,30-39,1,2,0,3,0,0,0,3,0,3,Lombardia,ITC4
2021-01-15,PF/BT,1284,FONDAZIONE GIOVANNI CARLO ROTA,LOM,40-49,2,8,0,9,1,0,0,10,0,10,Lombardia,ITC4
2021-01-15,PF/BT,1284,FONDAZIONE GIOVANNI CARLO ROTA,LOM,50-59,1,7,0,8,0,0,0,8,0,8,Lombardia,ITC4
2021-01-15,PF/BT,1411,Fondazione Don Stefano Palla Onlus,LOM,50-59,1,3,0,3,1,0,0,4,0,4,Lombardia,ITC4
2021-01-15,PF/BT,1411,Fondazione Don Stefano Palla Onlus,LOM,60-69,0,1,0,1,0,0,0,1,0,1,Lombardia,ITC4
2021-01-15,PF/BT,1411,Fondazione Don Stefano Palla Onlus,LOM,80-89,0,1,0,0,0,1,0,1,0,1,Lombardia,ITC4
2021-01-15,PF/BT,1430,RSA SANTANGELA MERICI,LOM,30-39,1,0,0,1,0,0,0,1,0,1,Lombardia,ITC4
2021-01-15,PF/BT,1430,RSA SANTANGELA MERICI,LOM,60-69,1,1,0,1,0,1,0,2,0,2,Lombardia,ITC4
2021-01-15,PF/BT,1430,RSA SANTANGELA MERICI,LOM,70-79,0,2,0,0,0,2,0,2,0,2,Lombardia,ITC4
2021-01-15,PF/BT,1430,RSA SANTANGELA MERICI,LOM,80-89,5,15,0,0,0,20,0,20,0,20,Lombardia,ITC4
2021-01-15,PF/BT,1430,RSA SANTANGELA MERICI,LOM,90+,2,15,0,0,0,17,0,17,0,17,Lombardia,ITC4
2021-01-15,PF/BT,1480,"Rsa ""Sorelle Girelli"" Marone (BS)",LOM,30-39,1,0,0,1,0,0,0,1,0,1,Lombardia,ITC4
2021-01-15,PF/BT,1480,"Rsa ""Sorelle Girelli"" Marone (BS)",LOM,50-59,1,0,0,0,1,0,0,1,0,1,Lombardia,ITC4
2021-01-15,PF/BT,1480,"Rsa ""Sorelle Girelli"" Marone (BS)",LOM,60-69,2,0,0,0,1,1,0,2,0,2,Lombardia,ITC4
2021-01-15,PF/BT,1480,"Rsa ""Sorelle Girelli"" Marone (BS)",LOM,70-79,1,0,0,0,0,1,0,1,0,1,Lombardia,ITC4
2021-01-15,PF/BT,1480,"Rsa ""Sorelle Girelli"" Marone (BS)",LOM,80-89,0,1,0,0,0,1,0,1,0,1,Lombardia,ITC4
2021-01-15,PF/BT,1544,CENTRO DIURNO RSA CASA INDUSTRIA,LOM,30-39,0,1,0,1,0,0,0,1,0,1,Lombardia,ITC4
2021-01-15,PF/BT,1544,CENTRO DIURNO RSA CASA INDUSTRIA,LOM,40-49,1,2,0,3,0,0,0,3,0,3,Lombardia,ITC4
2021-01-15,PF/BT,1544,CENTRO DIURNO RSA CASA INDUSTRIA,LOM,50-59,0,6,0,5,1,0,0,6,0,6,Lombardia,ITC4
2021-01-15,PF/BT,1544,CENTRO DIURNO RSA CASA INDUSTRIA,LOM,60-69,0,2,0,2,0,0,0,2,0,2,Lombardia,ITC4
2021-01-15,PF/BT,1585,RSA FEROLDI,LOM,20-29,0,9,0,5,4,0,0,9,0,9,Lombardia,ITC4
2021-01-15,PF/BT,1585,RSA FEROLDI,LOM,30-39,4,11,0,11,4,0,0,15,0,15,Lombardia,ITC4
2021-01-15,PF/BT,1585,RSA FEROLDI,LOM,40-49,5,25,0,23,7,0,0,30,0,30,Lombardia,ITC4
2021-01-15,PF/BT,1585,RSA FEROLDI,LOM,50-59,4,39,0,30,13,0,0,43,0,43,Lombardia,ITC4
2021-01-15,PF/BT,1585,RSA FEROLDI,LOM,60-69,2,9,0,8,3,0,0,11,0,11,Lombardia,ITC4
2021-01-15,PF/BT,1591,Fondazione O.P. Delbarba Maselli Dandolo ONLUS,LOM,20-29,0,1,0,1,0,0,0,1,0,1,Lombardia,ITC4
2021-01-15,PF/BT,1591,Fondazione O.P. Delbarba Maselli Dandolo ONLUS,LOM,30-39,0,5,0,2,3,0,0,5,0,5,Lombardia,ITC4
2021-01-15,PF/BT,1591,Fondazione O.P. Delbarba Maselli Dandolo ONLUS,LOM,40-49,0,5,0,4,1,0,0,5,0,5,Lombardia,ITC4
2021-01-15,PF/BT,1591,Fondazione O.P. Delbarba Maselli Dandolo ONLUS,LOM,50-59,1,4,0,4,1,0,0,5,0,5,Lombardia,ITC4
2021-01-15,PF/BT,1591,Fondazione O.P. Delbarba Maselli Dandolo ONLUS,LOM,60-69,0,1,0,0,1,0,0,1,0,1,Lombardia,ITC4
2021-01-15,PF/BT,1591,Fondazione O.P. Delbarba Maselli Dandolo ONLUS,LOM,80-89,3,0,0,0,3,0,0,3,0,3,Lombardia,ITC4
2021-01-15,PF/BT,1591,Fondazione O.P. Delbarba Maselli Dandolo ONLUS,LOM,90+,1,3,0,0,4,0,0,4,0,4,Lombardia,ITC4
2021-01-15,PF/BT,162,PVO COVID OSPEDALI DI GARDONE V.T.,LOM,20-29,7,20,0,13,14,0,0,27,0,27,Lombardia,ITC4
2021-01-15,PF/BT,162,PVO COVID OSPEDALI DI GARDONE V.T.,LOM,30-39,6,24,0,17,13,0,0,30,0,30,Lombardia,ITC4
2021-01-15,PF/BT,162,PVO COVID OSPEDALI DI GARDONE V.T.,LOM,40-49,7,34,0,17,24,0,0,41,0,41,Lombardia,ITC4
2021-01-15,PF/BT,162,PVO COVID OSPEDALI DI GARDONE V.T.,LOM,50-59,11,43,0,21,33,0,0,54,0,54,Lombardia,ITC4
2021-01-15,PF/BT,162,PVO COVID OSPEDALI DI GARDONE V.T.,LOM,60-69,4,6,0,3,6,0,1,10,0,10,Lombardia,ITC4
2021-01-15,PF/BT,1626, KOS CARE RSA VILLAGGIO SAN FRANCESCO,LOM,16-19,0,1,0,0,1,0,0,1,0,1,Lombardia,ITC4
2021-01-15,PF/BT,1626, KOS CARE RSA VILLAGGIO SAN FRANCESCO,LOM,20-29,0,1,0,1,0,0,0,1,0,1,Lombardia,ITC4
2021-01-15,PF/BT,1626, KOS CARE RSA VILLAGGIO SAN FRANCESCO,LOM,30-39,0,3,0,1,2,0,0,3,0,3,Lombardia,ITC4
2021-01-15,PF/BT,1626, KOS CARE RSA VILLAGGIO SAN FRANCESCO,LOM,40-49,0,2,0,2,0,0,0,2,0,2,Lombardia,ITC4
2021-01-15,PF/BT,167,ASST SPEDALI CIVILI AMBULATORIO COVID BRESCIA,LOM,20-29,21,53,0,57,17,0,0,74,0,74,Lombardia,ITC4
2021-01-15,PF/BT,167,ASST SPEDALI CIVILI AMBULATORIO COVID BRESCIA,LOM,30-39,30,67,0,83,14,0,0,97,0,97,Lombardia,ITC4
2021-01-15,PF/BT,167,ASST SPEDALI CIVILI AMBULATORIO COVID BRESCIA,LOM,40-49,44,78,0,89,33,0,0,122,0,122,Lombardia,ITC4
2021-01-15,PF/BT,167,ASST SPEDALI CIVILI AMBULATORIO COVID BRESCIA,LOM,50-59,48,99,0,87,60,0,0,147,0,147,Lombardia,ITC4
2021-01-15,PF/BT,167,ASST SPEDALI CIVILI AMBULATORIO COVID BRESCIA,LOM,60-69,26,32,0,38,20,0,0,58,0,58,Lombardia,ITC4
2021-01-15,PF/BT,1716,FONDAZIONE CASA DI RIPOSO DI MANERBIO ONLUS,LOM,20-29,0,2,0,2,0,0,0,2,0,2,Lombardia,ITC4
2021-01-15,PF/BT,1716,FONDAZIONE CASA DI RIPOSO DI MANERBIO ONLUS,LOM,30-39,1,5,0,6,0,0,0,6,0,6,Lombardia,ITC4
2021-01-15,PF/BT,1716,FONDAZIONE CASA DI RIPOSO DI MANERBIO ONLUS,LOM,40-49,0,10,0,8,2,0,0,10,0,10,Lombardia,ITC4
2021-01-15,PF/BT,1716,FONDAZIONE CASA DI RIPOSO DI MANERBIO ONLUS,LOM,50-59,2,5,0,4,3,0,0,7,0,7,Lombardia,ITC4
2021-01-15,PF/BT,1716,FONDAZIONE CASA DI RIPOSO DI MANERBIO ONLUS,LOM,60-69,1,0,0,1,0,0,0,1,0,1,Lombardia,ITC4
2021-01-15,PF/BT,1716,FONDAZIONE CASA DI RIPOSO DI MANERBIO ONLUS,LOM,80-89,0,2,0,0,0,2,0,2,0,2,Lombardia,ITC4
2021-01-15,PF/BT,1716,FONDAZIONE CASA DI RIPOSO DI MANERBIO ONLUS,LOM,90+,0,2,0,0,0,2,0,2,0,2,Lombardia,ITC4
2021-01-15,PF/BT,1717,FONDAZIONE GAMBARA TAVELLI,LOM,40-49,1,0,0,0,1,0,0,1,0,1,Lombardia,ITC4
2021-01-15,PF/BT,1717,FONDAZIONE GAMBARA TAVELLI,LOM,50-59,1,0,0,0,0,1,0,1,0,1,Lombardia,ITC4
2021-01-15,PF/BT,1717,FONDAZIONE GAMBARA TAVELLI,LOM,60-69,4,3,0,0,0,7,0,7,0,7,Lombardia,ITC4
2021-01-15,PF/BT,1717,FONDAZIONE GAMBARA TAVELLI,LOM,70-79,8,8,0,0,0,16,0,16,0,16,Lombardia,ITC4
2021-01-15,PF/BT,1717,FONDAZIONE GAMBARA TAVELLI,LOM,80-89,14,40,0,0,0,54,0,54,0,54,Lombardia,ITC4
2021-01-15,PF/BT,1717,FONDAZIONE GAMBARA TAVELLI,LOM,90+,2,33,0,0,0,35,0,35,0,35,Lombardia,ITC4
2021-01-15,PF/BT,1724,Fondazione Casa di Riposo di Ghedi ONLUS,LOM,30-39,1,1,0,2,0,0,0,2,0,2,Lombardia,ITC4
2021-01-15,PF/BT,1724,Fondazione Casa di Riposo di Ghedi ONLUS,LOM,40-49,1,3,0,4,0,0,0,4,0,4,Lombardia,ITC4
2021-01-15,PF/BT,1724,Fondazione Casa di Riposo di Ghedi ONLUS,LOM,50-59,1,6,0,6,1,0,0,7,0,7,Lombardia,ITC4
2021-01-15,PF/BT,1724,Fondazione Casa di Riposo di Ghedi ONLUS,LOM,60-69,0,1,0,0,1,0,0,1,0,1,Lombardia,ITC4
2021-01-15,PF/BT,1724,Fondazione Casa di Riposo di Ghedi ONLUS,LOM,80-89,0,4,0,0,0,4,0,4,0,4,Lombardia,ITC4
2021-01-15,PF/BT,1745,FONDAZIONE RSA CASA DI RIPOSO DI SALO' RESIDENZA GLI ULIVI,LOM,30-39,0,1,0,1,0,0,0,1,0,1,Lombardia,ITC4
2021-01-15,PF/BT,1745,FONDAZIONE RSA CASA DI RIPOSO DI SALO' RESIDENZA GLI ULIVI,LOM,40-49,1,1,0,1,1,0,0,2,0,2,Lombardia,ITC4
2021-01-15,PF/BT,1745,FONDAZIONE RSA CASA DI RIPOSO DI SALO' RESIDENZA GLI ULIVI,LOM,50-59,7,1,0,4,4,0,0,8,0,8,Lombardia,ITC4
2021-01-15,PF/BT,1745,FONDAZIONE RSA CASA DI RIPOSO DI SALO' RESIDENZA GLI ULIVI,LOM,60-69,0,1,0,1,0,0,0,1,0,1,Lombardia,ITC4
2021-01-15,PF/BT,1745,FONDAZIONE RSA CASA DI RIPOSO DI SALO' RESIDENZA GLI ULIVI,LOM,70-79,0,1,0,0,0,1,0,1,0,1,Lombardia,ITC4
2021-01-15,PF/BT,1745,FONDAZIONE RSA CASA DI RIPOSO DI SALO' RESIDENZA GLI ULIVI,LOM,80-89,2,8,0,0,0,10,0,10,0,10,Lombardia,ITC4
2021-01-15,PF/BT,1745,FONDAZIONE RSA CASA DI RIPOSO DI SALO' RESIDENZA GLI ULIVI,LOM,90+,1,0,0,0,0,1,0,1,0,1,Lombardia,ITC4
2021-01-15,PF/BT,1772,Fondazione Villa Sacro Cuore Coniugi Preyer,LOM,30-39,0,3,0,3,0,0,0,3,0,3,Lombardia,ITC4
2021-01-15,PF/BT,1772,Fondazione Villa Sacro Cuore Coniugi Preyer,LOM,40-49,1,10,0,11,0,0,0,11,0,11,Lombardia,ITC4
2021-01-15,PF/BT,1772,Fondazione Villa Sacro Cuore Coniugi Preyer,LOM,50-59,1,11,0,12,0,0,0,12,0,12,Lombardia,ITC4
2021-01-15,PF/BT,1772,Fondazione Villa Sacro Cuore Coniugi Preyer,LOM,60-69,2,1,0,2,1,0,0,3,0,3,Lombardia,ITC4
2021-01-15,PF/BT,1772,Fondazione Villa Sacro Cuore Coniugi Preyer,LOM,80-89,0,1,0,0,0,1,0,1,0,1,Lombardia,ITC4
2021-01-15,PF/BT,1774,RSA I CICLAMINI,LOM,20-29,0,1,0,0,1,0,0,1,0,1,Lombardia,ITC4
2021-01-15,PF/BT,1774,RSA I CICLAMINI,LOM,30-39,1,1,0,2,0,0,0,2,0,2,Lombardia,ITC4
2021-01-15,PF/BT,1774,RSA I CICLAMINI,LOM,40-49,0,4,0,3,1,0,0,4,0,4,Lombardia,ITC4
2021-01-15,PF/BT,1774,RSA I CICLAMINI,LOM,50-59,0,2,0,0,2,0,0,2,0,2,Lombardia,ITC4
2021-01-15,PF/BT,1774,RSA I CICLAMINI,LOM,70-79,5,4,0,0,0,9,0,9,0,9,Lombardia,ITC4
2021-01-15,PF/BT,1774,RSA I CICLAMINI,LOM,80-89,1,10,0,0,0,11,0,11,0,11,Lombardia,ITC4
2021-01-15,PF/BT,1774,RSA I CICLAMINI,LOM,90+,1,6,0,0,0,7,0,7,0,7,Lombardia,ITC4
2021-01-15,PF/BT,179,RSA SANTA GIULIA,LOM,30-39,1,1,0,2,0,0,0,2,0,2,Lombardia,ITC4
2021-01-15,PF/BT,179,RSA SANTA GIULIA,LOM,40-49,0,1,0,1,0,0,0,1,0,1,Lombardia,ITC4
2021-01-15,PF/BT,179,RSA SANTA GIULIA,LOM,50-59,0,2,0,2,0,0,0,2,0,2,Lombardia,ITC4
2021-01-15,PF/BT,179,RSA SANTA GIULIA,LOM,60-69,1,0,0,0,0,1,0,1,0,1,Lombardia,ITC4
2021-01-15,PF/BT,179,RSA SANTA GIULIA,LOM,70-79,2,1,0,0,0,3,0,3,0,3,Lombardia,ITC4
2021-01-15,PF/BT,179,RSA SANTA GIULIA,LOM,80-89,6,4,0,0,0,10,0,10,0,10,Lombardia,ITC4
2021-01-15,PF/BT,179,RSA SANTA GIULIA,LOM,90+,0,5,0,0,0,5,0,5,0,5,Lombardia,ITC4
2021-01-15,PF/BT,1798,FONDAZIONE GIUSEPPINA BRUNENGHI,LOM,60-69,0,1,0,0,0,1,0,1,0,1,Lombardia,ITC4
2021-01-15,PF/BT,1798,FONDAZIONE GIUSEPPINA BRUNENGHI,LOM,70-79,0,1,0,0,0,1,0,1,0,1,Lombardia,ITC4
2021-01-15,PF/BT,1798,FONDAZIONE GIUSEPPINA BRUNENGHI,LOM,80-89,0,3,0,0,0,3,0,3,0,3,Lombardia,ITC4
2021-01-15,PF/BT,1798,FONDAZIONE GIUSEPPINA BRUNENGHI,LOM,90+,0,1,0,0,0,1,0,1,0,1,Lombardia,ITC4
2021-01-15,PF/BT,1824,Fondazione Benefattori Cremaschi - RSA Zurla,LOM,30-39,1,3,0,3,1,0,0,4,0,4,Lombardia,ITC4
2021-01-15,PF/BT,1824,Fondazione Benefattori Cremaschi - RSA Zurla,LOM,40-49,2,6,0,4,4,0,0,8,0,8,Lombardia,ITC4
2021-01-15,PF/BT,1824,Fondazione Benefattori Cremaschi - RSA Zurla,LOM,50-59,6,11,0,11,6,0,0,17,0,17,Lombardia,ITC4
2021-01-15,PF/BT,1824,Fondazione Benefattori Cremaschi - RSA Zurla,LOM,60-69,1,0,0,0,0,1,0,1,0,1,Lombardia,ITC4
2021-01-15,PF/BT,1824,Fondazione Benefattori Cremaschi - RSA Zurla,LOM,70-79,1,1,0,0,0,2,0,2,0,2,Lombardia,ITC4
2021-01-15,PF/BT,1824,Fondazione Benefattori Cremaschi - RSA Zurla,LOM,80-89,3,19,0,0,0,22,0,22,0,22,Lombardia,ITC4
2021-01-15,PF/BT,1824,Fondazione Benefattori Cremaschi - RSA Zurla,LOM,90+,0,12,0,0,0,12,0,12,0,12,Lombardia,ITC4
2021-01-15,PF/BT,1886,"RSA E. BOVI, PEGOGNAGA",LOM,30-39,0,1,0,1,0,0,0,1,0,1,Lombardia,ITC4
2021-01-15,PF/BT,1886,"RSA E. BOVI, PEGOGNAGA",LOM,40-49,0,3,0,3,0,0,0,3,0,3,Lombardia,ITC4
2021-01-15,PF/BT,1886,"RSA E. BOVI, PEGOGNAGA",LOM,50-59,1,4,0,1,4,0,0,5,0,5,Lombardia,ITC4
2021-01-15,PF/BT,1886,"RSA E. BOVI, PEGOGNAGA",LOM,60-69,0,2,0,2,0,0,0,2,0,2,Lombardia,ITC4
2021-01-15,PF/BT,1886,"RSA E. BOVI, PEGOGNAGA",LOM,70-79,0,1,0,0,0,1,0,1,0,1,Lombardia,ITC4
2021-01-15,PF/BT,1894,RSA S.VINCENZO,LOM,30-39,0,3,0,3,0,0,0,3,0,3,Lombardia,ITC4
2021-01-15,PF/BT,1894,RSA S.VINCENZO,LOM,40-49,0,1,0,1,0,0,0,1,0,1,Lombardia,ITC4
2021-01-15,PF/BT,1894,RSA S.VINCENZO,LOM,50-59,0,1,0,1,0,0,0,1,0,1,Lombardia,ITC4
2021-01-15,PF/BT,1894,RSA S.VINCENZO,LOM,60-69,5,1,0,0,0,6,0,6,0,6,Lombardia,ITC4
2021-01-15,PF/BT,1894,RSA S.VINCENZO,LOM,70-79,4,7,0,0,0,11,0,11,0,11,Lombardia,ITC4
2021-01-15,PF/BT,1894,RSA S.VINCENZO,LOM,80-89,10,24,0,0,0,34,0,34,0,34,Lombardia,ITC4
2021-01-15,PF/BT,1894,RSA S.VINCENZO,LOM,90+,7,33,0,0,0,40,0,40,0,40,Lombardia,ITC4
2021-01-15,PF/BT,1934,FONDAZIONE BRUNO PARI ONLUS,LOM,20-29,1,2,0,2,1,0,0,3,0,3,Lombardia,ITC4
2021-01-15,PF/BT,1934,FONDAZIONE BRUNO PARI ONLUS,LOM,30-39,0,4,0,3,1,0,0,4,0,4,Lombardia,ITC4
2021-01-15,PF/BT,1934,FONDAZIONE BRUNO PARI ONLUS,LOM,40-49,0,3,0,3,0,0,0,3,0,3,Lombardia,ITC4
2021-01-15,PF/BT,1934,FONDAZIONE BRUNO PARI ONLUS,LOM,50-59,1,3,0,2,2,0,0,4,0,4,Lombardia,ITC4
2021-01-15,PF/BT,1934,FONDAZIONE BRUNO PARI ONLUS,LOM,60-69,1,1,0,1,0,1,0,2,0,2,Lombardia,ITC4
2021-01-15,PF/BT,1934,FONDAZIONE BRUNO PARI ONLUS,LOM,70-79,0,2,0,1,0,1,0,2,0,2,Lombardia,ITC4
2021-01-15,PF/BT,1934,FONDAZIONE BRUNO PARI ONLUS,LOM,80-89,0,2,0,0,0,2,0,2,0,2,Lombardia,ITC4
2021-01-15,PF/BT,1934,FONDAZIONE BRUNO PARI ONLUS,LOM,90+,0,4,0,0,0,4,0,4,0,4,Lombardia,ITC4
2021-01-15,PF/BT,1944,FOND. OSPEDALE GIUSEPPE ARAGONA - SAN GIOVANNI IN CROCE (CR),LOM,20-29,3,5,0,6,2,0,0,8,0,8,Lombardia,ITC4
2021-01-15,PF/BT,1944,FOND. OSPEDALE GIUSEPPE ARAGONA - SAN GIOVANNI IN CROCE (CR),LOM,30-39,4,5,0,4,4,1,0,9,0,9,Lombardia,ITC4
2021-01-15,PF/BT,1944,FOND. OSPEDALE GIUSEPPE ARAGONA - SAN GIOVANNI IN CROCE (CR),LOM,40-49,4,14,0,12,4,2,0,18,0,18,Lombardia,ITC4
2021-01-15,PF/BT,1944,FOND. OSPEDALE GIUSEPPE ARAGONA - SAN GIOVANNI IN CROCE (CR),LOM,50-59,8,17,0,10,10,5,0,25,0,25,Lombardia,ITC4
2021-01-15,PF/BT,1944,FOND. OSPEDALE GIUSEPPE ARAGONA - SAN GIOVANNI IN CROCE (CR),LOM,60-69,6,11,0,5,5,7,0,17,0,17,Lombardia,ITC4
2021-01-15,PF/BT,1944,FOND. OSPEDALE GIUSEPPE ARAGONA - SAN GIOVANNI IN CROCE (CR),LOM,70-79,3,4,0,0,0,7,0,7,0,7,Lombardia,ITC4
2021-01-15,PF/BT,1944,FOND. OSPEDALE GIUSEPPE ARAGONA - SAN GIOVANNI IN CROCE (CR),LOM,80-89,10,14,0,0,0,24,0,24,0,24,Lombardia,ITC4
2021-01-15,PF/BT,1944,FOND. OSPEDALE GIUSEPPE ARAGONA - SAN GIOVANNI IN CROCE (CR),LOM,90+,0,15,0,0,0,15,0,15,0,15,Lombardia,ITC4
2021-01-15,PF/BT,1946,"FONDAZIONE ""CONTE DR. CARLO CARACCI"" - ONLUS",LOM,20-29,0,2,0,2,0,0,0,2,0,2,Lombardia,ITC4
2021-01-15,PF/BT,1946,"FONDAZIONE ""CONTE DR. CARLO CARACCI"" - ONLUS",LOM,30-39,0,2,0,0,2,0,0,2,0,2,Lombardia,ITC4
2021-01-15,PF/BT,1946,"FONDAZIONE ""CONTE DR. CARLO CARACCI"" - ONLUS",LOM,40-49,0,4,0,3,1,0,0,4,0,4,Lombardia,ITC4
2021-01-15,PF/BT,1946,"FONDAZIONE ""CONTE DR. CARLO CARACCI"" - ONLUS",LOM,50-59,1,1,0,1,0,0,1,2,0,2,Lombardia,ITC4
2021-01-15,PF/BT,1946,"FONDAZIONE ""CONTE DR. CARLO CARACCI"" - ONLUS",LOM,70-79,0,1,0,0,0,1,0,1,0,1,Lombardia,ITC4
2021-01-15,PF/BT,1946,"FONDAZIONE ""CONTE DR. CARLO CARACCI"" - ONLUS",LOM,80-89,0,2,0,0,0,2,0,2,0,2,Lombardia,ITC4
2021-01-15,PF/BT,1946,"FONDAZIONE ""CONTE DR. CARLO CARACCI"" - ONLUS",LOM,90+,0,5,0,0,0,5,0,5,0,5,Lombardia,ITC4
2021-01-15,PF/BT,1959,RSA A RICCIARDELLI,LOM,20-29,0,2,0,2,0,0,0,2,0,2,Lombardia,ITC4
2021-01-15,PF/BT,1959,RSA A RICCIARDELLI,LOM,30-39,0,3,0,2,1,0,0,3,0,3,Lombardia,ITC4
2021-01-15,PF/BT,1959,RSA A RICCIARDELLI,LOM,40-49,1,11,0,7,5,0,0,12,0,12,Lombardia,ITC4
2021-01-15,PF/BT,1959,RSA A RICCIARDELLI,LOM,50-59,0,11,0,8,3,0,0,11,0,11,Lombardia,ITC4
2021-01-15,PF/BT,1959,RSA A RICCIARDELLI,LOM,60-69,0,2,0,2,0,0,0,2,0,2,Lombardia,ITC4
2021-01-15,PF/BT,1959,RSA A RICCIARDELLI,LOM,70-79,0,1,0,0,0,1,0,1,0,1,Lombardia,ITC4
2021-01-15,PF/BT,1959,RSA A RICCIARDELLI,LOM,80-89,0,4,0,0,0,4,0,4,0,4,Lombardia,ITC4
2021-01-15,PF/BT,1959,RSA A RICCIARDELLI,LOM,90+,0,1,0,0,0,1,0,1,0,1,Lombardia,ITC4
2021-01-15,PF/BT,1963,RSA DUCALE,LOM,20-29,1,0,0,1,0,0,0,1,0,1,Lombardia,ITC4
2021-01-15,PF/BT,1963,RSA DUCALE,LOM,30-39,1,3,0,3,1,0,0,4,0,4,Lombardia,ITC4
2021-01-15,PF/BT,1963,RSA DUCALE,LOM,50-59,0,5,0,3,2,0,0,5,0,5,Lombardia,ITC4
2021-01-15,PF/BT,1963,RSA DUCALE,LOM,70-79,1,1,0,0,0,2,0,2,0,2,Lombardia,ITC4
2021-01-15,PF/BT,1963,RSA DUCALE,LOM,80-89,0,4,0,0,0,4,0,4,0,4,Lombardia,ITC4
2021-01-15,PF/BT,1963,RSA DUCALE,LOM,90+,0,2,0,0,0,2,0,2,0,2,Lombardia,ITC4
2021-01-15,PF/BT,1965,RESIDENZA SANITARIA ASSISTENZIALE FONDAZIONE LUIGI BONI ONLUS,LOM,20-29,0,1,0,1,0,0,0,1,0,1,Lombardia,ITC4
2021-01-15,PF/BT,1965,RESIDENZA SANITARIA ASSISTENZIALE FONDAZIONE LUIGI BONI ONLUS,LOM,30-39,1,1,0,0,0,0,2,2,0,2,Lombardia,ITC4
2021-01-15,PF/BT,1965,RESIDENZA SANITARIA ASSISTENZIALE FONDAZIONE LUIGI BONI ONLUS,LOM,40-49,1,2,0,0,0,0,3,3,0,3,Lombardia,ITC4
2021-01-15,PF/BT,1965,RESIDENZA SANITARIA ASSISTENZIALE FONDAZIONE LUIGI BONI ONLUS,LOM,50-59,3,3,0,3,0,0,3,6,0,6,Lombardia,ITC4
2021-01-15,PF/BT,1965,RESIDENZA SANITARIA ASSISTENZIALE FONDAZIONE LUIGI BONI ONLUS,LOM,60-69,6,2,0,0,0,2,6,8,0,8,Lombardia,ITC4
2021-01-15,PF/BT,1965,RESIDENZA SANITARIA ASSISTENZIALE FONDAZIONE LUIGI BONI ONLUS,LOM,70-79,5,1,0,0,0,2,4,6,0,6,Lombardia,ITC4
2021-01-15,PF/BT,1965,RESIDENZA SANITARIA ASSISTENZIALE FONDAZIONE LUIGI BONI ONLUS,LOM,80-89,1,8,0,0,0,8,1,9,0,9,Lombardia,ITC4
2021-01-15,PF/BT,1965,RESIDENZA SANITARIA ASSISTENZIALE FONDAZIONE LUIGI BONI ONLUS,LOM,90+,1,6,0,0,0,7,0,7,0,7,Lombardia,ITC4
2021-01-15,PF/BT,1975,RSA ZUCCHI-FALCINA,LOM,20-29,0,1,0,1,0,0,0,1,0,1,Lombardia,ITC4
2021-01-15,PF/BT,1975,RSA ZUCCHI-FALCINA,LOM,30-39,0,5,0,5,0,0,0,5,0,5,Lombardia,ITC4
2021-01-15,PF/BT,1975,RSA ZUCCHI-FALCINA,LOM,40-49,0,11,0,10,1,0,0,11,0,11,Lombardia,ITC4
2021-01-15,PF/BT,1975,RSA ZUCCHI-FALCINA,LOM,50-59,1,7,0,7,1,0,0,8,0,8,Lombardia,ITC4
2021-01-15,PF/BT,1975,RSA ZUCCHI-FALCINA,LOM,60-69,1,2,0,3,0,0,0,3,0,3,Lombardia,ITC4
2021-01-15,PF/BT,1975,RSA ZUCCHI-FALCINA,LOM,70-79,0,2,0,0,0,2,0,2,0,2,Lombardia,ITC4
2021-01-15,PF/BT,1991,FONDAZIONE E. GERMANI CENTRO ASSISTENZIALE SANITARIO ONLUS,LOM,20-29,1,2,0,2,1,0,0,3,0,3,Lombardia,ITC4
2021-01-15,PF/BT,1991,FONDAZIONE E. GERMANI CENTRO ASSISTENZIALE SANITARIO ONLUS,LOM,30-39,4,9,0,10,3,0,0,13,0,13,Lombardia,ITC4
2021-01-15,PF/BT,1991,FONDAZIONE E. GERMANI CENTRO ASSISTENZIALE SANITARIO ONLUS,LOM,40-49,3,21,0,19,5,0,0,24,0,24,Lombardia,ITC4
2021-01-15,PF/BT,1991,FONDAZIONE E. GERMANI CENTRO ASSISTENZIALE SANITARIO ONLUS,LOM,50-59,9,17,0,17,8,1,0,26,0,26,Lombardia,ITC4
2021-01-15,PF/BT,1991,FONDAZIONE E. GERMANI CENTRO ASSISTENZIALE SANITARIO ONLUS,LOM,60-69,1,5,0,2,1,3,0,6,0,6,Lombardia,ITC4
2021-01-15,PF/BT,1991,FONDAZIONE E. GERMANI CENTRO ASSISTENZIALE SANITARIO ONLUS,LOM,70-79,13,11,0,0,1,23,0,24,0,24,Lombardia,ITC4
2021-01-15,PF/BT,1991,FONDAZIONE E. GERMANI CENTRO ASSISTENZIALE SANITARIO ONLUS,LOM,80-89,23,50,0,0,3,70,0,73,0,73,Lombardia,ITC4
2021-01-15,PF/BT,1991,FONDAZIONE E. GERMANI CENTRO ASSISTENZIALE SANITARIO ONLUS,LOM,90+,3,45,0,0,0,48,0,48,0,48,Lombardia,ITC4
2021-01-15,PF/BT,20,cv cremona,LOM,20-29,1,0,0,1,0,0,0,1,0,1,Lombardia,ITC4
2021-01-15,PF/BT,20,cv cremona,LOM,60-69,1,0,0,0,0,1,0,1,0,1,Lombardia,ITC4
2021-01-15,PF/BT,20,cv cremona,LOM,70-79,1,1,0,0,0,2,0,2,0,2,Lombardia,ITC4
2021-01-15,PF/BT,20,cv cremona,LOM,80-89,4,6,0,0,0,10,0,10,0,10,Lombardia,ITC4
2021-01-15,PF/BT,20,cv cremona,LOM,90+,1,15,0,0,0,16,0,16,0,16,Lombardia,ITC4
2021-01-15,PF/BT,2001,RESIDENZA SANITARIA ASSISTITA UNITA' GERIATRICA RIABILITATIVA ONLUS,LOM,20-29,0,2,0,2,0,0,0,2,0,2,Lombardia,ITC4
2021-01-15,PF/BT,2001,RESIDENZA SANITARIA ASSISTITA UNITA' GERIATRICA RIABILITATIVA ONLUS,LOM,30-39,0,1,0,1,0,0,0,1,0,1,Lombardia,ITC4
2021-01-15,PF/BT,2001,RESIDENZA SANITARIA ASSISTITA UNITA' GERIATRICA RIABILITATIVA ONLUS,LOM,40-49,0,4,0,4,0,0,0,4,0,4,Lombardia,ITC4
2021-01-15,PF/BT,2001,RESIDENZA SANITARIA ASSISTITA UNITA' GERIATRICA RIABILITATIVA ONLUS,LOM,50-59,0,3,0,3,0,0,0,3,0,3,Lombardia,ITC4
2021-01-15,PF/BT,2001,RESIDENZA SANITARIA ASSISTITA UNITA' GERIATRICA RIABILITATIVA ONLUS,LOM,60-69,0,2,0,2,0,0,0,2,0,2,Lombardia,ITC4
2021-01-15,PF/BT,2022,rsa Villa Mater,LOM,40-49,0,1,0,1,0,0,0,1,0,1,Lombardia,ITC4
2021-01-15,PF/BT,2022,rsa Villa Mater,LOM,60-69,0,2,0,0,0,2,0,2,0,2,Lombardia,ITC4
2021-01-15,PF/BT,2022,rsa Villa Mater,LOM,70-79,6,8,0,0,0,14,0,14,0,14,Lombardia,ITC4
2021-01-15,PF/BT,2022,rsa Villa Mater,LOM,80-89,5,15,0,0,0,20,0,20,0,20,Lombardia,ITC4
2021-01-15,PF/BT,2022,rsa Villa Mater,LOM,90+,0,7,0,0,0,7,0,7,0,7,Lombardia,ITC4
2021-01-15,PF/BT,2071,RSA CORTELLONA MORTARA,LOM,20-29,0,2,0,2,0,0,0,2,0,2,Lombardia,ITC4
2021-01-15,PF/BT,2071,RSA CORTELLONA MORTARA,LOM,30-39,0,2,0,1,1,0,0,2,0,2,Lombardia,ITC4
2021-01-15,PF/BT,2071,RSA CORTELLONA MORTARA,LOM,40-49,0,8,0,5,3,0,0,8,0,8,Lombardia,ITC4
2021-01-15,PF/BT,2071,RSA CORTELLONA MORTARA,LOM,50-59,1,8,0,6,3,0,0,9,0,9,Lombardia,ITC4
2021-01-15,PF/BT,2071,RSA CORTELLONA MORTARA,LOM,60-69,3,5,0,1,1,6,0,8,0,8,Lombardia,ITC4
2021-01-15,PF/BT,2071,RSA CORTELLONA MORTARA,LOM,70-79,2,3,0,0,0,5,0,5,0,5,Lombardia,ITC4
2021-01-15,PF/BT,2071,RSA CORTELLONA MORTARA,LOM,80-89,3,21,0,0,0,24,0,24,0,24,Lombardia,ITC4
2021-01-15,PF/BT,2071,RSA CORTELLONA MORTARA,LOM,90+,1,1,0,0,0,2,0,2,0,2,Lombardia,ITC4
2021-01-15,PF/BT,2110,RSA LA TUA CASA,LOM,20-29,1,1,0,2,0,0,0,2,0,2,Lombardia,ITC4
2021-01-15,PF/BT,2110,RSA LA TUA CASA,LOM,30-39,0,4,0,4,0,0,0,4,0,4,Lombardia,ITC4
2021-01-15,PF/BT,2110,RSA LA TUA CASA,LOM,40-49,0,8,0,6,2,0,0,8,0,8,Lombardia,ITC4
2021-01-15,PF/BT,2110,RSA LA TUA CASA,LOM,50-59,1,7,0,6,2,0,0,8,0,8,Lombardia,ITC4
2021-01-15,PF/BT,2110,RSA LA TUA CASA,LOM,60-69,1,1,0,2,0,0,0,2,0,2,Lombardia,ITC4
2021-01-15,PF/BT,2148,RSA DE RODOLFI VIGEVANO,LOM,20-29,0,3,0,3,0,0,0,3,0,3,Lombardia,ITC4
2021-01-15,PF/BT,2148,RSA DE RODOLFI VIGEVANO,LOM,30-39,0,4,0,3,1,0,0,4,0,4,Lombardia,ITC4
2021-01-15,PF/BT,2148,RSA DE RODOLFI VIGEVANO,LOM,40-49,4,8,0,6,6,0,0,12,0,12,Lombardia,ITC4
2021-01-15,PF/BT,2148,RSA DE RODOLFI VIGEVANO,LOM,50-59,1,18,0,8,11,0,0,19,0,19,Lombardia,ITC4
2021-01-15,PF/BT,2148,RSA DE RODOLFI VIGEVANO,LOM,60-69,3,3,0,2,4,0,0,6,0,6,Lombardia,ITC4
2021-01-15,PF/BT,2148,RSA DE RODOLFI VIGEVANO,LOM,70-79,0,2,0,0,0,2,0,2,0,2,Lombardia,ITC4
2021-01-15,PF/BT,2148,RSA DE RODOLFI VIGEVANO,LOM,80-89,0,4,0,0,0,4,0,4,0,4,Lombardia,ITC4
2021-01-15,PF/BT,2148,RSA DE RODOLFI VIGEVANO,LOM,90+,1,3,0,0,0,4,0,4,0,4,Lombardia,ITC4
2021-01-15,PF/BT,228,"RSA ""POLO GERIATRICO RIABILITATIVO 1”",LOM,40-49,0,1,0,0,1,0,0,1,0,1,Lombardia,ITC4
2021-01-15,PF/BT,228,"RSA ""POLO GERIATRICO RIABILITATIVO 1”",LOM,50-59,1,4,0,3,2,0,0,5,0,5,Lombardia,ITC4
2021-01-15,PF/BT,24,FONDAZIONE OSPEDALE MARCHESI DI INZAGO,LOM,20-29,0,1,0,1,0,0,0,1,0,1,Lombardia,ITC4
2021-01-15,PF/BT,24,FONDAZIONE OSPEDALE MARCHESI DI INZAGO,LOM,30-39,0,2,0,2,0,0,0,2,0,2,Lombardia,ITC4
2021-01-15,PF/BT,24,FONDAZIONE OSPEDALE MARCHESI DI INZAGO,LOM,40-49,1,7,0,8,0,0,0,8,0,8,Lombardia,ITC4
2021-01-15,PF/BT,24,FONDAZIONE OSPEDALE MARCHESI DI INZAGO,LOM,50-59,0,3,0,2,1,0,0,3,0,3,Lombardia,ITC4
2021-01-15,PF/BT,24,FONDAZIONE OSPEDALE MARCHESI DI INZAGO,LOM,60-69,0,2,0,2,0,0,0,2,0,2,Lombardia,ITC4
2021-01-15,PF/BT,270,HOSPICE BEATI CONIUGI MARTIN,LOM,30-39,1,0,0,1,0,0,0,1,0,1,Lombardia,ITC4
2021-01-15,PF/BT,270,HOSPICE BEATI CONIUGI MARTIN,LOM,50-59,0,3,0,2,1,0,0,3,0,3,Lombardia,ITC4
2021-01-15,PF/BT,2971,FONDAZIONE CA'D'INDUSTRIA LE CAMELIE,LOM,30-39,1,7,0,8,0,0,0,8,0,8,Lombardia,ITC4
2021-01-15,PF/BT,2971,FONDAZIONE CA'D'INDUSTRIA LE CAMELIE,LOM,40-49,0,5,0,4,1,0,0,5,0,5,Lombardia,ITC4
2021-01-15,PF/BT,2971,FONDAZIONE CA'D'INDUSTRIA LE CAMELIE,LOM,50-59,1,11,0,7,5,0,0,12,0,12,Lombardia,ITC4
2021-01-15,PF/BT,2971,FONDAZIONE CA'D'INDUSTRIA LE CAMELIE,LOM,60-69,0,6,0,5,1,0,0,6,0,6,Lombardia,ITC4
2021-01-15,PF/BT,2971,FONDAZIONE CA'D'INDUSTRIA LE CAMELIE,LOM,70-79,2,1,0,0,0,3,0,3,0,3,Lombardia,ITC4
2021-01-15,PF/BT,2971,FONDAZIONE CA'D'INDUSTRIA LE CAMELIE,LOM,80-89,16,3,0,0,0,19,0,19,0,19,Lombardia,ITC4
2021-01-15,PF/BT,2971,FONDAZIONE CA'D'INDUSTRIA LE CAMELIE,LOM,90+,1,6,0,0,0,7,0,7,0,7,Lombardia,ITC4
2021-01-15,PF/BT,30030,OSPEDALE VALDUCE-AMBULATORIO VACCINALE COVID,LOM,20-29,0,4,0,0,4,0,0,4,0,4,Lombardia,ITC4
2021-01-15,PF/BT,30030,OSPEDALE VALDUCE-AMBULATORIO VACCINALE COVID,LOM,30-39,5,6,0,4,7,0,0,11,0,11,Lombardia,ITC4
2021-01-15,PF/BT,30030,OSPEDALE VALDUCE-AMBULATORIO VACCINALE COVID,LOM,40-49,6,26,0,11,21,0,0,32,0,32,Lombardia,ITC4
2021-01-15,PF/BT,30030,OSPEDALE VALDUCE-AMBULATORIO VACCINALE COVID,LOM,50-59,5,55,0,21,39,0,0,60,0,60,Lombardia,ITC4
2021-01-15,PF/BT,30030,OSPEDALE VALDUCE-AMBULATORIO VACCINALE COVID,LOM,60-69,7,13,0,11,4,0,5,20,0,20,Lombardia,ITC4
2021-01-15,PF/BT,30030,OSPEDALE VALDUCE-AMBULATORIO VACCINALE COVID,LOM,70-79,4,4,0,3,0,0,5,8,0,8,Lombardia,ITC4
2021-01-15,PF/BT,30030,OSPEDALE VALDUCE-AMBULATORIO VACCINALE COVID,LOM,80-89,1,2,0,1,0,0,2,3,0,3,Lombardia,ITC4
2021-01-15,PF/BT,3003100,OSPEDALE MORIGGIA PELASCINI - GRAVEDONA,LOM,20-29,2,4,0,6,0,0,0,6,0,6,Lombardia,ITC4
2021-01-15,PF/BT,3003100,OSPEDALE MORIGGIA PELASCINI - GRAVEDONA,LOM,30-39,2,11,0,13,0,0,0,13,0,13,Lombardia,ITC4
2021-01-15,PF/BT,3003100,OSPEDALE MORIGGIA PELASCINI - GRAVEDONA,LOM,40-49,5,6,0,11,0,0,0,11,0,11,Lombardia,ITC4
2021-01-15,PF/BT,3003100,OSPEDALE MORIGGIA PELASCINI - GRAVEDONA,LOM,50-59,3,9,0,12,0,0,0,12,0,12,Lombardia,ITC4
2021-01-15,PF/BT,3003100,OSPEDALE MORIGGIA PELASCINI - GRAVEDONA,LOM,60-69,2,1,0,3,0,0,0,3,0,3,Lombardia,ITC4
2021-01-15,PF/BT,3003100,OSPEDALE MORIGGIA PELASCINI - GRAVEDONA,LOM,70-79,2,1,0,3,0,0,0,3,0,3,Lombardia,ITC4
2021-01-15,PF/BT,30044,Ambulatorio Covid Chiavenna,LOM,20-29,0,4,0,3,1,0,0,4,0,4,Lombardia,ITC4
2021-01-15,PF/BT,30044,Ambulatorio Covid Chiavenna,LOM,30-39,3,1,0,3,0,0,1,4,0,4,Lombardia,ITC4
2021-01-15,PF/BT,30044,Ambulatorio Covid Chiavenna,LOM,40-49,4,17,0,16,4,0,1,21,0,21,Lombardia,ITC4
2021-01-15,PF/BT,30044,Ambulatorio Covid Chiavenna,LOM,50-59,9,19,0,21,5,0,2,28,0,28,Lombardia,ITC4
2021-01-15,PF/BT,30044,Ambulatorio Covid Chiavenna,LOM,60-69,8,6,0,10,3,0,1,14,0,14,Lombardia,ITC4
2021-01-15,PF/BT,30044,Ambulatorio Covid Chiavenna,LOM,70-79,1,0,0,1,0,0,0,1,0,1,Lombardia,ITC4
2021-01-15,PF/BT,30071,Centro Vaccinale Covid Melzo - ASST Melegnano Martesana,LOM,16-19,1,1,0,2,0,0,0,2,0,2,Lombardia,ITC4
2021-01-15,PF/BT,30071,Centro Vaccinale Covid Melzo - ASST Melegnano Martesana,LOM,20-29,21,25,0,45,1,0,0,46,0,46,Lombardia,ITC4
2021-01-15,PF/BT,30071,Centro Vaccinale Covid Melzo - ASST Melegnano Martesana,LOM,30-39,22,15,0,33,4,0,0,37,0,37,Lombardia,ITC4
2021-01-15,PF/BT,30071,Centro Vaccinale Covid Melzo - ASST Melegnano Martesana,LOM,40-49,26,24,0,41,9,0,0,50,0,50,Lombardia,ITC4
2021-01-15,PF/BT,30071,Centro Vaccinale Covid Melzo - ASST Melegnano Martesana,LOM,50-59,23,51,0,62,12,0,0,74,0,74,Lombardia,ITC4
2021-01-15,PF/BT,30071,Centro Vaccinale Covid Melzo - ASST Melegnano Martesana,LOM,60-69,26,21,0,36,11,0,0,47,0,47,Lombardia,ITC4
2021-01-15,PF/BT,30071,Centro Vaccinale Covid Melzo - ASST Melegnano Martesana,LOM,70-79,12,5,0,0,0,0,17,17,0,17,Lombardia,ITC4
2021-01-15,PF/BT,30071,Centro Vaccinale Covid Melzo - ASST Melegnano Martesana,LOM,80-89,1,0,0,0,0,0,1,1,0,1,Lombardia,ITC4
2021-01-15,PF/BT,30072,Centro Vaccinale Covid Vizzolo - ASST Melegnano Martesana,LOM,20-29,7,13,0,20,0,0,0,20,0,20,Lombardia,ITC4
2021-01-15,PF/BT,30072,Centro Vaccinale Covid Vizzolo - ASST Melegnano Martesana,LOM,30-39,14,11,0,23,2,0,0,25,0,25,Lombardia,ITC4
2021-01-15,PF/BT,30072,Centro Vaccinale Covid Vizzolo - ASST Melegnano Martesana,LOM,40-49,10,19,0,28,1,0,0,29,0,29,Lombardia,ITC4
2021-01-15,PF/BT,30072,Centro Vaccinale Covid Vizzolo - ASST Melegnano Martesana,LOM,50-59,10,33,0,41,2,0,0,43,0,43,Lombardia,ITC4
2021-01-15,PF/BT,30072,Centro Vaccinale Covid Vizzolo - ASST Melegnano Martesana,LOM,60-69,10,15,0,25,0,0,0,25,0,25,Lombardia,ITC4
2021-01-15,PF/BT,30072,Centro Vaccinale Covid Vizzolo - ASST Melegnano Martesana,LOM,70-79,1,1,0,0,0,0,2,2,0,2,Lombardia,ITC4
2021-01-15,PF/BT,30074,HUB COVID MAGENTA,LOM,20-29,4,19,0,19,4,0,0,23,0,23,Lombardia,ITC4
2021-01-15,PF/BT,30074,HUB COVID MAGENTA,LOM,30-39,2,16,0,14,4,0,0,18,0,18,Lombardia,ITC4
2021-01-15,PF/BT,30074,HUB COVID MAGENTA,LOM,40-49,5,25,0,17,13,0,0,30,0,30,Lombardia,ITC4
2021-01-15,PF/BT,30074,HUB COVID MAGENTA,LOM,50-59,10,25,0,21,14,0,0,35,0,35,Lombardia,ITC4
2021-01-15,PF/BT,30074,HUB COVID MAGENTA,LOM,60-69,7,5,0,8,4,0,0,12,0,12,Lombardia,ITC4
2021-01-15,PF/BT,30074,HUB COVID MAGENTA,LOM,70-79,0,1,0,0,1,0,0,1,0,1,Lombardia,ITC4
2021-01-15,PF/BT,30085,Centro Vaccinale Covid Cernusco - ASST Melegnano Martesana,LOM,20-29,4,6,0,10,0,0,0,10,0,10,Lombardia,ITC4
2021-01-15,PF/BT,30085,Centro Vaccinale Covid Cernusco - ASST Melegnano Martesana,LOM,30-39,4,10,0,14,0,0,0,14,0,14,Lombardia,ITC4
2021-01-15,PF/BT,30085,Centro Vaccinale Covid Cernusco - ASST Melegnano Martesana,LOM,40-49,5,3,0,5,3,0,0,8,0,8,Lombardia,ITC4
2021-01-15,PF/BT,30085,Centro Vaccinale Covid Cernusco - ASST Melegnano Martesana,LOM,50-59,7,28,0,24,11,0,0,35,0,35,Lombardia,ITC4
2021-01-15,PF/BT,30085,Centro Vaccinale Covid Cernusco - ASST Melegnano Martesana,LOM,60-69,2,8,0,8,2,0,0,10,0,10,Lombardia,ITC4
2021-01-15,PF/BT,30085,Centro Vaccinale Covid Cernusco - ASST Melegnano Martesana,LOM,70-79,1,0,0,0,0,0,1,1,0,1,Lombardia,ITC4
2021-01-15,PF/BT,3014400,CASA DI CURA BEATO PALAZZOLO-BERGAMO,LOM,20-29,0,2,0,2,0,0,0,2,0,2,Lombardia,ITC4
2021-01-15,PF/BT,3014400,CASA DI CURA BEATO PALAZZOLO-BERGAMO,LOM,30-39,4,0,0,3,1,0,0,4,0,4,Lombardia,ITC4
2021-01-15,PF/BT,3014400,CASA DI CURA BEATO PALAZZOLO-BERGAMO,LOM,40-49,2,10,0,7,5,0,0,12,0,12,Lombardia,ITC4
2021-01-15,PF/BT,3014400,CASA DI CURA BEATO PALAZZOLO-BERGAMO,LOM,50-59,9,8,0,14,3,0,0,17,0,17,Lombardia,ITC4
2021-01-15,PF/BT,3014400,CASA DI CURA BEATO PALAZZOLO-BERGAMO,LOM,60-69,5,2,0,5,2,0,0,7,0,7,Lombardia,ITC4
2021-01-15,PF/BT,3014400,CASA DI CURA BEATO PALAZZOLO-BERGAMO,LOM,70-79,2,3,0,3,2,0,0,5,0,5,Lombardia,ITC4
2021-01-15,PF/BT,3014400,CASA DI CURA BEATO PALAZZOLO-BERGAMO,LOM,80-89,0,1,0,0,1,0,0,1,0,1,Lombardia,ITC4
2021-01-15,PF/BT,30156,Centro Vaccinale Covid Desenzano,LOM,20-29,3,11,0,9,0,0,5,14,0,14,Lombardia,ITC4
2021-01-15,PF/BT,30156,Centro Vaccinale Covid Desenzano,LOM,30-39,4,9,0,11,1,0,1,13,0,13,Lombardia,ITC4
2021-01-15,PF/BT,30156,Centro Vaccinale Covid Desenzano,LOM,40-49,6,13,0,13,2,0,4,19,0,19,Lombardia,ITC4
2021-01-15,PF/BT,30156,Centro Vaccinale Covid Desenzano,LOM,50-59,10,35,0,31,9,0,5,45,0,45,Lombardia,ITC4
2021-01-15,PF/BT,30156,Centro Vaccinale Covid Desenzano,LOM,60-69,6,7,0,8,2,0,3,13,0,13,Lombardia,ITC4
2021-01-15,PF/BT,30156,Centro Vaccinale Covid Desenzano,LOM,70-79,2,0,0,1,0,0,1,2,0,2,Lombardia,ITC4
2021-01-15,PF/BT,30157,Centro Vaccinale Covid Gavardo,LOM,16-19,1,0,0,0,0,0,1,1,0,1,Lombardia,ITC4
2021-01-15,PF/BT,30157,Centro Vaccinale Covid Gavardo,LOM,20-29,4,4,0,6,1,0,1,8,0,8,Lombardia,ITC4
2021-01-15,PF/BT,30157,Centro Vaccinale Covid Gavardo,LOM,30-39,6,4,0,7,2,0,1,10,0,10,Lombardia,ITC4
2021-01-15,PF/BT,30157,Centro Vaccinale Covid Gavardo,LOM,40-49,9,9,0,5,3,0,10,18,0,18,Lombardia,ITC4
2021-01-15,PF/BT,30157,Centro Vaccinale Covid Gavardo,LOM,50-59,6,24,0,15,8,0,7,30,0,30,Lombardia,ITC4
2021-01-15,PF/BT,30157,Centro Vaccinale Covid Gavardo,LOM,60-69,8,8,0,3,3,0,10,16,0,16,Lombardia,ITC4
2021-01-15,PF/BT,30157,Centro Vaccinale Covid Gavardo,LOM,70-79,10,6,0,2,2,0,12,16,0,16,Lombardia,ITC4
2021-01-15,PF/BT,30157,Centro Vaccinale Covid Gavardo,LOM,80-89,1,2,0,0,0,0,3,3,0,3,Lombardia,ITC4
2021-01-15,PF/BT,30176,ISTITUTO CLINICO S. ANNA di ISTITUTI OSPEDALIERI BRESCIANI S.p.A.,LOM,20-29,0,1,0,1,0,0,0,1,0,1,Lombardia,ITC4
2021-01-15,PF/BT,30176,ISTITUTO CLINICO S. ANNA di ISTITUTI OSPEDALIERI BRESCIANI S.p.A.,LOM,30-39,2,3,0,5,0,0,0,5,0,5,Lombardia,ITC4
2021-01-15,PF/BT,30176,ISTITUTO CLINICO S. ANNA di ISTITUTI OSPEDALIERI BRESCIANI S.p.A.,LOM,40-49,1,12,0,12,1,0,0,13,0,13,Lombardia,ITC4
2021-01-15,PF/BT,30176,ISTITUTO CLINICO S. ANNA di ISTITUTI OSPEDALIERI BRESCIANI S.p.A.,LOM,50-59,3,8,0,6,5,0,0,11,0,11,Lombardia,ITC4
2021-01-15,PF/BT,30176,ISTITUTO CLINICO S. ANNA di ISTITUTI OSPEDALIERI BRESCIANI S.p.A.,LOM,60-69,3,2,0,4,1,0,0,5,0,5,Lombardia,ITC4
2021-01-15,PF/BT,30176,ISTITUTO CLINICO S. ANNA di ISTITUTI OSPEDALIERI BRESCIANI S.p.A.,LOM,70-79,1,0,0,1,0,0,0,1,0,1,Lombardia,ITC4
2021-01-15,PF/BT,30184,Centro Vaccinale Covid Manerbio,LOM,20-29,8,15,0,7,0,0,16,23,0,23,Lombardia,ITC4
2021-01-15,PF/BT,30184,Centro Vaccinale Covid Manerbio,LOM,30-39,10,18,0,13,0,0,15,28,0,28,Lombardia,ITC4
2021-01-15,PF/BT,30184,Centro Vaccinale Covid Manerbio,LOM,40-49,4,31,0,27,0,0,8,35,0,35,Lombardia,ITC4
2021-01-15,PF/BT,30184,Centro Vaccinale Covid Manerbio,LOM,50-59,13,35,0,32,1,0,15,48,0,48,Lombardia,ITC4
2021-01-15,PF/BT,30184,Centro Vaccinale Covid Manerbio,LOM,60-69,5,6,0,5,0,0,6,11,0,11,Lombardia,ITC4
2021-01-15,PF/BT,30184,Centro Vaccinale Covid Manerbio,LOM,70-79,2,2,0,1,0,0,3,4,0,4,Lombardia,ITC4
2021-01-15,PF/BT,30193,Ambulatorio HUB Vigevano,LOM,16-19,0,2,0,0,2,0,0,2,0,2,Lombardia,ITC4
2021-01-15,PF/BT,30193,Ambulatorio HUB Vigevano,LOM,20-29,20,27,0,6,41,0,0,47,0,47,Lombardia,ITC4
2021-01-15,PF/BT,30193,Ambulatorio HUB Vigevano,LOM,30-39,15,22,0,2,35,0,0,37,0,37,Lombardia,ITC4
2021-01-15,PF/BT,30193,Ambulatorio HUB Vigevano,LOM,40-49,22,16,0,7,31,0,0,38,0,38,Lombardia,ITC4
2021-01-15,PF/BT,30193,Ambulatorio HUB Vigevano,LOM,50-59,24,35,0,11,48,0,0,59,0,59,Lombardia,ITC4
2021-01-15,PF/BT,30193,Ambulatorio HUB Vigevano,LOM,60-69,21,18,0,3,36,0,0,39,0,39,Lombardia,ITC4
2021-01-15,PF/BT,30193,Ambulatorio HUB Vigevano,LOM,70-79,11,5,0,0,16,0,0,16,0,16,Lombardia,ITC4
2021-01-15,PF/BT,30193,Ambulatorio HUB Vigevano,LOM,80-89,2,0,0,0,2,0,0,2,0,2,Lombardia,ITC4
2021-01-15,PF/BT,30194,AMBULATORIO HUB VOGHERA,LOM,16-19,0,1,0,1,0,0,0,1,0,1,Lombardia,ITC4
2021-01-15,PF/BT,30194,AMBULATORIO HUB VOGHERA,LOM,20-29,18,9,0,24,3,0,0,27,0,27,Lombardia,ITC4
2021-01-15,PF/BT,30194,AMBULATORIO HUB VOGHERA,LOM,30-39,6,12,0,15,3,0,0,18,0,18,Lombardia,ITC4
2021-01-15,PF/BT,30194,AMBULATORIO HUB VOGHERA,LOM,40-49,17,10,0,21,6,0,0,27,0,27,Lombardia,ITC4
2021-01-15,PF/BT,30194,AMBULATORIO HUB VOGHERA,LOM,50-59,13,17,0,19,11,0,0,30,0,30,Lombardia,ITC4
2021-01-15,PF/BT,30194,AMBULATORIO HUB VOGHERA,LOM,60-69,7,9,0,12,4,0,0,16,0,16,Lombardia,ITC4
2021-01-15,PF/BT,30194,AMBULATORIO HUB VOGHERA,LOM,70-79,2,3,0,3,2,0,0,5,0,5,Lombardia,ITC4
2021-01-15,PF/BT,30194,Punto vaccinale Territoriale ASST di Pavia,LOM,16-19,0,1,0,1,0,0,0,1,0,1,Lombardia,ITC4
2021-01-15,PF/BT,30194,Punto vaccinale Territoriale ASST di Pavia,LOM,20-29,1,13,0,13,1,0,0,14,0,14,Lombardia,ITC4
2021-01-15,PF/BT,30194,Punto vaccinale Territoriale ASST di Pavia,LOM,30-39,1,13,0,12,2,0,0,14,0,14,Lombardia,ITC4
2021-01-15,PF/BT,30194,Punto vaccinale Territoriale ASST di Pavia,LOM,40-49,1,4,0,4,1,0,0,5,0,5,Lombardia,ITC4
2021-01-15,PF/BT,30194,Punto vaccinale Territoriale ASST di Pavia,LOM,50-59,5,9,0,9,5,0,0,14,0,14,Lombardia,ITC4
2021-01-15,PF/BT,30194,Punto vaccinale Territoriale ASST di Pavia,LOM,60-69,3,2,0,3,2,0,0,5,0,5,Lombardia,ITC4
2021-01-15,PF/BT,302,Istituto Palazzolo Fondazione Don Carlo Gnocchi,LOM,20-29,2,2,0,4,0,0,0,4,0,4,Lombardia,ITC4
2021-01-15,PF/BT,302,Istituto Palazzolo Fondazione Don Carlo Gnocchi,LOM,30-39,12,8,0,20,0,0,0,20,0,20,Lombardia,ITC4
2021-01-15,PF/BT,302,Istituto Palazzolo Fondazione Don Carlo Gnocchi,LOM,40-49,5,22,0,25,2,0,0,27,0,27,Lombardia,ITC4
2021-01-15,PF/BT,302,Istituto Palazzolo Fondazione Don Carlo Gnocchi,LOM,50-59,14,17,0,30,1,0,0,31,0,31,Lombardia,ITC4
2021-01-15,PF/BT,302,Istituto Palazzolo Fondazione Don Carlo Gnocchi,LOM,60-69,4,10,0,14,0,0,0,14,0,14,Lombardia,ITC4
2021-01-15,PF/BT,30209,OSPEDALE MAGGIORE DI CREMA,LOM,20-29,6,14,0,11,0,0,9,20,0,20,Lombardia,ITC4
2021-01-15,PF/BT,30209,OSPEDALE MAGGIORE DI CREMA,LOM,30-39,9,24,0,24,4,0,5,33,0,33,Lombardia,ITC4
2021-01-15,PF/BT,30209,OSPEDALE MAGGIORE DI CREMA,LOM,40-49,11,30,0,20,12,0,9,41,0,41,Lombardia,ITC4
2021-01-15,PF/BT,30209,OSPEDALE MAGGIORE DI CREMA,LOM,50-59,11,37,0,22,19,0,7,48,0,48,Lombardia,ITC4
2021-01-15,PF/BT,30209,OSPEDALE MAGGIORE DI CREMA,LOM,60-69,10,12,0,5,6,0,11,22,0,22,Lombardia,ITC4
2021-01-15,PF/BT,30209,OSPEDALE MAGGIORE DI CREMA,LOM,70-79,9,1,0,1,0,0,9,10,0,10,Lombardia,ITC4
2021-01-15,PF/BT,3021800,Casa di Cura san Camillo cremona,LOM,20-29,2,0,0,2,0,0,0,2,0,2,Lombardia,ITC4
2021-01-15,PF/BT,3021800,Casa di Cura san Camillo cremona,LOM,30-39,0,2,0,2,0,0,0,2,0,2,Lombardia,ITC4
2021-01-15,PF/BT,3021800,Casa di Cura san Camillo cremona,LOM,40-49,5,6,0,5,6,0,0,11,0,11,Lombardia,ITC4
2021-01-15,PF/BT,3021800,Casa di Cura san Camillo cremona,LOM,50-59,1,6,0,5,2,0,0,7,0,7,Lombardia,ITC4
2021-01-15,PF/BT,3021800,Casa di Cura san Camillo cremona,LOM,60-69,1,4,0,5,0,0,0,5,0,5,Lombardia,ITC4
2021-01-15,PF/BT,3021800,Casa di Cura san Camillo cremona,LOM,70-79,3,0,0,2,0,0,1,3,0,3,Lombardia,ITC4
2021-01-15,PF/BT,3021900,CASA DI CURA FIGLIE DI SAN CAMILLO CREMONA,LOM,20-29,5,5,0,8,2,0,0,10,0,10,Lombardia,ITC4
2021-01-15,PF/BT,3021900,CASA DI CURA FIGLIE DI SAN CAMILLO CREMONA,LOM,30-39,5,11,0,13,3,0,0,16,0,16,Lombardia,ITC4
2021-01-15,PF/BT,3021900,CASA DI CURA FIGLIE DI SAN CAMILLO CREMONA,LOM,40-49,2,21,0,18,5,0,0,23,0,23,Lombardia,ITC4
2021-01-15,PF/BT,3021900,CASA DI CURA FIGLIE DI SAN CAMILLO CREMONA,LOM,50-59,7,13,0,13,5,0,2,20,0,20,Lombardia,ITC4
2021-01-15,PF/BT,3021900,CASA DI CURA FIGLIE DI SAN CAMILLO CREMONA,LOM,60-69,6,2,0,6,2,0,0,8,0,8,Lombardia,ITC4
2021-01-15,PF/BT,3021900,CASA DI CURA FIGLIE DI SAN CAMILLO CREMONA,LOM,70-79,7,0,0,6,0,0,1,7,0,7,Lombardia,ITC4
2021-01-15,PF/BT,30281,HUB LEGNANO,LOM,20-29,2,13,0,10,5,0,0,15,0,15,Lombardia,ITC4
2021-01-15,PF/BT,30281,HUB LEGNANO,LOM,30-39,9,19,0,20,8,0,0,28,0,28,Lombardia,ITC4
2021-01-15,PF/BT,30281,HUB LEGNANO,LOM,40-49,3,32,0,30,5,0,0,35,0,35,Lombardia,ITC4
2021-01-15,PF/BT,30281,HUB LEGNANO,LOM,50-59,6,34,0,31,9,0,0,40,0,40,Lombardia,ITC4
2021-01-15,PF/BT,30281,HUB LEGNANO,LOM,60-69,5,25,0,6,24,0,0,30,0,30,Lombardia,ITC4
2021-01-15,PF/BT,30281,HUB LEGNANO,LOM,70-79,4,4,0,0,8,0,0,8,0,8,Lombardia,ITC4
2021-01-15,PF/BT,30321000338 - 30321000390,Residenze Assistite maleo (Rsa Mons Trabattoni & RSA L. Corazza) Maleo - Lodi,LOM,40-49,0,1,0,1,0,0,0,1,0,1,Lombardia,ITC4
2021-01-15,PF/BT,30321000338 - 30321000390,Residenze Assistite maleo (Rsa Mons Trabattoni & RSA L. Corazza) Maleo - Lodi,LOM,50-59,0,3,0,3,0,0,0,3,0,3,Lombardia,ITC4
2021-01-15,PF/BT,30321000338 - 30321000390,Residenze Assistite maleo (Rsa Mons Trabattoni & RSA L. Corazza) Maleo - Lodi,LOM,70-79,0,6,0,1,1,4,0,6,0,6,Lombardia,ITC4
2021-01-15,PF/BT,30321000338 - 30321000390,Residenze Assistite maleo (Rsa Mons Trabattoni & RSA L. Corazza) Maleo - Lodi,LOM,80-89,2,16,0,0,1,17,0,18,0,18,Lombardia,ITC4
2021-01-15,PF/BT,30321000338 - 30321000390,Residenze Assistite maleo (Rsa Mons Trabattoni & RSA L. Corazza) Maleo - Lodi,LOM,90+,2,12,0,0,0,14,0,14,0,14,Lombardia,ITC4
2021-01-15,PF/BT,30322002809,FONDAZIONE ANNA BORLETTI PER INVALIDI E ANZIANI DI AROSIO ONLUS,LOM,30-39,0,1,0,1,0,0,0,1,0,1,Lombardia,ITC4
2021-01-15,PF/BT,30322002809,FONDAZIONE ANNA BORLETTI PER INVALIDI E ANZIANI DI AROSIO ONLUS,LOM,40-49,0,1,0,0,1,0,0,1,0,1,Lombardia,ITC4
2021-01-15,PF/BT,30322002809,FONDAZIONE ANNA BORLETTI PER INVALIDI E ANZIANI DI AROSIO ONLUS,LOM,60-69,1,2,0,0,0,3,0,3,0,3,Lombardia,ITC4
2021-01-15,PF/BT,30322002809,FONDAZIONE ANNA BORLETTI PER INVALIDI E ANZIANI DI AROSIO ONLUS,LOM,70-79,8,6,0,0,0,14,0,14,0,14,Lombardia,ITC4
2021-01-15,PF/BT,30322002809,FONDAZIONE ANNA BORLETTI PER INVALIDI E ANZIANI DI AROSIO ONLUS,LOM,80-89,5,35,0,0,0,40,0,40,0,40,Lombardia,ITC4
2021-01-15,PF/BT,30322002809,FONDAZIONE ANNA BORLETTI PER INVALIDI E ANZIANI DI AROSIO ONLUS,LOM,90+,1,30,0,0,0,31,0,31,0,31,Lombardia,ITC4
2021-01-15,PF/BT,30322029,Ospedale Religioso Classificato Sacra Famiglia Fatebenefratelli Erba,LOM,20-29,2,3,0,5,0,0,0,5,0,5,Lombardia,ITC4
2021-01-15,PF/BT,30322029,Ospedale Religioso Classificato Sacra Famiglia Fatebenefratelli Erba,LOM,30-39,6,9,0,14,1,0,0,15,0,15,Lombardia,ITC4
2021-01-15,PF/BT,30322029,Ospedale Religioso Classificato Sacra Famiglia Fatebenefratelli Erba,LOM,40-49,9,21,0,26,4,0,0,30,0,30,Lombardia,ITC4
2021-01-15,PF/BT,30322029,Ospedale Religioso Classificato Sacra Famiglia Fatebenefratelli Erba,LOM,50-59,14,31,0,40,5,0,0,45,0,45,Lombardia,ITC4
2021-01-15,PF/BT,30322029,Ospedale Religioso Classificato Sacra Famiglia Fatebenefratelli Erba,LOM,60-69,9,4,0,13,0,0,0,13,0,13,Lombardia,ITC4
2021-01-15,PF/BT,30326001600,FONDAZIONE CASA DI RIPOSO VILLA G.PADOVANI ONLUS,LOM,20-29,0,1,0,1,0,0,0,1,0,1,Lombardia,ITC4
2021-01-15,PF/BT,30326001600,FONDAZIONE CASA DI RIPOSO VILLA G.PADOVANI ONLUS,LOM,30-39,0,4,0,4,0,0,0,4,0,4,Lombardia,ITC4
2021-01-15,PF/BT,30326001600,FONDAZIONE CASA DI RIPOSO VILLA G.PADOVANI ONLUS,LOM,40-49,1,3,0,4,0,0,0,4,0,4,Lombardia,ITC4
2021-01-15,PF/BT,30326001600,FONDAZIONE CASA DI RIPOSO VILLA G.PADOVANI ONLUS,LOM,50-59,0,2,0,2,0,0,0,2,0,2,Lombardia,ITC4
2021-01-15,PF/BT,30326001600,FONDAZIONE CASA DI RIPOSO VILLA G.PADOVANI ONLUS,LOM,60-69,1,0,0,1,0,0,0,1,0,1,Lombardia,ITC4
2021-01-15,PF/BT,30327001819,RSA I GIRASOLI - VIA M. K. GANDHI N° 1 BORGO VIRGILIO (MN),LOM,20-29,0,1,0,1,0,0,0,1,0,1,Lombardia,ITC4
2021-01-15,PF/BT,30327001819,RSA I GIRASOLI - VIA M. K. GANDHI N° 1 BORGO VIRGILIO (MN),LOM,70-79,2,2,0,0,0,4,0,4,0,4,Lombardia,ITC4
2021-01-15,PF/BT,30327001819,RSA I GIRASOLI - VIA M. K. GANDHI N° 1 BORGO VIRGILIO (MN),LOM,80-89,0,16,0,0,0,16,0,16,0,16,Lombardia,ITC4
2021-01-15,PF/BT,30327001819,RSA I GIRASOLI - VIA M. K. GANDHI N° 1 BORGO VIRGILIO (MN),LOM,90+,3,12,0,0,0,15,0,15,0,15,Lombardia,ITC4
2021-01-15,PF/BT,3035500,ospedale di suzzara spa,LOM,20-29,3,12,0,14,1,0,0,15,0,15,Lombardia,ITC4
2021-01-15,PF/BT,3035500,ospedale di suzzara spa,LOM,30-39,5,9,0,10,4,0,0,14,0,14,Lombardia,ITC4
2021-01-15,PF/BT,3035500,ospedale di suzzara spa,LOM,40-49,3,5,0,5,3,0,0,8,0,8,Lombardia,ITC4
2021-01-15,PF/BT,3035500,ospedale di suzzara spa,LOM,50-59,1,13,0,9,5,0,0,14,0,14,Lombardia,ITC4
2021-01-15,PF/BT,3035500,ospedale di suzzara spa,LOM,60-69,5,3,0,7,1,0,0,8,0,8,Lombardia,ITC4
2021-01-15,PF/BT,3035500,ospedale di suzzara spa,LOM,70-79,0,1,0,1,0,0,0,1,0,1,Lombardia,ITC4
2021-01-15,PF/BT,3035600,ISTITUTO CLINICO HABILITA - CISERANO,LOM,20-29,14,1,0,8,7,0,0,15,0,15,Lombardia,ITC4
2021-01-15,PF/BT,3035600,ISTITUTO CLINICO HABILITA - CISERANO,LOM,30-39,36,12,0,26,22,0,0,48,0,48,Lombardia,ITC4
2021-01-15,PF/BT,3035600,ISTITUTO CLINICO HABILITA - CISERANO,LOM,40-49,40,17,0,32,25,0,0,57,0,57,Lombardia,ITC4
2021-01-15,PF/BT,3035600,ISTITUTO CLINICO HABILITA - CISERANO,LOM,50-59,22,18,0,25,15,0,0,40,0,40,Lombardia,ITC4
2021-01-15,PF/BT,3035600,ISTITUTO CLINICO HABILITA - CISERANO,LOM,60-69,2,11,0,11,2,0,0,13,0,13,Lombardia,ITC4
2021-01-15,PF/BT,3035600,ISTITUTO CLINICO HABILITA - CISERANO,LOM,70-79,0,11,0,10,1,0,0,11,0,11,Lombardia,ITC4
2021-01-15,PF/BT,3035700,OSPEDALE SAN PELLEGRINO SRL,LOM,20-29,4,15,0,12,6,0,1,19,0,19,Lombardia,ITC4
2021-01-15,PF/BT,3035700,OSPEDALE SAN PELLEGRINO SRL,LOM,30-39,12,18,0,23,3,0,4,30,0,30,Lombardia,ITC4
2021-01-15,PF/BT,3035700,OSPEDALE SAN PELLEGRINO SRL,LOM,40-49,6,12,0,12,4,0,2,18,0,18,Lombardia,ITC4
2021-01-15,PF/BT,3035700,OSPEDALE SAN PELLEGRINO SRL,LOM,50-59,10,9,0,16,2,0,1,19,0,19,Lombardia,ITC4
2021-01-15,PF/BT,3035700,OSPEDALE SAN PELLEGRINO SRL,LOM,60-69,5,2,0,6,1,0,0,7,0,7,Lombardia,ITC4
2021-01-15,PF/BT,3035700,OSPEDALE SAN PELLEGRINO SRL,LOM,70-79,3,0,0,3,0,0,0,3,0,3,Lombardia,ITC4
2021-01-15,PF/BT,30368,CENTRO ETTORE SPALENZA - FONDAZIONE DON CARLO GNOCCHI,LOM,20-29,6,11,0,16,1,0,0,17,0,17,Lombardia,ITC4
2021-01-15,PF/BT,30368,CENTRO ETTORE SPALENZA - FONDAZIONE DON CARLO GNOCCHI,LOM,30-39,8,15,0,21,2,0,0,23,0,23,Lombardia,ITC4
2021-01-15,PF/BT,30368,CENTRO ETTORE SPALENZA - FONDAZIONE DON CARLO GNOCCHI,LOM,40-49,4,16,0,13,7,0,0,20,0,20,Lombardia,ITC4
2021-01-15,PF/BT,30368,CENTRO ETTORE SPALENZA - FONDAZIONE DON CARLO GNOCCHI,LOM,50-59,8,14,0,18,4,0,0,22,0,22,Lombardia,ITC4
2021-01-15,PF/BT,30368,CENTRO ETTORE SPALENZA - FONDAZIONE DON CARLO GNOCCHI,LOM,60-69,1,1,0,1,1,0,0,2,0,2,Lombardia,ITC4
2021-01-15,PF/BT,30701,ASST GRANDE OSPEDALE METROPOLITANO NIGUARDA,LOM,16-19,1,1,0,1,1,0,0,2,0,2,Lombardia,ITC4
2021-01-15,PF/BT,30701,ASST GRANDE OSPEDALE METROPOLITANO NIGUARDA,LOM,20-29,27,37,0,36,11,0,17,64,0,64,Lombardia,ITC4
2021-01-15,PF/BT,30701,ASST GRANDE OSPEDALE METROPOLITANO NIGUARDA,LOM,30-39,29,58,0,48,28,0,11,87,0,87,Lombardia,ITC4
2021-01-15,PF/BT,30701,ASST GRANDE OSPEDALE METROPOLITANO NIGUARDA,LOM,40-49,45,72,0,55,48,0,14,117,0,117,Lombardia,ITC4
2021-01-15,PF/BT,30701,ASST GRANDE OSPEDALE METROPOLITANO NIGUARDA,LOM,50-59,77,160,0,122,97,0,18,237,0,237,Lombardia,ITC4
2021-01-15,PF/BT,30701,ASST GRANDE OSPEDALE METROPOLITANO NIGUARDA,LOM,60-69,31,41,0,37,25,0,10,72,0,72,Lombardia,ITC4
2021-01-15,PF/BT,30701,ASST GRANDE OSPEDALE METROPOLITANO NIGUARDA,LOM,70-79,1,0,0,0,0,0,1,1,0,1,Lombardia,ITC4
2021-01-15,PF/BT,30701,ASST GRANDE OSPEDALE METROPOLITANO NIGUARDA,LOM,80-89,1,1,0,0,0,0,2,2,0,2,Lombardia,ITC4
2021-01-15,PF/BT,30718,ASST PAPA GIOVANNI XXIII,LOM,20-29,8,46,0,45,9,0,0,54,0,54,Lombardia,ITC4
2021-01-15,PF/BT,30718,ASST PAPA GIOVANNI XXIII,LOM,30-39,21,40,0,52,9,0,0,61,0,61,Lombardia,ITC4
2021-01-15,PF/BT,30718,ASST PAPA GIOVANNI XXIII,LOM,40-49,25,70,0,70,25,0,0,95,0,95,Lombardia,ITC4
2021-01-15,PF/BT,30718,ASST PAPA GIOVANNI XXIII,LOM,50-59,25,69,0,65,29,0,0,94,0,94,Lombardia,ITC4
2021-01-15,PF/BT,30718,ASST PAPA GIOVANNI XXIII,LOM,60-69,11,16,0,17,10,0,0,27,0,27,Lombardia,ITC4
2021-01-15,PF/BT,30718,ASST PAPA GIOVANNI XXIII,LOM,70-79,1,0,0,1,0,0,0,1,0,1,Lombardia,ITC4
2021-01-15,PF/BT,30718,ASST PAPA GIOVANNI XXIII,LOM,80-89,0,1,0,0,1,0,0,1,0,1,Lombardia,ITC4
2021-01-15,PF/BT,30902,Ospedale S.Anna - Como,LOM,16-19,1,2,0,0,3,0,0,3,0,3,Lombardia,ITC4
2021-01-15,PF/BT,30902,Ospedale S.Anna - Como,LOM,20-29,17,40,0,15,36,0,6,57,0,57,Lombardia,ITC4
2021-01-15,PF/BT,30902,Ospedale S.Anna - Como,LOM,30-39,18,19,0,17,20,0,0,37,0,37,Lombardia,ITC4
2021-01-15,PF/BT,30902,Ospedale S.Anna - Como,LOM,40-49,14,33,0,14,33,0,0,47,0,47,Lombardia,ITC4
2021-01-15,PF/BT,30902,Ospedale S.Anna - Como,LOM,50-59,24,44,0,19,49,0,0,68,0,68,Lombardia,ITC4
2021-01-15,PF/BT,30902,Ospedale S.Anna - Como,LOM,60-69,39,29,0,9,59,0,0,68,0,68,Lombardia,ITC4
2021-01-15,PF/BT,30902,Ospedale S.Anna - Como,LOM,70-79,21,8,0,1,28,0,0,29,0,29,Lombardia,ITC4
2021-01-15,PF/BT,30902,Ospedale S.Anna - Como,LOM,80-89,2,1,0,0,3,0,0,3,0,3,Lombardia,ITC4
2021-01-15,PF/BT,30904,ASST VALTELLINA E ALTO LARIO PRESIDIO OSPEDALIERO DI SONDALO,LOM,20-29,3,2,0,4,1,0,0,5,0,5,Lombardia,ITC4
2021-01-15,PF/BT,30904,ASST VALTELLINA E ALTO LARIO PRESIDIO OSPEDALIERO DI SONDALO,LOM,30-39,1,2,0,2,1,0,0,3,0,3,Lombardia,ITC4
2021-01-15,PF/BT,30904,ASST VALTELLINA E ALTO LARIO PRESIDIO OSPEDALIERO DI SONDALO,LOM,40-49,4,5,0,6,3,0,0,9,0,9,Lombardia,ITC4
2021-01-15,PF/BT,30904,ASST VALTELLINA E ALTO LARIO PRESIDIO OSPEDALIERO DI SONDALO,LOM,50-59,5,16,0,15,6,0,0,21,0,21,Lombardia,ITC4
2021-01-15,PF/BT,30904,ASST VALTELLINA E ALTO LARIO PRESIDIO OSPEDALIERO DI SONDALO,LOM,60-69,4,6,0,8,2,0,0,10,0,10,Lombardia,ITC4
2021-01-15,PF/BT,30909,amb covid monza,LOM,16-19,2,11,1,12,1,0,0,13,0,13,Lombardia,ITC4
2021-01-15,PF/BT,30909,amb covid monza,LOM,20-29,84,156,1,226,10,0,4,240,0,240,Lombardia,ITC4
2021-01-15,PF/BT,30909,amb covid monza,LOM,30-39,41,80,1,96,17,0,8,121,0,121,Lombardia,ITC4
2021-01-15,PF/BT,30909,amb covid monza,LOM,40-49,40,76,1,81,17,0,18,116,0,116,Lombardia,ITC4
2021-01-15,PF/BT,30909,amb covid monza,LOM,50-59,53,94,1,87,39,0,21,147,0,147,Lombardia,ITC4
2021-01-15,PF/BT,30909,amb covid monza,LOM,60-69,21,34,1,35,17,0,3,55,0,55,Lombardia,ITC4
2021-01-15,PF/BT,30909,amb covid monza,LOM,70-79,4,4,1,4,3,0,1,8,0,8,Lombardia,ITC4
2021-01-15,PF/BT,30909,amb covid monza,LOM,80-89,2,0,1,0,0,0,2,2,0,2,Lombardia,ITC4
2021-01-15,PF/BT,30933,IRCCS CENTRO MEDICO DI CASTEL GOFFREDO,LOM,30-39,2,3,0,1,4,0,0,5,0,5,Lombardia,ITC4
2021-01-15,PF/BT,30933,IRCCS CENTRO MEDICO DI CASTEL GOFFREDO,LOM,40-49,1,6,0,1,6,0,0,7,0,7,Lombardia,ITC4
2021-01-15,PF/BT,30933,IRCCS CENTRO MEDICO DI CASTEL GOFFREDO,LOM,50-59,1,7,0,3,5,0,0,8,0,8,Lombardia,ITC4
2021-01-15,PF/BT,30933,IRCCS CENTRO MEDICO DI CASTEL GOFFREDO,LOM,60-69,2,1,0,2,1,0,0,3,0,3,Lombardia,ITC4
2021-01-15,PF/BT,3093400,0,LOM,20-29,10,20,0,19,11,0,0,30,0,30,Lombardia,ITC4
2021-01-15,PF/BT,3093400,0,LOM,30-39,23,38,0,48,10,0,3,61,0,61,Lombardia,ITC4
2021-01-15,PF/BT,3093400,0,LOM,40-49,8,34,0,30,12,0,0,42,0,42,Lombardia,ITC4
2021-01-15,PF/BT,3093400,0,LOM,50-59,8,21,0,19,10,0,0,29,0,29,Lombardia,ITC4
2021-01-15,PF/BT,3093400,0,LOM,60-69,2,2,0,2,1,0,1,4,0,4,Lombardia,ITC4
2021-01-15,PF/BT,30941,ISTITUTO EUROPEO DI ONCOLOGIA,LOM,20-29,30,48,0,58,20,0,0,78,0,78,Lombardia,ITC4
2021-01-15,PF/BT,30941,ISTITUTO EUROPEO DI ONCOLOGIA,LOM,30-39,33,42,0,49,26,0,0,75,0,75,Lombardia,ITC4
2021-01-15,PF/BT,30941,ISTITUTO EUROPEO DI ONCOLOGIA,LOM,40-49,9,55,0,21,42,0,1,64,0,64,Lombardia,ITC4
2021-01-15,PF/BT,30941,ISTITUTO EUROPEO DI ONCOLOGIA,LOM,50-59,11,32,0,8,34,0,1,43,0,43,Lombardia,ITC4
2021-01-15,PF/BT,30941,ISTITUTO EUROPEO DI ONCOLOGIA,LOM,60-69,1,3,0,1,3,0,0,4,0,4,Lombardia,ITC4
2021-01-15,PF/BT,30941,ISTITUTO EUROPEO DI ONCOLOGIA,LOM,70-79,1,1,0,0,0,0,2,2,0,2,Lombardia,ITC4
2021-01-15,PF/BT,30941,ISTITUTO EUROPEO DI ONCOLOGIA,LOM,90+,0,1,0,0,1,0,0,1,0,1,Lombardia,ITC4
2021-01-15,PF/BT,30946,ISTITUTO ORTOPEDICO GALEAZZI SPA,LOM,20-29,4,2,0,6,0,0,0,6,0,6,Lombardia,ITC4
2021-01-15,PF/BT,30946,ISTITUTO ORTOPEDICO GALEAZZI SPA,LOM,30-39,9,4,0,13,0,0,0,13,0,13,Lombardia,ITC4
2021-01-15,PF/BT,30946,ISTITUTO ORTOPEDICO GALEAZZI SPA,LOM,40-49,7,17,0,22,2,0,0,24,0,24,Lombardia,ITC4
2021-01-15,PF/BT,30946,ISTITUTO ORTOPEDICO GALEAZZI SPA,LOM,50-59,11,13,0,19,5,0,0,24,0,24,Lombardia,ITC4
2021-01-15,PF/BT,30946,ISTITUTO ORTOPEDICO GALEAZZI SPA,LOM,60-69,5,6,0,10,1,0,0,11,0,11,Lombardia,ITC4
2021-01-15,PF/BT,3094602,IST.CLINICO S.SIRO SPA-MILANO,LOM,20-29,1,0,0,1,0,0,0,1,0,1,Lombardia,ITC4
2021-01-15,PF/BT,3094602,IST.CLINICO S.SIRO SPA-MILANO,LOM,30-39,3,0,0,3,0,0,0,3,0,3,Lombardia,ITC4
2021-01-15,PF/BT,3094602,IST.CLINICO S.SIRO SPA-MILANO,LOM,40-49,1,6,0,7,0,0,0,7,0,7,Lombardia,ITC4
2021-01-15,PF/BT,3094602,IST.CLINICO S.SIRO SPA-MILANO,LOM,50-59,2,9,0,11,0,0,0,11,0,11,Lombardia,ITC4
2021-01-15,PF/BT,3094602,IST.CLINICO S.SIRO SPA-MILANO,LOM,60-69,3,4,0,7,0,0,0,7,0,7,Lombardia,ITC4
2021-01-15,PF/BT,314,RSA SAN GIORGIO,LOM,40-49,1,2,0,2,1,0,0,3,0,3,Lombardia,ITC4
2021-01-15,PF/BT,314,RSA SAN GIORGIO,LOM,50-59,2,3,0,3,2,0,0,5,0,5,Lombardia,ITC4
2021-01-15,PF/BT,314,RSA SAN GIORGIO,LOM,60-69,3,1,0,4,0,0,0,4,0,4,Lombardia,ITC4
2021-01-15,PF/BT,314,RSA SAN GIORGIO,LOM,70-79,2,0,0,0,0,2,0,2,0,2,Lombardia,ITC4
2021-01-15,PF/BT,314,RSA SAN GIORGIO,LOM,80-89,3,8,0,0,0,11,0,11,0,11,Lombardia,ITC4
2021-01-15,PF/BT,314,RSA SAN GIORGIO,LOM,90+,1,10,0,0,0,11,0,11,0,11,Lombardia,ITC4
2021-01-15,PF/BT,319700,CASA DI CURA VILLA ESPERIA,LOM,20-29,0,1,0,1,0,0,0,1,0,1,Lombardia,ITC4
2021-01-15,PF/BT,319700,CASA DI CURA VILLA ESPERIA,LOM,30-39,1,0,0,0,1,0,0,1,0,1,Lombardia,ITC4
2021-01-15,PF/BT,319700,CASA DI CURA VILLA ESPERIA,LOM,40-49,0,2,0,0,2,0,0,2,0,2,Lombardia,ITC4
2021-01-15,PF/BT,319700,CASA DI CURA VILLA ESPERIA,LOM,50-59,2,0,0,2,0,0,0,2,0,2,Lombardia,ITC4
2021-01-15,PF/BT,321,RSA S.MARIA AL CASTELLO FONDAZIONE DON CARLO GNOCCHI PESSANO CON BORNAGO,LOM,30-39,0,3,0,3,0,0,0,3,0,3,Lombardia,ITC4
2021-01-15,PF/BT,321,RSA S.MARIA AL CASTELLO FONDAZIONE DON CARLO GNOCCHI PESSANO CON BORNAGO,LOM,40-49,4,1,0,5,0,0,0,5,0,5,Lombardia,ITC4
2021-01-15,PF/BT,321,RSA S.MARIA AL CASTELLO FONDAZIONE DON CARLO GNOCCHI PESSANO CON BORNAGO,LOM,50-59,0,4,0,4,0,0,0,4,0,4,Lombardia,ITC4
2021-01-15,PF/BT,321000247,RSA GIOVANNI PAOLO II,LOM,20-29,0,2,0,1,1,0,0,2,0,2,Lombardia,ITC4
2021-01-15,PF/BT,321000247,RSA GIOVANNI PAOLO II,LOM,30-39,0,5,0,4,1,0,0,5,0,5,Lombardia,ITC4
2021-01-15,PF/BT,321000247,RSA GIOVANNI PAOLO II,LOM,40-49,0,7,0,6,1,0,0,7,0,7,Lombardia,ITC4
2021-01-15,PF/BT,321000247,RSA GIOVANNI PAOLO II,LOM,50-59,2,6,0,6,2,0,0,8,0,8,Lombardia,ITC4
2021-01-15,PF/BT,321000247,RSA GIOVANNI PAOLO II,LOM,70-79,2,4,0,0,0,6,0,6,0,6,Lombardia,ITC4
2021-01-15,PF/BT,321000247,RSA GIOVANNI PAOLO II,LOM,80-89,6,19,0,0,0,25,0,25,0,25,Lombardia,ITC4
2021-01-15,PF/BT,321000247,RSA GIOVANNI PAOLO II,LOM,90+,1,20,0,0,0,21,0,21,0,21,Lombardia,ITC4
2021-01-15,PF/BT,321000286,RSA SANTA LUCIA - MILANO,LOM,30-39,1,2,0,3,0,0,0,3,0,3,Lombardia,ITC4
2021-01-15,PF/BT,321000286,RSA SANTA LUCIA - MILANO,LOM,40-49,0,2,0,2,0,0,0,2,0,2,Lombardia,ITC4
2021-01-15,PF/BT,321000286,RSA SANTA LUCIA - MILANO,LOM,50-59,1,2,0,3,0,0,0,3,0,3,Lombardia,ITC4
2021-01-15,PF/BT,321000286,RSA SANTA LUCIA - MILANO,LOM,80-89,0,1,0,0,0,1,0,1,0,1,Lombardia,ITC4
2021-01-15,PF/BT,321000318,RSA IL NAVIGLIO,LOM,20-29,1,1,0,2,0,0,0,2,0,2,Lombardia,ITC4
2021-01-15,PF/BT,321000318,RSA IL NAVIGLIO,LOM,30-39,0,2,0,2,0,0,0,2,0,2,Lombardia,ITC4
2021-01-15,PF/BT,321000318,RSA IL NAVIGLIO,LOM,40-49,4,1,0,5,0,0,0,5,0,5,Lombardia,ITC4
2021-01-15,PF/BT,321000318,RSA IL NAVIGLIO,LOM,50-59,1,5,0,6,0,0,0,6,0,6,Lombardia,ITC4
2021-01-15,PF/BT,321000318,RSA IL NAVIGLIO,LOM,60-69,0,1,0,1,0,0,0,1,0,1,Lombardia,ITC4
2021-01-15,PF/BT,321000354 e 321000584,PUNTO VACCINALE RSA CASA PER CONIUGI,LOM,30-39,0,1,0,1,0,0,0,1,0,1,Lombardia,ITC4
2021-01-15,PF/BT,321000354 e 321000584,PUNTO VACCINALE RSA CASA PER CONIUGI,LOM,40-49,2,1,0,3,0,0,0,3,0,3,Lombardia,ITC4
2021-01-15,PF/BT,321000354 e 321000584,PUNTO VACCINALE RSA CASA PER CONIUGI,LOM,50-59,0,2,0,2,0,0,0,2,0,2,Lombardia,ITC4
2021-01-15,PF/BT,321000354 e 321000584,PUNTO VACCINALE RSA CASA PER CONIUGI,LOM,60-69,1,1,0,2,0,0,0,2,0,2,Lombardia,ITC4
2021-01-15,PF/BT,321000354 e 321000584,PUNTO VACCINALE RSA CASA PER CONIUGI,LOM,70-79,2,1,0,0,0,3,0,3,0,3,Lombardia,ITC4
2021-01-15,PF/BT,321000354 e 321000584,PUNTO VACCINALE RSA CASA PER CONIUGI,LOM,80-89,2,4,0,0,0,6,0,6,0,6,Lombardia,ITC4
2021-01-15,PF/BT,321000354 e 321000584,PUNTO VACCINALE RSA CASA PER CONIUGI,LOM,90+,2,5,0,0,0,7,0,7,0,7,Lombardia,ITC4
2021-01-15,PF/BT,321000373,rsa parco delle cave e baggio,LOM,20-29,4,4,0,7,1,0,0,8,0,8,Lombardia,ITC4
2021-01-15,PF/BT,321000373,rsa parco delle cave e baggio,LOM,30-39,4,4,0,3,5,0,0,8,0,8,Lombardia,ITC4
2021-01-15,PF/BT,321000373,rsa parco delle cave e baggio,LOM,40-49,2,15,0,10,7,0,0,17,0,17,Lombardia,ITC4
2021-01-15,PF/BT,321000373,rsa parco delle cave e baggio,LOM,50-59,0,7,0,3,4,0,0,7,0,7,Lombardia,ITC4
2021-01-15,PF/BT,321000373,rsa parco delle cave e baggio,LOM,60-69,0,2,0,2,0,0,0,2,0,2,Lombardia,ITC4
2021-01-15,PF/BT,321000532 - 321000533,RSA SACCARDO A e B,LOM,20-29,0,2,0,1,1,0,0,2,0,2,Lombardia,ITC4
2021-01-15,PF/BT,321000532 - 321000533,RSA SACCARDO A e B,LOM,30-39,3,6,0,7,2,0,0,9,0,9,Lombardia,ITC4
2021-01-15,PF/BT,321000532 - 321000533,RSA SACCARDO A e B,LOM,40-49,7,7,0,9,5,0,0,14,0,14,Lombardia,ITC4
2021-01-15,PF/BT,321000532 - 321000533,RSA SACCARDO A e B,LOM,50-59,4,12,0,10,6,0,0,16,0,16,Lombardia,ITC4
2021-01-15,PF/BT,321000532 - 321000533,RSA SACCARDO A e B,LOM,60-69,0,3,0,1,2,0,0,3,0,3,Lombardia,ITC4
2021-01-15,PF/BT,321000532 - 321000533,RSA SACCARDO A e B,LOM,70-79,2,2,0,0,0,4,0,4,0,4,Lombardia,ITC4
2021-01-15,PF/BT,321000532 - 321000533,RSA SACCARDO A e B,LOM,80-89,2,6,0,0,0,8,0,8,0,8,Lombardia,ITC4
2021-01-15,PF/BT,321000532 - 321000533,RSA SACCARDO A e B,LOM,90+,2,8,0,0,0,10,0,10,0,10,Lombardia,ITC4
2021-01-15,PF/BT,32170712,ambulatorio covid SESTO SAN GIOVANNI,LOM,16-19,2,4,0,6,0,0,0,6,0,6,Lombardia,ITC4
2021-01-15,PF/BT,32170712,ambulatorio covid SESTO SAN GIOVANNI,LOM,20-29,13,26,0,31,8,0,0,39,0,39,Lombardia,ITC4
2021-01-15,PF/BT,32170712,ambulatorio covid SESTO SAN GIOVANNI,LOM,30-39,18,25,0,32,11,0,0,43,0,43,Lombardia,ITC4
2021-01-15,PF/BT,32170712,ambulatorio covid SESTO SAN GIOVANNI,LOM,40-49,23,53,0,41,35,0,0,76,0,76,Lombardia,ITC4
2021-01-15,PF/BT,32170712,ambulatorio covid SESTO SAN GIOVANNI,LOM,50-59,35,53,0,39,49,0,0,88,0,88,Lombardia,ITC4
2021-01-15,PF/BT,32170712,ambulatorio covid SESTO SAN GIOVANNI,LOM,60-69,20,28,0,25,23,0,0,48,0,48,Lombardia,ITC4
2021-01-15,PF/BT,32170712,ambulatorio covid SESTO SAN GIOVANNI,LOM,70-79,5,17,0,7,15,0,0,22,0,22,Lombardia,ITC4
2021-01-15,PF/BT,32170712,ambulatorio covid SESTO SAN GIOVANNI,LOM,80-89,0,1,0,1,0,0,0,1,0,1,Lombardia,ITC4
2021-01-15,PF/BT,322000722,RSA  - CASA CARDINAL G. LERCARO - BODIO LOMNAGO (VA),LOM,30-39,0,3,0,3,0,0,0,3,0,3,Lombardia,ITC4
2021-01-15,PF/BT,322000722,RSA  - CASA CARDINAL G. LERCARO - BODIO LOMNAGO (VA),LOM,40-49,0,3,0,3,0,0,0,3,0,3,Lombardia,ITC4
2021-01-15,PF/BT,322000722,RSA  - CASA CARDINAL G. LERCARO - BODIO LOMNAGO (VA),LOM,50-59,2,3,0,3,2,0,0,5,0,5,Lombardia,ITC4
2021-01-15,PF/BT,322000722,RSA  - CASA CARDINAL G. LERCARO - BODIO LOMNAGO (VA),LOM,80-89,1,0,0,0,0,1,0,1,0,1,Lombardia,ITC4
2021-01-15,PF/BT,322000728,RSA CAMELOT,LOM,20-29,1,2,0,2,1,0,0,3,0,3,Lombardia,ITC4
2021-01-15,PF/BT,322000728,RSA CAMELOT,LOM,30-39,0,1,0,0,1,0,0,1,0,1,Lombardia,ITC4
2021-01-15,PF/BT,322000728,RSA CAMELOT,LOM,40-49,0,9,0,8,1,0,0,9,0,9,Lombardia,ITC4
2021-01-15,PF/BT,322000728,RSA CAMELOT,LOM,50-59,0,4,0,3,1,0,0,4,0,4,Lombardia,ITC4
2021-01-15,PF/BT,322000728,RSA CAMELOT,LOM,70-79,1,0,0,0,0,1,0,1,0,1,Lombardia,ITC4
2021-01-15,PF/BT,322000797,RSA CENTRO ACCOGLIENZA ANZIANI ONLUS,LOM,20-29,2,2,0,3,1,0,0,4,0,4,Lombardia,ITC4
2021-01-15,PF/BT,322000797,RSA CENTRO ACCOGLIENZA ANZIANI ONLUS,LOM,30-39,0,2,0,2,0,0,0,2,0,2,Lombardia,ITC4
2021-01-15,PF/BT,322000797,RSA CENTRO ACCOGLIENZA ANZIANI ONLUS,LOM,40-49,1,10,0,8,3,0,0,11,0,11,Lombardia,ITC4
2021-01-15,PF/BT,322000797,RSA CENTRO ACCOGLIENZA ANZIANI ONLUS,LOM,50-59,0,10,0,7,3,0,0,10,0,10,Lombardia,ITC4
2021-01-15,PF/BT,322000797,RSA CENTRO ACCOGLIENZA ANZIANI ONLUS,LOM,60-69,1,2,0,3,0,0,0,3,0,3,Lombardia,ITC4
2021-01-15,PF/BT,322000797,RSA CENTRO ACCOGLIENZA ANZIANI ONLUS,LOM,70-79,0,2,0,0,0,2,0,2,0,2,Lombardia,ITC4
2021-01-15,PF/BT,322000797,RSA CENTRO ACCOGLIENZA ANZIANI ONLUS,LOM,80-89,2,2,0,0,0,4,0,4,0,4,Lombardia,ITC4
2021-01-15,PF/BT,322000844 - 322000712,Istituto La Provvidenza - UG1 /UG3,LOM,30-39,1,0,0,1,0,0,0,1,0,1,Lombardia,ITC4
2021-01-15,PF/BT,322000844 - 322000712,Istituto La Provvidenza - UG1 /UG3,LOM,40-49,1,0,0,0,0,0,1,1,0,1,Lombardia,ITC4
2021-01-15,PF/BT,322000844 - 322000712,Istituto La Provvidenza - UG1 /UG3,LOM,50-59,0,4,0,0,0,4,0,4,0,4,Lombardia,ITC4
2021-01-15,PF/BT,322000844 - 322000712,Istituto La Provvidenza - UG1 /UG3,LOM,60-69,1,4,0,0,0,5,0,5,0,5,Lombardia,ITC4
2021-01-15,PF/BT,322000844 - 322000712,Istituto La Provvidenza - UG1 /UG3,LOM,70-79,14,22,0,0,0,36,0,36,0,36,Lombardia,ITC4
2021-01-15,PF/BT,322000844 - 322000712,Istituto La Provvidenza - UG1 /UG3,LOM,80-89,19,90,0,0,0,109,0,109,0,109,Lombardia,ITC4
2021-01-15,PF/BT,322000844 - 322000712,Istituto La Provvidenza - UG1 /UG3,LOM,90+,9,81,0,0,0,90,0,90,0,90,Lombardia,ITC4
2021-01-15,PF/BT,322000902,RSA IL MELO,LOM,20-29,0,3,0,3,0,0,0,3,0,3,Lombardia,ITC4
2021-01-15,PF/BT,322000902,RSA IL MELO,LOM,30-39,1,6,0,5,2,0,0,7,0,7,Lombardia,ITC4
2021-01-15,PF/BT,322000902,RSA IL MELO,LOM,40-49,2,7,0,6,3,0,0,9,0,9,Lombardia,ITC4
2021-01-15,PF/BT,322000902,RSA IL MELO,LOM,50-59,2,6,0,6,2,0,0,8,0,8,Lombardia,ITC4
2021-01-15,PF/BT,322000902,RSA IL MELO,LOM,60-69,1,0,0,0,0,1,0,1,0,1,Lombardia,ITC4
2021-01-15,PF/BT,322000902,RSA IL MELO,LOM,70-79,1,2,0,0,0,3,0,3,0,3,Lombardia,ITC4
2021-01-15,PF/BT,322000902,RSA IL MELO,LOM,80-89,4,10,0,0,0,14,0,14,0,14,Lombardia,ITC4
2021-01-15,PF/BT,322000902,RSA IL MELO,LOM,90+,3,6,0,0,0,9,0,9,0,9,Lombardia,ITC4
2021-01-15,PF/BT,322002746,FONDAZIONE RSA GARIBALDI POGLIANI - CAPIAGO INTIMIANO,LOM,40-49,1,3,0,3,1,0,0,4,0,4,Lombardia,ITC4
2021-01-15,PF/BT,322002746,FONDAZIONE RSA GARIBALDI POGLIANI - CAPIAGO INTIMIANO,LOM,50-59,1,6,0,5,1,0,1,7,0,7,Lombardia,ITC4
2021-01-15,PF/BT,322002746,FONDAZIONE RSA GARIBALDI POGLIANI - CAPIAGO INTIMIANO,LOM,60-69,1,1,0,1,0,1,0,2,0,2,Lombardia,ITC4
2021-01-15,PF/BT,322002746,FONDAZIONE RSA GARIBALDI POGLIANI - CAPIAGO INTIMIANO,LOM,70-79,0,2,0,0,0,2,0,2,0,2,Lombardia,ITC4
2021-01-15,PF/BT,322002746,FONDAZIONE RSA GARIBALDI POGLIANI - CAPIAGO INTIMIANO,LOM,80-89,1,6,0,0,0,7,0,7,0,7,Lombardia,ITC4
2021-01-15,PF/BT,322002746,FONDAZIONE RSA GARIBALDI POGLIANI - CAPIAGO INTIMIANO,LOM,90+,0,2,0,0,0,2,0,2,0,2,Lombardia,ITC4
2021-01-15,PF/BT,32271028,AMBULATORIO COVID OSPEDALE CIRCOLO,LOM,16-19,1,6,0,7,0,0,0,7,0,7,Lombardia,ITC4
2021-01-15,PF/BT,32271028,AMBULATORIO COVID OSPEDALE CIRCOLO,LOM,20-29,35,43,0,78,0,0,0,78,0,78,Lombardia,ITC4
2021-01-15,PF/BT,32271028,AMBULATORIO COVID OSPEDALE CIRCOLO,LOM,30-39,30,52,0,82,0,0,0,82,0,82,Lombardia,ITC4
2021-01-15,PF/BT,32271028,AMBULATORIO COVID OSPEDALE CIRCOLO,LOM,40-49,41,69,0,110,0,0,0,110,0,110,Lombardia,ITC4
2021-01-15,PF/BT,32271028,AMBULATORIO COVID OSPEDALE CIRCOLO,LOM,50-59,35,63,0,98,0,0,0,98,0,98,Lombardia,ITC4
2021-01-15,PF/BT,32271028,AMBULATORIO COVID OSPEDALE CIRCOLO,LOM,60-69,30,20,0,50,0,0,0,50,0,50,Lombardia,ITC4
2021-01-15,PF/BT,32271028,AMBULATORIO COVID OSPEDALE CIRCOLO,LOM,70-79,11,1,0,12,0,0,0,12,0,12,Lombardia,ITC4
2021-01-15,PF/BT,32271028,AMBULATORIO COVID OSPEDALE CIRCOLO,LOM,80-89,1,0,0,1,0,0,0,1,0,1,Lombardia,ITC4
2021-01-15,PF/BT,32271116,ambulatorio covid Gallarate,LOM,16-19,1,2,0,3,0,0,0,3,0,3,Lombardia,ITC4
2021-01-15,PF/BT,32271116,ambulatorio covid Gallarate,LOM,20-29,5,15,0,20,0,0,0,20,0,20,Lombardia,ITC4
2021-01-15,PF/BT,32271116,ambulatorio covid Gallarate,LOM,30-39,4,4,0,8,0,0,0,8,0,8,Lombardia,ITC4
2021-01-15,PF/BT,32271116,ambulatorio covid Gallarate,LOM,40-49,10,20,0,30,0,0,0,30,0,30,Lombardia,ITC4
2021-01-15,PF/BT,32271116,ambulatorio covid Gallarate,LOM,50-59,10,20,0,30,0,0,0,30,0,30,Lombardia,ITC4
2021-01-15,PF/BT,32271116,ambulatorio covid Gallarate,LOM,60-69,6,14,0,20,0,0,0,20,0,20,Lombardia,ITC4
2021-01-15,PF/BT,32271116,ambulatorio covid Gallarate,LOM,70-79,1,2,0,3,0,0,0,3,0,3,Lombardia,ITC4
2021-01-15,PF/BT,32271117,ambulatorio covid Saronno,LOM,20-29,4,13,0,17,0,0,0,17,0,17,Lombardia,ITC4
2021-01-15,PF/BT,32271117,ambulatorio covid Saronno,LOM,30-39,7,8,0,15,0,0,0,15,0,15,Lombardia,ITC4
2021-01-15,PF/BT,32271117,ambulatorio covid Saronno,LOM,40-49,7,21,0,28,0,0,0,28,0,28,Lombardia,ITC4
2021-01-15,PF/BT,32271117,ambulatorio covid Saronno,LOM,50-59,12,26,0,38,0,0,0,38,0,38,Lombardia,ITC4
2021-01-15,PF/BT,32271117,ambulatorio covid Saronno,LOM,60-69,12,14,0,26,0,0,0,26,0,26,Lombardia,ITC4
2021-01-15,PF/BT,32271117,ambulatorio covid Saronno,LOM,70-79,2,0,0,2,0,0,0,2,0,2,Lombardia,ITC4
2021-01-15,PF/BT,32271118,Ambulatorio Covid Busto Arsizio,LOM,20-29,7,23,0,30,0,0,0,30,0,30,Lombardia,ITC4
2021-01-15,PF/BT,32271118,Ambulatorio Covid Busto Arsizio,LOM,30-39,10,12,0,22,0,0,0,22,0,22,Lombardia,ITC4
2021-01-15,PF/BT,32271118,Ambulatorio Covid Busto Arsizio,LOM,40-49,20,32,0,52,0,0,0,52,0,52,Lombardia,ITC4
2021-01-15,PF/BT,32271118,Ambulatorio Covid Busto Arsizio,LOM,50-59,28,42,0,70,0,0,0,70,0,70,Lombardia,ITC4
2021-01-15,PF/BT,32271118,Ambulatorio Covid Busto Arsizio,LOM,60-69,10,14,0,24,0,0,0,24,0,24,Lombardia,ITC4
2021-01-15,PF/BT,323000904,RSA VILLA MONS.D.ZANI BIENNO (BS),LOM,20-29,1,0,0,0,1,0,0,1,0,1,Lombardia,ITC4
2021-01-15,PF/BT,323000904,RSA VILLA MONS.D.ZANI BIENNO (BS),LOM,30-39,0,2,0,2,0,0,0,2,0,2,Lombardia,ITC4
2021-01-15,PF/BT,323000904,RSA VILLA MONS.D.ZANI BIENNO (BS),LOM,40-49,0,7,0,5,2,0,0,7,0,7,Lombardia,ITC4
2021-01-15,PF/BT,323000904,RSA VILLA MONS.D.ZANI BIENNO (BS),LOM,50-59,0,4,0,2,2,0,0,4,0,4,Lombardia,ITC4
2021-01-15,PF/BT,323000904,RSA VILLA MONS.D.ZANI BIENNO (BS),LOM,70-79,1,0,0,0,0,1,0,1,0,1,Lombardia,ITC4
2021-01-15,PF/BT,323000904,RSA VILLA MONS.D.ZANI BIENNO (BS),LOM,80-89,0,4,0,0,0,4,0,4,0,4,Lombardia,ITC4
2021-01-15,PF/BT,323000904,RSA VILLA MONS.D.ZANI BIENNO (BS),LOM,90+,0,5,0,0,0,5,0,5,0,5,Lombardia,ITC4
2021-01-15,PF/BT,323000937,RSA SAN BENIGNO,LOM,40-49,1,8,0,6,2,0,1,9,0,9,Lombardia,ITC4
2021-01-15,PF/BT,323000937,RSA SAN BENIGNO,LOM,50-59,0,6,0,6,0,0,0,6,0,6,Lombardia,ITC4
2021-01-15,PF/BT,323000937,RSA SAN BENIGNO,LOM,60-69,0,1,0,0,0,1,0,1,0,1,Lombardia,ITC4
2021-01-15,PF/BT,323000937,RSA SAN BENIGNO,LOM,70-79,0,2,0,0,0,2,0,2,0,2,Lombardia,ITC4
2021-01-15,PF/BT,323000937,RSA SAN BENIGNO,LOM,80-89,2,6,0,0,0,8,0,8,0,8,Lombardia,ITC4
2021-01-15,PF/BT,323000937,RSA SAN BENIGNO,LOM,90+,1,9,0,0,0,10,0,10,0,10,Lombardia,ITC4
2021-01-15,PF/BT,323000952,RSA TOMASO AMBROSETTI - MORBEGNO (SO),LOM,20-29,0,1,0,1,0,0,0,1,0,1,Lombardia,ITC4
2021-01-15,PF/BT,323000952,RSA TOMASO AMBROSETTI - MORBEGNO (SO),LOM,30-39,0,3,0,3,0,0,0,3,0,3,Lombardia,ITC4
2021-01-15,PF/BT,323000952,RSA TOMASO AMBROSETTI - MORBEGNO (SO),LOM,50-59,1,5,0,4,0,2,0,6,0,6,Lombardia,ITC4
2021-01-15,PF/BT,323000952,RSA TOMASO AMBROSETTI - MORBEGNO (SO),LOM,60-69,0,4,0,2,1,1,0,4,0,4,Lombardia,ITC4
2021-01-15,PF/BT,323000952,RSA TOMASO AMBROSETTI - MORBEGNO (SO),LOM,70-79,0,1,0,0,0,1,0,1,0,1,Lombardia,ITC4
2021-01-15,PF/BT,323000952,RSA TOMASO AMBROSETTI - MORBEGNO (SO),LOM,80-89,0,2,0,0,0,2,0,2,0,2,Lombardia,ITC4
2021-01-15,PF/BT,323000952,RSA TOMASO AMBROSETTI - MORBEGNO (SO),LOM,90+,0,1,0,0,0,1,0,1,0,1,Lombardia,ITC4
2021-01-15,PF/BT,323000962,FONDAZIONE CASA DI RIPOSO S.ORSOLA ONLUS,LOM,20-29,0,5,0,5,0,0,0,5,0,5,Lombardia,ITC4
2021-01-15,PF/BT,323000962,FONDAZIONE CASA DI RIPOSO S.ORSOLA ONLUS,LOM,30-39,0,1,0,1,0,0,0,1,0,1,Lombardia,ITC4
2021-01-15,PF/BT,323000962,FONDAZIONE CASA DI RIPOSO S.ORSOLA ONLUS,LOM,40-49,0,4,0,3,1,0,0,4,0,4,Lombardia,ITC4
2021-01-15,PF/BT,323000962,FONDAZIONE CASA DI RIPOSO S.ORSOLA ONLUS,LOM,50-59,0,8,0,7,1,0,0,8,0,8,Lombardia,ITC4
2021-01-15,PF/BT,323000962,FONDAZIONE CASA DI RIPOSO S.ORSOLA ONLUS,LOM,60-69,1,0,0,0,0,1,0,1,0,1,Lombardia,ITC4
2021-01-15,PF/BT,323000962,FONDAZIONE CASA DI RIPOSO S.ORSOLA ONLUS,LOM,70-79,1,1,0,1,0,1,0,2,0,2,Lombardia,ITC4
2021-01-15,PF/BT,323000962,FONDAZIONE CASA DI RIPOSO S.ORSOLA ONLUS,LOM,80-89,1,9,0,0,0,10,0,10,0,10,Lombardia,ITC4
2021-01-15,PF/BT,323000962,FONDAZIONE CASA DI RIPOSO S.ORSOLA ONLUS,LOM,90+,0,5,0,0,0,5,0,5,0,5,Lombardia,ITC4
2021-01-15,PF/BT,323008561,RSA PAOLO PARAVICINI- MORBEGNO (SO),LOM,20-29,0,3,0,2,1,0,0,3,0,3,Lombardia,ITC4
2021-01-15,PF/BT,323008561,RSA PAOLO PARAVICINI- MORBEGNO (SO),LOM,30-39,1,5,0,5,1,0,0,6,0,6,Lombardia,ITC4
2021-01-15,PF/BT,323008561,RSA PAOLO PARAVICINI- MORBEGNO (SO),LOM,40-49,2,2,0,4,0,0,0,4,0,4,Lombardia,ITC4
2021-01-15,PF/BT,323008561,RSA PAOLO PARAVICINI- MORBEGNO (SO),LOM,50-59,0,18,0,14,3,1,0,18,0,18,Lombardia,ITC4
2021-01-15,PF/BT,323008561,RSA PAOLO PARAVICINI- MORBEGNO (SO),LOM,60-69,1,2,0,1,0,2,0,3,0,3,Lombardia,ITC4
2021-01-15,PF/BT,323008561,RSA PAOLO PARAVICINI- MORBEGNO (SO),LOM,70-79,3,2,0,0,0,5,0,5,0,5,Lombardia,ITC4
2021-01-15,PF/BT,323008561,RSA PAOLO PARAVICINI- MORBEGNO (SO),LOM,80-89,1,6,0,0,0,7,0,7,0,7,Lombardia,ITC4
2021-01-15,PF/BT,323008561,RSA PAOLO PARAVICINI- MORBEGNO (SO),LOM,90+,0,2,0,0,0,2,0,2,0,2,Lombardia,ITC4
2021-01-15,PF/BT,325001329,"FONDAZIONE PICCINELLI ""ONLUS""",LOM,20-29,2,1,0,3,0,0,0,3,0,3,Lombardia,ITC4
2021-01-15,PF/BT,325001329,"FONDAZIONE PICCINELLI ""ONLUS""",LOM,30-39,5,9,0,10,4,0,0,14,0,14,Lombardia,ITC4
2021-01-15,PF/BT,325001329,"FONDAZIONE PICCINELLI ""ONLUS""",LOM,40-49,4,10,0,7,7,0,0,14,0,14,Lombardia,ITC4
2021-01-15,PF/BT,325001329,"FONDAZIONE PICCINELLI ""ONLUS""",LOM,50-59,2,16,0,4,14,0,0,18,0,18,Lombardia,ITC4
2021-01-15,PF/BT,325001329,"FONDAZIONE PICCINELLI ""ONLUS""",LOM,60-69,1,5,0,1,4,1,0,6,0,6,Lombardia,ITC4
2021-01-15,PF/BT,325001329,"FONDAZIONE PICCINELLI ""ONLUS""",LOM,70-79,1,3,0,0,0,4,0,4,0,4,Lombardia,ITC4
2021-01-15,PF/BT,325001329,"FONDAZIONE PICCINELLI ""ONLUS""",LOM,80-89,4,27,0,0,0,31,0,31,0,31,Lombardia,ITC4
2021-01-15,PF/BT,325001329,"FONDAZIONE PICCINELLI ""ONLUS""",LOM,90+,4,20,0,0,0,24,0,24,0,24,Lombardia,ITC4
2021-01-15,PF/BT,325001342,CLINICHE GAVAZZENI SPA,LOM,20-29,6,11,0,17,0,0,0,17,0,17,Lombardia,ITC4
2021-01-15,PF/BT,325001342,CLINICHE GAVAZZENI SPA,LOM,30-39,11,7,0,18,0,0,0,18,0,18,Lombardia,ITC4
2021-01-15,PF/BT,325001342,CLINICHE GAVAZZENI SPA,LOM,40-49,4,18,0,22,0,0,0,22,0,22,Lombardia,ITC4
2021-01-15,PF/BT,325001342,CLINICHE GAVAZZENI SPA,LOM,50-59,6,11,0,17,0,0,0,17,0,17,Lombardia,ITC4
2021-01-15,PF/BT,325001342,CLINICHE GAVAZZENI SPA,LOM,60-69,1,2,0,3,0,0,0,3,0,3,Lombardia,ITC4
2021-01-15,PF/BT,325001342,CLINICHE GAVAZZENI SPA,LOM,70-79,1,0,0,1,0,0,0,1,0,1,Lombardia,ITC4
2021-01-15,PF/BT,32503014600,CASA DI CURA SAN FRANCESCO - BERGAMO,LOM,20-29,1,0,0,1,0,0,0,1,0,1,Lombardia,ITC4
2021-01-15,PF/BT,32503014600,CASA DI CURA SAN FRANCESCO - BERGAMO,LOM,30-39,0,6,0,6,0,0,0,6,0,6,Lombardia,ITC4
2021-01-15,PF/BT,32503014600,CASA DI CURA SAN FRANCESCO - BERGAMO,LOM,40-49,1,6,0,7,0,0,0,7,0,7,Lombardia,ITC4
2021-01-15,PF/BT,32503014600,CASA DI CURA SAN FRANCESCO - BERGAMO,LOM,50-59,2,4,0,6,0,0,0,6,0,6,Lombardia,ITC4
2021-01-15,PF/BT,32503014600,CASA DI CURA SAN FRANCESCO - BERGAMO,LOM,60-69,2,2,0,4,0,0,0,4,0,4,Lombardia,ITC4
2021-01-15,PF/BT,32572021,Ambulatorio COVID PO Alzano Lombardo,LOM,20-29,2,5,0,7,0,0,0,7,0,7,Lombardia,ITC4
2021-01-15,PF/BT,32572021,Ambulatorio COVID PO Alzano Lombardo,LOM,30-39,1,4,0,5,0,0,0,5,0,5,Lombardia,ITC4
2021-01-15,PF/BT,32572021,Ambulatorio COVID PO Alzano Lombardo,LOM,40-49,3,7,0,9,0,0,1,10,0,10,Lombardia,ITC4
2021-01-15,PF/BT,32572021,Ambulatorio COVID PO Alzano Lombardo,LOM,50-59,10,16,0,25,0,0,1,26,0,26,Lombardia,ITC4
2021-01-15,PF/BT,32572021,Ambulatorio COVID PO Alzano Lombardo,LOM,60-69,4,5,0,8,0,0,1,9,0,9,Lombardia,ITC4
2021-01-15,PF/BT,32572021,Ambulatorio COVID PO Alzano Lombardo,LOM,70-79,3,0,0,3,0,0,0,3,0,3,Lombardia,ITC4
2021-01-15,PF/BT,32572026,AMBULATORIO COVID PIARIO,LOM,20-29,0,3,0,3,0,0,0,3,0,3,Lombardia,ITC4
2021-01-15,PF/BT,32572026,AMBULATORIO COVID PIARIO,LOM,30-39,0,4,0,4,0,0,0,4,0,4,Lombardia,ITC4
2021-01-15,PF/BT,32572026,AMBULATORIO COVID PIARIO,LOM,40-49,4,6,0,10,0,0,0,10,0,10,Lombardia,ITC4
2021-01-15,PF/BT,32572026,AMBULATORIO COVID PIARIO,LOM,50-59,1,10,0,11,0,0,0,11,0,11,Lombardia,ITC4
2021-01-15,PF/BT,32572026,AMBULATORIO COVID PIARIO,LOM,60-69,0,2,0,2,0,0,0,2,0,2,Lombardia,ITC4
2021-01-15,PF/BT,326001641,"RSA VIA GAMBARA, 20 ORZINUOVI",LOM,20-29,1,1,0,2,0,0,0,2,0,2,Lombardia,ITC4
2021-01-15,PF/BT,326001641,"RSA VIA GAMBARA, 20 ORZINUOVI",LOM,30-39,2,5,0,6,1,0,0,7,0,7,Lombardia,ITC4
2021-01-15,PF/BT,326001641,"RSA VIA GAMBARA, 20 ORZINUOVI",LOM,40-49,1,6,0,7,0,0,0,7,0,7,Lombardia,ITC4
2021-01-15,PF/BT,326001641,"RSA VIA GAMBARA, 20 ORZINUOVI",LOM,50-59,0,12,0,10,2,0,0,12,0,12,Lombardia,ITC4
2021-01-15,PF/BT,326001641,"RSA VIA GAMBARA, 20 ORZINUOVI",LOM,60-69,0,2,0,2,0,0,0,2,0,2,Lombardia,ITC4
2021-01-15,PF/BT,327001818,R.S.A. VILLA MADDALENA,LOM,40-49,0,2,0,1,1,0,0,2,0,2,Lombardia,ITC4
2021-01-15,PF/BT,327001818,R.S.A. VILLA MADDALENA,LOM,50-59,0,1,0,0,1,0,0,1,0,1,Lombardia,ITC4
2021-01-15,PF/BT,327001818,R.S.A. VILLA MADDALENA,LOM,80-89,2,0,0,0,0,2,0,2,0,2,Lombardia,ITC4
2021-01-15,PF/BT,327001818,R.S.A. VILLA MADDALENA,LOM,90+,0,1,0,0,0,1,0,1,0,1,Lombardia,ITC4
2021-01-15,PF/BT,327001875,RSA Fondazione Pietro Sissa,LOM,30-39,1,0,0,0,1,0,0,1,0,1,Lombardia,ITC4
2021-01-15,PF/BT,327001875,RSA Fondazione Pietro Sissa,LOM,50-59,2,0,0,0,2,0,0,2,0,2,Lombardia,ITC4
2021-01-15,PF/BT,327001875,RSA Fondazione Pietro Sissa,LOM,70-79,0,1,0,0,0,1,0,1,0,1,Lombardia,ITC4
2021-01-15,PF/BT,327001875,RSA Fondazione Pietro Sissa,LOM,80-89,0,1,0,0,0,1,0,1,0,1,Lombardia,ITC4
2021-01-15,PF/BT,327001875,RSA Fondazione Pietro Sissa,LOM,90+,0,1,0,0,0,1,0,1,0,1,Lombardia,ITC4
2021-01-15,PF/BT,327001941,CASA DI RIPOSO GIOVANNI E LUCIANA ARVEDI,LOM,20-29,1,3,0,4,0,0,0,4,0,4,Lombardia,ITC4
2021-01-15,PF/BT,327001941,CASA DI RIPOSO GIOVANNI E LUCIANA ARVEDI,LOM,30-39,1,3,0,3,1,0,0,4,0,4,Lombardia,ITC4
2021-01-15,PF/BT,327001941,CASA DI RIPOSO GIOVANNI E LUCIANA ARVEDI,LOM,40-49,1,12,0,9,4,0,0,13,0,13,Lombardia,ITC4
2021-01-15,PF/BT,327001941,CASA DI RIPOSO GIOVANNI E LUCIANA ARVEDI,LOM,50-59,1,6,0,4,3,0,0,7,0,7,Lombardia,ITC4
2021-01-15,PF/BT,327001941,CASA DI RIPOSO GIOVANNI E LUCIANA ARVEDI,LOM,60-69,0,6,0,3,3,0,0,6,0,6,Lombardia,ITC4
2021-01-15,PF/BT,327001941,CASA DI RIPOSO GIOVANNI E LUCIANA ARVEDI,LOM,70-79,1,2,0,0,1,2,0,3,0,3,Lombardia,ITC4
2021-01-15,PF/BT,327001941,CASA DI RIPOSO GIOVANNI E LUCIANA ARVEDI,LOM,80-89,1,2,0,0,1,2,0,3,0,3,Lombardia,ITC4
2021-01-15,PF/BT,327001941,CASA DI RIPOSO GIOVANNI E LUCIANA ARVEDI,LOM,90+,2,6,0,0,0,8,0,8,0,8,Lombardia,ITC4
2021-01-15,PF/BT,327001960,RSA VILLA CARPANEDA,LOM,20-29,0,1,0,1,0,0,0,1,0,1,Lombardia,ITC4
2021-01-15,PF/BT,327001960,RSA VILLA CARPANEDA,LOM,30-39,1,1,0,2,0,0,0,2,0,2,Lombardia,ITC4
2021-01-15,PF/BT,327001960,RSA VILLA CARPANEDA,LOM,40-49,0,4,0,3,1,0,0,4,0,4,Lombardia,ITC4
2021-01-15,PF/BT,327001960,RSA VILLA CARPANEDA,LOM,50-59,2,9,0,6,3,1,1,11,0,11,Lombardia,ITC4
2021-01-15,PF/BT,327001960,RSA VILLA CARPANEDA,LOM,60-69,0,3,0,1,0,1,1,3,0,3,Lombardia,ITC4
2021-01-15,PF/BT,327001960,RSA VILLA CARPANEDA,LOM,80-89,2,3,0,0,0,5,0,5,0,5,Lombardia,ITC4
2021-01-15,PF/BT,327001960,RSA VILLA CARPANEDA,LOM,90+,0,1,0,0,0,1,0,1,0,1,Lombardia,ITC4
2021-01-15,PF/BT,327001964,FONDAZIONE OSPEDALE CIVILE DI GONZAGA,LOM,20-29,0,1,0,1,0,0,0,1,0,1,Lombardia,ITC4
2021-01-15,PF/BT,327001964,FONDAZIONE OSPEDALE CIVILE DI GONZAGA,LOM,30-39,1,0,0,1,0,0,0,1,0,1,Lombardia,ITC4
2021-01-15,PF/BT,327001964,FONDAZIONE OSPEDALE CIVILE DI GONZAGA,LOM,40-49,0,3,0,1,2,0,0,3,0,3,Lombardia,ITC4
2021-01-15,PF/BT,327001964,FONDAZIONE OSPEDALE CIVILE DI GONZAGA,LOM,50-59,0,8,0,7,1,0,0,8,0,8,Lombardia,ITC4
2021-01-15,PF/BT,327001964,FONDAZIONE OSPEDALE CIVILE DI GONZAGA,LOM,60-69,1,1,0,2,0,0,0,2,0,2,Lombardia,ITC4
2021-01-15,PF/BT,327001964,FONDAZIONE OSPEDALE CIVILE DI GONZAGA,LOM,80-89,1,5,0,0,0,6,0,6,0,6,Lombardia,ITC4
2021-01-15,PF/BT,327001964,FONDAZIONE OSPEDALE CIVILE DI GONZAGA,LOM,90+,1,8,0,0,0,9,0,9,0,9,Lombardia,ITC4
2021-01-15,PF/BT,327002005,RSA EMANUELE E GIUSEPPINA CORDIOLI MARMIROLO,LOM,40-49,0,4,0,4,0,0,0,4,0,4,Lombardia,ITC4
2021-01-15,PF/BT,327002005,RSA EMANUELE E GIUSEPPINA CORDIOLI MARMIROLO,LOM,50-59,1,6,0,5,2,0,0,7,0,7,Lombardia,ITC4
2021-01-15,PF/BT,327002005,RSA EMANUELE E GIUSEPPINA CORDIOLI MARMIROLO,LOM,60-69,0,1,0,0,1,0,0,1,0,1,Lombardia,ITC4
2021-01-15,PF/BT,327003606,RSA RODIGO,LOM,20-29,0,3,0,3,0,0,0,3,0,3,Lombardia,ITC4
2021-01-15,PF/BT,327003606,RSA RODIGO,LOM,30-39,0,6,0,6,0,0,0,6,0,6,Lombardia,ITC4
2021-01-15,PF/BT,327003606,RSA RODIGO,LOM,40-49,0,1,0,0,1,0,0,1,0,1,Lombardia,ITC4
2021-01-15,PF/BT,327003606,RSA RODIGO,LOM,50-59,0,6,0,5,1,0,0,6,0,6,Lombardia,ITC4
2021-01-15,PF/BT,327003606,RSA RODIGO,LOM,60-69,1,2,0,3,0,0,0,3,0,3,Lombardia,ITC4
2021-01-15,PF/BT,327003606,RSA RODIGO,LOM,70-79,0,2,0,0,0,2,0,2,0,2,Lombardia,ITC4
2021-01-15,PF/BT,32772407,CV COVID CREMONA,LOM,20-29,12,26,0,0,0,0,38,38,0,38,Lombardia,ITC4
2021-01-15,PF/BT,32772407,CV COVID CREMONA,LOM,30-39,34,84,0,2,0,0,116,118,0,118,Lombardia,ITC4
2021-01-15,PF/BT,32772407,CV COVID CREMONA,LOM,40-49,5,14,0,12,0,0,7,19,0,19,Lombardia,ITC4
2021-01-15,PF/BT,32772407,CV COVID CREMONA,LOM,50-59,4,17,0,11,0,0,10,21,0,21,Lombardia,ITC4
2021-01-15,PF/BT,32772407,CV COVID CREMONA,LOM,60-69,2,18,0,13,2,0,5,20,0,20,Lombardia,ITC4
2021-01-15,PF/BT,32772407,CV COVID CREMONA,LOM,70-79,4,6,0,8,1,0,1,10,0,10,Lombardia,ITC4
2021-01-15,PF/BT,32772407,CV COVID CREMONA,LOM,80-89,1,0,0,1,0,0,0,1,0,1,Lombardia,ITC4
2021-01-15,PF/BT,32772407,CV COVID CREMONA,LOM,90+,1,0,0,1,0,0,0,1,0,1,Lombardia,ITC4
2021-01-15,PF/BT,328002013,R.S.A. VILLA CHIARA,LOM,20-29,0,5,0,5,0,0,0,5,0,5,Lombardia,ITC4
2021-01-15,PF/BT,328002013,R.S.A. VILLA CHIARA,LOM,30-39,1,4,0,5,0,0,0,5,0,5,Lombardia,ITC4
2021-01-15,PF/BT,328002013,R.S.A. VILLA CHIARA,LOM,40-49,0,6,0,6,0,0,0,6,0,6,Lombardia,ITC4
2021-01-15,PF/BT,328002013,R.S.A. VILLA CHIARA,LOM,50-59,2,4,0,4,0,2,0,6,0,6,Lombardia,ITC4
2021-01-15,PF/BT,328002013,R.S.A. VILLA CHIARA,LOM,60-69,9,5,0,0,0,14,0,14,0,14,Lombardia,ITC4
2021-01-15,PF/BT,328002013,R.S.A. VILLA CHIARA,LOM,70-79,12,9,0,0,0,21,0,21,0,21,Lombardia,ITC4
2021-01-15,PF/BT,328002013,R.S.A. VILLA CHIARA,LOM,80-89,7,14,0,0,0,21,0,21,0,21,Lombardia,ITC4
2021-01-15,PF/BT,328002013,R.S.A. VILLA CHIARA,LOM,90+,0,2,0,0,0,2,0,2,0,2,Lombardia,ITC4
2021-01-15,PF/BT,347,Fondazione San Giuseppe Moscati,LOM,30-39,0,2,0,2,0,0,0,2,0,2,Lombardia,ITC4
2021-01-15,PF/BT,347,Fondazione San Giuseppe Moscati,LOM,40-49,1,3,0,1,3,0,0,4,0,4,Lombardia,ITC4
2021-01-15,PF/BT,347,Fondazione San Giuseppe Moscati,LOM,50-59,1,3,0,2,2,0,0,4,0,4,Lombardia,ITC4
2021-01-15,PF/BT,347,Fondazione San Giuseppe Moscati,LOM,60-69,0,1,0,0,1,0,0,1,0,1,Lombardia,ITC4
2021-01-15,PF/BT,347,Fondazione San Giuseppe Moscati,LOM,70-79,1,0,0,0,1,0,0,1,0,1,Lombardia,ITC4
2021-01-15,PF/BT,521,"RSA ""POLO GERIATRICO RIABILITATIVO 2”",LOM,30-39,2,1,0,1,2,0,0,3,0,3,Lombardia,ITC4
2021-01-15,PF/BT,521,"RSA ""POLO GERIATRICO RIABILITATIVO 2”",LOM,50-59,1,3,0,3,1,0,0,4,0,4,Lombardia,ITC4
2021-01-15,PF/BT,521,"RSA ""POLO GERIATRICO RIABILITATIVO 2”",LOM,60-69,0,1,0,1,0,0,0,1,0,1,Lombardia,ITC4
2021-01-15,PF/BT,558,RSA PIO ALBERGO TRIVULZIO,LOM,20-29,10,17,0,15,12,0,0,27,0,27,Lombardia,ITC4
2021-01-15,PF/BT,558,RSA PIO ALBERGO TRIVULZIO,LOM,30-39,19,13,0,22,10,0,0,32,0,32,Lombardia,ITC4
2021-01-15,PF/BT,558,RSA PIO ALBERGO TRIVULZIO,LOM,40-49,11,18,0,17,12,0,0,29,0,29,Lombardia,ITC4
2021-01-15,PF/BT,558,RSA PIO ALBERGO TRIVULZIO,LOM,50-59,8,10,0,11,7,0,0,18,0,18,Lombardia,ITC4
2021-01-15,PF/BT,558,RSA PIO ALBERGO TRIVULZIO,LOM,60-69,3,4,0,5,2,0,0,7,0,7,Lombardia,ITC4
2021-01-15,PF/BT,558,RSA PIO ALBERGO TRIVULZIO,LOM,70-79,1,0,0,0,1,0,0,1,0,1,Lombardia,ITC4
2021-01-15,PF/BT,680,"RSA GIUSEPPE GEROSA BRICHETTO  VIA MECENATE,96 MILANO",LOM,60-69,1,1,0,0,0,2,0,2,0,2,Lombardia,ITC4
2021-01-15,PF/BT,680,"RSA GIUSEPPE GEROSA BRICHETTO  VIA MECENATE,96 MILANO",LOM,70-79,3,4,0,0,0,7,0,7,0,7,Lombardia,ITC4
2021-01-15,PF/BT,680,"RSA GIUSEPPE GEROSA BRICHETTO  VIA MECENATE,96 MILANO",LOM,80-89,3,5,0,0,0,8,0,8,0,8,Lombardia,ITC4
2021-01-15,PF/BT,680,"RSA GIUSEPPE GEROSA BRICHETTO  VIA MECENATE,96 MILANO",LOM,90+,0,7,0,0,0,7,0,7,0,7,Lombardia,ITC4
2021-01-15,PF/BT,690548,RSA Fondazione Lucini-Cantù Onlus,LOM,30-39,0,2,0,2,0,0,0,2,0,2,Lombardia,ITC4
2021-01-15,PF/BT,690548,RSA Fondazione Lucini-Cantù Onlus,LOM,50-59,0,1,0,1,0,0,0,1,0,1,Lombardia,ITC4
2021-01-15,PF/BT,690548,RSA Fondazione Lucini-Cantù Onlus,LOM,60-69,0,1,0,1,0,0,0,1,0,1,Lombardia,ITC4
2021-01-15,PF/BT,690548,RSA Fondazione Lucini-Cantù Onlus,LOM,80-89,0,4,0,0,0,4,0,4,0,4,Lombardia,ITC4
2021-01-15,PF/BT,690548,RSA Fondazione Lucini-Cantù Onlus,LOM,90+,1,3,0,0,0,4,0,4,0,4,Lombardia,ITC4
2021-01-15,PF/BT,697,CASA RIPOSO F.LLI MOLINA P.E.T,LOM,20-29,2,4,0,6,0,0,0,6,0,6,Lombardia,ITC4
2021-01-15,PF/BT,697,CASA RIPOSO F.LLI MOLINA P.E.T,LOM,30-39,0,6,0,5,1,0,0,6,0,6,Lombardia,ITC4
2021-01-15,PF/BT,697,CASA RIPOSO F.LLI MOLINA P.E.T,LOM,40-49,2,12,0,11,3,0,0,14,0,14,Lombardia,ITC4
2021-01-15,PF/BT,697,CASA RIPOSO F.LLI MOLINA P.E.T,LOM,50-59,2,16,0,16,2,0,0,18,0,18,Lombardia,ITC4
2021-01-15,PF/BT,697,CASA RIPOSO F.LLI MOLINA P.E.T,LOM,60-69,1,3,0,3,1,0,0,4,0,4,Lombardia,ITC4
2021-01-15,PF/BT,789,RSA RESIDENZA MARIO E RINA MOLINA - LUINO,LOM,20-29,0,3,0,3,0,0,0,3,0,3,Lombardia,ITC4
2021-01-15,PF/BT,789,RSA RESIDENZA MARIO E RINA MOLINA - LUINO,LOM,40-49,0,3,0,3,0,0,0,3,0,3,Lombardia,ITC4
2021-01-15,PF/BT,789,RSA RESIDENZA MARIO E RINA MOLINA - LUINO,LOM,50-59,1,1,0,2,0,0,0,2,0,2,Lombardia,ITC4
2021-01-15,PF/BT,789,RSA RESIDENZA MARIO E RINA MOLINA - LUINO,LOM,60-69,0,2,0,2,0,0,0,2,0,2,Lombardia,ITC4
2021-01-15,PF/BT,789,RSA RESIDENZA MARIO E RINA MOLINA - LUINO,LOM,70-79,0,1,0,0,0,1,0,1,0,1,Lombardia,ITC4
2021-01-15,PF/BT,789,RSA RESIDENZA MARIO E RINA MOLINA - LUINO,LOM,80-89,2,11,0,0,0,13,0,13,0,13,Lombardia,ITC4
2021-01-15,PF/BT,789,RSA RESIDENZA MARIO E RINA MOLINA - LUINO,LOM,90+,0,6,0,0,0,6,0,6,0,6,Lombardia,ITC4
2021-01-15,PF/BT,906,FONDAZIONE ONLUS NINJ BECCAGUTTI,LOM,30-39,0,1,0,1,0,0,0,1,0,1,Lombardia,ITC4
2021-01-15,PF/BT,906,FONDAZIONE ONLUS NINJ BECCAGUTTI,LOM,40-49,0,1,0,1,0,0,0,1,0,1,Lombardia,ITC4
2021-01-15,PF/BT,906,FONDAZIONE ONLUS NINJ BECCAGUTTI,LOM,50-59,0,1,0,1,0,0,0,1,0,1,Lombardia,ITC4
2021-01-15,PF/BT,906,FONDAZIONE ONLUS NINJ BECCAGUTTI,LOM,60-69,0,1,0,1,0,0,0,1,0,1,Lombardia,ITC4
2021-01-15,PF/BT,906,FONDAZIONE ONLUS NINJ BECCAGUTTI,LOM,80-89,0,2,0,0,0,1,1,2,0,2,Lombardia,ITC4
2021-01-15,PF/BT,907,RSA SANTA MARIA DELLA NEVE,LOM,20-29,0,1,0,1,0,0,0,1,0,1,Lombardia,ITC4
2021-01-15,PF/BT,907,RSA SANTA MARIA DELLA NEVE,LOM,30-39,0,3,0,2,1,0,0,3,0,3,Lombardia,ITC4
2021-01-15,PF/BT,907,RSA SANTA MARIA DELLA NEVE,LOM,40-49,0,5,0,5,0,0,0,5,0,5,Lombardia,ITC4
2021-01-15,PF/BT,907,RSA SANTA MARIA DELLA NEVE,LOM,50-59,0,7,0,7,0,0,0,7,0,7,Lombardia,ITC4
2021-01-15,PF/BT,907,RSA SANTA MARIA DELLA NEVE,LOM,60-69,0,2,0,2,0,0,0,2,0,2,Lombardia,ITC4
2021-01-15,PF/BT,922,CASA DI RIPOSO G.M. VENZOLI,LOM,20-29,0,1,0,1,0,0,0,1,0,1,Lombardia,ITC4
2021-01-15,PF/BT,922,CASA DI RIPOSO G.M. VENZOLI,LOM,30-39,1,4,0,3,1,1,0,5,0,5,Lombardia,ITC4
2021-01-15,PF/BT,922,CASA DI RIPOSO G.M. VENZOLI,LOM,40-49,1,7,0,7,1,0,0,8,0,8,Lombardia,ITC4
2021-01-15,PF/BT,922,CASA DI RIPOSO G.M. VENZOLI,LOM,50-59,1,10,0,10,0,1,0,11,0,11,Lombardia,ITC4
2021-01-15,PF/BT,922,CASA DI RIPOSO G.M. VENZOLI,LOM,60-69,0,2,0,0,0,2,0,2,0,2,Lombardia,ITC4
2021-01-15,PF/BT,922,CASA DI RIPOSO G.M. VENZOLI,LOM,70-79,1,0,0,0,0,1,0,1,0,1,Lombardia,ITC4
2021-01-15,PF/BT,922,CASA DI RIPOSO G.M. VENZOLI,LOM,80-89,1,7,0,0,0,8,0,8,0,8,Lombardia,ITC4
2021-01-15,PF/BT,922,CASA DI RIPOSO G.M. VENZOLI,LOM,90+,0,4,0,0,0,4,0,4,0,4,Lombardia,ITC4
2021-01-15,PF/BT,943,R.S.A RESIDENZA FONDAZIONE ANGELO MAJ FONDAZIONE ONLUS,LOM,20-29,0,1,0,0,1,0,0,1,0,1,Lombardia,ITC4
2021-01-15,PF/BT,943,R.S.A RESIDENZA FONDAZIONE ANGELO MAJ FONDAZIONE ONLUS,LOM,30-39,1,1,0,1,1,0,0,2,0,2,Lombardia,ITC4
2021-01-15,PF/BT,943,R.S.A RESIDENZA FONDAZIONE ANGELO MAJ FONDAZIONE ONLUS,LOM,50-59,1,0,0,0,1,0,0,1,0,1,Lombardia,ITC4
2021-01-15,PF/BT,943,R.S.A RESIDENZA FONDAZIONE ANGELO MAJ FONDAZIONE ONLUS,LOM,70-79,1,6,0,0,0,7,0,7,0,7,Lombardia,ITC4
2021-01-15,PF/BT,943,R.S.A RESIDENZA FONDAZIONE ANGELO MAJ FONDAZIONE ONLUS,LOM,80-89,4,12,0,0,0,16,0,16,0,16,Lombardia,ITC4
2021-01-15,PF/BT,943,R.S.A RESIDENZA FONDAZIONE ANGELO MAJ FONDAZIONE ONLUS,LOM,90+,2,7,0,0,0,9,0,9,0,9,Lombardia,ITC4
2021-01-15,PF/BT,947,I.R.C.C.S. POLICLINICO SAN DONATO,LOM,20-29,5,5,0,9,1,0,0,10,0,10,Lombardia,ITC4
2021-01-15,PF/BT,947,I.R.C.C.S. POLICLINICO SAN DONATO,LOM,30-39,4,5,0,9,0,0,0,9,0,9,Lombardia,ITC4
2021-01-15,PF/BT,947,I.R.C.C.S. POLICLINICO SAN DONATO,LOM,40-49,4,5,0,6,3,0,0,9,0,9,Lombardia,ITC4
2021-01-15,PF/BT,947,I.R.C.C.S. POLICLINICO SAN DONATO,LOM,50-59,3,4,0,3,3,0,1,7,0,7,Lombardia,ITC4
2021-01-15,PF/BT,947,I.R.C.C.S. POLICLINICO SAN DONATO,LOM,60-69,1,0,0,0,1,0,0,1,0,1,Lombardia,ITC4
2021-01-15,PF/BT,953,Fondazione Casa di Riposo Bongioni-Lambertenghi Onlus,LOM,30-39,0,2,0,0,0,0,2,2,0,2,Lombardia,ITC4
2021-01-15,PF/BT,953,Fondazione Casa di Riposo Bongioni-Lambertenghi Onlus,LOM,40-49,0,1,0,0,0,0,1,1,0,1,Lombardia,ITC4
2021-01-15,PF/BT,953,Fondazione Casa di Riposo Bongioni-Lambertenghi Onlus,LOM,50-59,0,1,0,0,0,0,1,1,0,1,Lombardia,ITC4
2021-01-15,PF/BT,953,Fondazione Casa di Riposo Bongioni-Lambertenghi Onlus,LOM,60-69,1,0,0,0,0,0,1,1,0,1,Lombardia,ITC4
2021-01-15,PF/BT,953,Fondazione Casa di Riposo Bongioni-Lambertenghi Onlus,LOM,70-79,0,1,0,0,0,1,0,1,0,1,Lombardia,ITC4
2021-01-15,PF/BT,958,RSA VILLA W.A. MOZART,LOM,20-29,0,1,0,0,1,0,0,1,0,1,Lombardia,ITC4
2021-01-15,PF/BT,958,RSA VILLA W.A. MOZART,LOM,30-39,0,1,0,0,1,0,0,1,0,1,Lombardia,ITC4
2021-01-15,PF/BT,958,RSA VILLA W.A. MOZART,LOM,40-49,2,2,0,2,2,0,0,4,0,4,Lombardia,ITC4
2021-01-15,PF/BT,958,RSA VILLA W.A. MOZART,LOM,50-59,0,1,0,0,1,0,0,1,0,1,Lombardia,ITC4
2021-01-15,PF/BT,958,RSA VILLA W.A. MOZART,LOM,60-69,3,0,0,0,0,2,1,3,0,3,Lombardia,ITC4
2021-01-15,PF/BT,958,RSA VILLA W.A. MOZART,LOM,70-79,1,0,0,0,0,1,0,1,0,1,Lombardia,ITC4
2021-01-15,PF/BT,958,RSA VILLA W.A. MOZART,LOM,80-89,1,0,0,0,0,1,0,1,0,1,Lombardia,ITC4
2021-01-15,PF/BT,980,CASA MADONNA DEL LAVORO,LOM,20-29,0,2,0,2,0,0,0,2,0,2,Lombardia,ITC4
2021-01-15,PF/BT,980,CASA MADONNA DEL LAVORO,LOM,30-39,0,1,0,1,0,0,0,1,0,1,Lombardia,ITC4
2021-01-15,PF/BT,980,CASA MADONNA DEL LAVORO,LOM,40-49,1,12,0,10,3,0,0,13,0,13,Lombardia,ITC4
2021-01-15,PF/BT,980,CASA MADONNA DEL LAVORO,LOM,50-59,0,7,0,5,2,0,0,7,0,7,Lombardia,ITC4
2021-01-15,PF/BT,980,CASA MADONNA DEL LAVORO,LOM,60-69,1,0,0,1,0,0,0,1,0,1,Lombardia,ITC4
2021-01-15,PF/BT,HSP11-11 bis,Policlinico San Pietro,LOM,20-29,3,4,0,7,0,0,0,7,0,7,Lombardia,ITC4
2021-01-15,PF/BT,HSP11-11 bis,Policlinico San Pietro,LOM,30-39,3,8,0,11,0,0,0,11,0,11,Lombardia,ITC4
2021-01-15,PF/BT,HSP11-11 bis,Policlinico San Pietro,LOM,40-49,6,18,0,24,0,0,0,24,0,24,Lombardia,ITC4
2021-01-15,PF/BT,HSP11-11 bis,Policlinico San Pietro,LOM,50-59,1,20,0,21,0,0,0,21,0,21,Lombardia,ITC4
2021-01-15,PF/BT,HSP11-11 bis,Policlinico San Pietro,LOM,60-69,5,5,0,10,0,0,0,10,0,10,Lombardia,ITC4
2021-01-15,PF/BT,HSP11-11 bis,Policlinico San Pietro,LOM,70-79,0,5,0,5,0,0,0,5,0,5,Lombardia,ITC4
2021-01-15,PF/BT,HSP11-11bis,32170223 HUB COVID SS PAOLO E CARLO - PVO Ospedale San Paolo,LOM,16-19,0,1,0,1,0,0,0,1,0,1,Lombardia,ITC4
2021-01-15,PF/BT,HSP11-11bis,32170223 HUB COVID SS PAOLO E CARLO - PVO Ospedale San Paolo,LOM,20-29,11,26,0,29,8,0,0,37,0,37,Lombardia,ITC4
2021-01-15,PF/BT,HSP11-11bis,32170223 HUB COVID SS PAOLO E CARLO - PVO Ospedale San Paolo,LOM,30-39,14,18,0,14,18,0,0,32,0,32,Lombardia,ITC4
2021-01-15,PF/BT,HSP11-11bis,32170223 HUB COVID SS PAOLO E CARLO - PVO Ospedale San Paolo,LOM,40-49,33,28,0,19,42,0,0,61,0,61,Lombardia,ITC4
2021-01-15,PF/BT,HSP11-11bis,32170223 HUB COVID SS PAOLO E CARLO - PVO Ospedale San Paolo,LOM,50-59,29,45,0,30,44,0,0,74,0,74,Lombardia,ITC4
2021-01-15,PF/BT,HSP11-11bis,32170223 HUB COVID SS PAOLO E CARLO - PVO Ospedale San Paolo,LOM,60-69,7,21,0,16,12,0,0,28,0,28,Lombardia,ITC4
2021-01-15,PF/BT,HSP11-11bis,32170224 HUB COVID OSP. SAN CARLO - PVO Ospedale San Carlo,LOM,20-29,8,12,0,11,0,0,9,20,0,20,Lombardia,ITC4
2021-01-15,PF/BT,HSP11-11bis,32170224 HUB COVID OSP. SAN CARLO - PVO Ospedale San Carlo,LOM,30-39,20,21,0,13,1,0,27,41,0,41,Lombardia,ITC4
2021-01-15,PF/BT,HSP11-11bis,32170224 HUB COVID OSP. SAN CARLO - PVO Ospedale San Carlo,LOM,40-49,21,33,0,21,2,0,31,54,0,54,Lombardia,ITC4
2021-01-15,PF/BT,HSP11-11bis,32170224 HUB COVID OSP. SAN CARLO - PVO Ospedale San Carlo,LOM,50-59,14,52,0,28,9,0,29,66,0,66,Lombardia,ITC4
2021-01-15,PF/BT,HSP11-11bis,32170224 HUB COVID OSP. SAN CARLO - PVO Ospedale San Carlo,LOM,60-69,8,17,0,13,2,0,10,25,0,25,Lombardia,ITC4
2021-01-15,PF/BT,HSP11-11bis,32170224 HUB COVID OSP. SAN CARLO - PVO Ospedale San Carlo,LOM,70-79,0,3,0,3,0,0,0,3,0,3,Lombardia,ITC4
2021-01-15,PF/BT,HSP11-11bis,32170224 HUB COVID OSP. SAN CARLO - PVO Ospedale San Carlo,LOM,90+,1,0,0,1,0,0,0,1,0,1,Lombardia,ITC4
2021-01-15,PF/BT,HSP11-11bis,Ambulatorio COVID PO LODI,LOM,20-29,2,6,0,6,2,0,0,8,0,8,Lombardia,ITC4
2021-01-15,PF/BT,HSP11-11bis,Ambulatorio COVID PO LODI,LOM,30-39,4,18,0,17,5,0,0,22,0,22,Lombardia,ITC4
2021-01-15,PF/BT,HSP11-11bis,Ambulatorio COVID PO LODI,LOM,40-49,5,24,0,20,9,0,0,29,0,29,Lombardia,ITC4
2021-01-15,PF/BT,HSP11-11bis,Ambulatorio COVID PO LODI,LOM,50-59,12,38,0,36,14,0,0,50,0,50,Lombardia,ITC4
2021-01-15,PF/BT,HSP11-11bis,Ambulatorio COVID PO LODI,LOM,60-69,7,5,0,9,3,0,0,12,0,12,Lombardia,ITC4
2021-01-15,PF/BT,HSP11-11bis,Ambulatorio COVID PO LODI,LOM,70-79,4,1,0,0,5,0,0,5,0,5,Lombardia,ITC4
2021-01-15,PF/BT,HSP11-11bis,Ambulatorio COVID PO LODI - RSA VALSASINO SAN COLOMBANO,LOM,60-69,2,2,0,0,0,4,0,4,0,4,Lombardia,ITC4
2021-01-15,PF/BT,HSP11-11bis,Ambulatorio COVID PO LODI - RSA VALSASINO SAN COLOMBANO,LOM,70-79,9,4,0,0,0,13,0,13,0,13,Lombardia,ITC4
2021-01-15,PF/BT,HSP11-11bis,Ambulatorio COVID PO LODI - RSA VALSASINO SAN COLOMBANO,LOM,80-89,7,16,0,0,0,23,0,23,0,23,Lombardia,ITC4
2021-01-15,PF/BT,HSP11-11bis,Ambulatorio COVID PO LODI - RSA VALSASINO SAN COLOMBANO,LOM,90+,2,18,0,0,0,20,0,20,0,20,Lombardia,ITC4
2021-01-15,PF/BT,HSP11-11bis,Ambulatorio COVID PO LODI- RSA  S. CHIARA,LOM,40-49,1,1,0,1,0,1,0,2,0,2,Lombardia,ITC4
2021-01-15,PF/BT,HSP11-11bis,Ambulatorio COVID PO LODI- RSA  S. CHIARA,LOM,60-69,1,3,0,0,0,4,0,4,0,4,Lombardia,ITC4
2021-01-15,PF/BT,HSP11-11bis,Ambulatorio COVID PO LODI- RSA  S. CHIARA,LOM,70-79,4,5,0,0,0,9,0,9,0,9,Lombardia,ITC4
2021-01-15,PF/BT,HSP11-11bis,Ambulatorio COVID PO LODI- RSA  S. CHIARA,LOM,80-89,7,20,0,0,0,27,0,27,0,27,Lombardia,ITC4
2021-01-15,PF/BT,HSP11-11bis,Ambulatorio COVID PO LODI- RSA  S. CHIARA,LOM,90+,2,16,0,0,0,18,0,18,0,18,Lombardia,ITC4
2021-01-15,PF/BT,HSP11-11bis,Ambulatorio COVID PO S.Angelo Lod.,LOM,30-39,0,2,0,2,0,0,0,2,0,2,Lombardia,ITC4
2021-01-15,PF/BT,HSP11-11bis,Ambulatorio COVID PO S.Angelo Lod.,LOM,40-49,3,3,0,5,1,0,0,6,0,6,Lombardia,ITC4
2021-01-15,PF/BT,HSP11-11bis,Ambulatorio COVID PO S.Angelo Lod.,LOM,50-59,0,7,0,4,3,0,0,7,0,7,Lombardia,ITC4
2021-01-15,PF/BT,HSP11-11bis,Ambulatorio COVID PO S.Angelo Lod.,LOM,60-69,2,0,0,2,0,0,0,2,0,2,Lombardia,ITC4
2021-01-15,PF/BT,HSP11-11bis,Ambulatorio COVID PO S.Angelo Lod.,LOM,70-79,1,0,0,0,1,0,0,1,0,1,Lombardia,ITC4
2021-01-15,PF/BT,HSP11-11bis,AMBULATORIO COVID PO SACCO,LOM,20-29,22,51,0,47,4,0,22,73,0,73,Lombardia,ITC4
2021-01-15,PF/BT,HSP11-11bis,AMBULATORIO COVID PO SACCO,LOM,30-39,30,41,0,40,19,0,12,71,0,71,Lombardia,ITC4
2021-01-15,PF/BT,HSP11-11bis,AMBULATORIO COVID PO SACCO,LOM,40-49,30,44,0,32,26,0,16,74,0,74,Lombardia,ITC4
2021-01-15,PF/BT,HSP11-11bis,AMBULATORIO COVID PO SACCO,LOM,50-59,28,62,0,39,35,0,16,90,0,90,Lombardia,ITC4
2021-01-15,PF/BT,HSP11-11bis,AMBULATORIO COVID PO SACCO,LOM,60-69,24,31,0,26,19,0,10,55,0,55,Lombardia,ITC4
2021-01-15,PF/BT,HSP11-11bis,AMBULATORIO COVID PO SACCO,LOM,70-79,1,2,0,1,0,0,2,3,0,3,Lombardia,ITC4
2021-01-15,PF/BT,HSP11-11bis,ASST BERGAMO OVEST - OSPEDALE TREVIGLIO,LOM,20-29,4,4,0,4,2,0,2,8,0,8,Lombardia,ITC4
2021-01-15,PF/BT,HSP11-11bis,ASST BERGAMO OVEST - OSPEDALE TREVIGLIO,LOM,30-39,4,14,0,13,3,0,2,18,0,18,Lombardia,ITC4
2021-01-15,PF/BT,HSP11-11bis,ASST BERGAMO OVEST - OSPEDALE TREVIGLIO,LOM,40-49,7,21,0,20,5,0,3,28,0,28,Lombardia,ITC4
2021-01-15,PF/BT,HSP11-11bis,ASST BERGAMO OVEST - OSPEDALE TREVIGLIO,LOM,50-59,10,31,0,27,9,0,5,41,0,41,Lombardia,ITC4
2021-01-15,PF/BT,HSP11-11bis,ASST BERGAMO OVEST - OSPEDALE TREVIGLIO,LOM,60-69,3,4,0,4,0,0,3,7,0,7,Lombardia,ITC4
2021-01-15,PF/BT,HSP11-11bis,CASA DI CURA SAN CAMILLO - BRESCIA,LOM,20-29,4,0,0,2,2,0,0,4,0,4,Lombardia,ITC4
2021-01-15,PF/BT,HSP11-11bis,CASA DI CURA SAN CAMILLO - BRESCIA,LOM,30-39,3,8,0,6,5,0,0,11,0,11,Lombardia,ITC4
2021-01-15,PF/BT,HSP11-11bis,CASA DI CURA SAN CAMILLO - BRESCIA,LOM,40-49,5,19,0,17,7,0,0,24,0,24,Lombardia,ITC4
2021-01-15,PF/BT,HSP11-11bis,CASA DI CURA SAN CAMILLO - BRESCIA,LOM,50-59,5,18,0,14,9,0,0,23,0,23,Lombardia,ITC4
2021-01-15,PF/BT,HSP11-11bis,CASA DI CURA SAN CAMILLO - BRESCIA,LOM,60-69,4,4,0,6,2,0,0,8,0,8,Lombardia,ITC4
2021-01-15,PF/BT,HSP11-11bis,CASA DI CURA SAN CAMILLO - BRESCIA,LOM,70-79,2,0,0,2,0,0,0,2,0,2,Lombardia,ITC4
2021-01-15,PF/BT,HSP11-11bis,ICS Maugeri- Istituto Scientifico di Montescano (Pv),LOM,20-29,3,3,0,6,0,0,0,6,0,6,Lombardia,ITC4
2021-01-15,PF/BT,HSP11-11bis,ICS Maugeri- Istituto Scientifico di Montescano (Pv),LOM,30-39,2,6,0,8,0,0,0,8,0,8,Lombardia,ITC4
2021-01-15,PF/BT,HSP11-11bis,ICS Maugeri- Istituto Scientifico di Montescano (Pv),LOM,40-49,4,7,0,11,0,0,0,11,0,11,Lombardia,ITC4
2021-01-15,PF/BT,HSP11-11bis,ICS Maugeri- Istituto Scientifico di Montescano (Pv),LOM,50-59,6,17,0,18,5,0,0,23,0,23,Lombardia,ITC4
2021-01-15,PF/BT,HSP11-11bis,ICS Maugeri- Istituto Scientifico di Montescano (Pv),LOM,60-69,4,2,0,5,1,0,0,6,0,6,Lombardia,ITC4
2021-01-15,PF/BT,HSP11-11bis,PO LODI - RSA CABRINI CODOGNO,LOM,40-49,0,4,0,3,1,0,0,4,0,4,Lombardia,ITC4
2021-01-15,PF/BT,HSP11-11bis,PO LODI - RSA CABRINI CODOGNO,LOM,50-59,0,2,0,1,1,0,0,2,0,2,Lombardia,ITC4
2021-01-15,PF/BT,HSP11-11bis,PO LODI - RSA CABRINI CODOGNO,LOM,60-69,1,2,0,0,0,3,0,3,0,3,Lombardia,ITC4
2021-01-15,PF/BT,HSP11-11bis,PO LODI - RSA CABRINI CODOGNO,LOM,70-79,7,3,0,0,0,10,0,10,0,10,Lombardia,ITC4
2021-01-15,PF/BT,HSP11-11bis,PO LODI - RSA CABRINI CODOGNO,LOM,80-89,8,20,0,0,0,28,0,28,0,28,Lombardia,ITC4
2021-01-15,PF/BT,HSP11-11bis,PO LODI - RSA CABRINI CODOGNO,LOM,90+,1,6,0,0,0,7,0,7,0,7,Lombardia,ITC4
2021-01-15,PF/BT,HSP11-11BIS-03010600,CASA DI CURA POLICLINICO DI MONZA-MONZA-,LOM,20-29,4,1,0,3,0,0,2,5,0,5,Lombardia,ITC4
2021-01-15,PF/BT,HSP11-11BIS-03010600,CASA DI CURA POLICLINICO DI MONZA-MONZA-,LOM,30-39,4,5,0,4,0,0,5,9,0,9,Lombardia,ITC4
2021-01-15,PF/BT,HSP11-11BIS-03010600,CASA DI CURA POLICLINICO DI MONZA-MONZA-,LOM,40-49,5,22,0,10,2,0,15,27,0,27,Lombardia,ITC4
2021-01-15,PF/BT,HSP11-11BIS-03010600,CASA DI CURA POLICLINICO DI MONZA-MONZA-,LOM,50-59,3,7,0,3,0,0,7,10,0,10,Lombardia,ITC4
2021-01-15,PF/BT,HSP11-11BIS-03010600,CASA DI CURA POLICLINICO DI MONZA-MONZA-,LOM,60-69,2,1,0,0,0,0,3,3,0,3,Lombardia,ITC4
2021-01-15,PF/BT,S09,FONDAZIONE PENSIONATO SANNAZZARESE ONLUS,LOM,30-39,0,2,0,2,0,0,0,2,0,2,Lombardia,ITC4
2021-01-15,PF/BT,S09,FONDAZIONE PENSIONATO SANNAZZARESE ONLUS,LOM,40-49,0,4,0,3,1,0,0,4,0,4,Lombardia,ITC4
2021-01-15,PF/BT,S09,FONDAZIONE PENSIONATO SANNAZZARESE ONLUS,LOM,50-59,1,1,0,1,0,1,0,2,0,2,Lombardia,ITC4
2021-01-15,PF/BT,S09,FONDAZIONE PENSIONATO SANNAZZARESE ONLUS,LOM,80-89,1,10,0,0,0,11,0,11,0,11,Lombardia,ITC4
2021-01-15,PF/BT,S09,FONDAZIONE PENSIONATO SANNAZZARESE ONLUS,LOM,90+,0,5,0,0,0,5,0,5,0,5,Lombardia,ITC4
2021-01-15,PF/BT,S-09,FONDAZIONE CONTE FRANCO CELLA DI RIVARA ONLUS R.S.A. DI ARENA PO,LOM,20-29,1,6,0,7,0,0,0,7,0,7,Lombardia,ITC4
2021-01-15,PF/BT,S-09,FONDAZIONE CONTE FRANCO CELLA DI RIVARA ONLUS R.S.A. DI ARENA PO,LOM,30-39,2,8,0,8,2,0,0,10,0,10,Lombardia,ITC4
2021-01-15,PF/BT,S-09,FONDAZIONE CONTE FRANCO CELLA DI RIVARA ONLUS R.S.A. DI ARENA PO,LOM,40-49,4,14,0,17,1,0,0,18,0,18,Lombardia,ITC4
2021-01-15,PF/BT,S-09,FONDAZIONE CONTE FRANCO CELLA DI RIVARA ONLUS R.S.A. DI ARENA PO,LOM,50-59,4,25,0,21,8,0,0,29,0,29,Lombardia,ITC4
2021-01-15,PF/BT,S-09,FONDAZIONE CONTE FRANCO CELLA DI RIVARA ONLUS R.S.A. DI ARENA PO,LOM,60-69,0,2,0,1,1,0,0,2,0,2,Lombardia,ITC4
2021-01-15,PF/BT,STS11,ASC CREMONA SOLIDALE,LOM,20-29,6,2,0,5,2,0,1,8,0,8,Lombardia,ITC4
2021-01-15,PF/BT,STS11,ASC CREMONA SOLIDALE,LOM,30-39,2,12,0,11,1,0,2,14,0,14,Lombardia,ITC4
2021-01-15,PF/BT,STS11,ASC CREMONA SOLIDALE,LOM,40-49,3,19,0,17,5,0,0,22,0,22,Lombardia,ITC4
2021-01-15,PF/BT,STS11,ASC CREMONA SOLIDALE,LOM,50-59,7,44,0,39,9,0,3,51,0,51,Lombardia,ITC4
2021-01-15,PF/BT,STS11,ASC CREMONA SOLIDALE,LOM,60-69,2,7,0,2,4,0,3,9,0,9,Lombardia,ITC4
2021-01-15,PF/BT,STS11,ASC CREMONA SOLIDALE,LOM,70-79,3,1,0,0,0,0,4,4,0,4,Lombardia,ITC4
2021-01-15,PF/BT,STS11,CASA DI RIPOSO COSTANTE PATRIZI ONLUS,LOM,20-29,0,1,0,0,0,0,1,1,0,1,Lombardia,ITC4
2021-01-15,PF/BT,STS11,CASA DI RIPOSO COSTANTE PATRIZI ONLUS,LOM,30-39,1,0,0,1,0,0,0,1,0,1,Lombardia,ITC4
2021-01-15,PF/BT,STS11,CASA DI RIPOSO COSTANTE PATRIZI ONLUS,LOM,40-49,0,8,0,7,1,0,0,8,0,8,Lombardia,ITC4
2021-01-15,PF/BT,STS11,CASA DI RIPOSO COSTANTE PATRIZI ONLUS,LOM,50-59,4,5,0,8,1,0,0,9,0,9,Lombardia,ITC4
2021-01-15,PF/BT,STS11,CASA DI RIPOSO COSTANTE PATRIZI ONLUS,LOM,60-69,1,3,0,0,0,0,4,4,0,4,Lombardia,ITC4
2021-01-15,PF/BT,STS11,CASA DI RIPOSO COSTANTE PATRIZI ONLUS,LOM,70-79,3,4,0,1,0,2,4,7,0,7,Lombardia,ITC4
2021-01-15,PF/BT,STS11,CASA DI RIPOSO COSTANTE PATRIZI ONLUS,LOM,80-89,3,10,0,0,0,11,2,13,0,13,Lombardia,ITC4
2021-01-15,PF/BT,STS11,CASA DI RIPOSO COSTANTE PATRIZI ONLUS,LOM,90+,0,5,0,0,0,5,0,5,0,5,Lombardia,ITC4
2021-01-15,PF/BT,STS11,CASA DI RIPOSO MANDELLO LARIO,LOM,20-29,0,1,0,1,0,0,0,1,0,1,Lombardia,ITC4
2021-01-15,PF/BT,STS11,CASA DI RIPOSO MANDELLO LARIO,LOM,30-39,0,1,0,1,0,0,0,1,0,1,Lombardia,ITC4
2021-01-15,PF/BT,STS11,CASA DI RIPOSO MANDELLO LARIO,LOM,40-49,0,1,0,1,0,0,0,1,0,1,Lombardia,ITC4
2021-01-15,PF/BT,STS11,CASA DI RIPOSO MANDELLO LARIO,LOM,50-59,0,2,0,2,0,0,0,2,0,2,Lombardia,ITC4
2021-01-15,PF/BT,STS11,CASA DI RIPOSO MANDELLO LARIO,LOM,70-79,0,5,0,0,0,5,0,5,0,5,Lombardia,ITC4
2021-01-15,PF/BT,STS11,CASA DI RIPOSO MANDELLO LARIO,LOM,80-89,0,16,0,0,0,16,0,16,0,16,Lombardia,ITC4
2021-01-15,PF/BT,STS11,CASA DI RIPOSO MANDELLO LARIO,LOM,90+,0,10,0,0,0,10,0,10,0,10,Lombardia,ITC4
2021-01-15,PF/BT,STS11,FONDAZIONE IN PARTECIPAZIONE CASA DI RIPOSO VILLA DEL SORRISO ONLUS,LOM,20-29,0,2,0,1,1,0,0,2,0,2,Lombardia,ITC4
2021-01-15,PF/BT,STS11,FONDAZIONE IN PARTECIPAZIONE CASA DI RIPOSO VILLA DEL SORRISO ONLUS,LOM,30-39,0,2,0,1,1,0,0,2,0,2,Lombardia,ITC4
2021-01-15,PF/BT,STS11,FONDAZIONE IN PARTECIPAZIONE CASA DI RIPOSO VILLA DEL SORRISO ONLUS,LOM,40-49,0,2,0,2,0,0,0,2,0,2,Lombardia,ITC4
2021-01-15,PF/BT,STS11,FONDAZIONE IN PARTECIPAZIONE CASA DI RIPOSO VILLA DEL SORRISO ONLUS,LOM,50-59,4,6,0,5,2,3,0,10,0,10,Lombardia,ITC4
2021-01-15,PF/BT,STS11,FONDAZIONE IN PARTECIPAZIONE CASA DI RIPOSO VILLA DEL SORRISO ONLUS,LOM,60-69,0,2,0,1,0,1,0,2,0,2,Lombardia,ITC4
2021-01-15,PF/BT,STS11,FONDAZIONE IN PARTECIPAZIONE CASA DI RIPOSO VILLA DEL SORRISO ONLUS,LOM,70-79,2,1,0,1,0,2,0,3,0,3,Lombardia,ITC4
2021-01-15,PF/BT,STS11,FONDAZIONE IN PARTECIPAZIONE CASA DI RIPOSO VILLA DEL SORRISO ONLUS,LOM,80-89,6,3,0,0,0,9,0,9,0,9,Lombardia,ITC4
2021-01-15,PF/BT,STS11,FONDAZIONE IN PARTECIPAZIONE CASA DI RIPOSO VILLA DEL SORRISO ONLUS,LOM,90+,0,4,0,0,0,4,0,4,0,4,Lombardia,ITC4
2021-01-15,PF/BT,STS11,Fondazione Istituto C: Vismara - G. De Petri ONLUS,LOM,40-49,0,3,0,3,0,0,0,3,0,3,Lombardia,ITC4
2021-01-15,PF/BT,STS11,Fondazione Istituto C: Vismara - G. De Petri ONLUS,LOM,50-59,0,3,0,2,1,0,0,3,0,3,Lombardia,ITC4
2021-01-15,PF/BT,STS11,FONDAZIONE MONS.BENEDINI ONLUS   - MARCARIA,LOM,30-39,1,1,0,2,0,0,0,2,0,2,Lombardia,ITC4
2021-01-15,PF/BT,STS11,FONDAZIONE MONS.BENEDINI ONLUS   - MARCARIA,LOM,40-49,1,4,0,3,2,0,0,5,0,5,Lombardia,ITC4
2021-01-15,PF/BT,STS11,FONDAZIONE MONS.BENEDINI ONLUS   - MARCARIA,LOM,50-59,0,4,0,4,0,0,0,4,0,4,Lombardia,ITC4
2021-01-15,PF/BT,STS11,FONDAZIONE MONS.BENEDINI ONLUS   - MARCARIA,LOM,70-79,2,1,0,0,0,3,0,3,0,3,Lombardia,ITC4
2021-01-15,PF/BT,STS11,FONDAZIONE MONS.BENEDINI ONLUS   - MARCARIA,LOM,80-89,3,13,0,0,0,16,0,16,0,16,Lombardia,ITC4
2021-01-15,PF/BT,STS11,FONDAZIONE MONS.BENEDINI ONLUS   - MARCARIA,LOM,90+,3,8,0,0,0,11,0,11,0,11,Lombardia,ITC4
2021-01-15,PF/BT,STS11,HOSPICE PONTEVICO (BS),LOM,20-29,1,4,0,5,0,0,0,5,0,5,Lombardia,ITC4
2021-01-15,PF/BT,STS11,HOSPICE PONTEVICO (BS),LOM,30-39,0,7,0,7,0,0,0,7,0,7,Lombardia,ITC4
2021-01-15,PF/BT,STS11,HOSPICE PONTEVICO (BS),LOM,40-49,2,3,0,5,0,0,0,5,0,5,Lombardia,ITC4
2021-01-15,PF/BT,STS11,HOSPICE PONTEVICO (BS),LOM,50-59,0,1,0,1,0,0,0,1,0,1,Lombardia,ITC4
2021-01-15,PF/BT,STS11,ISTITUTO GERIATRICO CARLO LOUISA GRASSI ONLUS - VIADANA (MN),LOM,40-49,0,2,0,2,0,0,0,2,0,2,Lombardia,ITC4
2021-01-15,PF/BT,STS11,ISTITUTO GERIATRICO CARLO LOUISA GRASSI ONLUS - VIADANA (MN),LOM,60-69,0,1,0,0,0,1,0,1,0,1,Lombardia,ITC4
2021-01-15,PF/BT,STS11,ISTITUTO GERIATRICO CARLO LOUISA GRASSI ONLUS - VIADANA (MN),LOM,70-79,2,1,0,0,0,3,0,3,0,3,Lombardia,ITC4
2021-01-15,PF/BT,STS11,ISTITUTO GERIATRICO CARLO LOUISA GRASSI ONLUS - VIADANA (MN),LOM,80-89,1,9,0,0,0,10,0,10,0,10,Lombardia,ITC4
2021-01-15,PF/BT,STS11,ISTITUTO GERIATRICO CARLO LOUISA GRASSI ONLUS - VIADANA (MN),LOM,90+,18,1,0,0,0,19,0,19,0,19,Lombardia,ITC4
2021-01-15,PF/BT,STS11,PO LODI - Fondazione De Petri ONLUS,LOM,40-49,0,3,0,3,0,0,0,3,0,3,Lombardia,ITC4
2021-01-15,PF/BT,STS11,PO LODI - Fondazione De Petri ONLUS,LOM,50-59,0,3,0,2,1,0,0,3,0,3,Lombardia,ITC4
2021-01-15,PF/BT,STS11,PO LODI - RSA SAN GIORGIO DI CODOGNO,LOM,50-59,0,1,0,0,0,1,0,1,0,1,Lombardia,ITC4
2021-01-15,PF/BT,STS11,PO LODI - RSA SAN GIORGIO DI CODOGNO,LOM,60-69,0,2,0,0,0,2,0,2,0,2,Lombardia,ITC4
2021-01-15,PF/BT,STS11,PO LODI - RSA SAN GIORGIO DI CODOGNO,LOM,70-79,1,10,0,0,0,11,0,11,0,11,Lombardia,ITC4
2021-01-15,PF/BT,STS11,PO LODI - RSA SAN GIORGIO DI CODOGNO,LOM,80-89,4,24,0,0,0,28,0,28,0,28,Lombardia,ITC4
2021-01-15,PF/BT,STS11,PO LODI - RSA SAN GIORGIO DI CODOGNO,LOM,90+,2,10,0,0,0,12,0,12,0,12,Lombardia,ITC4
2021-01-15,PF/BT,STS11,RSA  FONDAZIONE ANNI SERENI TREVIGLIO CARAVAGGI E FARA GA ONLUS,LOM,20-29,0,3,0,3,0,0,0,3,0,3,Lombardia,ITC4
2021-01-15,PF/BT,STS11,RSA  FONDAZIONE ANNI SERENI TREVIGLIO CARAVAGGI E FARA GA ONLUS,LOM,30-39,2,4,0,6,0,0,0,6,0,6,Lombardia,ITC4
2021-01-15,PF/BT,STS11,RSA  FONDAZIONE ANNI SERENI TREVIGLIO CARAVAGGI E FARA GA ONLUS,LOM,40-49,1,11,0,8,4,0,0,12,0,12,Lombardia,ITC4
2021-01-15,PF/BT,STS11,RSA  FONDAZIONE ANNI SERENI TREVIGLIO CARAVAGGI E FARA GA ONLUS,LOM,50-59,3,17,0,11,9,0,0,20,0,20,Lombardia,ITC4
2021-01-15,PF/BT,STS11,RSA  FONDAZIONE ANNI SERENI TREVIGLIO CARAVAGGI E FARA GA ONLUS,LOM,60-69,2,5,0,4,3,0,0,7,0,7,Lombardia,ITC4
2021-01-15,PF/BT,STS11,"RSA ""BEATO INNOCENZO""",LOM,20-29,0,1,0,1,0,0,0,1,0,1,Lombardia,ITC4
2021-01-15,PF/BT,STS11,"RSA ""BEATO INNOCENZO""",LOM,30-39,0,2,0,1,1,0,0,2,0,2,Lombardia,ITC4
2021-01-15,PF/BT,STS11,"RSA ""BEATO INNOCENZO""",LOM,40-49,1,0,0,0,0,0,1,1,0,1,Lombardia,ITC4
2021-01-15,PF/BT,STS11,"RSA ""BEATO INNOCENZO""",LOM,70-79,1,0,0,1,0,0,0,1,0,1,Lombardia,ITC4
2021-01-15,PF/BT,STS11,"RSA ""BEATO INNOCENZO""",LOM,90+,0,1,0,0,0,0,1,1,0,1,Lombardia,ITC4
2021-01-15,PF/BT,STS11,"RSA ""CASA BEATO LUIGI GUANELLA"" - VIA CAGNOLA, 11 - 20154 MILANO",LOM,60-69,1,1,0,1,1,0,0,2,0,2,Lombardia,ITC4
2021-01-15,PF/BT,STS11,"RSA ""CASA BEATO LUIGI GUANELLA"" - VIA CAGNOLA, 11 - 20154 MILANO",LOM,70-79,0,2,0,0,0,2,0,2,0,2,Lombardia,ITC4
2021-01-15,PF/BT,STS11,"RSA ""CASA BEATO LUIGI GUANELLA"" - VIA CAGNOLA, 11 - 20154 MILANO",LOM,80-89,0,57,0,0,0,57,0,57,0,57,Lombardia,ITC4
2021-01-15,PF/BT,STS11,"RSA ""CASA BEATO LUIGI GUANELLA"" - VIA CAGNOLA, 11 - 20154 MILANO",LOM,90+,0,53,0,0,0,53,0,53,0,53,Lombardia,ITC4
2021-01-15,PF/BT,STS11,RSA CASA PACE,LOM,30-39,0,1,0,1,0,0,0,1,0,1,Lombardia,ITC4
2021-01-15,PF/BT,STS11,RSA CASA PACE,LOM,40-49,0,4,0,4,0,0,0,4,0,4,Lombardia,ITC4
2021-01-15,PF/BT,STS11,RSA CASA PACE,LOM,50-59,0,5,0,1,4,0,0,5,0,5,Lombardia,ITC4
2021-01-15,PF/BT,STS11,RSA CASA PACE,LOM,60-69,2,1,0,0,2,1,0,3,0,3,Lombardia,ITC4
2021-01-15,PF/BT,STS11,RSA CASA PACE,LOM,70-79,1,0,0,1,0,0,0,1,0,1,Lombardia,ITC4
2021-01-15,PF/BT,STS11,RSA CASA PACE,LOM,80-89,0,4,0,0,0,4,0,4,0,4,Lombardia,ITC4
2021-01-15,PF/BT,STS11,RSA CAV. PAOLO RIVADOSSI BORNO (BS),LOM,20-29,0,2,0,1,1,0,0,2,0,2,Lombardia,ITC4
2021-01-15,PF/BT,STS11,RSA CAV. PAOLO RIVADOSSI BORNO (BS),LOM,30-39,1,1,0,2,0,0,0,2,0,2,Lombardia,ITC4
2021-01-15,PF/BT,STS11,RSA CAV. PAOLO RIVADOSSI BORNO (BS),LOM,40-49,0,5,0,4,1,0,0,5,0,5,Lombardia,ITC4
2021-01-15,PF/BT,STS11,RSA CAV. PAOLO RIVADOSSI BORNO (BS),LOM,50-59,3,4,0,4,3,0,0,7,0,7,Lombardia,ITC4
2021-01-15,PF/BT,STS11,RSA CAV. PAOLO RIVADOSSI BORNO (BS),LOM,60-69,0,6,0,6,0,0,0,6,0,6,Lombardia,ITC4
2021-01-15,PF/BT,STS11,RSA CAV. PAOLO RIVADOSSI BORNO (BS),LOM,70-79,1,1,0,0,1,1,0,2,0,2,Lombardia,ITC4
2021-01-15,PF/BT,STS11,RSA CAV. PAOLO RIVADOSSI BORNO (BS),LOM,80-89,0,3,0,0,0,3,0,3,0,3,Lombardia,ITC4
2021-01-15,PF/BT,STS11,RSA CAV. PAOLO RIVADOSSI BORNO (BS),LOM,90+,1,2,0,0,0,3,0,3,0,3,Lombardia,ITC4
2021-01-15,PF/BT,STS11,RSA DON GIOVANNI FERRAGLIOMALONNO ONLUS,LOM,50-59,0,1,0,0,1,0,0,1,0,1,Lombardia,ITC4
2021-01-15,PF/BT,STS11,RSA DON GIOVANNI FERRAGLIOMALONNO ONLUS,LOM,60-69,1,0,0,0,0,1,0,1,0,1,Lombardia,ITC4
2021-01-15,PF/BT,STS11,RSA DON GIOVANNI FERRAGLIOMALONNO ONLUS,LOM,70-79,0,2,0,0,0,2,0,2,0,2,Lombardia,ITC4
2021-01-15,PF/BT,STS11,RSA DON GIOVANNI FERRAGLIOMALONNO ONLUS,LOM,80-89,1,1,0,0,0,2,0,2,0,2,Lombardia,ITC4
2021-01-15,PF/BT,STS11 - 000939,CASA DI RIPOSO CORTI NEMESIO,LOM,30-39,0,3,0,3,0,0,0,3,0,3,Lombardia,ITC4
2021-01-15,PF/BT,STS11 - 000939,CASA DI RIPOSO CORTI NEMESIO,LOM,40-49,0,8,0,6,2,0,0,8,0,8,Lombardia,ITC4
2021-01-15,PF/BT,STS11 - 000939,CASA DI RIPOSO CORTI NEMESIO,LOM,50-59,4,11,0,6,9,0,0,15,0,15,Lombardia,ITC4
2021-01-15,PF/BT,STS11 - 000939,CASA DI RIPOSO CORTI NEMESIO,LOM,60-69,1,2,0,1,0,2,0,3,0,3,Lombardia,ITC4
2021-01-15,PF/BT,STS11 - 000939,CASA DI RIPOSO CORTI NEMESIO,LOM,70-79,4,0,0,0,0,4,0,4,0,4,Lombardia,ITC4
2021-01-15,PF/BT,STS11 - 000939,CASA DI RIPOSO CORTI NEMESIO,LOM,80-89,11,4,0,0,0,15,0,15,0,15,Lombardia,ITC4
2021-01-15,PF/BT,STS11 - 000939,CASA DI RIPOSO CORTI NEMESIO,LOM,90+,2,9,0,0,0,11,0,11,0,11,Lombardia,ITC4
2021-01-15,PF/BT,STS11  002035,RSA Fondazione Bellinie Silva,LOM,40-49,1,0,0,1,0,0,0,1,0,1,Lombardia,ITC4
2021-01-15,PF/BT,STS11  002035,RSA Fondazione Bellinie Silva,LOM,60-69,0,1,0,1,0,0,0,1,0,1,Lombardia,ITC4
2021-01-15,PF/BT,STS11  002035,RSA Fondazione Bellinie Silva,LOM,80-89,1,2,0,0,0,3,0,3,0,3,Lombardia,ITC4
2021-01-15,PF/BT,STS11  002035,RSA Fondazione Bellinie Silva,LOM,90+,1,0,0,0,0,1,0,1,0,1,Lombardia,ITC4
2021-01-15,PF/BT,STS11  002193,RSA CASA DEL VECCHIO E DEL FANCIULLO ITALA VOCHIERI,LOM,40-49,1,0,0,0,1,0,0,1,0,1,Lombardia,ITC4
2021-01-15,PF/BT,STS11  002193,RSA CASA DEL VECCHIO E DEL FANCIULLO ITALA VOCHIERI,LOM,50-59,0,1,0,1,0,0,0,1,0,1,Lombardia,ITC4
2021-01-15,PF/BT,STS11  002193,RSA CASA DEL VECCHIO E DEL FANCIULLO ITALA VOCHIERI,LOM,70-79,1,4,0,0,0,5,0,5,0,5,Lombardia,ITC4
2021-01-15,PF/BT,STS11  002193,RSA CASA DEL VECCHIO E DEL FANCIULLO ITALA VOCHIERI,LOM,80-89,2,17,0,0,0,19,0,19,0,19,Lombardia,ITC4
2021-01-15,PF/BT,STS11  002193,RSA CASA DEL VECCHIO E DEL FANCIULLO ITALA VOCHIERI,LOM,90+,1,15,0,0,0,16,0,16,0,16,Lombardia,ITC4
2021-01-15,PF/BT,STS11 000942,PSVR RSA FONDAZIONE ENTE CELERI BRENO,LOM,20-29,1,0,0,0,1,0,0,1,0,1,Lombardia,ITC4
2021-01-15,PF/BT,STS11 000942,PSVR RSA FONDAZIONE ENTE CELERI BRENO,LOM,30-39,1,1,0,1,1,0,0,2,0,2,Lombardia,ITC4
2021-01-15,PF/BT,STS11 000942,PSVR RSA FONDAZIONE ENTE CELERI BRENO,LOM,40-49,0,5,0,4,1,0,0,5,0,5,Lombardia,ITC4
2021-01-15,PF/BT,STS11 000942,PSVR RSA FONDAZIONE ENTE CELERI BRENO,LOM,50-59,0,2,0,2,0,0,0,2,0,2,Lombardia,ITC4
2021-01-15,PF/BT,STS11 000942,PSVR RSA FONDAZIONE ENTE CELERI BRENO,LOM,60-69,2,0,0,0,0,0,2,2,0,2,Lombardia,ITC4
2021-01-15,PF/BT,STS11 000942,PSVR RSA FONDAZIONE ENTE CELERI BRENO,LOM,80-89,1,2,0,0,0,3,0,3,0,3,Lombardia,ITC4
2021-01-15,PF/BT,STS11 000942,PSVR RSA FONDAZIONE ENTE CELERI BRENO,LOM,90+,1,2,0,0,0,3,0,3,0,3,Lombardia,ITC4
2021-01-15,PF/BT,STS11/32170226,AMBULATORIO COVID OSP. MILITARE,LOM,20-29,0,1,0,0,1,0,0,1,0,1,Lombardia,ITC4
2021-01-15,PF/BT,STS11/32170226,AMBULATORIO COVID OSP. MILITARE,LOM,30-39,2,0,0,1,1,0,0,2,0,2,Lombardia,ITC4
2021-01-15,PF/BT,STS11/32170226,AMBULATORIO COVID OSP. MILITARE,LOM,40-49,1,0,0,1,0,0,0,1,0,1,Lombardia,ITC4
2021-01-15,PF/BT,STS11/32170226,AMBULATORIO COVID OSP. MILITARE,LOM,50-59,2,0,0,0,2,0,0,2,0,2,Lombardia,ITC4
2021-01-15,PF/BT,STS24,RSA FONDAZIONE ONLUS MONS. A. MAZZALI (MANTOVA),LOM,20-29,0,3,0,3,0,0,0,3,0,3,Lombardia,ITC4
2021-01-15,PF/BT,STS24,RSA FONDAZIONE ONLUS MONS. A. MAZZALI (MANTOVA),LOM,30-39,1,4,0,3,2,0,0,5,0,5,Lombardia,ITC4
2021-01-15,PF/BT,STS24,RSA FONDAZIONE ONLUS MONS. A. MAZZALI (MANTOVA),LOM,40-49,0,5,0,5,0,0,0,5,0,5,Lombardia,ITC4
2021-01-15,PF/BT,STS24,RSA FONDAZIONE ONLUS MONS. A. MAZZALI (MANTOVA),LOM,50-59,2,7,0,4,5,0,0,9,0,9,Lombardia,ITC4
2021-01-15,PF/BT,STS24,RSA FONDAZIONE ONLUS MONS. A. MAZZALI (MANTOVA),LOM,60-69,0,2,0,1,1,0,0,2,0,2,Lombardia,ITC4
2021-01-16,PF/BT,(03027500/001752),PVO Istituto Clinico San Rocco (Spoke),LOM,20-29,1,3,0,4,0,0,0,4,0,4,Lombardia,ITC4
2021-01-16,PF/BT,(03027500/001752),PVO Istituto Clinico San Rocco (Spoke),LOM,30-39,1,5,0,5,1,0,0,6,0,6,Lombardia,ITC4
2021-01-16,PF/BT,(03027500/001752),PVO Istituto Clinico San Rocco (Spoke),LOM,40-49,3,10,0,11,2,0,0,13,0,13,Lombardia,ITC4
2021-01-16,PF/BT,(03027500/001752),PVO Istituto Clinico San Rocco (Spoke),LOM,50-59,2,12,0,10,4,0,0,14,0,14,Lombardia,ITC4
2021-01-16,PF/BT,(03027500/001752),PVO Istituto Clinico San Rocco (Spoke),LOM,60-69,4,1,0,5,0,0,0,5,0,5,Lombardia,ITC4
2021-01-16,PF/BT,****,AMBULATORIO COVID P.O. ALZANO L.DO,LOM,20-29,1,12,0,12,1,0,0,13,0,13,Lombardia,ITC4
2021-01-16,PF/BT,****,AMBULATORIO COVID P.O. ALZANO L.DO,LOM,30-39,3,6,0,7,2,0,0,9,0,9,Lombardia,ITC4
2021-01-16,PF/BT,****,AMBULATORIO COVID P.O. ALZANO L.DO,LOM,40-49,3,15,0,13,5,0,0,18,0,18,Lombardia,ITC4
2021-01-16,PF/BT,****,AMBULATORIO COVID P.O. ALZANO L.DO,LOM,50-59,5,15,0,12,8,0,0,20,0,20,Lombardia,ITC4
2021-01-16,PF/BT,****,AMBULATORIO COVID P.O. ALZANO L.DO,LOM,60-69,8,3,0,9,2,0,0,11,0,11,Lombardia,ITC4
2021-01-16,PF/BT,.030042,ASST VALTELLINA ALTO LARIO - PRESIDIO OSPEDALIERO DI SONDRIO,LOM,20-29,23,57,0,79,1,0,0,80,0,80,Lombardia,ITC4
2021-01-16,PF/BT,.030042,ASST VALTELLINA ALTO LARIO - PRESIDIO OSPEDALIERO DI SONDRIO,LOM,30-39,4,16,0,17,3,0,0,20,0,20,Lombardia,ITC4
2021-01-16,PF/BT,.030042,ASST VALTELLINA ALTO LARIO - PRESIDIO OSPEDALIERO DI SONDRIO,LOM,40-49,7,11,0,15,3,0,0,18,0,18,Lombardia,ITC4
2021-01-16,PF/BT,.030042,ASST VALTELLINA ALTO LARIO - PRESIDIO OSPEDALIERO DI SONDRIO,LOM,50-59,8,29,0,26,11,0,0,37,0,37,Lombardia,ITC4
2021-01-16,PF/BT,.030042,ASST VALTELLINA ALTO LARIO - PRESIDIO OSPEDALIERO DI SONDRIO,LOM,60-69,17,13,0,30,0,0,0,30,0,30,Lombardia,ITC4
2021-01-16,PF/BT,.030042,ASST VALTELLINA ALTO LARIO - PRESIDIO OSPEDALIERO DI SONDRIO,LOM,70-79,1,0,0,1,0,0,0,1,0,1,Lombardia,ITC4
2021-01-16,PF/BT,0,Istituto Redaelli Milano,LOM,30-39,0,1,0,1,0,0,0,1,0,1,Lombardia,ITC4
2021-01-16,PF/BT,0,Istituto Redaelli Milano,LOM,50-59,2,0,0,0,0,2,0,2,0,2,Lombardia,ITC4
2021-01-16,PF/BT,0,Istituto Redaelli Milano,LOM,60-69,2,1,0,0,0,3,0,3,0,3,Lombardia,ITC4
2021-01-16,PF/BT,0,Istituto Redaelli Milano,LOM,70-79,5,2,0,0,0,7,0,7,0,7,Lombardia,ITC4
2021-01-16,PF/BT,0,Istituto Redaelli Milano,LOM,80-89,3,12,0,0,0,15,0,15,0,15,Lombardia,ITC4
2021-01-16,PF/BT,0,Istituto Redaelli Milano,LOM,90+,1,17,0,0,0,18,0,18,0,18,Lombardia,ITC4
2021-01-16,PF/BT,000050,Poliambulatorio IRCSS OSPEDALE SAN LUCA,LOM,20-29,13,32,0,18,27,0,0,45,0,45,Lombardia,ITC4
2021-01-16,PF/BT,000050,Poliambulatorio IRCSS OSPEDALE SAN LUCA,LOM,30-39,31,46,0,30,47,0,0,77,0,77,Lombardia,ITC4
2021-01-16,PF/BT,000050,Poliambulatorio IRCSS OSPEDALE SAN LUCA,LOM,40-49,32,55,0,31,56,0,0,87,0,87,Lombardia,ITC4
2021-01-16,PF/BT,000050,Poliambulatorio IRCSS OSPEDALE SAN LUCA,LOM,50-59,28,57,0,28,57,0,0,85,0,85,Lombardia,ITC4
2021-01-16,PF/BT,000050,Poliambulatorio IRCSS OSPEDALE SAN LUCA,LOM,60-69,12,14,0,14,12,0,0,26,0,26,Lombardia,ITC4
2021-01-16,PF/BT,000050,Poliambulatorio IRCSS OSPEDALE SAN LUCA,LOM,70-79,6,0,0,5,1,0,0,6,0,6,Lombardia,ITC4
2021-01-16,PF/BT,000050,Poliambulatorio IRCSS OSPEDALE SAN LUCA,LOM,80-89,2,1,0,2,1,0,0,3,0,3,Lombardia,ITC4
2021-01-16,PF/BT,000119,POLIAMBULATORIO IRCSS OSPEDALE SAN MICHELE,LOM,20-29,0,1,0,1,0,0,0,1,0,1,Lombardia,ITC4
2021-01-16,PF/BT,000119,POLIAMBULATORIO IRCSS OSPEDALE SAN MICHELE,LOM,30-39,0,1,0,1,0,0,0,1,0,1,Lombardia,ITC4
2021-01-16,PF/BT,000119,POLIAMBULATORIO IRCSS OSPEDALE SAN MICHELE,LOM,50-59,0,7,0,4,3,0,0,7,0,7,Lombardia,ITC4
2021-01-16,PF/BT,000119,POLIAMBULATORIO IRCSS OSPEDALE SAN MICHELE,LOM,60-69,2,0,0,2,0,0,0,2,0,2,Lombardia,ITC4
2021-01-16,PF/BT,000119,POLIAMBULATORIO IRCSS OSPEDALE SAN MICHELE,LOM,70-79,0,1,0,1,0,0,0,1,0,1,Lombardia,ITC4
2021-01-16,PF/BT,000293,IRCCS MultiMedica,LOM,16-19,0,5,0,5,0,0,0,5,0,5,Lombardia,ITC4
2021-01-16,PF/BT,000293,IRCCS MultiMedica,LOM,20-29,38,81,0,109,10,0,0,119,0,119,Lombardia,ITC4
2021-01-16,PF/BT,000293,IRCCS MultiMedica,LOM,30-39,52,73,0,107,18,0,0,125,0,125,Lombardia,ITC4
2021-01-16,PF/BT,000293,IRCCS MultiMedica,LOM,40-49,56,178,0,182,52,0,0,234,0,234,Lombardia,ITC4
2021-01-16,PF/BT,000293,IRCCS MultiMedica,LOM,50-59,34,161,0,136,59,0,0,195,0,195,Lombardia,ITC4
2021-01-16,PF/BT,000293,IRCCS MultiMedica,LOM,60-69,27,31,0,42,16,0,0,58,0,58,Lombardia,ITC4
2021-01-16,PF/BT,000293,IRCCS MultiMedica,LOM,70-79,7,7,0,12,2,0,0,14,0,14,Lombardia,ITC4
2021-01-16,PF/BT,000427,CENTRO DIAGNOSTICO PIOLTELLO,LOM,20-29,0,4,0,1,3,0,0,4,0,4,Lombardia,ITC4
2021-01-16,PF/BT,000427,CENTRO DIAGNOSTICO PIOLTELLO,LOM,30-39,1,3,0,0,4,0,0,4,0,4,Lombardia,ITC4
2021-01-16,PF/BT,000427,CENTRO DIAGNOSTICO PIOLTELLO,LOM,40-49,1,1,0,1,1,0,0,2,0,2,Lombardia,ITC4
2021-01-16,PF/BT,000427,CENTRO DIAGNOSTICO PIOLTELLO,LOM,60-69,1,1,0,0,2,0,0,2,0,2,Lombardia,ITC4
2021-01-16,PF/BT,000547,Ambulatorio Vaccinale Ospedale Militare,LOM,50-59,2,1,0,0,0,3,0,3,0,3,Lombardia,ITC4
2021-01-16,PF/BT,000547,Ambulatorio Vaccinale Ospedale Militare,LOM,60-69,3,5,0,0,0,8,0,8,0,8,Lombardia,ITC4
2021-01-16,PF/BT,000547,Ambulatorio Vaccinale Ospedale Militare,LOM,70-79,1,7,0,0,0,8,0,8,0,8,Lombardia,ITC4
2021-01-16,PF/BT,000547,Ambulatorio Vaccinale Ospedale Militare,LOM,80-89,2,17,0,0,0,19,0,19,0,19,Lombardia,ITC4
2021-01-16,PF/BT,000547,Ambulatorio Vaccinale Ospedale Militare,LOM,90+,2,14,0,0,0,16,0,16,0,16,Lombardia,ITC4
2021-01-16,PF/BT,000928,RSA FONDAZIONE VISCONTI VENOSTA GROSIO,LOM,40-49,0,2,0,2,0,0,0,2,0,2,Lombardia,ITC4
2021-01-16,PF/BT,000928,RSA FONDAZIONE VISCONTI VENOSTA GROSIO,LOM,50-59,0,1,0,1,0,0,0,1,0,1,Lombardia,ITC4
2021-01-16,PF/BT,000928,RSA FONDAZIONE VISCONTI VENOSTA GROSIO,LOM,60-69,0,3,0,3,0,0,0,3,0,3,Lombardia,ITC4
2021-01-16,PF/BT,000961,RSA BAITA SERENA,LOM,20-29,0,1,0,1,0,0,0,1,0,1,Lombardia,ITC4
2021-01-16,PF/BT,000961,RSA BAITA SERENA,LOM,30-39,3,4,0,4,3,0,0,7,0,7,Lombardia,ITC4
2021-01-16,PF/BT,000961,RSA BAITA SERENA,LOM,40-49,1,2,0,2,1,0,0,3,0,3,Lombardia,ITC4
2021-01-16,PF/BT,000961,RSA BAITA SERENA,LOM,50-59,3,7,0,6,4,0,0,10,0,10,Lombardia,ITC4
2021-01-16,PF/BT,000961,RSA BAITA SERENA,LOM,60-69,1,0,0,1,0,0,0,1,0,1,Lombardia,ITC4
2021-01-16,PF/BT,001995,"Fondazione ""Tosi/Cippelletti di Rivarolo Mantovano"" Onlus",LOM,30-39,0,2,0,1,1,0,0,2,0,2,Lombardia,ITC4
2021-01-16,PF/BT,001995,"Fondazione ""Tosi/Cippelletti di Rivarolo Mantovano"" Onlus",LOM,40-49,1,5,0,3,3,0,0,6,0,6,Lombardia,ITC4
2021-01-16,PF/BT,001995,"Fondazione ""Tosi/Cippelletti di Rivarolo Mantovano"" Onlus",LOM,50-59,0,4,0,3,1,0,0,4,0,4,Lombardia,ITC4
2021-01-16,PF/BT,001995,"Fondazione ""Tosi/Cippelletti di Rivarolo Mantovano"" Onlus",LOM,70-79,0,1,0,1,0,0,0,1,0,1,Lombardia,ITC4
2021-01-16,PF/BT,001995,"Fondazione ""Tosi/Cippelletti di Rivarolo Mantovano"" Onlus",LOM,80-89,0,5,0,0,0,5,0,5,0,5,Lombardia,ITC4
2021-01-16,PF/BT,001995,"Fondazione ""Tosi/Cippelletti di Rivarolo Mantovano"" Onlus",LOM,90+,0,5,0,0,0,5,0,5,0,5,Lombardia,ITC4
2021-01-16,PF/BT,030 - 322 - 002785,RSA Via Varesina,LOM,30-39,1,1,0,2,0,0,0,2,0,2,Lombardia,ITC4
2021-01-16,PF/BT,030 - 322 - 002785,RSA Via Varesina,LOM,40-49,4,2,0,3,3,0,0,6,0,6,Lombardia,ITC4
2021-01-16,PF/BT,030 - 322 - 002785,RSA Via Varesina,LOM,50-59,0,7,0,6,1,0,0,7,0,7,Lombardia,ITC4
2021-01-16,PF/BT,030 - 322 - 002785,RSA Via Varesina,LOM,60-69,1,2,0,1,2,0,0,3,0,3,Lombardia,ITC4
2021-01-16,PF/BT,030017,Istituto clinico Casa di cura Mater Domini -Castellanza,LOM,20-29,4,11,0,10,5,0,0,15,0,15,Lombardia,ITC4
2021-01-16,PF/BT,030017,Istituto clinico Casa di cura Mater Domini -Castellanza,LOM,30-39,4,8,0,10,2,0,0,12,0,12,Lombardia,ITC4
2021-01-16,PF/BT,030017,Istituto clinico Casa di cura Mater Domini -Castellanza,LOM,40-49,1,8,0,6,3,0,0,9,0,9,Lombardia,ITC4
2021-01-16,PF/BT,030017,Istituto clinico Casa di cura Mater Domini -Castellanza,LOM,50-59,0,2,0,1,1,0,0,2,0,2,Lombardia,ITC4
2021-01-16,PF/BT,030017,Istituto clinico Casa di cura Mater Domini -Castellanza,LOM,60-69,5,3,0,4,4,0,0,8,0,8,Lombardia,ITC4
2021-01-16,PF/BT,030017,Istituto clinico Casa di cura Mater Domini -Castellanza,LOM,70-79,2,0,0,1,1,0,0,2,0,2,Lombardia,ITC4
2021-01-16,PF/BT,030066,CV Garbagnate,LOM,20-29,2,2,0,3,1,0,0,4,0,4,Lombardia,ITC4
2021-01-16,PF/BT,030066,CV Garbagnate,LOM,30-39,5,4,0,3,6,0,0,9,0,9,Lombardia,ITC4
2021-01-16,PF/BT,030066,CV Garbagnate,LOM,40-49,7,14,0,10,11,0,0,21,0,21,Lombardia,ITC4
2021-01-16,PF/BT,030066,CV Garbagnate,LOM,50-59,7,52,0,24,35,0,0,59,0,59,Lombardia,ITC4
2021-01-16,PF/BT,030066,CV Garbagnate,LOM,60-69,6,27,0,17,16,0,0,33,0,33,Lombardia,ITC4
2021-01-16,PF/BT,030068,PUNTO VACCINALE OSPEDALIERO DESIO,LOM,16-19,1,1,0,2,0,0,0,2,0,2,Lombardia,ITC4
2021-01-16,PF/BT,030068,PUNTO VACCINALE OSPEDALIERO DESIO,LOM,20-29,12,17,0,27,2,0,0,29,0,29,Lombardia,ITC4
2021-01-16,PF/BT,030068,PUNTO VACCINALE OSPEDALIERO DESIO,LOM,30-39,5,19,0,19,5,0,0,24,0,24,Lombardia,ITC4
2021-01-16,PF/BT,030068,PUNTO VACCINALE OSPEDALIERO DESIO,LOM,40-49,12,41,0,30,23,0,0,53,0,53,Lombardia,ITC4
2021-01-16,PF/BT,030068,PUNTO VACCINALE OSPEDALIERO DESIO,LOM,50-59,17,67,0,65,19,0,0,84,0,84,Lombardia,ITC4
2021-01-16,PF/BT,030068,PUNTO VACCINALE OSPEDALIERO DESIO,LOM,60-69,7,22,0,23,6,0,0,29,0,29,Lombardia,ITC4
2021-01-16,PF/BT,030068,PUNTO VACCINALE OSPEDALIERO DESIO,LOM,70-79,1,1,0,2,0,0,0,2,0,2,Lombardia,ITC4
2021-01-16,PF/BT,030070,PUNTO VACCINALE OSPEDALIERO CARATE BRIANZA,LOM,16-19,0,1,0,1,0,0,0,1,0,1,Lombardia,ITC4
2021-01-16,PF/BT,030070,PUNTO VACCINALE OSPEDALIERO CARATE BRIANZA,LOM,20-29,6,13,0,15,4,0,0,19,0,19,Lombardia,ITC4
2021-01-16,PF/BT,030070,PUNTO VACCINALE OSPEDALIERO CARATE BRIANZA,LOM,30-39,3,16,0,17,2,0,0,19,0,19,Lombardia,ITC4
2021-01-16,PF/BT,030070,PUNTO VACCINALE OSPEDALIERO CARATE BRIANZA,LOM,40-49,4,28,0,27,5,0,0,32,0,32,Lombardia,ITC4
2021-01-16,PF/BT,030070,PUNTO VACCINALE OSPEDALIERO CARATE BRIANZA,LOM,50-59,12,47,0,41,18,0,0,59,0,59,Lombardia,ITC4
2021-01-16,PF/BT,030070,PUNTO VACCINALE OSPEDALIERO CARATE BRIANZA,LOM,60-69,5,17,0,18,4,0,0,22,0,22,Lombardia,ITC4
2021-01-16,PF/BT,030070,PUNTO VACCINALE OSPEDALIERO CARATE BRIANZA,LOM,70-79,6,0,0,4,2,0,0,6,0,6,Lombardia,ITC4
2021-01-16,PF/BT,030078,PUNTO VACCINALE OSPEDALIERO VIMERCATE,LOM,16-19,0,1,0,1,0,0,0,1,0,1,Lombardia,ITC4
2021-01-16,PF/BT,030078,PUNTO VACCINALE OSPEDALIERO VIMERCATE,LOM,20-29,9,15,0,17,6,0,1,24,0,24,Lombardia,ITC4
2021-01-16,PF/BT,030078,PUNTO VACCINALE OSPEDALIERO VIMERCATE,LOM,30-39,11,12,0,14,9,0,0,23,0,23,Lombardia,ITC4
2021-01-16,PF/BT,030078,PUNTO VACCINALE OSPEDALIERO VIMERCATE,LOM,40-49,9,29,0,24,13,0,1,38,0,38,Lombardia,ITC4
2021-01-16,PF/BT,030078,PUNTO VACCINALE OSPEDALIERO VIMERCATE,LOM,50-59,12,27,0,22,17,0,0,39,0,39,Lombardia,ITC4
2021-01-16,PF/BT,030078,PUNTO VACCINALE OSPEDALIERO VIMERCATE,LOM,60-69,16,11,0,20,7,0,0,27,0,27,Lombardia,ITC4
2021-01-16,PF/BT,030078,PUNTO VACCINALE OSPEDALIERO VIMERCATE,LOM,70-79,5,2,0,7,0,0,0,7,0,7,Lombardia,ITC4
2021-01-16,PF/BT,030178,ISTITUTO CLINICO CITTA' DI BRESCIA DI ISTITUTI OSPEDALIERI BRESCIANI,LOM,20-29,1,0,0,1,0,0,0,1,0,1,Lombardia,ITC4
2021-01-16,PF/BT,030178,ISTITUTO CLINICO CITTA' DI BRESCIA DI ISTITUTI OSPEDALIERI BRESCIANI,LOM,30-39,4,1,0,5,0,0,0,5,0,5,Lombardia,ITC4
2021-01-16,PF/BT,030178,ISTITUTO CLINICO CITTA' DI BRESCIA DI ISTITUTI OSPEDALIERI BRESCIANI,LOM,40-49,0,10,0,10,0,0,0,10,0,10,Lombardia,ITC4
2021-01-16,PF/BT,030178,ISTITUTO CLINICO CITTA' DI BRESCIA DI ISTITUTI OSPEDALIERI BRESCIANI,LOM,50-59,0,7,0,7,0,0,0,7,0,7,Lombardia,ITC4
2021-01-16,PF/BT,030178,ISTITUTO CLINICO CITTA' DI BRESCIA DI ISTITUTI OSPEDALIERI BRESCIANI,LOM,60-69,1,0,0,0,1,0,0,1,0,1,Lombardia,ITC4
2021-01-16,PF/BT,03019800,ISTITUTO CLINICO BEATO MATTEO,LOM,20-29,0,2,0,2,0,0,0,2,0,2,Lombardia,ITC4
2021-01-16,PF/BT,03019800,ISTITUTO CLINICO BEATO MATTEO,LOM,30-39,2,3,0,4,1,0,0,5,0,5,Lombardia,ITC4
2021-01-16,PF/BT,03019800,ISTITUTO CLINICO BEATO MATTEO,LOM,40-49,2,12,0,11,3,0,0,14,0,14,Lombardia,ITC4
2021-01-16,PF/BT,03019800,ISTITUTO CLINICO BEATO MATTEO,LOM,50-59,3,9,0,9,3,0,0,12,0,12,Lombardia,ITC4
2021-01-16,PF/BT,03019800,ISTITUTO CLINICO BEATO MATTEO,LOM,60-69,0,2,0,1,1,0,0,2,0,2,Lombardia,ITC4
2021-01-16,PF/BT,03019800,ISTITUTO CLINICO BEATO MATTEO,LOM,80-89,1,0,0,0,1,0,0,1,0,1,Lombardia,ITC4
2021-01-16,PF/BT,03020200,ISTITUTO DI CURA CITTA' DI PAVIA,LOM,16-19,2,9,0,11,0,0,0,11,0,11,Lombardia,ITC4
2021-01-16,PF/BT,03020200,ISTITUTO DI CURA CITTA' DI PAVIA,LOM,20-29,9,60,0,68,1,0,0,69,0,69,Lombardia,ITC4
2021-01-16,PF/BT,03020200,ISTITUTO DI CURA CITTA' DI PAVIA,LOM,30-39,1,0,0,1,0,0,0,1,0,1,Lombardia,ITC4
2021-01-16,PF/BT,03020200,ISTITUTO DI CURA CITTA' DI PAVIA,LOM,40-49,0,2,0,2,0,0,0,2,0,2,Lombardia,ITC4
2021-01-16,PF/BT,03020200,ISTITUTO DI CURA CITTA' DI PAVIA,LOM,50-59,0,1,0,1,0,0,0,1,0,1,Lombardia,ITC4
2021-01-16,PF/BT,030295,Fondazione Poliambulanza - Brescia,LOM,20-29,6,23,0,18,11,0,0,29,0,29,Lombardia,ITC4
2021-01-16,PF/BT,030295,Fondazione Poliambulanza - Brescia,LOM,30-39,8,17,0,15,10,0,0,25,0,25,Lombardia,ITC4
2021-01-16,PF/BT,030295,Fondazione Poliambulanza - Brescia,LOM,40-49,8,41,0,26,23,0,0,49,0,49,Lombardia,ITC4
2021-01-16,PF/BT,030295,Fondazione Poliambulanza - Brescia,LOM,50-59,11,38,0,18,31,0,0,49,0,49,Lombardia,ITC4
2021-01-16,PF/BT,030295,Fondazione Poliambulanza - Brescia,LOM,60-69,2,1,0,3,0,0,0,3,0,3,Lombardia,ITC4
2021-01-16,PF/BT,030295,Fondazione Poliambulanza - Brescia,LOM,70-79,1,0,0,0,1,0,0,1,0,1,Lombardia,ITC4
2021-01-16,PF/BT,030-322-002809,FONDAZIONE ANNA BORLETTI,LOM,20-29,0,2,0,2,0,0,0,2,0,2,Lombardia,ITC4
2021-01-16,PF/BT,030-322-002809,FONDAZIONE ANNA BORLETTI,LOM,30-39,0,4,0,4,0,0,0,4,0,4,Lombardia,ITC4
2021-01-16,PF/BT,030-322-002809,FONDAZIONE ANNA BORLETTI,LOM,40-49,1,6,0,6,1,0,0,7,0,7,Lombardia,ITC4
2021-01-16,PF/BT,030-322-002809,FONDAZIONE ANNA BORLETTI,LOM,50-59,1,6,0,7,0,0,0,7,0,7,Lombardia,ITC4
2021-01-16,PF/BT,030-322-002809,FONDAZIONE ANNA BORLETTI,LOM,60-69,0,2,0,1,0,1,0,2,0,2,Lombardia,ITC4
2021-01-16,PF/BT,030-322-002809,FONDAZIONE ANNA BORLETTI,LOM,70-79,4,5,0,0,0,9,0,9,0,9,Lombardia,ITC4
2021-01-16,PF/BT,030-322-002809,FONDAZIONE ANNA BORLETTI,LOM,80-89,4,7,0,0,0,11,0,11,0,11,Lombardia,ITC4
2021-01-16,PF/BT,030-322-002809,FONDAZIONE ANNA BORLETTI,LOM,90+,3,15,0,0,0,18,0,18,0,18,Lombardia,ITC4
2021-01-16,PF/BT,030322002847,RSA VILLA CITTERIO,LOM,30-39,0,1,0,1,0,0,0,1,0,1,Lombardia,ITC4
2021-01-16,PF/BT,030322002847,RSA VILLA CITTERIO,LOM,40-49,2,5,0,6,1,0,0,7,0,7,Lombardia,ITC4
2021-01-16,PF/BT,030322002847,RSA VILLA CITTERIO,LOM,50-59,1,10,0,5,6,0,0,11,0,11,Lombardia,ITC4
2021-01-16,PF/BT,030322002847,RSA VILLA CITTERIO,LOM,60-69,0,5,0,5,0,0,0,5,0,5,Lombardia,ITC4
2021-01-16,PF/BT,030903,AMB COVID LECCO,LOM,16-19,1,2,0,1,2,0,0,3,0,3,Lombardia,ITC4
2021-01-16,PF/BT,030903,AMB COVID LECCO,LOM,20-29,29,25,0,38,14,0,2,54,0,54,Lombardia,ITC4
2021-01-16,PF/BT,030903,AMB COVID LECCO,LOM,30-39,37,32,0,45,24,0,0,69,0,69,Lombardia,ITC4
2021-01-16,PF/BT,030903,AMB COVID LECCO,LOM,40-49,56,35,0,53,35,0,3,91,0,91,Lombardia,ITC4
2021-01-16,PF/BT,030903,AMB COVID LECCO,LOM,50-59,84,45,0,79,46,0,4,129,0,129,Lombardia,ITC4
2021-01-16,PF/BT,030903,AMB COVID LECCO,LOM,60-69,53,46,0,60,35,3,1,99,0,99,Lombardia,ITC4
2021-01-16,PF/BT,030903,AMB COVID LECCO,LOM,70-79,26,38,0,22,18,24,0,64,0,64,Lombardia,ITC4
2021-01-16,PF/BT,030903,AMB COVID LECCO,LOM,80-89,13,81,0,6,0,88,0,94,0,94,Lombardia,ITC4
2021-01-16,PF/BT,030903,AMB COVID LECCO,LOM,90+,8,53,0,0,2,59,0,61,0,61,Lombardia,ITC4
2021-01-16,PF/BT,030922,"FOND.IRCCS ""ISTIT.NAZ.LE TUMORI""MILANO",LOM,20-29,1,5,0,1,0,0,5,6,0,6,Lombardia,ITC4
2021-01-16,PF/BT,030922,"FOND.IRCCS ""ISTIT.NAZ.LE TUMORI""MILANO",LOM,30-39,3,4,0,0,0,0,7,7,0,7,Lombardia,ITC4
2021-01-16,PF/BT,030922,"FOND.IRCCS ""ISTIT.NAZ.LE TUMORI""MILANO",LOM,40-49,6,4,0,0,0,0,10,10,0,10,Lombardia,ITC4
2021-01-16,PF/BT,030922,"FOND.IRCCS ""ISTIT.NAZ.LE TUMORI""MILANO",LOM,50-59,6,28,0,1,0,0,33,34,0,34,Lombardia,ITC4
2021-01-16,PF/BT,030922,"FOND.IRCCS ""ISTIT.NAZ.LE TUMORI""MILANO",LOM,60-69,15,61,0,0,0,0,76,76,0,76,Lombardia,ITC4
2021-01-16,PF/BT,030922,"FOND.IRCCS ""ISTIT.NAZ.LE TUMORI""MILANO",LOM,70-79,17,32,0,0,0,0,49,49,0,49,Lombardia,ITC4
2021-01-16,PF/BT,030922,"FOND.IRCCS ""ISTIT.NAZ.LE TUMORI""MILANO",LOM,80-89,1,7,0,0,0,0,8,8,0,8,Lombardia,ITC4
2021-01-16,PF/BT,030922,"FOND.IRCCS ""ISTIT.NAZ.LE TUMORI""MILANO",LOM,90+,0,2,0,0,0,0,2,2,0,2,Lombardia,ITC4
2021-01-16,PF/BT,030924,IRCCS POLICLINICO S. MATTEO - PAVIA,LOM,20-29,17,41,0,50,8,0,0,58,0,58,Lombardia,ITC4
2021-01-16,PF/BT,030924,IRCCS POLICLINICO S. MATTEO - PAVIA,LOM,30-39,35,46,0,65,15,0,1,81,0,81,Lombardia,ITC4
2021-01-16,PF/BT,030924,IRCCS POLICLINICO S. MATTEO - PAVIA,LOM,40-49,24,33,0,44,11,0,2,57,0,57,Lombardia,ITC4
2021-01-16,PF/BT,030924,IRCCS POLICLINICO S. MATTEO - PAVIA,LOM,50-59,36,50,0,42,38,0,6,86,0,86,Lombardia,ITC4
2021-01-16,PF/BT,030924,IRCCS POLICLINICO S. MATTEO - PAVIA,LOM,60-69,14,9,0,16,6,0,1,23,0,23,Lombardia,ITC4
2021-01-16,PF/BT,030924,IRCCS POLICLINICO S. MATTEO - PAVIA,LOM,70-79,1,0,0,1,0,0,0,1,0,1,Lombardia,ITC4
2021-01-16,PF/BT,030925,Fondazione IRCCS Ca' Granda Ospedale Maggiore Policlinico,LOM,16-19,0,5,0,5,0,0,0,5,0,5,Lombardia,ITC4
2021-01-16,PF/BT,030925,Fondazione IRCCS Ca' Granda Ospedale Maggiore Policlinico,LOM,20-29,10,51,0,57,4,0,0,61,0,61,Lombardia,ITC4
2021-01-16,PF/BT,030925,Fondazione IRCCS Ca' Granda Ospedale Maggiore Policlinico,LOM,30-39,15,21,0,30,6,0,0,36,0,36,Lombardia,ITC4
2021-01-16,PF/BT,030925,Fondazione IRCCS Ca' Granda Ospedale Maggiore Policlinico,LOM,40-49,12,36,0,38,10,0,0,48,0,48,Lombardia,ITC4
2021-01-16,PF/BT,030925,Fondazione IRCCS Ca' Granda Ospedale Maggiore Policlinico,LOM,50-59,26,45,0,61,10,0,0,71,0,71,Lombardia,ITC4
2021-01-16,PF/BT,030925,Fondazione IRCCS Ca' Granda Ospedale Maggiore Policlinico,LOM,60-69,25,15,0,33,7,0,0,40,0,40,Lombardia,ITC4
2021-01-16,PF/BT,030925,Fondazione IRCCS Ca' Granda Ospedale Maggiore Policlinico,LOM,70-79,2,1,0,2,1,0,0,3,0,3,Lombardia,ITC4
2021-01-16,PF/BT,030935,IRCCS    S. RAFFAELE - MILANO,LOM,20-29,5,6,0,11,0,0,0,11,0,11,Lombardia,ITC4
2021-01-16,PF/BT,030935,IRCCS    S. RAFFAELE - MILANO,LOM,30-39,8,8,0,16,0,0,0,16,0,16,Lombardia,ITC4
2021-01-16,PF/BT,030935,IRCCS    S. RAFFAELE - MILANO,LOM,40-49,9,32,0,41,0,0,0,41,0,41,Lombardia,ITC4
2021-01-16,PF/BT,030935,IRCCS    S. RAFFAELE - MILANO,LOM,50-59,10,17,0,27,0,0,0,27,0,27,Lombardia,ITC4
2021-01-16,PF/BT,030935,IRCCS    S. RAFFAELE - MILANO,LOM,60-69,4,3,0,7,0,0,0,7,0,7,Lombardia,ITC4
2021-01-16,PF/BT,030937,PRO JOVENTUDE DON C. GNOCCHI - MI IRCCS PRIVATO,LOM,20-29,11,12,0,23,0,0,0,23,0,23,Lombardia,ITC4
2021-01-16,PF/BT,030937,PRO JOVENTUDE DON C. GNOCCHI - MI IRCCS PRIVATO,LOM,30-39,16,9,0,25,0,0,0,25,0,25,Lombardia,ITC4
2021-01-16,PF/BT,030937,PRO JOVENTUDE DON C. GNOCCHI - MI IRCCS PRIVATO,LOM,40-49,7,16,0,22,1,0,0,23,0,23,Lombardia,ITC4
2021-01-16,PF/BT,030937,PRO JOVENTUDE DON C. GNOCCHI - MI IRCCS PRIVATO,LOM,50-59,7,22,0,29,0,0,0,29,0,29,Lombardia,ITC4
2021-01-16,PF/BT,030937,PRO JOVENTUDE DON C. GNOCCHI - MI IRCCS PRIVATO,LOM,60-69,2,10,0,11,1,0,0,12,0,12,Lombardia,ITC4
2021-01-16,PF/BT,030937,PRO JOVENTUDE DON C. GNOCCHI - MI IRCCS PRIVATO,LOM,70-79,2,0,0,2,0,0,0,2,0,2,Lombardia,ITC4
2021-01-16,PF/BT,1284,FONDAZIONE GIOVANNI CARLO ROTA,LOM,20-29,1,3,0,4,0,0,0,4,0,4,Lombardia,ITC4
2021-01-16,PF/BT,1284,FONDAZIONE GIOVANNI CARLO ROTA,LOM,30-39,1,0,0,1,0,0,0,1,0,1,Lombardia,ITC4
2021-01-16,PF/BT,1284,FONDAZIONE GIOVANNI CARLO ROTA,LOM,40-49,1,3,0,4,0,0,0,4,0,4,Lombardia,ITC4
2021-01-16,PF/BT,1284,FONDAZIONE GIOVANNI CARLO ROTA,LOM,50-59,1,6,0,6,1,0,0,7,0,7,Lombardia,ITC4
2021-01-16,PF/BT,1284,FONDAZIONE GIOVANNI CARLO ROTA,LOM,60-69,0,2,0,1,1,0,0,2,0,2,Lombardia,ITC4
2021-01-16,PF/BT,1585,RSA FEROLDI,LOM,20-29,0,3,0,3,0,0,0,3,0,3,Lombardia,ITC4
2021-01-16,PF/BT,1585,RSA FEROLDI,LOM,30-39,1,1,0,2,0,0,0,2,0,2,Lombardia,ITC4
2021-01-16,PF/BT,1585,RSA FEROLDI,LOM,40-49,0,3,0,2,1,0,0,3,0,3,Lombardia,ITC4
2021-01-16,PF/BT,1585,RSA FEROLDI,LOM,50-59,0,5,0,2,3,0,0,5,0,5,Lombardia,ITC4
2021-01-16,PF/BT,1585,RSA FEROLDI,LOM,60-69,2,3,0,2,3,0,0,5,0,5,Lombardia,ITC4
2021-01-16,PF/BT,1668,SOGGIORNO SERENO EMILIA ED EGIDIO PASINI ONLUS,LOM,20-29,0,2,0,1,1,0,0,2,0,2,Lombardia,ITC4
2021-01-16,PF/BT,1668,SOGGIORNO SERENO EMILIA ED EGIDIO PASINI ONLUS,LOM,40-49,1,5,0,4,2,0,0,6,0,6,Lombardia,ITC4
2021-01-16,PF/BT,1668,SOGGIORNO SERENO EMILIA ED EGIDIO PASINI ONLUS,LOM,50-59,0,2,0,2,0,0,0,2,0,2,Lombardia,ITC4
2021-01-16,PF/BT,1668,SOGGIORNO SERENO EMILIA ED EGIDIO PASINI ONLUS,LOM,70-79,1,4,0,0,0,5,0,5,0,5,Lombardia,ITC4
2021-01-16,PF/BT,1668,SOGGIORNO SERENO EMILIA ED EGIDIO PASINI ONLUS,LOM,80-89,4,9,0,0,0,13,0,13,0,13,Lombardia,ITC4
2021-01-16,PF/BT,1668,SOGGIORNO SERENO EMILIA ED EGIDIO PASINI ONLUS,LOM,90+,2,12,0,0,0,14,0,14,0,14,Lombardia,ITC4
2021-01-16,PF/BT,167,ASST SPEDALI CIVILI AMBULATORIO COVID BRESCIA,LOM,20-29,21,43,0,49,14,0,1,64,0,64,Lombardia,ITC4
2021-01-16,PF/BT,167,ASST SPEDALI CIVILI AMBULATORIO COVID BRESCIA,LOM,30-39,38,46,0,50,32,0,2,84,0,84,Lombardia,ITC4
2021-01-16,PF/BT,167,ASST SPEDALI CIVILI AMBULATORIO COVID BRESCIA,LOM,40-49,32,81,0,66,45,0,2,113,0,113,Lombardia,ITC4
2021-01-16,PF/BT,167,ASST SPEDALI CIVILI AMBULATORIO COVID BRESCIA,LOM,50-59,51,109,0,80,80,0,0,160,0,160,Lombardia,ITC4
2021-01-16,PF/BT,167,ASST SPEDALI CIVILI AMBULATORIO COVID BRESCIA,LOM,60-69,15,28,0,19,24,0,0,43,0,43,Lombardia,ITC4
2021-01-16,PF/BT,167,ASST SPEDALI CIVILI AMBULATORIO COVID BRESCIA,LOM,70-79,3,0,0,1,2,0,0,3,0,3,Lombardia,ITC4
2021-01-16,PF/BT,167,ASST SPEDALI CIVILI AMBULATORIO COVID BRESCIA,LOM,80-89,0,1,0,0,0,0,1,1,0,1,Lombardia,ITC4
2021-01-16,PF/BT,1731,"RSA - CASA DI RIPOSO ""B. BERTELLA"" - SABBIO CHIESE",LOM,20-29,1,1,0,2,0,0,0,2,0,2,Lombardia,ITC4
2021-01-16,PF/BT,1731,"RSA - CASA DI RIPOSO ""B. BERTELLA"" - SABBIO CHIESE",LOM,30-39,1,4,0,4,1,0,0,5,0,5,Lombardia,ITC4
2021-01-16,PF/BT,1731,"RSA - CASA DI RIPOSO ""B. BERTELLA"" - SABBIO CHIESE",LOM,40-49,0,11,0,9,2,0,0,11,0,11,Lombardia,ITC4
2021-01-16,PF/BT,1731,"RSA - CASA DI RIPOSO ""B. BERTELLA"" - SABBIO CHIESE",LOM,50-59,4,11,0,10,5,0,0,15,0,15,Lombardia,ITC4
2021-01-16,PF/BT,1731,"RSA - CASA DI RIPOSO ""B. BERTELLA"" - SABBIO CHIESE",LOM,60-69,2,3,0,2,3,0,0,5,0,5,Lombardia,ITC4
2021-01-16,PF/BT,1731,"RSA - CASA DI RIPOSO ""B. BERTELLA"" - SABBIO CHIESE",LOM,70-79,0,4,0,0,0,4,0,4,0,4,Lombardia,ITC4
2021-01-16,PF/BT,1731,"RSA - CASA DI RIPOSO ""B. BERTELLA"" - SABBIO CHIESE",LOM,80-89,5,11,0,0,1,15,0,16,0,16,Lombardia,ITC4
2021-01-16,PF/BT,1731,"RSA - CASA DI RIPOSO ""B. BERTELLA"" - SABBIO CHIESE",LOM,90+,0,5,0,0,0,5,0,5,0,5,Lombardia,ITC4
2021-01-16,PF/BT,1745,FONDAZIONE RSA CASA DI RIPOSO DI SALO' RESIDENZA GLI ULIVI,LOM,20-29,0,1,0,0,1,0,0,1,0,1,Lombardia,ITC4
2021-01-16,PF/BT,1745,FONDAZIONE RSA CASA DI RIPOSO DI SALO' RESIDENZA GLI ULIVI,LOM,40-49,0,6,0,3,3,0,0,6,0,6,Lombardia,ITC4
2021-01-16,PF/BT,1745,FONDAZIONE RSA CASA DI RIPOSO DI SALO' RESIDENZA GLI ULIVI,LOM,50-59,0,5,0,2,3,0,0,5,0,5,Lombardia,ITC4
2021-01-16,PF/BT,1745,FONDAZIONE RSA CASA DI RIPOSO DI SALO' RESIDENZA GLI ULIVI,LOM,60-69,1,1,0,0,0,2,0,2,0,2,Lombardia,ITC4
2021-01-16,PF/BT,1745,FONDAZIONE RSA CASA DI RIPOSO DI SALO' RESIDENZA GLI ULIVI,LOM,70-79,1,3,0,0,0,4,0,4,0,4,Lombardia,ITC4
2021-01-16,PF/BT,1745,FONDAZIONE RSA CASA DI RIPOSO DI SALO' RESIDENZA GLI ULIVI,LOM,80-89,3,12,0,0,0,15,0,15,0,15,Lombardia,ITC4
2021-01-16,PF/BT,1745,FONDAZIONE RSA CASA DI RIPOSO DI SALO' RESIDENZA GLI ULIVI,LOM,90+,1,14,0,0,0,15,0,15,0,15,Lombardia,ITC4
2021-01-16,PF/BT,1774,0,LOM,30-39,0,1,0,1,0,0,0,1,0,1,Lombardia,ITC4
2021-01-16,PF/BT,1774,0,LOM,60-69,1,0,0,0,0,1,0,1,0,1,Lombardia,ITC4
2021-01-16,PF/BT,1774,0,LOM,70-79,1,1,0,0,0,2,0,2,0,2,Lombardia,ITC4
2021-01-16,PF/BT,1774,0,LOM,80-89,2,4,0,0,0,6,0,6,0,6,Lombardia,ITC4
2021-01-16,PF/BT,1774,0,LOM,90+,1,7,0,0,0,8,0,8,0,8,Lombardia,ITC4
2021-01-16,PF/BT,1934,FONDAZIONE BRUNO PARI ONLUS,LOM,20-29,3,5,0,8,0,0,0,8,0,8,Lombardia,ITC4
2021-01-16,PF/BT,1934,FONDAZIONE BRUNO PARI ONLUS,LOM,30-39,1,11,0,11,1,0,0,12,0,12,Lombardia,ITC4
2021-01-16,PF/BT,1934,FONDAZIONE BRUNO PARI ONLUS,LOM,40-49,0,9,0,8,1,0,0,9,0,9,Lombardia,ITC4
2021-01-16,PF/BT,1934,FONDAZIONE BRUNO PARI ONLUS,LOM,50-59,1,15,0,14,2,0,0,16,0,16,Lombardia,ITC4
2021-01-16,PF/BT,1934,FONDAZIONE BRUNO PARI ONLUS,LOM,60-69,0,1,0,0,1,0,0,1,0,1,Lombardia,ITC4
2021-01-16,PF/BT,1944,FOND. OSPEDALE GIUSEPPE ARAGONA - SAN GIOVANNI IN CROCE (CR),LOM,16-19,0,1,0,1,0,0,0,1,0,1,Lombardia,ITC4
2021-01-16,PF/BT,1944,FOND. OSPEDALE GIUSEPPE ARAGONA - SAN GIOVANNI IN CROCE (CR),LOM,20-29,3,6,0,9,0,0,0,9,0,9,Lombardia,ITC4
2021-01-16,PF/BT,1944,FOND. OSPEDALE GIUSEPPE ARAGONA - SAN GIOVANNI IN CROCE (CR),LOM,30-39,4,9,0,13,0,0,0,13,0,13,Lombardia,ITC4
2021-01-16,PF/BT,1944,FOND. OSPEDALE GIUSEPPE ARAGONA - SAN GIOVANNI IN CROCE (CR),LOM,40-49,2,20,0,21,1,0,0,22,0,22,Lombardia,ITC4
2021-01-16,PF/BT,1944,FOND. OSPEDALE GIUSEPPE ARAGONA - SAN GIOVANNI IN CROCE (CR),LOM,50-59,0,35,0,32,3,0,0,35,0,35,Lombardia,ITC4
2021-01-16,PF/BT,1944,FOND. OSPEDALE GIUSEPPE ARAGONA - SAN GIOVANNI IN CROCE (CR),LOM,60-69,1,6,0,4,3,0,0,7,0,7,Lombardia,ITC4
2021-01-16,PF/BT,1944,FOND. OSPEDALE GIUSEPPE ARAGONA - SAN GIOVANNI IN CROCE (CR),LOM,70-79,2,1,0,1,2,0,0,3,0,3,Lombardia,ITC4
2021-01-16,PF/BT,1946,"FONDAZIONE ""CONTE DR. CARLO CARACCI"" - ONLUS",LOM,20-29,0,1,0,1,0,0,0,1,0,1,Lombardia,ITC4
2021-01-16,PF/BT,1946,"FONDAZIONE ""CONTE DR. CARLO CARACCI"" - ONLUS",LOM,30-39,0,2,0,2,0,0,0,2,0,2,Lombardia,ITC4
2021-01-16,PF/BT,1946,"FONDAZIONE ""CONTE DR. CARLO CARACCI"" - ONLUS",LOM,40-49,0,2,0,2,0,0,0,2,0,2,Lombardia,ITC4
2021-01-16,PF/BT,1946,"FONDAZIONE ""CONTE DR. CARLO CARACCI"" - ONLUS",LOM,50-59,1,3,0,2,1,0,1,4,0,4,Lombardia,ITC4
2021-01-16,PF/BT,1946,"FONDAZIONE ""CONTE DR. CARLO CARACCI"" - ONLUS",LOM,70-79,0,1,0,0,0,1,0,1,0,1,Lombardia,ITC4
2021-01-16,PF/BT,1946,"FONDAZIONE ""CONTE DR. CARLO CARACCI"" - ONLUS",LOM,80-89,0,5,0,0,0,5,0,5,0,5,Lombardia,ITC4
2021-01-16,PF/BT,1946,"FONDAZIONE ""CONTE DR. CARLO CARACCI"" - ONLUS",LOM,90+,0,3,0,0,0,3,0,3,0,3,Lombardia,ITC4
2021-01-16,PF/BT,1948,FONDAZIONE SCARPARI FORATTINI ONLUS,LOM,30-39,0,1,0,1,0,0,0,1,0,1,Lombardia,ITC4
2021-01-16,PF/BT,1948,FONDAZIONE SCARPARI FORATTINI ONLUS,LOM,50-59,0,3,0,1,2,0,0,3,0,3,Lombardia,ITC4
2021-01-16,PF/BT,1948,FONDAZIONE SCARPARI FORATTINI ONLUS,LOM,60-69,0,2,0,1,1,0,0,2,0,2,Lombardia,ITC4
2021-01-16,PF/BT,2071,RSA CORTELLONA MORTARA,LOM,40-49,0,1,0,1,0,0,0,1,0,1,Lombardia,ITC4
2021-01-16,PF/BT,2071,RSA CORTELLONA MORTARA,LOM,50-59,0,3,0,3,0,0,0,3,0,3,Lombardia,ITC4
2021-01-16,PF/BT,2071,RSA CORTELLONA MORTARA,LOM,60-69,0,1,0,1,0,0,0,1,0,1,Lombardia,ITC4
2021-01-16,PF/BT,2071,RSA CORTELLONA MORTARA,LOM,80-89,0,1,0,0,0,1,0,1,0,1,Lombardia,ITC4
2021-01-16,PF/BT,2761,FONDAZIONE CA'D'INDUSTRIA LE CAMELIE,LOM,30-39,0,1,0,1,0,0,0,1,0,1,Lombardia,ITC4
2021-01-16,PF/BT,2761,FONDAZIONE CA'D'INDUSTRIA LE CAMELIE,LOM,40-49,1,2,0,2,1,0,0,3,0,3,Lombardia,ITC4
2021-01-16,PF/BT,2761,FONDAZIONE CA'D'INDUSTRIA LE CAMELIE,LOM,50-59,0,5,0,2,3,0,0,5,0,5,Lombardia,ITC4
2021-01-16,PF/BT,2761,FONDAZIONE CA'D'INDUSTRIA LE CAMELIE,LOM,60-69,1,0,0,0,1,0,0,1,0,1,Lombardia,ITC4
2021-01-16,PF/BT,2761,FONDAZIONE CA'D'INDUSTRIA LE CAMELIE,LOM,80-89,0,1,0,0,0,1,0,1,0,1,Lombardia,ITC4
2021-01-16,PF/BT,2761,FONDAZIONE CA'D'INDUSTRIA LE CAMELIE,LOM,90+,0,1,0,0,0,1,0,1,0,1,Lombardia,ITC4
2021-01-16,PF/BT,30072,Centro Vaccinale Covid Vizzolo - ASST Melegnano Martesana,LOM,20-29,6,2,0,8,0,0,0,8,0,8,Lombardia,ITC4
2021-01-16,PF/BT,30072,Centro Vaccinale Covid Vizzolo - ASST Melegnano Martesana,LOM,30-39,9,9,0,18,0,0,0,18,0,18,Lombardia,ITC4
2021-01-16,PF/BT,30072,Centro Vaccinale Covid Vizzolo - ASST Melegnano Martesana,LOM,40-49,17,21,0,37,1,0,0,38,0,38,Lombardia,ITC4
2021-01-16,PF/BT,30072,Centro Vaccinale Covid Vizzolo - ASST Melegnano Martesana,LOM,50-59,13,20,0,33,0,0,0,33,0,33,Lombardia,ITC4
2021-01-16,PF/BT,30072,Centro Vaccinale Covid Vizzolo - ASST Melegnano Martesana,LOM,60-69,34,23,0,57,0,0,0,57,0,57,Lombardia,ITC4
2021-01-16,PF/BT,30072,Centro Vaccinale Covid Vizzolo - ASST Melegnano Martesana,LOM,70-79,2,3,0,0,0,0,5,5,0,5,Lombardia,ITC4
2021-01-16,PF/BT,30073,cv rho,LOM,20-29,0,2,0,2,0,0,0,2,0,2,Lombardia,ITC4
2021-01-16,PF/BT,30073,cv rho,LOM,30-39,3,3,0,3,3,0,0,6,0,6,Lombardia,ITC4
2021-01-16,PF/BT,30073,cv rho,LOM,40-49,2,7,0,8,1,0,0,9,0,9,Lombardia,ITC4
2021-01-16,PF/BT,30073,cv rho,LOM,50-59,2,15,0,15,1,0,1,17,0,17,Lombardia,ITC4
2021-01-16,PF/BT,30073,cv rho,LOM,60-69,11,15,0,25,1,0,0,26,0,26,Lombardia,ITC4
2021-01-16,PF/BT,30074,HUB COVID MAGENTA,LOM,16-19,0,2,0,2,0,0,0,2,0,2,Lombardia,ITC4
2021-01-16,PF/BT,30074,HUB COVID MAGENTA,LOM,20-29,21,41,0,54,8,0,0,62,0,62,Lombardia,ITC4
2021-01-16,PF/BT,30074,HUB COVID MAGENTA,LOM,30-39,24,15,0,28,11,0,0,39,0,39,Lombardia,ITC4
2021-01-16,PF/BT,30074,HUB COVID MAGENTA,LOM,40-49,32,24,0,46,10,0,0,56,0,56,Lombardia,ITC4
2021-01-16,PF/BT,30074,HUB COVID MAGENTA,LOM,50-59,26,21,0,27,20,0,0,47,0,47,Lombardia,ITC4
2021-01-16,PF/BT,30074,HUB COVID MAGENTA,LOM,60-69,38,24,0,15,47,0,0,62,0,62,Lombardia,ITC4
2021-01-16,PF/BT,30074,HUB COVID MAGENTA,LOM,70-79,39,13,0,2,50,0,0,52,0,52,Lombardia,ITC4
2021-01-16,PF/BT,30156,Centro Vaccinale Covid Desenzano,LOM,16-19,1,1,0,2,0,0,0,2,0,2,Lombardia,ITC4
2021-01-16,PF/BT,30156,Centro Vaccinale Covid Desenzano,LOM,20-29,11,22,0,16,0,0,17,33,0,33,Lombardia,ITC4
2021-01-16,PF/BT,30156,Centro Vaccinale Covid Desenzano,LOM,30-39,2,11,0,4,2,0,7,13,0,13,Lombardia,ITC4
2021-01-16,PF/BT,30156,Centro Vaccinale Covid Desenzano,LOM,40-49,12,17,0,11,4,0,14,29,0,29,Lombardia,ITC4
2021-01-16,PF/BT,30156,Centro Vaccinale Covid Desenzano,LOM,50-59,10,26,0,13,3,0,20,36,0,36,Lombardia,ITC4
2021-01-16,PF/BT,30156,Centro Vaccinale Covid Desenzano,LOM,60-69,15,13,0,9,3,0,16,28,0,28,Lombardia,ITC4
2021-01-16,PF/BT,30156,Centro Vaccinale Covid Desenzano,LOM,70-79,8,1,0,0,0,0,9,9,0,9,Lombardia,ITC4
2021-01-16,PF/BT,30157,Centro Vaccinale Covid Gavardo,LOM,20-29,5,4,0,1,1,0,7,9,0,9,Lombardia,ITC4
2021-01-16,PF/BT,30157,Centro Vaccinale Covid Gavardo,LOM,30-39,9,13,0,9,5,0,8,22,0,22,Lombardia,ITC4
2021-01-16,PF/BT,30157,Centro Vaccinale Covid Gavardo,LOM,40-49,5,30,0,19,4,0,12,35,0,35,Lombardia,ITC4
2021-01-16,PF/BT,30157,Centro Vaccinale Covid Gavardo,LOM,50-59,16,19,0,13,5,0,17,35,0,35,Lombardia,ITC4
2021-01-16,PF/BT,30157,Centro Vaccinale Covid Gavardo,LOM,60-69,11,11,0,8,1,0,13,22,0,22,Lombardia,ITC4
2021-01-16,PF/BT,30157,Centro Vaccinale Covid Gavardo,LOM,70-79,7,1,0,1,0,0,7,8,0,8,Lombardia,ITC4
2021-01-16,PF/BT,30176,ISTITUTO CLINICO S. ANNA di ISTITUTI OSPEDALIERI BRESCIANI S.p.A.,LOM,20-29,0,3,0,2,1,0,0,3,0,3,Lombardia,ITC4
2021-01-16,PF/BT,30176,ISTITUTO CLINICO S. ANNA di ISTITUTI OSPEDALIERI BRESCIANI S.p.A.,LOM,30-39,0,2,0,1,1,0,0,2,0,2,Lombardia,ITC4
2021-01-16,PF/BT,30176,ISTITUTO CLINICO S. ANNA di ISTITUTI OSPEDALIERI BRESCIANI S.p.A.,LOM,40-49,4,7,0,7,4,0,0,11,0,11,Lombardia,ITC4
2021-01-16,PF/BT,30176,ISTITUTO CLINICO S. ANNA di ISTITUTI OSPEDALIERI BRESCIANI S.p.A.,LOM,50-59,1,6,0,6,1,0,0,7,0,7,Lombardia,ITC4
2021-01-16,PF/BT,30176,ISTITUTO CLINICO S. ANNA di ISTITUTI OSPEDALIERI BRESCIANI S.p.A.,LOM,70-79,1,0,0,1,0,0,0,1,0,1,Lombardia,ITC4
2021-01-16,PF/BT,30184,Centro Vaccinale Covid Manerbio,LOM,20-29,4,7,0,4,0,0,7,11,0,11,Lombardia,ITC4
2021-01-16,PF/BT,30184,Centro Vaccinale Covid Manerbio,LOM,30-39,6,19,0,13,4,0,8,25,0,25,Lombardia,ITC4
2021-01-16,PF/BT,30184,Centro Vaccinale Covid Manerbio,LOM,40-49,10,21,0,17,6,0,8,31,0,31,Lombardia,ITC4
2021-01-16,PF/BT,30184,Centro Vaccinale Covid Manerbio,LOM,50-59,10,13,0,9,8,0,6,23,0,23,Lombardia,ITC4
2021-01-16,PF/BT,30184,Centro Vaccinale Covid Manerbio,LOM,60-69,15,12,0,8,4,0,15,27,0,27,Lombardia,ITC4
2021-01-16,PF/BT,30184,Centro Vaccinale Covid Manerbio,LOM,70-79,8,0,0,1,0,0,7,8,0,8,Lombardia,ITC4
2021-01-16,PF/BT,30184,Centro Vaccinale Covid Manerbio,LOM,80-89,1,0,0,0,0,0,1,1,0,1,Lombardia,ITC4
2021-01-16,PF/BT,30193,Ambulatorio HUB Vigevano,LOM,16-19,2,2,0,0,4,0,0,4,0,4,Lombardia,ITC4
2021-01-16,PF/BT,30193,Ambulatorio HUB Vigevano,LOM,20-29,14,20,0,0,34,0,0,34,0,34,Lombardia,ITC4
2021-01-16,PF/BT,30193,Ambulatorio HUB Vigevano,LOM,30-39,18,14,0,1,31,0,0,32,0,32,Lombardia,ITC4
2021-01-16,PF/BT,30193,Ambulatorio HUB Vigevano,LOM,40-49,23,12,0,2,33,0,0,35,0,35,Lombardia,ITC4
2021-01-16,PF/BT,30193,Ambulatorio HUB Vigevano,LOM,50-59,24,19,0,0,43,0,0,43,0,43,Lombardia,ITC4
2021-01-16,PF/BT,30193,Ambulatorio HUB Vigevano,LOM,60-69,23,20,0,0,43,0,0,43,0,43,Lombardia,ITC4
2021-01-16,PF/BT,30193,Ambulatorio HUB Vigevano,LOM,70-79,14,15,0,0,29,0,0,29,0,29,Lombardia,ITC4
2021-01-16,PF/BT,30193,Ambulatorio HUB Vigevano,LOM,80-89,3,3,0,0,6,0,0,6,0,6,Lombardia,ITC4
2021-01-16,PF/BT,30194,AMBULATORIO HUB VOGHERA,LOM,16-19,2,4,0,5,1,0,0,6,0,6,Lombardia,ITC4
2021-01-16,PF/BT,30194,AMBULATORIO HUB VOGHERA,LOM,20-29,5,8,0,9,4,0,0,13,0,13,Lombardia,ITC4
2021-01-16,PF/BT,30194,AMBULATORIO HUB VOGHERA,LOM,30-39,14,9,0,20,3,0,0,23,0,23,Lombardia,ITC4
2021-01-16,PF/BT,30194,AMBULATORIO HUB VOGHERA,LOM,40-49,17,14,0,22,9,0,0,31,0,31,Lombardia,ITC4
2021-01-16,PF/BT,30194,AMBULATORIO HUB VOGHERA,LOM,50-59,25,17,0,27,15,0,0,42,0,42,Lombardia,ITC4
2021-01-16,PF/BT,30194,AMBULATORIO HUB VOGHERA,LOM,60-69,9,3,0,7,5,0,0,12,0,12,Lombardia,ITC4
2021-01-16,PF/BT,30194,AMBULATORIO HUB VOGHERA,LOM,70-79,7,1,0,1,7,0,0,8,0,8,Lombardia,ITC4
2021-01-16,PF/BT,30209,OSPEDALE MAGGIORE DI CREMA,LOM,20-29,6,9,0,1,0,0,14,15,0,15,Lombardia,ITC4
2021-01-16,PF/BT,30209,OSPEDALE MAGGIORE DI CREMA,LOM,30-39,20,10,0,1,0,0,29,30,0,30,Lombardia,ITC4
2021-01-16,PF/BT,30209,OSPEDALE MAGGIORE DI CREMA,LOM,40-49,19,7,0,1,0,0,25,26,0,26,Lombardia,ITC4
2021-01-16,PF/BT,30209,OSPEDALE MAGGIORE DI CREMA,LOM,50-59,27,10,0,0,0,0,37,37,0,37,Lombardia,ITC4
2021-01-16,PF/BT,30209,OSPEDALE MAGGIORE DI CREMA,LOM,60-69,31,11,0,1,0,0,41,42,0,42,Lombardia,ITC4
2021-01-16,PF/BT,30209,OSPEDALE MAGGIORE DI CREMA,LOM,70-79,18,11,0,0,0,0,29,29,0,29,Lombardia,ITC4
2021-01-16,PF/BT,30209,OSPEDALE MAGGIORE DI CREMA,LOM,80-89,0,1,0,0,0,0,1,1,0,1,Lombardia,ITC4
2021-01-16,PF/BT,3021900,CASA DI CURA FIGLIE DI SAN CAMILLO CREMONA,LOM,20-29,10,7,0,16,1,0,0,17,0,17,Lombardia,ITC4
2021-01-16,PF/BT,3021900,CASA DI CURA FIGLIE DI SAN CAMILLO CREMONA,LOM,30-39,13,12,0,21,4,0,0,25,0,25,Lombardia,ITC4
2021-01-16,PF/BT,3021900,CASA DI CURA FIGLIE DI SAN CAMILLO CREMONA,LOM,40-49,10,30,0,29,9,0,2,40,0,40,Lombardia,ITC4
2021-01-16,PF/BT,3021900,CASA DI CURA FIGLIE DI SAN CAMILLO CREMONA,LOM,50-59,5,37,0,23,18,0,1,42,0,42,Lombardia,ITC4
2021-01-16,PF/BT,3021900,CASA DI CURA FIGLIE DI SAN CAMILLO CREMONA,LOM,60-69,12,10,0,19,2,0,1,22,0,22,Lombardia,ITC4
2021-01-16,PF/BT,3021900,CASA DI CURA FIGLIE DI SAN CAMILLO CREMONA,LOM,70-79,1,1,0,1,0,0,1,2,0,2,Lombardia,ITC4
2021-01-16,PF/BT,3021900,CASA DI CURA FIGLIE DI SAN CAMILLO CREMONA,LOM,80-89,0,6,0,0,0,0,6,6,0,6,Lombardia,ITC4
2021-01-16,PF/BT,3021900,CASA DI CURA FIGLIE DI SAN CAMILLO CREMONA,LOM,90+,0,2,0,0,0,0,2,2,0,2,Lombardia,ITC4
2021-01-16,PF/BT,30281,HUB LEGNANO,LOM,16-19,5,4,0,9,0,0,0,9,0,9,Lombardia,ITC4
2021-01-16,PF/BT,30281,HUB LEGNANO,LOM,20-29,45,44,0,82,7,0,0,89,0,89,Lombardia,ITC4
2021-01-16,PF/BT,30281,HUB LEGNANO,LOM,30-39,30,26,0,48,8,0,0,56,0,56,Lombardia,ITC4
2021-01-16,PF/BT,30281,HUB LEGNANO,LOM,40-49,40,15,0,48,7,0,0,55,0,55,Lombardia,ITC4
2021-01-16,PF/BT,30281,HUB LEGNANO,LOM,50-59,36,19,0,45,10,0,0,55,0,55,Lombardia,ITC4
2021-01-16,PF/BT,30281,HUB LEGNANO,LOM,60-69,26,15,0,25,16,0,0,41,0,41,Lombardia,ITC4
2021-01-16,PF/BT,30281,HUB LEGNANO,LOM,70-79,15,4,0,3,16,0,0,19,0,19,Lombardia,ITC4
2021-01-16,PF/BT,30326001600,FONDAZIONE CASA DI RIPOSO VILLA G.PADOVANI ONLUS,LOM,20-29,0,1,0,1,0,0,0,1,0,1,Lombardia,ITC4
2021-01-16,PF/BT,30326001600,FONDAZIONE CASA DI RIPOSO VILLA G.PADOVANI ONLUS,LOM,30-39,0,3,0,3,0,0,0,3,0,3,Lombardia,ITC4
2021-01-16,PF/BT,30326001600,FONDAZIONE CASA DI RIPOSO VILLA G.PADOVANI ONLUS,LOM,40-49,0,3,0,3,0,0,0,3,0,3,Lombardia,ITC4
2021-01-16,PF/BT,30326001600,FONDAZIONE CASA DI RIPOSO VILLA G.PADOVANI ONLUS,LOM,50-59,1,3,0,3,1,0,0,4,0,4,Lombardia,ITC4
2021-01-16,PF/BT,30326001600,FONDAZIONE CASA DI RIPOSO VILLA G.PADOVANI ONLUS,LOM,60-69,0,1,0,0,1,0,0,1,0,1,Lombardia,ITC4
2021-01-16,PF/BT,30327001819,RSA I GIRASOLI - VIA M. K. GANDHI N° 1 BORGO VIRGILIO (MN),LOM,30-39,0,3,0,2,1,0,0,3,0,3,Lombardia,ITC4
2021-01-16,PF/BT,30327001819,RSA I GIRASOLI - VIA M. K. GANDHI N° 1 BORGO VIRGILIO (MN),LOM,40-49,0,2,0,1,1,0,0,2,0,2,Lombardia,ITC4
2021-01-16,PF/BT,30327001819,RSA I GIRASOLI - VIA M. K. GANDHI N° 1 BORGO VIRGILIO (MN),LOM,50-59,0,2,0,1,1,0,0,2,0,2,Lombardia,ITC4
2021-01-16,PF/BT,30327001819,RSA I GIRASOLI - VIA M. K. GANDHI N° 1 BORGO VIRGILIO (MN),LOM,60-69,2,3,0,2,1,2,0,5,0,5,Lombardia,ITC4
2021-01-16,PF/BT,30327001819,RSA I GIRASOLI - VIA M. K. GANDHI N° 1 BORGO VIRGILIO (MN),LOM,70-79,0,4,0,0,0,4,0,4,0,4,Lombardia,ITC4
2021-01-16,PF/BT,30327001819,RSA I GIRASOLI - VIA M. K. GANDHI N° 1 BORGO VIRGILIO (MN),LOM,80-89,2,14,0,0,0,16,0,16,0,16,Lombardia,ITC4
2021-01-16,PF/BT,30327001819,RSA I GIRASOLI - VIA M. K. GANDHI N° 1 BORGO VIRGILIO (MN),LOM,90+,0,16,0,0,0,16,0,16,0,16,Lombardia,ITC4
2021-01-16,PF/BT,3035500,ospedale di suzzara spa,LOM,20-29,0,6,0,5,1,0,0,6,0,6,Lombardia,ITC4
2021-01-16,PF/BT,3035500,ospedale di suzzara spa,LOM,30-39,0,4,0,2,2,0,0,4,0,4,Lombardia,ITC4
2021-01-16,PF/BT,3035500,ospedale di suzzara spa,LOM,40-49,2,10,0,5,7,0,0,12,0,12,Lombardia,ITC4
2021-01-16,PF/BT,3035500,ospedale di suzzara spa,LOM,50-59,4,12,0,4,12,0,0,16,0,16,Lombardia,ITC4
2021-01-16,PF/BT,3035500,ospedale di suzzara spa,LOM,60-69,0,2,0,2,0,0,0,2,0,2,Lombardia,ITC4
2021-01-16,PF/BT,3035500,ospedale di suzzara spa,LOM,70-79,2,0,0,0,2,0,0,2,0,2,Lombardia,ITC4
2021-01-16,PF/BT,3035600,ISTITUTO CLINICO HABILITA - CISERANO,LOM,20-29,6,26,0,24,8,0,0,32,0,32,Lombardia,ITC4
2021-01-16,PF/BT,3035600,ISTITUTO CLINICO HABILITA - CISERANO,LOM,30-39,14,40,0,41,13,0,0,54,0,54,Lombardia,ITC4
2021-01-16,PF/BT,3035600,ISTITUTO CLINICO HABILITA - CISERANO,LOM,40-49,7,37,0,35,9,0,0,44,0,44,Lombardia,ITC4
2021-01-16,PF/BT,3035600,ISTITUTO CLINICO HABILITA - CISERANO,LOM,50-59,10,23,0,29,4,0,0,33,0,33,Lombardia,ITC4
2021-01-16,PF/BT,3035600,ISTITUTO CLINICO HABILITA - CISERANO,LOM,60-69,5,5,0,7,3,0,0,10,0,10,Lombardia,ITC4
2021-01-16,PF/BT,3035600,ISTITUTO CLINICO HABILITA - CISERANO,LOM,70-79,6,0,0,4,2,0,0,6,0,6,Lombardia,ITC4
2021-01-16,PF/BT,3035600,ISTITUTO CLINICO HABILITA - CISERANO,LOM,80-89,1,0,0,1,0,0,0,1,0,1,Lombardia,ITC4
2021-01-16,PF/BT,30368,CENTRO ETTORE SPALENZA - FONDAZIONE DON CARLO GNOCCHI,LOM,20-29,2,13,0,14,1,0,0,15,0,15,Lombardia,ITC4
2021-01-16,PF/BT,30368,CENTRO ETTORE SPALENZA - FONDAZIONE DON CARLO GNOCCHI,LOM,30-39,3,2,0,4,1,0,0,5,0,5,Lombardia,ITC4
2021-01-16,PF/BT,30368,CENTRO ETTORE SPALENZA - FONDAZIONE DON CARLO GNOCCHI,LOM,40-49,3,8,0,7,4,0,0,11,0,11,Lombardia,ITC4
2021-01-16,PF/BT,30368,CENTRO ETTORE SPALENZA - FONDAZIONE DON CARLO GNOCCHI,LOM,50-59,3,6,0,8,1,0,0,9,0,9,Lombardia,ITC4
2021-01-16,PF/BT,30368,CENTRO ETTORE SPALENZA - FONDAZIONE DON CARLO GNOCCHI,LOM,60-69,1,1,0,1,1,0,0,2,0,2,Lombardia,ITC4
2021-01-16,PF/BT,30701,ASST GRANDE OSPEDALE METROPOLITANO NIGUARDA,LOM,16-19,0,1,0,1,0,0,0,1,0,1,Lombardia,ITC4
2021-01-16,PF/BT,30701,ASST GRANDE OSPEDALE METROPOLITANO NIGUARDA,LOM,20-29,22,61,0,67,9,0,7,83,0,83,Lombardia,ITC4
2021-01-16,PF/BT,30701,ASST GRANDE OSPEDALE METROPOLITANO NIGUARDA,LOM,30-39,34,41,0,42,22,0,11,75,0,75,Lombardia,ITC4
2021-01-16,PF/BT,30701,ASST GRANDE OSPEDALE METROPOLITANO NIGUARDA,LOM,40-49,22,48,0,42,23,0,5,70,0,70,Lombardia,ITC4
2021-01-16,PF/BT,30701,ASST GRANDE OSPEDALE METROPOLITANO NIGUARDA,LOM,50-59,49,90,0,74,52,0,13,139,0,139,Lombardia,ITC4
2021-01-16,PF/BT,30701,ASST GRANDE OSPEDALE METROPOLITANO NIGUARDA,LOM,60-69,60,43,0,76,13,0,14,103,0,103,Lombardia,ITC4
2021-01-16,PF/BT,30701,ASST GRANDE OSPEDALE METROPOLITANO NIGUARDA,LOM,70-79,6,5,0,6,1,0,4,11,0,11,Lombardia,ITC4
2021-01-16,PF/BT,30701,ASST GRANDE OSPEDALE METROPOLITANO NIGUARDA,LOM,80-89,4,0,0,3,1,0,0,4,0,4,Lombardia,ITC4
2021-01-16,PF/BT,30718,ASST PAPA GIOVANNI XXIII,LOM,16-19,2,4,0,0,6,0,0,6,0,6,Lombardia,ITC4
2021-01-16,PF/BT,30718,ASST PAPA GIOVANNI XXIII,LOM,20-29,36,50,0,14,72,0,0,86,0,86,Lombardia,ITC4
2021-01-16,PF/BT,30718,ASST PAPA GIOVANNI XXIII,LOM,30-39,64,27,0,21,70,0,0,91,0,91,Lombardia,ITC4
2021-01-16,PF/BT,30718,ASST PAPA GIOVANNI XXIII,LOM,40-49,60,58,0,14,104,0,0,118,0,118,Lombardia,ITC4
2021-01-16,PF/BT,30718,ASST PAPA GIOVANNI XXIII,LOM,50-59,112,109,0,51,170,0,0,221,0,221,Lombardia,ITC4
2021-01-16,PF/BT,30718,ASST PAPA GIOVANNI XXIII,LOM,60-69,104,67,0,39,132,0,0,171,0,171,Lombardia,ITC4
2021-01-16,PF/BT,30718,ASST PAPA GIOVANNI XXIII,LOM,70-79,14,4,0,1,17,0,0,18,0,18,Lombardia,ITC4
2021-01-16,PF/BT,30718,ASST PAPA GIOVANNI XXIII,LOM,80-89,1,1,0,0,2,0,0,2,0,2,Lombardia,ITC4
2021-01-16,PF/BT,30902,Ospedale S.Anna - Como,LOM,16-19,2,1,0,0,3,0,0,3,0,3,Lombardia,ITC4
2021-01-16,PF/BT,30902,Ospedale S.Anna - Como,LOM,20-29,17,19,0,5,31,0,0,36,0,36,Lombardia,ITC4
2021-01-16,PF/BT,30902,Ospedale S.Anna - Como,LOM,30-39,18,26,0,11,29,0,4,44,0,44,Lombardia,ITC4
2021-01-16,PF/BT,30902,Ospedale S.Anna - Como,LOM,40-49,23,18,0,7,33,0,1,41,0,41,Lombardia,ITC4
2021-01-16,PF/BT,30902,Ospedale S.Anna - Como,LOM,50-59,20,26,0,9,37,0,0,46,0,46,Lombardia,ITC4
2021-01-16,PF/BT,30902,Ospedale S.Anna - Como,LOM,60-69,21,19,0,12,28,0,0,40,0,40,Lombardia,ITC4
2021-01-16,PF/BT,30902,Ospedale S.Anna - Como,LOM,70-79,2,3,0,0,5,0,0,5,0,5,Lombardia,ITC4
2021-01-16,PF/BT,30902,Ospedale S.Anna - Como,LOM,80-89,1,0,0,1,0,0,0,1,0,1,Lombardia,ITC4
2021-01-16,PF/BT,30904,ASST VALTELLINA E ALTO LARIO PRESIDIO OSPEDALIERO DI SONDALO,LOM,20-29,3,1,0,3,1,0,0,4,0,4,Lombardia,ITC4
2021-01-16,PF/BT,30904,ASST VALTELLINA E ALTO LARIO PRESIDIO OSPEDALIERO DI SONDALO,LOM,30-39,3,6,0,9,0,0,0,9,0,9,Lombardia,ITC4
2021-01-16,PF/BT,30904,ASST VALTELLINA E ALTO LARIO PRESIDIO OSPEDALIERO DI SONDALO,LOM,40-49,1,7,0,8,0,0,0,8,0,8,Lombardia,ITC4
2021-01-16,PF/BT,30904,ASST VALTELLINA E ALTO LARIO PRESIDIO OSPEDALIERO DI SONDALO,LOM,50-59,6,10,0,12,4,0,0,16,0,16,Lombardia,ITC4
2021-01-16,PF/BT,30904,ASST VALTELLINA E ALTO LARIO PRESIDIO OSPEDALIERO DI SONDALO,LOM,60-69,10,7,0,14,3,0,0,17,0,17,Lombardia,ITC4
2021-01-16,PF/BT,30909,amb covid monza,LOM,16-19,7,22,0,27,1,0,1,29,0,29,Lombardia,ITC4
2021-01-16,PF/BT,30909,amb covid monza,LOM,20-29,86,152,0,229,4,0,5,238,0,238,Lombardia,ITC4
2021-01-16,PF/BT,30909,amb covid monza,LOM,30-39,27,73,0,82,8,0,10,100,0,100,Lombardia,ITC4
2021-01-16,PF/BT,30909,amb covid monza,LOM,40-49,27,60,0,70,10,0,7,87,0,87,Lombardia,ITC4
2021-01-16,PF/BT,30909,amb covid monza,LOM,50-59,38,79,0,79,28,0,10,117,0,117,Lombardia,ITC4
2021-01-16,PF/BT,30909,amb covid monza,LOM,60-69,20,28,0,32,9,0,7,48,0,48,Lombardia,ITC4
2021-01-16,PF/BT,30909,amb covid monza,LOM,70-79,11,5,0,14,1,0,1,16,0,16,Lombardia,ITC4
2021-01-16,PF/BT,30909,amb covid monza,LOM,80-89,1,0,0,1,0,0,0,1,0,1,Lombardia,ITC4
2021-01-16,PF/BT,321000354 e 321000584,PUNTO VACCINALE RSA CASA PER CONIUGI,LOM,20-29,0,1,0,1,0,0,0,1,0,1,Lombardia,ITC4
2021-01-16,PF/BT,321000354 e 321000584,PUNTO VACCINALE RSA CASA PER CONIUGI,LOM,30-39,2,0,0,1,1,0,0,2,0,2,Lombardia,ITC4
2021-01-16,PF/BT,321000354 e 321000584,PUNTO VACCINALE RSA CASA PER CONIUGI,LOM,40-49,0,2,0,2,0,0,0,2,0,2,Lombardia,ITC4
2021-01-16,PF/BT,321000354 e 321000584,PUNTO VACCINALE RSA CASA PER CONIUGI,LOM,50-59,1,1,0,1,0,1,0,2,0,2,Lombardia,ITC4
2021-01-16,PF/BT,321000354 e 321000584,PUNTO VACCINALE RSA CASA PER CONIUGI,LOM,70-79,0,5,0,0,0,5,0,5,0,5,Lombardia,ITC4
2021-01-16,PF/BT,321000354 e 321000584,PUNTO VACCINALE RSA CASA PER CONIUGI,LOM,80-89,3,8,0,0,0,11,0,11,0,11,Lombardia,ITC4
2021-01-16,PF/BT,321000354 e 321000584,PUNTO VACCINALE RSA CASA PER CONIUGI,LOM,90+,1,0,0,0,0,1,0,1,0,1,Lombardia,ITC4
2021-01-16,PF/BT,322002746,FONDAZIONE RSA GARIBALDI POGLIANI - CAPIAGO INTIMIANO,LOM,30-39,1,0,0,1,0,0,0,1,0,1,Lombardia,ITC4
2021-01-16,PF/BT,322002746,FONDAZIONE RSA GARIBALDI POGLIANI - CAPIAGO INTIMIANO,LOM,40-49,0,6,0,5,0,0,1,6,0,6,Lombardia,ITC4
2021-01-16,PF/BT,322002746,FONDAZIONE RSA GARIBALDI POGLIANI - CAPIAGO INTIMIANO,LOM,50-59,0,9,0,5,0,0,4,9,0,9,Lombardia,ITC4
2021-01-16,PF/BT,322002746,FONDAZIONE RSA GARIBALDI POGLIANI - CAPIAGO INTIMIANO,LOM,60-69,1,0,0,1,0,0,0,1,0,1,Lombardia,ITC4
2021-01-16,PF/BT,322002746,FONDAZIONE RSA GARIBALDI POGLIANI - CAPIAGO INTIMIANO,LOM,90+,0,1,0,0,0,1,0,1,0,1,Lombardia,ITC4
2021-01-16,PF/BT,32271028,AMBULATORIO COVID OSPEDALE CIRCOLO,LOM,16-19,7,6,0,13,0,0,0,13,0,13,Lombardia,ITC4
2021-01-16,PF/BT,32271028,AMBULATORIO COVID OSPEDALE CIRCOLO,LOM,20-29,36,64,0,100,0,0,0,100,0,100,Lombardia,ITC4
2021-01-16,PF/BT,32271028,AMBULATORIO COVID OSPEDALE CIRCOLO,LOM,30-39,22,44,0,66,0,0,0,66,0,66,Lombardia,ITC4
2021-01-16,PF/BT,32271028,AMBULATORIO COVID OSPEDALE CIRCOLO,LOM,40-49,28,58,0,86,0,0,0,86,0,86,Lombardia,ITC4
2021-01-16,PF/BT,32271028,AMBULATORIO COVID OSPEDALE CIRCOLO,LOM,50-59,32,56,0,88,0,0,0,88,0,88,Lombardia,ITC4
2021-01-16,PF/BT,32271028,AMBULATORIO COVID OSPEDALE CIRCOLO,LOM,60-69,26,33,0,59,0,0,0,59,0,59,Lombardia,ITC4
2021-01-16,PF/BT,32271028,AMBULATORIO COVID OSPEDALE CIRCOLO,LOM,70-79,8,4,0,12,0,0,0,12,0,12,Lombardia,ITC4
2021-01-16,PF/BT,32271028,AMBULATORIO COVID OSPEDALE CIRCOLO,LOM,80-89,1,0,0,1,0,0,0,1,0,1,Lombardia,ITC4
2021-01-16,PF/BT,323000937,RSA SAN BENIGNO,LOM,20-29,1,0,0,1,0,0,0,1,0,1,Lombardia,ITC4
2021-01-16,PF/BT,323000937,RSA SAN BENIGNO,LOM,30-39,0,3,0,3,0,0,0,3,0,3,Lombardia,ITC4
2021-01-16,PF/BT,323000937,RSA SAN BENIGNO,LOM,40-49,0,5,0,2,3,0,0,5,0,5,Lombardia,ITC4
2021-01-16,PF/BT,323000937,RSA SAN BENIGNO,LOM,50-59,0,13,0,7,5,0,1,13,0,13,Lombardia,ITC4
2021-01-16,PF/BT,323000937,RSA SAN BENIGNO,LOM,70-79,0,3,0,0,0,3,0,3,0,3,Lombardia,ITC4
2021-01-16,PF/BT,323000937,RSA SAN BENIGNO,LOM,80-89,1,10,0,0,0,11,0,11,0,11,Lombardia,ITC4
2021-01-16,PF/BT,323000937,RSA SAN BENIGNO,LOM,90+,1,11,0,0,0,12,0,12,0,12,Lombardia,ITC4
2021-01-16,PF/BT,323000952,RSA TOMASO AMBROSETTI - MORBEGNO (SO),LOM,20-29,1,0,0,0,0,0,1,1,0,1,Lombardia,ITC4
2021-01-16,PF/BT,323000952,RSA TOMASO AMBROSETTI - MORBEGNO (SO),LOM,30-39,0,2,0,1,0,0,1,2,0,2,Lombardia,ITC4
2021-01-16,PF/BT,323000952,RSA TOMASO AMBROSETTI - MORBEGNO (SO),LOM,40-49,1,2,0,1,1,0,1,3,0,3,Lombardia,ITC4
2021-01-16,PF/BT,323000952,RSA TOMASO AMBROSETTI - MORBEGNO (SO),LOM,50-59,1,2,0,1,0,0,2,3,0,3,Lombardia,ITC4
2021-01-16,PF/BT,323000952,RSA TOMASO AMBROSETTI - MORBEGNO (SO),LOM,60-69,2,0,0,0,1,0,1,2,0,2,Lombardia,ITC4
2021-01-16,PF/BT,323000952,RSA TOMASO AMBROSETTI - MORBEGNO (SO),LOM,70-79,3,2,0,0,0,2,3,5,0,5,Lombardia,ITC4
2021-01-16,PF/BT,323000952,RSA TOMASO AMBROSETTI - MORBEGNO (SO),LOM,80-89,3,2,0,0,0,2,3,5,0,5,Lombardia,ITC4
2021-01-16,PF/BT,323000952,RSA TOMASO AMBROSETTI - MORBEGNO (SO),LOM,90+,1,0,0,0,0,1,0,1,0,1,Lombardia,ITC4
2021-01-16,PF/BT,323008561,RSA PAOLO PARAVICINI- MORBEGNO (SO),LOM,40-49,0,1,0,1,0,0,0,1,0,1,Lombardia,ITC4
2021-01-16,PF/BT,323008561,RSA PAOLO PARAVICINI- MORBEGNO (SO),LOM,50-59,1,0,0,0,0,1,0,1,0,1,Lombardia,ITC4
2021-01-16,PF/BT,323008561,RSA PAOLO PARAVICINI- MORBEGNO (SO),LOM,60-69,1,0,0,0,0,1,0,1,0,1,Lombardia,ITC4
2021-01-16,PF/BT,323008561,RSA PAOLO PARAVICINI- MORBEGNO (SO),LOM,70-79,2,1,0,0,0,3,0,3,0,3,Lombardia,ITC4
2021-01-16,PF/BT,323008561,RSA PAOLO PARAVICINI- MORBEGNO (SO),LOM,80-89,0,1,0,0,0,1,0,1,0,1,Lombardia,ITC4
2021-01-16,PF/BT,323008561,RSA PAOLO PARAVICINI- MORBEGNO (SO),LOM,90+,0,1,0,0,0,1,0,1,0,1,Lombardia,ITC4
2021-01-16,PF/BT,32572026,AMBULATORIO COVID PIARIO,LOM,20-29,1,4,0,5,0,0,0,5,0,5,Lombardia,ITC4
2021-01-16,PF/BT,32572026,AMBULATORIO COVID PIARIO,LOM,30-39,2,3,0,5,0,0,0,5,0,5,Lombardia,ITC4
2021-01-16,PF/BT,32572026,AMBULATORIO COVID PIARIO,LOM,40-49,1,14,0,13,2,0,0,15,0,15,Lombardia,ITC4
2021-01-16,PF/BT,32572026,AMBULATORIO COVID PIARIO,LOM,50-59,3,16,0,17,2,0,0,19,0,19,Lombardia,ITC4
2021-01-16,PF/BT,32572026,AMBULATORIO COVID PIARIO,LOM,60-69,0,3,0,3,0,0,0,3,0,3,Lombardia,ITC4
2021-01-16,PF/BT,32572026,AMBULATORIO COVID PIARIO,LOM,70-79,1,0,0,1,0,0,0,1,0,1,Lombardia,ITC4
2021-01-16,PF/BT,32572027,Ambulatorio COVID SERIATE,LOM,20-29,4,21,0,16,6,0,3,25,0,25,Lombardia,ITC4
2021-01-16,PF/BT,32572027,Ambulatorio COVID SERIATE,LOM,30-39,7,15,0,13,9,0,0,22,0,22,Lombardia,ITC4
2021-01-16,PF/BT,32572027,Ambulatorio COVID SERIATE,LOM,40-49,9,25,0,24,5,0,5,34,0,34,Lombardia,ITC4
2021-01-16,PF/BT,32572027,Ambulatorio COVID SERIATE,LOM,50-59,11,29,0,22,13,0,5,40,0,40,Lombardia,ITC4
2021-01-16,PF/BT,32572027,Ambulatorio COVID SERIATE,LOM,60-69,16,10,0,22,0,0,4,26,0,26,Lombardia,ITC4
2021-01-16,PF/BT,32572027,Ambulatorio COVID SERIATE,LOM,70-79,1,1,0,1,0,0,1,2,0,2,Lombardia,ITC4
2021-01-16,PF/BT,32572027,Ambulatorio COVID SERIATE,LOM,80-89,0,1,0,0,0,0,1,1,0,1,Lombardia,ITC4
2021-01-16,PF/BT,326001641,"RSA VIA GAMBARA, 20 ORZINUOVI",LOM,20-29,0,1,0,1,0,0,0,1,0,1,Lombardia,ITC4
2021-01-16,PF/BT,326001641,"RSA VIA GAMBARA, 20 ORZINUOVI",LOM,30-39,1,5,0,6,0,0,0,6,0,6,Lombardia,ITC4
2021-01-16,PF/BT,326001641,"RSA VIA GAMBARA, 20 ORZINUOVI",LOM,40-49,1,8,0,7,2,0,0,9,0,9,Lombardia,ITC4
2021-01-16,PF/BT,326001641,"RSA VIA GAMBARA, 20 ORZINUOVI",LOM,50-59,2,9,0,7,4,0,0,11,0,11,Lombardia,ITC4
2021-01-16,PF/BT,326001641,"RSA VIA GAMBARA, 20 ORZINUOVI",LOM,60-69,1,1,0,0,2,0,0,2,0,2,Lombardia,ITC4
2021-01-16,PF/BT,326001641,"RSA VIA GAMBARA, 20 ORZINUOVI",LOM,70-79,1,0,0,1,0,0,0,1,0,1,Lombardia,ITC4
2021-01-16,PF/BT,328002013,R.S.A. VILLA CHIARA,LOM,30-39,0,1,0,1,0,0,0,1,0,1,Lombardia,ITC4
2021-01-16,PF/BT,328002013,R.S.A. VILLA CHIARA,LOM,40-49,0,6,0,5,0,1,0,6,0,6,Lombardia,ITC4
2021-01-16,PF/BT,328002013,R.S.A. VILLA CHIARA,LOM,50-59,0,3,0,3,0,0,0,3,0,3,Lombardia,ITC4
2021-01-16,PF/BT,328002013,R.S.A. VILLA CHIARA,LOM,60-69,4,5,0,3,0,6,0,9,0,9,Lombardia,ITC4
2021-01-16,PF/BT,328002013,R.S.A. VILLA CHIARA,LOM,70-79,0,4,0,0,0,4,0,4,0,4,Lombardia,ITC4
2021-01-16,PF/BT,328002013,R.S.A. VILLA CHIARA,LOM,80-89,2,7,0,0,0,9,0,9,0,9,Lombardia,ITC4
2021-01-16,PF/BT,328002013,R.S.A. VILLA CHIARA,LOM,90+,2,6,0,0,0,8,0,8,0,8,Lombardia,ITC4
2021-01-16,PF/BT,558,RSA PIO ALBERGO TRIVULZIO,LOM,20-29,4,5,0,5,4,0,0,9,0,9,Lombardia,ITC4
2021-01-16,PF/BT,558,RSA PIO ALBERGO TRIVULZIO,LOM,30-39,7,3,0,4,6,0,0,10,0,10,Lombardia,ITC4
2021-01-16,PF/BT,558,RSA PIO ALBERGO TRIVULZIO,LOM,40-49,6,12,0,11,7,0,0,18,0,18,Lombardia,ITC4
2021-01-16,PF/BT,558,RSA PIO ALBERGO TRIVULZIO,LOM,50-59,2,13,0,10,5,0,0,15,0,15,Lombardia,ITC4
2021-01-16,PF/BT,558,RSA PIO ALBERGO TRIVULZIO,LOM,60-69,1,1,0,1,1,0,0,2,0,2,Lombardia,ITC4
2021-01-16,PF/BT,789,RSA Mario e Rina Molina,LOM,70-79,1,0,0,0,0,1,0,1,0,1,Lombardia,ITC4
2021-01-16,PF/BT,789,RSA Mario e Rina Molina,LOM,80-89,0,1,0,0,0,1,0,1,0,1,Lombardia,ITC4
2021-01-16,PF/BT,789,RSA Mario e Rina Molina,LOM,90+,1,0,0,0,0,1,0,1,0,1,Lombardia,ITC4
2021-01-16,PF/BT,980,CASA MADONNA DEL LAVORO,LOM,20-29,0,1,0,1,0,0,0,1,0,1,Lombardia,ITC4
2021-01-16,PF/BT,980,CASA MADONNA DEL LAVORO,LOM,30-39,0,1,0,1,0,0,0,1,0,1,Lombardia,ITC4
2021-01-16,PF/BT,980,CASA MADONNA DEL LAVORO,LOM,40-49,0,4,0,2,2,0,0,4,0,4,Lombardia,ITC4
2021-01-16,PF/BT,980,CASA MADONNA DEL LAVORO,LOM,50-59,1,5,0,1,5,0,0,6,0,6,Lombardia,ITC4
2021-01-16,PF/BT,980,CASA MADONNA DEL LAVORO,LOM,60-69,0,3,0,2,1,0,0,3,0,3,Lombardia,ITC4
2021-01-16,PF/BT,980,CASA MADONNA DEL LAVORO,LOM,70-79,1,1,0,0,2,0,0,2,0,2,Lombardia,ITC4
2021-01-16,PF/BT,980,CASA MADONNA DEL LAVORO,LOM,80-89,1,0,0,0,1,0,0,1,0,1,Lombardia,ITC4
2021-01-16,PF/BT,Cudes 001959,RSA A RICCIARDELLI,LOM,60-69,1,0,0,1,0,0,0,1,0,1,Lombardia,ITC4
2021-01-16,PF/BT,Cudes 001959,RSA A RICCIARDELLI,LOM,70-79,0,1,0,0,0,1,0,1,0,1,Lombardia,ITC4
2021-01-16,PF/BT,Cudes 001959,RSA A RICCIARDELLI,LOM,80-89,4,11,0,0,0,15,0,15,0,15,Lombardia,ITC4
2021-01-16,PF/BT,Cudes 001959,RSA A RICCIARDELLI,LOM,90+,2,17,0,0,0,19,0,19,0,19,Lombardia,ITC4
2021-01-16,PF/BT,HSP11-11bis,Ambulatorio COVID PO S.Angelo Lod.,LOM,20-29,0,1,0,1,0,0,0,1,0,1,Lombardia,ITC4
2021-01-16,PF/BT,HSP11-11bis,Ambulatorio COVID PO S.Angelo Lod.,LOM,30-39,1,1,0,2,0,0,0,2,0,2,Lombardia,ITC4
2021-01-16,PF/BT,HSP11-11bis,Ambulatorio COVID PO S.Angelo Lod.,LOM,40-49,1,3,0,3,1,0,0,4,0,4,Lombardia,ITC4
2021-01-16,PF/BT,HSP11-11bis,Ambulatorio COVID PO S.Angelo Lod.,LOM,50-59,0,2,0,1,1,0,0,2,0,2,Lombardia,ITC4
2021-01-16,PF/BT,HSP11-11bis,Ambulatorio COVID PO S.Angelo Lod.,LOM,60-69,1,1,0,0,2,0,0,2,0,2,Lombardia,ITC4
2021-01-16,PF/BT,HSP11-11bis,Ambulatorio COVID PO S.Angelo Lod.,LOM,70-79,1,0,0,1,0,0,0,1,0,1,Lombardia,ITC4
2021-01-16,PF/BT,HSP11-11bis,PO  LODI - RSA Santa Chiara,LOM,20-29,0,5,0,5,0,0,0,5,0,5,Lombardia,ITC4
2021-01-16,PF/BT,HSP11-11bis,PO  LODI - RSA Santa Chiara,LOM,30-39,4,4,0,7,1,0,0,8,0,8,Lombardia,ITC4
2021-01-16,PF/BT,HSP11-11bis,PO  LODI - RSA Santa Chiara,LOM,40-49,0,3,0,3,0,0,0,3,0,3,Lombardia,ITC4
2021-01-16,PF/BT,HSP11-11bis,PO  LODI - RSA Santa Chiara,LOM,50-59,3,10,0,10,0,3,0,13,0,13,Lombardia,ITC4
2021-01-16,PF/BT,HSP11-11bis,PO  LODI - RSA Santa Chiara,LOM,60-69,1,5,0,4,0,2,0,6,0,6,Lombardia,ITC4
2021-01-16,PF/BT,HSP11-11bis,PO  LODI - RSA Santa Chiara,LOM,70-79,4,6,0,0,0,10,0,10,0,10,Lombardia,ITC4
2021-01-16,PF/BT,HSP11-11bis,PO  LODI - RSA Santa Chiara,LOM,80-89,10,17,0,0,0,27,0,27,0,27,Lombardia,ITC4
2021-01-16,PF/BT,HSP11-11bis,PO  LODI - RSA Santa Chiara,LOM,90+,3,15,0,0,0,18,0,18,0,18,Lombardia,ITC4
2021-01-16,PF/BT,HSP11-11bis,PO Lodi - RSA Opere Pie Codogno,LOM,60-69,5,1,0,0,6,0,0,6,0,6,Lombardia,ITC4
2021-01-16,PF/BT,HSP11-11bis,PO Lodi - RSA Opere Pie Codogno,LOM,70-79,4,8,0,0,12,0,0,12,0,12,Lombardia,ITC4
2021-01-16,PF/BT,HSP11-11bis,PO Lodi - RSA Opere Pie Codogno,LOM,80-89,4,62,0,0,66,0,0,66,0,66,Lombardia,ITC4
2021-01-16,PF/BT,HSP11-11bis,PO Lodi - RSA Opere Pie Codogno,LOM,90+,3,26,0,0,29,0,0,29,0,29,Lombardia,ITC4
2021-01-16,PF/BT,HSP11-11bis,PO LODI - RSA PETRANCA SAN ROCCO,LOM,70-79,1,1,0,0,0,2,0,2,0,2,Lombardia,ITC4
2021-01-16,PF/BT,HSP11-11bis,PO LODI - RSA PETRANCA SAN ROCCO,LOM,80-89,2,3,0,0,0,5,0,5,0,5,Lombardia,ITC4
2021-01-16,PF/BT,HSP11-11bis,PO LODI - RSA PETRANCA SAN ROCCO,LOM,90+,2,6,0,0,0,8,0,8,0,8,Lombardia,ITC4
2021-01-16,PF/BT,HSP11-11bis - 703,AMBULATORIO COVID PO SACCO,LOM,16-19,2,9,0,4,0,0,7,11,0,11,Lombardia,ITC4
2021-01-16,PF/BT,HSP11-11bis - 703,AMBULATORIO COVID PO SACCO,LOM,20-29,71,163,0,168,9,0,57,234,0,234,Lombardia,ITC4
2021-01-16,PF/BT,HSP11-11bis - 703,AMBULATORIO COVID PO SACCO,LOM,30-39,35,55,0,50,22,0,18,90,0,90,Lombardia,ITC4
2021-01-16,PF/BT,HSP11-11bis - 703,AMBULATORIO COVID PO SACCO,LOM,40-49,47,47,0,43,35,0,16,94,0,94,Lombardia,ITC4
2021-01-16,PF/BT,HSP11-11bis - 703,AMBULATORIO COVID PO SACCO,LOM,50-59,55,83,0,47,67,0,24,138,0,138,Lombardia,ITC4
2021-01-16,PF/BT,HSP11-11bis - 703,AMBULATORIO COVID PO SACCO,LOM,60-69,30,13,0,26,6,0,11,43,0,43,Lombardia,ITC4
2021-01-16,PF/BT,HSP11-11bis - 703,AMBULATORIO COVID PO SACCO,LOM,70-79,2,0,0,0,0,0,2,2,0,2,Lombardia,ITC4
2021-01-16,PF/BT,S-09,FONDAZIONE CONTE FRANCO CELLA DI RIVARA ONLUS R.S.A. DI ARENA PO,LOM,30-39,1,0,0,1,0,0,0,1,0,1,Lombardia,ITC4
2021-01-16,PF/BT,S-09,FONDAZIONE CONTE FRANCO CELLA DI RIVARA ONLUS R.S.A. DI ARENA PO,LOM,40-49,0,4,0,4,0,0,0,4,0,4,Lombardia,ITC4
2021-01-16,PF/BT,S-09,FONDAZIONE CONTE FRANCO CELLA DI RIVARA ONLUS R.S.A. DI ARENA PO,LOM,50-59,1,3,0,3,1,0,0,4,0,4,Lombardia,ITC4
2021-01-16,PF/BT,S-09,FONDAZIONE CONTE FRANCO CELLA DI RIVARA ONLUS R.S.A. DI ARENA PO,LOM,60-69,0,1,0,1,0,0,0,1,0,1,Lombardia,ITC4
2021-01-16,PF/BT,S-09,FONDAZIONE CONTE FRANCO CELLA DI RIVARA ONLUS R.S.A. DI ARENA PO,LOM,70-79,1,0,0,0,0,1,0,1,0,1,Lombardia,ITC4
2021-01-16,PF/BT,S-09,FONDAZIONE CONTE FRANCO CELLA DI RIVARA ONLUS R.S.A. DI ARENA PO,LOM,80-89,0,1,0,0,0,1,0,1,0,1,Lombardia,ITC4
2021-01-16,PF/BT,S-09,FONDAZIONE CONTE FRANCO CELLA DI RIVARA ONLUS R.S.A. DI BRONI,LOM,30-39,1,3,0,3,1,0,0,4,0,4,Lombardia,ITC4
2021-01-16,PF/BT,S-09,FONDAZIONE CONTE FRANCO CELLA DI RIVARA ONLUS R.S.A. DI BRONI,LOM,40-49,0,3,0,3,0,0,0,3,0,3,Lombardia,ITC4
2021-01-16,PF/BT,S-09,FONDAZIONE CONTE FRANCO CELLA DI RIVARA ONLUS R.S.A. DI BRONI,LOM,50-59,1,3,0,4,0,0,0,4,0,4,Lombardia,ITC4
2021-01-16,PF/BT,S-09,FONDAZIONE CONTE FRANCO CELLA DI RIVARA ONLUS R.S.A. DI BRONI,LOM,60-69,0,1,0,1,0,0,0,1,0,1,Lombardia,ITC4
2021-01-16,PF/BT,S-09,FONDAZIONE CONTE FRANCO CELLA DI RIVARA ONLUS R.S.A. DI BRONI,LOM,70-79,0,2,0,0,0,2,0,2,0,2,Lombardia,ITC4
2021-01-16,PF/BT,S-09,FONDAZIONE CONTE FRANCO CELLA DI RIVARA ONLUS R.S.A. DI BRONI,LOM,80-89,0,8,0,0,0,8,0,8,0,8,Lombardia,ITC4
2021-01-16,PF/BT,S-09,FONDAZIONE CONTE FRANCO CELLA DI RIVARA ONLUS R.S.A. DI BRONI,LOM,90+,0,2,0,0,0,2,0,2,0,2,Lombardia,ITC4
2021-01-16,PF/BT,STS11,CASA DI RIPOSO COSTANTE PATRIZI ONLUS,LOM,30-39,0,1,0,1,0,0,0,1,0,1,Lombardia,ITC4
2021-01-16,PF/BT,STS11,CASA DI RIPOSO COSTANTE PATRIZI ONLUS,LOM,40-49,0,3,0,2,1,0,0,3,0,3,Lombardia,ITC4
2021-01-16,PF/BT,STS11,CASA DI RIPOSO COSTANTE PATRIZI ONLUS,LOM,50-59,0,2,0,1,1,0,0,2,0,2,Lombardia,ITC4
2021-01-16,PF/BT,STS11,CASA DI RIPOSO COSTANTE PATRIZI ONLUS,LOM,60-69,1,5,0,2,1,1,2,6,0,6,Lombardia,ITC4
2021-01-16,PF/BT,STS11,CASA DI RIPOSO COSTANTE PATRIZI ONLUS,LOM,70-79,2,6,0,0,1,3,4,8,0,8,Lombardia,ITC4
2021-01-16,PF/BT,STS11,CASA DI RIPOSO COSTANTE PATRIZI ONLUS,LOM,80-89,5,6,0,0,0,11,0,11,0,11,Lombardia,ITC4
2021-01-16,PF/BT,STS11,CASA DI RIPOSO COSTANTE PATRIZI ONLUS,LOM,90+,0,4,0,0,0,4,0,4,0,4,Lombardia,ITC4
2021-01-16,PF/BT,STS11,Fondazione Istituto C: Vismara - G. De Petri ONLUS,LOM,20-29,0,1,0,1,0,0,0,1,0,1,Lombardia,ITC4
2021-01-16,PF/BT,STS11,Fondazione Istituto C: Vismara - G. De Petri ONLUS,LOM,30-39,0,2,0,0,2,0,0,2,0,2,Lombardia,ITC4
2021-01-16,PF/BT,STS11,Fondazione Istituto C: Vismara - G. De Petri ONLUS,LOM,40-49,0,1,0,1,0,0,0,1,0,1,Lombardia,ITC4
2021-01-16,PF/BT,STS11,Fondazione Istituto C: Vismara - G. De Petri ONLUS,LOM,50-59,1,1,0,1,1,0,0,2,0,2,Lombardia,ITC4
2021-01-16,PF/BT,STS11,PO Lodi - RSA Vismara - G. De Petri ONLUS,LOM,20-29,0,1,0,1,0,0,0,1,0,1,Lombardia,ITC4
2021-01-16,PF/BT,STS11,PO Lodi - RSA Vismara - G. De Petri ONLUS,LOM,30-39,0,2,0,0,2,0,0,2,0,2,Lombardia,ITC4
2021-01-16,PF/BT,STS11,PO Lodi - RSA Vismara - G. De Petri ONLUS,LOM,40-49,0,1,0,1,0,0,0,1,0,1,Lombardia,ITC4
2021-01-16,PF/BT,STS11,PO Lodi - RSA Vismara - G. De Petri ONLUS,LOM,50-59,1,1,0,1,1,0,0,2,0,2,Lombardia,ITC4
2021-01-16,PF/BT,STS11,PVT COVID BRESCIA VIA ACERBI,LOM,20-29,27,39,0,16,4,0,46,66,0,66,Lombardia,ITC4
2021-01-16,PF/BT,STS11,PVT COVID BRESCIA VIA ACERBI,LOM,30-39,22,32,0,24,6,0,24,54,0,54,Lombardia,ITC4
2021-01-16,PF/BT,STS11,PVT COVID BRESCIA VIA ACERBI,LOM,40-49,19,38,0,25,14,0,18,57,0,57,Lombardia,ITC4
2021-01-16,PF/BT,STS11,PVT COVID BRESCIA VIA ACERBI,LOM,50-59,38,76,0,49,24,0,41,114,0,114,Lombardia,ITC4
2021-01-16,PF/BT,STS11,PVT COVID BRESCIA VIA ACERBI,LOM,60-69,51,39,0,49,6,0,35,90,0,90,Lombardia,ITC4
2021-01-16,PF/BT,STS11,PVT COVID BRESCIA VIA ACERBI,LOM,70-79,11,2,0,1,0,0,12,13,0,13,Lombardia,ITC4
2021-01-16,PF/BT,STS11,PVT COVID BRESCIA VIA ACERBI,LOM,80-89,2,0,0,0,0,0,2,2,0,2,Lombardia,ITC4
2021-01-16,PF/BT,STS11 - 000939,CASA DI RIPOSO CORTI NEMESIO,LOM,20-29,0,1,0,1,0,0,0,1,0,1,Lombardia,ITC4
2021-01-16,PF/BT,STS11 - 000939,CASA DI RIPOSO CORTI NEMESIO,LOM,30-39,0,1,0,0,1,0,0,1,0,1,Lombardia,ITC4
2021-01-16,PF/BT,STS11 - 000939,CASA DI RIPOSO CORTI NEMESIO,LOM,40-49,0,6,0,5,1,0,0,6,0,6,Lombardia,ITC4
2021-01-16,PF/BT,STS11 - 000939,CASA DI RIPOSO CORTI NEMESIO,LOM,50-59,2,8,0,7,1,0,2,10,0,10,Lombardia,ITC4
2021-01-16,PF/BT,STS11 - 000939,CASA DI RIPOSO CORTI NEMESIO,LOM,60-69,1,1,0,1,0,0,1,2,0,2,Lombardia,ITC4
2021-01-16,PF/BT,STS11 - 000939,CASA DI RIPOSO CORTI NEMESIO,LOM,70-79,1,2,0,0,0,2,1,3,0,3,Lombardia,ITC4
2021-01-16,PF/BT,STS11 - 000939,CASA DI RIPOSO CORTI NEMESIO,LOM,80-89,4,2,0,0,0,5,1,6,0,6,Lombardia,ITC4
2021-01-16,PF/BT,STS11 - 000939,CASA DI RIPOSO CORTI NEMESIO,LOM,90+,4,3,0,0,0,7,0,7,0,7,Lombardia,ITC4
2021-01-16,PF/BT,STS11  002193,RSA CASA DEL VECCHIO E DEL FANCIULLO ITALA VOCHIERI,LOM,16-19,0,1,0,1,0,0,0,1,0,1,Lombardia,ITC4
2021-01-16,PF/BT,STS11  002193,RSA CASA DEL VECCHIO E DEL FANCIULLO ITALA VOCHIERI,LOM,30-39,0,2,0,2,0,0,0,2,0,2,Lombardia,ITC4
2021-01-16,PF/BT,STS11  002193,RSA CASA DEL VECCHIO E DEL FANCIULLO ITALA VOCHIERI,LOM,40-49,0,5,0,4,1,0,0,5,0,5,Lombardia,ITC4
2021-01-16,PF/BT,STS11  002193,RSA CASA DEL VECCHIO E DEL FANCIULLO ITALA VOCHIERI,LOM,50-59,1,5,0,2,4,0,0,6,0,6,Lombardia,ITC4
2021-01-16,PF/BT,STS11  002193,RSA CASA DEL VECCHIO E DEL FANCIULLO ITALA VOCHIERI,LOM,60-69,0,3,0,1,2,0,0,3,0,3,Lombardia,ITC4
2021-01-16,PF/BT,STS11  002193,RSA CASA DEL VECCHIO E DEL FANCIULLO ITALA VOCHIERI,LOM,70-79,0,1,0,0,1,0,0,1,0,1,Lombardia,ITC4
2021-01-16,PF/BT,STS24,RSA FONDAZIONE ONLUS MONS. A. MAZZALI (MANTOVA),LOM,20-29,0,1,0,1,0,0,0,1,0,1,Lombardia,ITC4
2021-01-16,PF/BT,STS24,RSA FONDAZIONE ONLUS MONS. A. MAZZALI (MANTOVA),LOM,30-39,0,4,0,4,0,0,0,4,0,4,Lombardia,ITC4
2021-01-16,PF/BT,STS24,RSA FONDAZIONE ONLUS MONS. A. MAZZALI (MANTOVA),LOM,40-49,0,5,0,5,0,0,0,5,0,5,Lombardia,ITC4
2021-01-16,PF/BT,STS24,RSA FONDAZIONE ONLUS MONS. A. MAZZALI (MANTOVA),LOM,50-59,0,8,0,7,1,0,0,8,0,8,Lombardia,ITC4
2021-01-17,PF/BT,****,"U.O Bolognini Seriate, Asst Bergamo Est",LOM,20-29,8,12,0,18,2,0,0,20,0,20,Lombardia,ITC4
2021-01-17,PF/BT,****,"U.O Bolognini Seriate, Asst Bergamo Est",LOM,30-39,4,14,0,15,3,0,0,18,0,18,Lombardia,ITC4
2021-01-17,PF/BT,****,"U.O Bolognini Seriate, Asst Bergamo Est",LOM,40-49,4,28,0,26,6,0,0,32,0,32,Lombardia,ITC4
2021-01-17,PF/BT,****,"U.O Bolognini Seriate, Asst Bergamo Est",LOM,50-59,11,28,0,31,8,0,0,39,0,39,Lombardia,ITC4
2021-01-17,PF/BT,****,"U.O Bolognini Seriate, Asst Bergamo Est",LOM,60-69,7,8,0,10,5,0,0,15,0,15,Lombardia,ITC4
2021-01-17,PF/BT,****,"U.O Bolognini Seriate, Asst Bergamo Est",LOM,70-79,1,0,0,1,0,0,0,1,0,1,Lombardia,ITC4
2021-01-17,PF/BT,****,"U.O Bolognini Seriate, Asst Bergamo Est",LOM,80-89,0,1,0,0,1,0,0,1,0,1,Lombardia,ITC4
2021-01-17,PF/BT,.030042,ASST VALTELLINA ALTO LARIO - PRESIDIO OSPEDALIERO DI SONDRIO,LOM,16-19,0,1,0,1,0,0,0,1,0,1,Lombardia,ITC4
2021-01-17,PF/BT,.030042,ASST VALTELLINA ALTO LARIO - PRESIDIO OSPEDALIERO DI SONDRIO,LOM,20-29,7,6,0,11,2,0,0,13,0,13,Lombardia,ITC4
2021-01-17,PF/BT,.030042,ASST VALTELLINA ALTO LARIO - PRESIDIO OSPEDALIERO DI SONDRIO,LOM,30-39,4,5,0,6,3,0,0,9,0,9,Lombardia,ITC4
2021-01-17,PF/BT,.030042,ASST VALTELLINA ALTO LARIO - PRESIDIO OSPEDALIERO DI SONDRIO,LOM,40-49,8,5,0,12,1,0,0,13,0,13,Lombardia,ITC4
2021-01-17,PF/BT,.030042,ASST VALTELLINA ALTO LARIO - PRESIDIO OSPEDALIERO DI SONDRIO,LOM,50-59,11,10,0,20,1,0,0,21,0,21,Lombardia,ITC4
2021-01-17,PF/BT,.030042,ASST VALTELLINA ALTO LARIO - PRESIDIO OSPEDALIERO DI SONDRIO,LOM,60-69,7,2,0,8,1,0,0,8,1,9,Lombardia,ITC4
2021-01-17,PF/BT,0,RSA “OPERA PASTOR ANGELUCUS”,LOM,60-69,2,1,0,0,0,3,0,3,0,3,Lombardia,ITC4
2021-01-17,PF/BT,0,RSA “OPERA PASTOR ANGELUCUS”,LOM,70-79,7,2,0,0,0,9,0,9,0,9,Lombardia,ITC4
2021-01-17,PF/BT,0,RSA “OPERA PASTOR ANGELUCUS”,LOM,80-89,5,6,0,0,0,11,0,11,0,11,Lombardia,ITC4
2021-01-17,PF/BT,0,RSA “OPERA PASTOR ANGELUCUS”,LOM,90+,1,13,0,0,0,14,0,14,0,14,Lombardia,ITC4
2021-01-17,PF/BT,0,RSA Istituto Santa Savina - Lodi,LOM,20-29,0,3,0,3,0,0,0,3,0,3,Lombardia,ITC4
2021-01-17,PF/BT,0,RSA Istituto Santa Savina - Lodi,LOM,30-39,1,9,0,6,4,0,0,10,0,10,Lombardia,ITC4
2021-01-17,PF/BT,0,RSA Istituto Santa Savina - Lodi,LOM,40-49,1,11,0,10,2,0,0,12,0,12,Lombardia,ITC4
2021-01-17,PF/BT,0,RSA Istituto Santa Savina - Lodi,LOM,50-59,1,16,0,13,4,0,0,17,0,17,Lombardia,ITC4
2021-01-17,PF/BT,0,RSA Istituto Santa Savina - Lodi,LOM,60-69,0,5,0,2,2,1,0,5,0,5,Lombardia,ITC4
2021-01-17,PF/BT,0,RSA Istituto Santa Savina - Lodi,LOM,70-79,0,2,0,0,0,1,1,2,0,2,Lombardia,ITC4
2021-01-17,PF/BT,0,RSA Istituto Santa Savina - Lodi,LOM,80-89,1,19,0,0,0,17,3,20,0,20,Lombardia,ITC4
2021-01-17,PF/BT,0,RSA Istituto Santa Savina - Lodi,LOM,90+,0,27,0,0,0,27,0,27,0,27,Lombardia,ITC4
2021-01-17,PF/BT,000050,Poliambulatorio IRCSS OSPEDALE SAN LUCA,LOM,20-29,7,11,0,4,14,0,0,18,0,18,Lombardia,ITC4
2021-01-17,PF/BT,000050,Poliambulatorio IRCSS OSPEDALE SAN LUCA,LOM,30-39,20,15,0,8,27,0,0,35,0,35,Lombardia,ITC4
2021-01-17,PF/BT,000050,Poliambulatorio IRCSS OSPEDALE SAN LUCA,LOM,40-49,13,24,0,16,21,0,0,37,0,37,Lombardia,ITC4
2021-01-17,PF/BT,000050,Poliambulatorio IRCSS OSPEDALE SAN LUCA,LOM,50-59,19,28,0,22,25,0,0,47,0,47,Lombardia,ITC4
2021-01-17,PF/BT,000050,Poliambulatorio IRCSS OSPEDALE SAN LUCA,LOM,60-69,5,12,0,8,9,0,0,17,0,17,Lombardia,ITC4
2021-01-17,PF/BT,000050,Poliambulatorio IRCSS OSPEDALE SAN LUCA,LOM,70-79,5,5,0,2,8,0,0,10,0,10,Lombardia,ITC4
2021-01-17,PF/BT,000050,Poliambulatorio IRCSS OSPEDALE SAN LUCA,LOM,80-89,0,2,0,0,2,0,0,2,0,2,Lombardia,ITC4
2021-01-17,PF/BT,030066,CV Garbagnate,LOM,20-29,0,3,0,3,0,0,0,2,1,3,Lombardia,ITC4
2021-01-17,PF/BT,030066,CV Garbagnate,LOM,30-39,1,2,0,2,1,0,0,3,0,3,Lombardia,ITC4
2021-01-17,PF/BT,030066,CV Garbagnate,LOM,40-49,1,3,0,3,1,0,0,3,1,4,Lombardia,ITC4
2021-01-17,PF/BT,030066,CV Garbagnate,LOM,50-59,4,7,0,5,6,0,0,10,1,11,Lombardia,ITC4
2021-01-17,PF/BT,030066,CV Garbagnate,LOM,60-69,7,8,0,15,0,0,0,13,2,15,Lombardia,ITC4
2021-01-17,PF/BT,030068,PUNTO VACCINALE OSPEDALIERO DESIO,LOM,16-19,2,0,0,2,0,0,0,2,0,2,Lombardia,ITC4
2021-01-17,PF/BT,030068,PUNTO VACCINALE OSPEDALIERO DESIO,LOM,20-29,8,15,0,23,0,0,0,23,0,23,Lombardia,ITC4
2021-01-17,PF/BT,030068,PUNTO VACCINALE OSPEDALIERO DESIO,LOM,30-39,7,19,0,24,2,0,0,26,0,26,Lombardia,ITC4
2021-01-17,PF/BT,030068,PUNTO VACCINALE OSPEDALIERO DESIO,LOM,40-49,19,35,0,39,15,0,0,54,0,54,Lombardia,ITC4
2021-01-17,PF/BT,030068,PUNTO VACCINALE OSPEDALIERO DESIO,LOM,50-59,12,59,0,46,25,0,0,71,0,71,Lombardia,ITC4
2021-01-17,PF/BT,030068,PUNTO VACCINALE OSPEDALIERO DESIO,LOM,60-69,8,14,0,18,4,0,0,22,0,22,Lombardia,ITC4
2021-01-17,PF/BT,030070,PUNTO VACCINALE OSPEDALIERO CARATE BRIANZA,LOM,16-19,1,0,0,1,0,0,0,1,0,1,Lombardia,ITC4
2021-01-17,PF/BT,030070,PUNTO VACCINALE OSPEDALIERO CARATE BRIANZA,LOM,20-29,7,7,0,13,1,0,0,14,0,14,Lombardia,ITC4
2021-01-17,PF/BT,030070,PUNTO VACCINALE OSPEDALIERO CARATE BRIANZA,LOM,30-39,6,15,0,15,6,0,0,21,0,21,Lombardia,ITC4
2021-01-17,PF/BT,030070,PUNTO VACCINALE OSPEDALIERO CARATE BRIANZA,LOM,40-49,10,33,0,35,8,0,0,43,0,43,Lombardia,ITC4
2021-01-17,PF/BT,030070,PUNTO VACCINALE OSPEDALIERO CARATE BRIANZA,LOM,50-59,13,45,0,38,20,0,0,58,0,58,Lombardia,ITC4
2021-01-17,PF/BT,030070,PUNTO VACCINALE OSPEDALIERO CARATE BRIANZA,LOM,60-69,5,13,0,13,5,0,0,18,0,18,Lombardia,ITC4
2021-01-17,PF/BT,030070,PUNTO VACCINALE OSPEDALIERO CARATE BRIANZA,LOM,70-79,3,2,0,2,3,0,0,5,0,5,Lombardia,ITC4
2021-01-17,PF/BT,030078,PUNTO VACCINALE OSPEDALIERO VIMERCATE,LOM,20-29,8,10,0,14,4,0,0,18,0,18,Lombardia,ITC4
2021-01-17,PF/BT,030078,PUNTO VACCINALE OSPEDALIERO VIMERCATE,LOM,30-39,13,14,0,17,10,0,0,27,0,27,Lombardia,ITC4
2021-01-17,PF/BT,030078,PUNTO VACCINALE OSPEDALIERO VIMERCATE,LOM,40-49,13,24,0,27,10,0,0,37,0,37,Lombardia,ITC4
2021-01-17,PF/BT,030078,PUNTO VACCINALE OSPEDALIERO VIMERCATE,LOM,50-59,16,33,0,32,17,0,0,49,0,49,Lombardia,ITC4
2021-01-17,PF/BT,030078,PUNTO VACCINALE OSPEDALIERO VIMERCATE,LOM,60-69,11,18,0,18,11,0,0,29,0,29,Lombardia,ITC4
2021-01-17,PF/BT,030078,PUNTO VACCINALE OSPEDALIERO VIMERCATE,LOM,70-79,3,3,0,5,1,0,0,6,0,6,Lombardia,ITC4
2021-01-17,PF/BT,03019800,ISTITUTO CLINICO BEATO MATTEO,LOM,20-29,2,0,0,0,2,0,0,2,0,2,Lombardia,ITC4
2021-01-17,PF/BT,03019800,ISTITUTO CLINICO BEATO MATTEO,LOM,30-39,5,4,0,5,4,0,0,9,0,9,Lombardia,ITC4
2021-01-17,PF/BT,03019800,ISTITUTO CLINICO BEATO MATTEO,LOM,40-49,9,7,0,7,9,0,0,16,0,16,Lombardia,ITC4
2021-01-17,PF/BT,03019800,ISTITUTO CLINICO BEATO MATTEO,LOM,50-59,9,11,0,2,18,0,0,20,0,20,Lombardia,ITC4
2021-01-17,PF/BT,03019800,ISTITUTO CLINICO BEATO MATTEO,LOM,60-69,4,2,0,3,3,0,0,6,0,6,Lombardia,ITC4
2021-01-17,PF/BT,03019800,ISTITUTO CLINICO BEATO MATTEO,LOM,70-79,1,0,0,0,1,0,0,1,0,1,Lombardia,ITC4
2021-01-17,PF/BT,03020200,ISTITUTO DI CURA CITTA' DI PAVIA,LOM,20-29,8,3,0,1,10,0,0,11,0,11,Lombardia,ITC4
2021-01-17,PF/BT,03020200,ISTITUTO DI CURA CITTA' DI PAVIA,LOM,30-39,4,5,0,1,8,0,0,9,0,9,Lombardia,ITC4
2021-01-17,PF/BT,03020200,ISTITUTO DI CURA CITTA' DI PAVIA,LOM,40-49,10,10,0,4,16,0,0,20,0,20,Lombardia,ITC4
2021-01-17,PF/BT,03020200,ISTITUTO DI CURA CITTA' DI PAVIA,LOM,50-59,10,9,0,6,13,0,0,19,0,19,Lombardia,ITC4
2021-01-17,PF/BT,03020200,ISTITUTO DI CURA CITTA' DI PAVIA,LOM,60-69,2,4,0,3,3,0,0,6,0,6,Lombardia,ITC4
2021-01-17,PF/BT,03020200,ISTITUTO DI CURA CITTA' DI PAVIA,LOM,70-79,5,2,0,7,0,0,0,7,0,7,Lombardia,ITC4
2021-01-17,PF/BT,030-322-002913,RSA SACRO CUORE,LOM,30-39,4,4,0,3,5,0,0,8,0,8,Lombardia,ITC4
2021-01-17,PF/BT,030-322-002913,RSA SACRO CUORE,LOM,40-49,3,11,0,12,2,0,0,14,0,14,Lombardia,ITC4
2021-01-17,PF/BT,030-322-002913,RSA SACRO CUORE,LOM,50-59,2,7,0,6,2,1,0,9,0,9,Lombardia,ITC4
2021-01-17,PF/BT,030-322-002913,RSA SACRO CUORE,LOM,60-69,1,1,0,1,0,1,0,2,0,2,Lombardia,ITC4
2021-01-17,PF/BT,030-322-002913,RSA SACRO CUORE,LOM,70-79,4,2,0,0,0,6,0,6,0,6,Lombardia,ITC4
2021-01-17,PF/BT,030-322-002913,RSA SACRO CUORE,LOM,80-89,3,14,0,0,0,17,0,17,0,17,Lombardia,ITC4
2021-01-17,PF/BT,030-322-002913,RSA SACRO CUORE,LOM,90+,1,9,0,0,0,10,0,10,0,10,Lombardia,ITC4
2021-01-17,PF/BT,030903,AMB COVID LECCO,LOM,16-19,0,1,0,1,0,0,0,1,0,1,Lombardia,ITC4
2021-01-17,PF/BT,030903,AMB COVID LECCO,LOM,20-29,2,11,0,7,6,0,0,13,0,13,Lombardia,ITC4
2021-01-17,PF/BT,030903,AMB COVID LECCO,LOM,30-39,15,17,0,23,9,0,0,32,0,32,Lombardia,ITC4
2021-01-17,PF/BT,030903,AMB COVID LECCO,LOM,40-49,19,21,0,21,19,0,0,39,1,40,Lombardia,ITC4
2021-01-17,PF/BT,030903,AMB COVID LECCO,LOM,50-59,34,33,0,28,39,0,0,66,1,67,Lombardia,ITC4
2021-01-17,PF/BT,030903,AMB COVID LECCO,LOM,60-69,26,15,0,17,24,0,0,40,1,41,Lombardia,ITC4
2021-01-17,PF/BT,030903,AMB COVID LECCO,LOM,70-79,8,5,0,2,11,0,0,13,0,13,Lombardia,ITC4
2021-01-17,PF/BT,030924,IRCCS POLICLINICO S. MATTEO - PAVIA,LOM,16-19,1,0,0,1,0,0,0,1,0,1,Lombardia,ITC4
2021-01-17,PF/BT,030924,IRCCS POLICLINICO S. MATTEO - PAVIA,LOM,20-29,17,15,0,29,2,0,1,32,0,32,Lombardia,ITC4
2021-01-17,PF/BT,030924,IRCCS POLICLINICO S. MATTEO - PAVIA,LOM,30-39,20,29,0,47,2,0,0,49,0,49,Lombardia,ITC4
2021-01-17,PF/BT,030924,IRCCS POLICLINICO S. MATTEO - PAVIA,LOM,40-49,25,39,0,53,7,0,4,64,0,64,Lombardia,ITC4
2021-01-17,PF/BT,030924,IRCCS POLICLINICO S. MATTEO - PAVIA,LOM,50-59,39,69,0,86,21,0,1,108,0,108,Lombardia,ITC4
2021-01-17,PF/BT,030924,IRCCS POLICLINICO S. MATTEO - PAVIA,LOM,60-69,26,19,0,41,4,0,0,45,0,45,Lombardia,ITC4
2021-01-17,PF/BT,030924,IRCCS POLICLINICO S. MATTEO - PAVIA,LOM,70-79,4,3,0,7,0,0,0,7,0,7,Lombardia,ITC4
2021-01-17,PF/BT,030925,Fondazione IRCCS Ca' Granda Ospedale Maggiore Policlinico,LOM,16-19,31,73,0,103,1,0,0,104,0,104,Lombardia,ITC4
2021-01-17,PF/BT,030925,Fondazione IRCCS Ca' Granda Ospedale Maggiore Policlinico,LOM,20-29,182,384,0,565,1,0,0,566,0,566,Lombardia,ITC4
2021-01-17,PF/BT,030925,Fondazione IRCCS Ca' Granda Ospedale Maggiore Policlinico,LOM,30-39,199,186,0,380,5,0,0,385,0,385,Lombardia,ITC4
2021-01-17,PF/BT,030925,Fondazione IRCCS Ca' Granda Ospedale Maggiore Policlinico,LOM,40-49,208,197,0,399,6,0,0,405,0,405,Lombardia,ITC4
2021-01-17,PF/BT,030925,Fondazione IRCCS Ca' Granda Ospedale Maggiore Policlinico,LOM,50-59,265,263,0,522,6,0,0,528,0,528,Lombardia,ITC4
2021-01-17,PF/BT,030925,Fondazione IRCCS Ca' Granda Ospedale Maggiore Policlinico,LOM,60-69,229,170,0,393,6,0,0,398,1,399,Lombardia,ITC4
2021-01-17,PF/BT,030925,Fondazione IRCCS Ca' Granda Ospedale Maggiore Policlinico,LOM,70-79,118,109,0,226,1,0,0,227,0,227,Lombardia,ITC4
2021-01-17,PF/BT,030925,Fondazione IRCCS Ca' Granda Ospedale Maggiore Policlinico,LOM,80-89,10,13,0,23,0,0,0,23,0,23,Lombardia,ITC4
2021-01-17,PF/BT,030925,Fondazione IRCCS Ca' Granda Ospedale Maggiore Policlinico,LOM,90+,0,1,0,1,0,0,0,1,0,1,Lombardia,ITC4
2021-01-17,PF/BT,159,PVO COVID OSPEDALI DI MONTICHIARI,LOM,20-29,2,6,0,6,2,0,0,8,0,8,Lombardia,ITC4
2021-01-17,PF/BT,159,PVO COVID OSPEDALI DI MONTICHIARI,LOM,30-39,7,12,0,14,5,0,0,19,0,19,Lombardia,ITC4
2021-01-17,PF/BT,159,PVO COVID OSPEDALI DI MONTICHIARI,LOM,40-49,5,28,0,19,14,0,0,33,0,33,Lombardia,ITC4
2021-01-17,PF/BT,159,PVO COVID OSPEDALI DI MONTICHIARI,LOM,50-59,6,59,0,43,22,0,0,65,0,65,Lombardia,ITC4
2021-01-17,PF/BT,159,PVO COVID OSPEDALI DI MONTICHIARI,LOM,60-69,5,14,0,10,9,0,0,19,0,19,Lombardia,ITC4
2021-01-17,PF/BT,167,ASST SPEDALI CIVILI AMBULATORIO COVID BRESCIA,LOM,20-29,6,19,0,21,4,0,0,25,0,25,Lombardia,ITC4
2021-01-17,PF/BT,167,ASST SPEDALI CIVILI AMBULATORIO COVID BRESCIA,LOM,30-39,10,27,0,33,4,0,0,37,0,37,Lombardia,ITC4
2021-01-17,PF/BT,167,ASST SPEDALI CIVILI AMBULATORIO COVID BRESCIA,LOM,40-49,9,50,0,37,22,0,0,59,0,59,Lombardia,ITC4
2021-01-17,PF/BT,167,ASST SPEDALI CIVILI AMBULATORIO COVID BRESCIA,LOM,50-59,18,65,0,52,31,0,0,82,1,83,Lombardia,ITC4
2021-01-17,PF/BT,167,ASST SPEDALI CIVILI AMBULATORIO COVID BRESCIA,LOM,60-69,8,10,0,16,2,0,0,18,0,18,Lombardia,ITC4
2021-01-17,PF/BT,1745,FONDAZIONE RSA CASA DI RIPOSO DI SALO' RESIDENZA GLI ULIVI,LOM,30-39,0,2,0,1,1,0,0,2,0,2,Lombardia,ITC4
2021-01-17,PF/BT,1745,FONDAZIONE RSA CASA DI RIPOSO DI SALO' RESIDENZA GLI ULIVI,LOM,40-49,0,4,0,3,1,0,0,4,0,4,Lombardia,ITC4
2021-01-17,PF/BT,1745,FONDAZIONE RSA CASA DI RIPOSO DI SALO' RESIDENZA GLI ULIVI,LOM,50-59,1,3,0,3,1,0,0,4,0,4,Lombardia,ITC4
2021-01-17,PF/BT,1745,FONDAZIONE RSA CASA DI RIPOSO DI SALO' RESIDENZA GLI ULIVI,LOM,60-69,0,1,0,1,0,0,0,1,0,1,Lombardia,ITC4
2021-01-17,PF/BT,1745,FONDAZIONE RSA CASA DI RIPOSO DI SALO' RESIDENZA GLI ULIVI,LOM,70-79,2,3,0,0,0,5,0,5,0,5,Lombardia,ITC4
2021-01-17,PF/BT,1745,FONDAZIONE RSA CASA DI RIPOSO DI SALO' RESIDENZA GLI ULIVI,LOM,80-89,2,18,0,0,0,20,0,20,0,20,Lombardia,ITC4
2021-01-17,PF/BT,1745,FONDAZIONE RSA CASA DI RIPOSO DI SALO' RESIDENZA GLI ULIVI,LOM,90+,2,10,0,0,0,12,0,12,0,12,Lombardia,ITC4
2021-01-17,PF/BT,1946,"FONDAZIONE ""CONTE DR. CARLO CARACCI"" - ONLUS",LOM,20-29,0,1,0,1,0,0,0,1,0,1,Lombardia,ITC4
2021-01-17,PF/BT,1946,"FONDAZIONE ""CONTE DR. CARLO CARACCI"" - ONLUS",LOM,30-39,0,1,0,1,0,0,0,1,0,1,Lombardia,ITC4
2021-01-17,PF/BT,1946,"FONDAZIONE ""CONTE DR. CARLO CARACCI"" - ONLUS",LOM,40-49,0,2,0,1,0,0,1,2,0,2,Lombardia,ITC4
2021-01-17,PF/BT,1946,"FONDAZIONE ""CONTE DR. CARLO CARACCI"" - ONLUS",LOM,50-59,1,2,0,1,2,0,0,3,0,3,Lombardia,ITC4
2021-01-17,PF/BT,1946,"FONDAZIONE ""CONTE DR. CARLO CARACCI"" - ONLUS",LOM,60-69,2,1,0,2,1,0,0,3,0,3,Lombardia,ITC4
2021-01-17,PF/BT,1946,"FONDAZIONE ""CONTE DR. CARLO CARACCI"" - ONLUS",LOM,70-79,0,2,0,0,0,2,0,2,0,2,Lombardia,ITC4
2021-01-17,PF/BT,1946,"FONDAZIONE ""CONTE DR. CARLO CARACCI"" - ONLUS",LOM,80-89,1,3,0,0,0,4,0,4,0,4,Lombardia,ITC4
2021-01-17,PF/BT,1946,"FONDAZIONE ""CONTE DR. CARLO CARACCI"" - ONLUS",LOM,90+,0,2,0,0,0,2,0,2,0,2,Lombardia,ITC4
2021-01-17,PF/BT,30073,cv rho,LOM,20-29,0,2,0,2,0,0,0,2,0,2,Lombardia,ITC4
2021-01-17,PF/BT,30073,cv rho,LOM,30-39,0,1,0,0,1,0,0,1,0,1,Lombardia,ITC4
2021-01-17,PF/BT,30073,cv rho,LOM,40-49,2,5,0,5,2,0,0,7,0,7,Lombardia,ITC4
2021-01-17,PF/BT,30073,cv rho,LOM,50-59,7,6,0,11,2,0,0,13,0,13,Lombardia,ITC4
2021-01-17,PF/BT,30073,cv rho,LOM,60-69,7,6,0,13,0,0,0,13,0,13,Lombardia,ITC4
2021-01-17,PF/BT,30074,HUB COVID MAGENTA,LOM,16-19,1,0,0,0,1,0,0,1,0,1,Lombardia,ITC4
2021-01-17,PF/BT,30074,HUB COVID MAGENTA,LOM,20-29,11,8,0,4,15,0,0,19,0,19,Lombardia,ITC4
2021-01-17,PF/BT,30074,HUB COVID MAGENTA,LOM,30-39,14,10,0,4,20,0,0,24,0,24,Lombardia,ITC4
2021-01-17,PF/BT,30074,HUB COVID MAGENTA,LOM,40-49,11,17,0,3,25,0,0,28,0,28,Lombardia,ITC4
2021-01-17,PF/BT,30074,HUB COVID MAGENTA,LOM,50-59,24,12,0,2,34,0,0,36,0,36,Lombardia,ITC4
2021-01-17,PF/BT,30074,HUB COVID MAGENTA,LOM,60-69,95,25,0,0,120,0,0,120,0,120,Lombardia,ITC4
2021-01-17,PF/BT,30074,HUB COVID MAGENTA,LOM,70-79,74,27,0,0,101,0,0,101,0,101,Lombardia,ITC4
2021-01-17,PF/BT,30074,HUB COVID MAGENTA,LOM,80-89,4,0,0,0,4,0,0,4,0,4,Lombardia,ITC4
2021-01-17,PF/BT,30156,Centro Vaccinale Covid Desenzano,LOM,20-29,1,11,0,0,8,0,4,12,0,12,Lombardia,ITC4
2021-01-17,PF/BT,30156,Centro Vaccinale Covid Desenzano,LOM,30-39,8,6,0,0,6,0,8,13,1,14,Lombardia,ITC4
2021-01-17,PF/BT,30156,Centro Vaccinale Covid Desenzano,LOM,40-49,2,25,0,0,9,0,18,27,0,27,Lombardia,ITC4
2021-01-17,PF/BT,30156,Centro Vaccinale Covid Desenzano,LOM,50-59,6,27,0,0,12,0,21,32,1,33,Lombardia,ITC4
2021-01-17,PF/BT,30156,Centro Vaccinale Covid Desenzano,LOM,60-69,7,7,0,0,7,0,7,13,1,14,Lombardia,ITC4
2021-01-17,PF/BT,30156,Centro Vaccinale Covid Desenzano,LOM,70-79,3,1,0,0,1,0,3,4,0,4,Lombardia,ITC4
2021-01-17,PF/BT,30157,Centro Vaccinale Covid Gavardo,LOM,20-29,4,9,0,4,0,0,9,13,0,13,Lombardia,ITC4
2021-01-17,PF/BT,30157,Centro Vaccinale Covid Gavardo,LOM,30-39,8,6,0,3,0,0,11,14,0,14,Lombardia,ITC4
2021-01-17,PF/BT,30157,Centro Vaccinale Covid Gavardo,LOM,40-49,8,12,0,5,1,0,14,20,0,20,Lombardia,ITC4
2021-01-17,PF/BT,30157,Centro Vaccinale Covid Gavardo,LOM,50-59,17,11,0,6,1,0,21,26,2,28,Lombardia,ITC4
2021-01-17,PF/BT,30157,Centro Vaccinale Covid Gavardo,LOM,60-69,13,6,0,3,0,0,16,19,0,19,Lombardia,ITC4
2021-01-17,PF/BT,30157,Centro Vaccinale Covid Gavardo,LOM,70-79,11,1,0,0,0,0,12,12,0,12,Lombardia,ITC4
2021-01-17,PF/BT,30184,Centro Vaccinale Covid Manerbio,LOM,20-29,4,3,0,4,0,0,3,7,0,7,Lombardia,ITC4
2021-01-17,PF/BT,30184,Centro Vaccinale Covid Manerbio,LOM,30-39,7,8,0,12,1,0,2,14,1,15,Lombardia,ITC4
2021-01-17,PF/BT,30184,Centro Vaccinale Covid Manerbio,LOM,40-49,0,18,0,15,0,0,3,17,1,18,Lombardia,ITC4
2021-01-17,PF/BT,30184,Centro Vaccinale Covid Manerbio,LOM,50-59,8,26,0,26,0,0,8,34,0,34,Lombardia,ITC4
2021-01-17,PF/BT,30184,Centro Vaccinale Covid Manerbio,LOM,60-69,9,9,0,17,0,0,1,18,0,18,Lombardia,ITC4
2021-01-17,PF/BT,30184,Centro Vaccinale Covid Manerbio,LOM,70-79,1,2,0,3,0,0,0,3,0,3,Lombardia,ITC4
2021-01-17,PF/BT,30184,Centro Vaccinale Covid Manerbio,LOM,80-89,1,0,0,1,0,0,0,1,0,1,Lombardia,ITC4
2021-01-17,PF/BT,30193,Ambulatorio HUB Vigevano,LOM,20-29,2,3,0,0,5,0,0,5,0,5,Lombardia,ITC4
2021-01-17,PF/BT,30193,Ambulatorio HUB Vigevano,LOM,30-39,3,5,0,0,8,0,0,8,0,8,Lombardia,ITC4
2021-01-17,PF/BT,30193,Ambulatorio HUB Vigevano,LOM,40-49,14,5,0,1,18,0,0,19,0,19,Lombardia,ITC4
2021-01-17,PF/BT,30193,Ambulatorio HUB Vigevano,LOM,50-59,8,5,0,1,12,0,0,13,0,13,Lombardia,ITC4
2021-01-17,PF/BT,30193,Ambulatorio HUB Vigevano,LOM,60-69,6,4,0,0,10,0,0,10,0,10,Lombardia,ITC4
2021-01-17,PF/BT,30193,Ambulatorio HUB Vigevano,LOM,70-79,1,4,0,0,5,0,0,5,0,5,Lombardia,ITC4
2021-01-17,PF/BT,30194,AMBULATORIO HUB VOGHERA,LOM,16-19,1,0,0,0,1,0,0,1,0,1,Lombardia,ITC4
2021-01-17,PF/BT,30194,AMBULATORIO HUB VOGHERA,LOM,20-29,11,9,0,12,8,0,0,20,0,20,Lombardia,ITC4
2021-01-17,PF/BT,30194,AMBULATORIO HUB VOGHERA,LOM,30-39,21,9,0,16,14,0,0,30,0,30,Lombardia,ITC4
2021-01-17,PF/BT,30194,AMBULATORIO HUB VOGHERA,LOM,40-49,16,7,0,16,7,0,0,23,0,23,Lombardia,ITC4
2021-01-17,PF/BT,30194,AMBULATORIO HUB VOGHERA,LOM,50-59,13,18,0,25,6,0,0,31,0,31,Lombardia,ITC4
2021-01-17,PF/BT,30194,AMBULATORIO HUB VOGHERA,LOM,60-69,5,4,0,7,2,0,0,9,0,9,Lombardia,ITC4
2021-01-17,PF/BT,30209,OSPEDALE MAGGIORE DI CREMA,LOM,16-19,1,0,0,0,0,0,1,1,0,1,Lombardia,ITC4
2021-01-17,PF/BT,30209,OSPEDALE MAGGIORE DI CREMA,LOM,20-29,15,4,0,2,0,0,17,17,2,19,Lombardia,ITC4
2021-01-17,PF/BT,30209,OSPEDALE MAGGIORE DI CREMA,LOM,30-39,3,8,0,2,0,0,9,9,2,11,Lombardia,ITC4
2021-01-17,PF/BT,30209,OSPEDALE MAGGIORE DI CREMA,LOM,40-49,8,8,0,2,0,0,14,15,1,16,Lombardia,ITC4
2021-01-17,PF/BT,30209,OSPEDALE MAGGIORE DI CREMA,LOM,50-59,10,3,0,2,0,0,11,11,2,13,Lombardia,ITC4
2021-01-17,PF/BT,30209,OSPEDALE MAGGIORE DI CREMA,LOM,60-69,9,0,0,0,0,0,9,9,0,9,Lombardia,ITC4
2021-01-17,PF/BT,30209,OSPEDALE MAGGIORE DI CREMA,LOM,70-79,3,0,0,0,0,0,3,3,0,3,Lombardia,ITC4
2021-01-17,PF/BT,3021900,CASA DI CURA FIGLIE DI SAN CAMILLO CREMONA,LOM,20-29,3,3,0,4,2,0,0,6,0,6,Lombardia,ITC4
2021-01-17,PF/BT,3021900,CASA DI CURA FIGLIE DI SAN CAMILLO CREMONA,LOM,30-39,5,3,0,5,3,0,0,8,0,8,Lombardia,ITC4
2021-01-17,PF/BT,3021900,CASA DI CURA FIGLIE DI SAN CAMILLO CREMONA,LOM,40-49,3,7,0,7,2,0,1,10,0,10,Lombardia,ITC4
2021-01-17,PF/BT,3021900,CASA DI CURA FIGLIE DI SAN CAMILLO CREMONA,LOM,50-59,4,13,0,12,5,0,0,17,0,17,Lombardia,ITC4
2021-01-17,PF/BT,3021900,CASA DI CURA FIGLIE DI SAN CAMILLO CREMONA,LOM,60-69,6,2,0,8,0,0,0,8,0,8,Lombardia,ITC4
2021-01-17,PF/BT,3021900,CASA DI CURA FIGLIE DI SAN CAMILLO CREMONA,LOM,70-79,4,1,0,0,3,0,2,5,0,5,Lombardia,ITC4
2021-01-17,PF/BT,30281,HUB LEGNANO,LOM,16-19,6,5,0,8,3,0,0,11,0,11,Lombardia,ITC4
2021-01-17,PF/BT,30281,HUB LEGNANO,LOM,20-29,38,47,0,81,4,0,0,85,0,85,Lombardia,ITC4
2021-01-17,PF/BT,30281,HUB LEGNANO,LOM,30-39,24,19,0,39,4,0,0,42,1,43,Lombardia,ITC4
2021-01-17,PF/BT,30281,HUB LEGNANO,LOM,40-49,46,24,0,67,3,0,0,67,3,70,Lombardia,ITC4
2021-01-17,PF/BT,30281,HUB LEGNANO,LOM,50-59,25,19,0,34,10,0,0,43,1,44,Lombardia,ITC4
2021-01-17,PF/BT,30281,HUB LEGNANO,LOM,60-69,35,21,0,46,10,0,0,55,1,56,Lombardia,ITC4
2021-01-17,PF/BT,30281,HUB LEGNANO,LOM,70-79,20,6,0,16,10,0,0,26,0,26,Lombardia,ITC4
2021-01-17,PF/BT,30281,HUB LEGNANO,LOM,80-89,1,0,0,1,0,0,0,1,0,1,Lombardia,ITC4
2021-01-17,PF/BT,30701,ASST GRANDE OSPEDALE METROPOLITANO NIGUARDA,LOM,16-19,2,3,0,2,3,0,0,5,0,5,Lombardia,ITC4
2021-01-17,PF/BT,30701,ASST GRANDE OSPEDALE METROPOLITANO NIGUARDA,LOM,20-29,52,73,0,67,31,0,27,125,0,125,Lombardia,ITC4
2021-01-17,PF/BT,30701,ASST GRANDE OSPEDALE METROPOLITANO NIGUARDA,LOM,30-39,30,45,0,55,13,0,7,75,0,75,Lombardia,ITC4
2021-01-17,PF/BT,30701,ASST GRANDE OSPEDALE METROPOLITANO NIGUARDA,LOM,40-49,37,60,0,48,21,0,28,97,0,97,Lombardia,ITC4
2021-01-17,PF/BT,30701,ASST GRANDE OSPEDALE METROPOLITANO NIGUARDA,LOM,50-59,45,88,0,67,46,0,20,133,0,133,Lombardia,ITC4
2021-01-17,PF/BT,30701,ASST GRANDE OSPEDALE METROPOLITANO NIGUARDA,LOM,60-69,29,25,0,31,15,0,8,54,0,54,Lombardia,ITC4
2021-01-17,PF/BT,30701,ASST GRANDE OSPEDALE METROPOLITANO NIGUARDA,LOM,70-79,6,1,0,7,0,0,0,7,0,7,Lombardia,ITC4
2021-01-17,PF/BT,30701,ASST GRANDE OSPEDALE METROPOLITANO NIGUARDA,LOM,80-89,2,0,0,1,1,0,0,2,0,2,Lombardia,ITC4
2021-01-17,PF/BT,30718,ASST PAPA GIOVANNI XXIII,LOM,16-19,7,53,0,60,0,0,0,60,0,60,Lombardia,ITC4
2021-01-17,PF/BT,30718,ASST PAPA GIOVANNI XXIII,LOM,20-29,57,305,0,361,1,0,0,362,0,362,Lombardia,ITC4
2021-01-17,PF/BT,30718,ASST PAPA GIOVANNI XXIII,LOM,30-39,19,49,0,59,9,0,0,68,0,68,Lombardia,ITC4
2021-01-17,PF/BT,30718,ASST PAPA GIOVANNI XXIII,LOM,40-49,11,78,0,72,17,0,0,89,0,89,Lombardia,ITC4
2021-01-17,PF/BT,30718,ASST PAPA GIOVANNI XXIII,LOM,50-59,29,75,0,81,23,0,0,104,0,104,Lombardia,ITC4
2021-01-17,PF/BT,30718,ASST PAPA GIOVANNI XXIII,LOM,60-69,13,6,0,17,2,0,0,19,0,19,Lombardia,ITC4
2021-01-17,PF/BT,30902,Ospedale S.Anna - Como,LOM,16-19,1,0,0,0,1,0,0,1,0,1,Lombardia,ITC4
2021-01-17,PF/BT,30902,Ospedale S.Anna - Como,LOM,20-29,9,7,0,4,12,0,0,16,0,16,Lombardia,ITC4
2021-01-17,PF/BT,30902,Ospedale S.Anna - Como,LOM,30-39,7,6,0,3,10,0,0,13,0,13,Lombardia,ITC4
2021-01-17,PF/BT,30902,Ospedale S.Anna - Como,LOM,40-49,8,12,0,9,11,0,0,20,0,20,Lombardia,ITC4
2021-01-17,PF/BT,30902,Ospedale S.Anna - Como,LOM,50-59,7,14,0,4,15,0,2,21,0,21,Lombardia,ITC4
2021-01-17,PF/BT,30902,Ospedale S.Anna - Como,LOM,60-69,10,9,0,9,10,0,0,19,0,19,Lombardia,ITC4
2021-01-17,PF/BT,30909,amb covid monza,LOM,16-19,1,10,0,11,0,0,0,11,0,11,Lombardia,ITC4
2021-01-17,PF/BT,30909,amb covid monza,LOM,20-29,53,118,0,165,2,0,4,170,1,171,Lombardia,ITC4
2021-01-17,PF/BT,30909,amb covid monza,LOM,30-39,25,57,0,65,11,0,6,78,4,82,Lombardia,ITC4
2021-01-17,PF/BT,30909,amb covid monza,LOM,40-49,31,64,0,71,12,0,12,84,11,95,Lombardia,ITC4
2021-01-17,PF/BT,30909,amb covid monza,LOM,50-59,36,82,0,82,18,0,18,95,23,118,Lombardia,ITC4
2021-01-17,PF/BT,30909,amb covid monza,LOM,60-69,21,24,0,30,10,0,5,36,9,45,Lombardia,ITC4
2021-01-17,PF/BT,30909,amb covid monza,LOM,70-79,5,1,0,4,2,0,0,4,2,6,Lombardia,ITC4
2021-01-17,PF/BT,321,RSA S.MARIA AL CASTELLO FONDAZIONE DON CARLO GNOCCHI PESSANO CON BORNAGO,LOM,20-29,10,13,0,22,1,0,0,23,0,23,Lombardia,ITC4
2021-01-17,PF/BT,321,RSA S.MARIA AL CASTELLO FONDAZIONE DON CARLO GNOCCHI PESSANO CON BORNAGO,LOM,30-39,5,12,0,15,2,0,0,17,0,17,Lombardia,ITC4
2021-01-17,PF/BT,321,RSA S.MARIA AL CASTELLO FONDAZIONE DON CARLO GNOCCHI PESSANO CON BORNAGO,LOM,40-49,2,23,0,23,2,0,0,25,0,25,Lombardia,ITC4
2021-01-17,PF/BT,321,RSA S.MARIA AL CASTELLO FONDAZIONE DON CARLO GNOCCHI PESSANO CON BORNAGO,LOM,50-59,2,26,0,28,0,0,0,28,0,28,Lombardia,ITC4
2021-01-17,PF/BT,321,RSA S.MARIA AL CASTELLO FONDAZIONE DON CARLO GNOCCHI PESSANO CON BORNAGO,LOM,60-69,5,4,0,9,0,0,0,9,0,9,Lombardia,ITC4
2021-01-17,PF/BT,321000247,RSA GIOVANNI PAOLO II,LOM,60-69,1,0,0,0,0,1,0,1,0,1,Lombardia,ITC4
2021-01-17,PF/BT,321000247,RSA GIOVANNI PAOLO II,LOM,70-79,1,0,0,0,0,1,0,1,0,1,Lombardia,ITC4
2021-01-17,PF/BT,321000247,RSA GIOVANNI PAOLO II,LOM,80-89,0,1,0,0,0,1,0,1,0,1,Lombardia,ITC4
2021-01-17,PF/BT,321000354 e 321000584,PUNTO VACCINALE RSA CASA PER CONIUGI,LOM,60-69,0,1,0,0,0,1,0,1,0,1,Lombardia,ITC4
2021-01-17,PF/BT,321000354 e 321000584,PUNTO VACCINALE RSA CASA PER CONIUGI,LOM,70-79,0,2,0,0,0,2,0,2,0,2,Lombardia,ITC4
2021-01-17,PF/BT,321000354 e 321000584,PUNTO VACCINALE RSA CASA PER CONIUGI,LOM,80-89,2,16,0,0,0,18,0,18,0,18,Lombardia,ITC4
2021-01-17,PF/BT,321000354 e 321000584,PUNTO VACCINALE RSA CASA PER CONIUGI,LOM,90+,0,9,0,0,0,9,0,9,0,9,Lombardia,ITC4
2021-01-17,PF/BT,32170712,ambulatorio covid SESTO SAN GIOVANNI,LOM,16-19,3,2,0,3,2,0,0,5,0,5,Lombardia,ITC4
2021-01-17,PF/BT,32170712,ambulatorio covid SESTO SAN GIOVANNI,LOM,20-29,15,31,0,28,18,0,0,46,0,46,Lombardia,ITC4
2021-01-17,PF/BT,32170712,ambulatorio covid SESTO SAN GIOVANNI,LOM,30-39,20,23,0,26,17,0,0,43,0,43,Lombardia,ITC4
2021-01-17,PF/BT,32170712,ambulatorio covid SESTO SAN GIOVANNI,LOM,40-49,8,35,0,22,21,0,0,43,0,43,Lombardia,ITC4
2021-01-17,PF/BT,32170712,ambulatorio covid SESTO SAN GIOVANNI,LOM,50-59,23,19,0,31,11,0,0,41,1,42,Lombardia,ITC4
2021-01-17,PF/BT,32170712,ambulatorio covid SESTO SAN GIOVANNI,LOM,60-69,19,10,0,20,9,0,0,29,0,29,Lombardia,ITC4
2021-01-17,PF/BT,32170712,ambulatorio covid SESTO SAN GIOVANNI,LOM,70-79,10,7,0,6,11,0,0,17,0,17,Lombardia,ITC4
2021-01-17,PF/BT,32170712,ambulatorio covid SESTO SAN GIOVANNI,LOM,80-89,1,1,0,1,1,0,0,2,0,2,Lombardia,ITC4
2021-01-17,PF/BT,32271028,AMBULATORIO COVID OSPEDALE CIRCOLO,LOM,16-19,0,1,0,1,0,0,0,1,0,1,Lombardia,ITC4
2021-01-17,PF/BT,32271028,AMBULATORIO COVID OSPEDALE CIRCOLO,LOM,20-29,2,4,0,6,0,0,0,5,1,6,Lombardia,ITC4
2021-01-17,PF/BT,32271028,AMBULATORIO COVID OSPEDALE CIRCOLO,LOM,30-39,7,8,0,15,0,0,0,9,6,15,Lombardia,ITC4
2021-01-17,PF/BT,32271028,AMBULATORIO COVID OSPEDALE CIRCOLO,LOM,40-49,8,7,0,15,0,0,0,5,10,15,Lombardia,ITC4
2021-01-17,PF/BT,32271028,AMBULATORIO COVID OSPEDALE CIRCOLO,LOM,50-59,15,22,0,37,0,0,0,14,23,37,Lombardia,ITC4
2021-01-17,PF/BT,32271028,AMBULATORIO COVID OSPEDALE CIRCOLO,LOM,60-69,18,6,0,24,0,0,0,3,21,24,Lombardia,ITC4
2021-01-17,PF/BT,32271028,AMBULATORIO COVID OSPEDALE CIRCOLO,LOM,70-79,1,2,0,3,0,0,0,2,1,3,Lombardia,ITC4
2021-01-17,PF/BT,325001360,"CASA DI RIPOSO ""PIATTI-VENANZI"" - VIA SANTA MARIA ELISABETTA, 36 - 24050 PALOSCO (BG)",LOM,50-59,1,1,0,2,0,0,0,2,0,2,Lombardia,ITC4
2021-01-17,PF/BT,325001360,"CASA DI RIPOSO ""PIATTI-VENANZI"" - VIA SANTA MARIA ELISABETTA, 36 - 24050 PALOSCO (BG)",LOM,60-69,0,2,0,0,0,2,0,2,0,2,Lombardia,ITC4
2021-01-17,PF/BT,325001360,"CASA DI RIPOSO ""PIATTI-VENANZI"" - VIA SANTA MARIA ELISABETTA, 36 - 24050 PALOSCO (BG)",LOM,80-89,0,1,0,0,0,1,0,1,0,1,Lombardia,ITC4
2021-01-17,PF/BT,325001360,"CASA DI RIPOSO ""PIATTI-VENANZI"" - VIA SANTA MARIA ELISABETTA, 36 - 24050 PALOSCO (BG)",LOM,90+,0,1,0,0,0,1,0,1,0,1,Lombardia,ITC4
2021-01-17,PF/BT,32572021,Ambulatorio COVID PO Alzano Lombardo,LOM,16-19,1,0,0,1,0,0,0,1,0,1,Lombardia,ITC4
2021-01-17,PF/BT,32572021,Ambulatorio COVID PO Alzano Lombardo,LOM,20-29,3,2,0,5,0,0,0,5,0,5,Lombardia,ITC4
2021-01-17,PF/BT,32572021,Ambulatorio COVID PO Alzano Lombardo,LOM,30-39,4,6,0,10,0,0,0,10,0,10,Lombardia,ITC4
2021-01-17,PF/BT,32572021,Ambulatorio COVID PO Alzano Lombardo,LOM,40-49,2,7,0,9,0,0,0,9,0,9,Lombardia,ITC4
2021-01-17,PF/BT,32572021,Ambulatorio COVID PO Alzano Lombardo,LOM,50-59,7,10,0,17,0,0,0,17,0,17,Lombardia,ITC4
2021-01-17,PF/BT,32572021,Ambulatorio COVID PO Alzano Lombardo,LOM,60-69,4,6,0,10,0,0,0,10,0,10,Lombardia,ITC4
2021-01-17,PF/BT,32572021,Ambulatorio COVID PO Alzano Lombardo,LOM,70-79,4,3,0,7,0,0,0,7,0,7,Lombardia,ITC4
2021-01-17,PF/BT,32572026,AMBULATORIO COVID PIARIO,LOM,20-29,1,3,0,3,1,0,0,4,0,4,Lombardia,ITC4
2021-01-17,PF/BT,32572026,AMBULATORIO COVID PIARIO,LOM,30-39,1,4,0,4,1,0,0,5,0,5,Lombardia,ITC4
2021-01-17,PF/BT,32572026,AMBULATORIO COVID PIARIO,LOM,40-49,4,10,0,11,3,0,0,14,0,14,Lombardia,ITC4
2021-01-17,PF/BT,32572026,AMBULATORIO COVID PIARIO,LOM,50-59,1,19,0,16,4,0,0,20,0,20,Lombardia,ITC4
2021-01-17,PF/BT,32572026,AMBULATORIO COVID PIARIO,LOM,60-69,3,2,0,3,2,0,0,5,0,5,Lombardia,ITC4
2021-01-17,PF/BT,558,RSA PIO ALBERGO TRIVULZIO,LOM,20-29,4,10,0,14,0,0,0,6,8,14,Lombardia,ITC4
2021-01-17,PF/BT,558,RSA PIO ALBERGO TRIVULZIO,LOM,40-49,3,5,0,6,2,0,0,2,6,8,Lombardia,ITC4
2021-01-17,PF/BT,558,RSA PIO ALBERGO TRIVULZIO,LOM,50-59,4,4,0,7,1,0,0,1,7,8,Lombardia,ITC4
2021-01-17,PF/BT,558,RSA PIO ALBERGO TRIVULZIO,LOM,60-69,6,6,0,11,1,0,0,1,11,12,Lombardia,ITC4
2021-01-17,PF/BT,HSP11-11bis,AMBULATORIO COVID PO SACCO,LOM,16-19,0,13,0,12,0,0,1,13,0,13,Lombardia,ITC4
2021-01-17,PF/BT,HSP11-11bis,AMBULATORIO COVID PO SACCO,LOM,20-29,19,35,0,42,10,0,2,54,0,54,Lombardia,ITC4
2021-01-17,PF/BT,HSP11-11bis,AMBULATORIO COVID PO SACCO,LOM,30-39,14,24,0,24,14,0,0,36,2,38,Lombardia,ITC4
2021-01-17,PF/BT,HSP11-11bis,AMBULATORIO COVID PO SACCO,LOM,40-49,15,27,0,18,22,0,2,42,0,42,Lombardia,ITC4
2021-01-17,PF/BT,HSP11-11bis,AMBULATORIO COVID PO SACCO,LOM,50-59,25,22,0,20,26,0,1,47,0,47,Lombardia,ITC4
2021-01-17,PF/BT,HSP11-11bis,AMBULATORIO COVID PO SACCO,LOM,60-69,6,15,0,9,11,0,1,21,0,21,Lombardia,ITC4
2021-01-17,PF/BT,HSP11-11bis,AMBULATORIO COVID PO SACCO,LOM,70-79,1,0,0,1,0,0,0,1,0,1,Lombardia,ITC4
2021-01-17,PF/BT,HSP11-11bis,ASST BERGAMO OVEST - OSPEDALE TREVIGLIO,LOM,16-19,0,1,0,0,1,0,0,1,0,1,Lombardia,ITC4
2021-01-17,PF/BT,HSP11-11bis,ASST BERGAMO OVEST - OSPEDALE TREVIGLIO,LOM,20-29,2,16,0,17,1,0,0,18,0,18,Lombardia,ITC4
2021-01-17,PF/BT,HSP11-11bis,ASST BERGAMO OVEST - OSPEDALE TREVIGLIO,LOM,30-39,5,6,0,6,4,0,1,11,0,11,Lombardia,ITC4
2021-01-17,PF/BT,HSP11-11bis,ASST BERGAMO OVEST - OSPEDALE TREVIGLIO,LOM,40-49,7,25,0,24,6,0,2,32,0,32,Lombardia,ITC4
2021-01-17,PF/BT,HSP11-11bis,ASST BERGAMO OVEST - OSPEDALE TREVIGLIO,LOM,50-59,18,34,0,34,17,0,1,52,0,52,Lombardia,ITC4
2021-01-17,PF/BT,HSP11-11bis,ASST BERGAMO OVEST - OSPEDALE TREVIGLIO,LOM,60-69,18,8,0,22,3,0,1,26,0,26,Lombardia,ITC4
2021-01-17,PF/BT,HSP11-11bis,ASST BERGAMO OVEST - OSPEDALE TREVIGLIO,LOM,70-79,0,1,0,0,0,0,1,1,0,1,Lombardia,ITC4
2021-01-17,PF/BT,HSP11-11bis,ASST BERGAMO OVEST - OSPEDALE TREVIGLIO,LOM,80-89,1,0,0,1,0,0,0,1,0,1,Lombardia,ITC4
2021-01-17,PF/BT,HSP11-11bis,PO Lodi - RSA Opera Pia Luigi Mazza - 17.01.2021,LOM,40-49,0,1,0,1,0,0,0,1,0,1,Lombardia,ITC4
2021-01-17,PF/BT,HSP11-11bis,PO Lodi - RSA Opera Pia Luigi Mazza - 17.01.2021,LOM,50-59,0,1,0,1,0,0,0,1,0,1,Lombardia,ITC4
2021-01-17,PF/BT,HSP11-11bis,PO Lodi - RSA Opera Pia Luigi Mazza - 17.01.2021,LOM,70-79,3,2,0,0,0,5,0,5,0,5,Lombardia,ITC4
2021-01-17,PF/BT,HSP11-11bis,PO Lodi - RSA Opera Pia Luigi Mazza - 17.01.2021,LOM,80-89,6,9,0,0,0,15,0,15,0,15,Lombardia,ITC4
2021-01-17,PF/BT,HSP11-11bis,PO Lodi - RSA Opera Pia Luigi Mazza - 17.01.2021,LOM,90+,2,6,0,0,0,8,0,8,0,8,Lombardia,ITC4
2021-01-17,PF/BT,HSP11-11bis,RSA MONSIGNOR SALVADERI,LOM,40-49,0,1,0,1,0,0,0,1,0,1,Lombardia,ITC4
2021-01-17,PF/BT,HSP11-11bis,RSA MONSIGNOR SALVADERI,LOM,60-69,0,1,0,0,0,1,0,1,0,1,Lombardia,ITC4
2021-01-17,PF/BT,HSP11-11bis,RSA MONSIGNOR SALVADERI,LOM,70-79,1,6,0,0,0,7,0,7,0,7,Lombardia,ITC4
2021-01-17,PF/BT,HSP11-11bis,RSA MONSIGNOR SALVADERI,LOM,80-89,0,15,0,0,0,15,0,15,0,15,Lombardia,ITC4
2021-01-17,PF/BT,HSP11-11bis,RSA MONSIGNOR SALVADERI,LOM,90+,4,10,0,0,0,14,0,14,0,14,Lombardia,ITC4
2021-01-17,PF/BT,STS11,Fondazione Opera Pia Luigi Mazza - Pizzighettone,LOM,40-49,0,1,0,1,0,0,0,1,0,1,Lombardia,ITC4
2021-01-17,PF/BT,STS11,Fondazione Opera Pia Luigi Mazza - Pizzighettone,LOM,50-59,0,1,0,1,0,0,0,1,0,1,Lombardia,ITC4
2021-01-17,PF/BT,STS11,Fondazione Opera Pia Luigi Mazza - Pizzighettone,LOM,70-79,3,2,0,0,0,5,0,5,0,5,Lombardia,ITC4
2021-01-17,PF/BT,STS11,Fondazione Opera Pia Luigi Mazza - Pizzighettone,LOM,80-89,6,9,0,0,0,15,0,15,0,15,Lombardia,ITC4
2021-01-17,PF/BT,STS11,Fondazione Opera Pia Luigi Mazza - Pizzighettone,LOM,90+,2,6,0,0,0,8,0,8,0,8,Lombardia,ITC4
2021-01-18,PF/BT,0,Istituto Redaelli Milano,LOM,30-39,1,2,0,0,3,0,0,3,0,3,Lombardia,ITC4
2021-01-18,PF/BT,0,Istituto Redaelli Milano,LOM,40-49,6,5,0,3,8,0,0,11,0,11,Lombardia,ITC4
2021-01-18,PF/BT,0,Istituto Redaelli Milano,LOM,50-59,5,10,0,4,11,0,0,15,0,15,Lombardia,ITC4
2021-01-18,PF/BT,0,Istituto Redaelli Milano,LOM,60-69,5,2,0,4,3,0,0,7,0,7,Lombardia,ITC4
2021-01-18,PF/BT,0,RSA “OPERA PASTOR ANGELUCUS”,LOM,20-29,0,1,0,0,1,0,0,1,0,1,Lombardia,ITC4
2021-01-18,PF/BT,0,RSA “OPERA PASTOR ANGELUCUS”,LOM,30-39,0,2,0,1,1,0,0,2,0,2,Lombardia,ITC4
2021-01-18,PF/BT,0,RSA “OPERA PASTOR ANGELUCUS”,LOM,40-49,0,2,0,2,0,0,0,2,0,2,Lombardia,ITC4
2021-01-18,PF/BT,0,RSA “OPERA PASTOR ANGELUCUS”,LOM,50-59,2,2,0,2,2,0,0,4,0,4,Lombardia,ITC4
2021-01-18,PF/BT,0,RSA “OPERA PASTOR ANGELUCUS”,LOM,60-69,0,1,0,1,0,0,0,1,0,1,Lombardia,ITC4
2021-01-18,PF/BT,0,RSA “OPERA PASTOR ANGELUCUS”,LOM,70-79,1,0,0,0,0,1,0,1,0,1,Lombardia,ITC4
2021-01-18,PF/BT,0,RSA “OPERA PASTOR ANGELUCUS”,LOM,80-89,0,1,0,0,0,1,0,1,0,1,Lombardia,ITC4
2021-01-18,PF/BT,030322002847,RSA VILLA CITTERIO,LOM,40-49,1,1,0,2,0,0,0,2,0,2,Lombardia,ITC4
2021-01-18,PF/BT,030322002847,RSA VILLA CITTERIO,LOM,50-59,1,0,0,0,0,1,0,1,0,1,Lombardia,ITC4
2021-01-18,PF/BT,030322002847,RSA VILLA CITTERIO,LOM,60-69,1,0,0,0,0,1,0,1,0,1,Lombardia,ITC4
2021-01-18,PF/BT,030322002847,RSA VILLA CITTERIO,LOM,70-79,3,2,0,0,0,5,0,5,0,5,Lombardia,ITC4
2021-01-18,PF/BT,030322002847,RSA VILLA CITTERIO,LOM,80-89,2,8,0,0,0,10,0,10,0,10,Lombardia,ITC4
2021-01-18,PF/BT,030322002847,RSA VILLA CITTERIO,LOM,90+,0,11,0,0,0,11,0,11,0,11,Lombardia,ITC4
2021-01-18,PF/BT,030-322-002913,RSA SACRO CUORE,LOM,20-29,1,0,0,1,0,0,0,1,0,1,Lombardia,ITC4
2021-01-18,PF/BT,030-322-002913,RSA SACRO CUORE,LOM,30-39,1,0,0,0,1,0,0,1,0,1,Lombardia,ITC4
2021-01-18,PF/BT,030-322-002913,RSA SACRO CUORE,LOM,40-49,2,1,0,1,2,0,0,3,0,3,Lombardia,ITC4
2021-01-18,PF/BT,030-322-002913,RSA SACRO CUORE,LOM,50-59,2,3,0,3,0,2,0,5,0,5,Lombardia,ITC4
2021-01-18,PF/BT,030-322-002913,RSA SACRO CUORE,LOM,60-69,2,3,0,4,0,1,0,5,0,5,Lombardia,ITC4
2021-01-18,PF/BT,030-322-002913,RSA SACRO CUORE,LOM,70-79,1,2,0,1,0,2,0,3,0,3,Lombardia,ITC4
2021-01-18,PF/BT,030-322-002913,RSA SACRO CUORE,LOM,80-89,0,1,0,0,0,1,0,1,0,1,Lombardia,ITC4
2021-01-18,PF/BT,030-322-002913,RSA SACRO CUORE,LOM,90+,0,2,0,0,0,2,0,2,0,2,Lombardia,ITC4
2021-01-18,PF/BT,030923,FOND.IRCCS IST.NAZ.NEUROLOGICO C.BESTA-MI,LOM,20-29,0,2,0,2,0,0,0,2,0,2,Lombardia,ITC4
2021-01-18,PF/BT,030923,FOND.IRCCS IST.NAZ.NEUROLOGICO C.BESTA-MI,LOM,30-39,1,4,0,1,2,0,2,5,0,5,Lombardia,ITC4
2021-01-18,PF/BT,030923,FOND.IRCCS IST.NAZ.NEUROLOGICO C.BESTA-MI,LOM,40-49,2,3,0,2,2,0,1,3,2,5,Lombardia,ITC4
2021-01-18,PF/BT,030923,FOND.IRCCS IST.NAZ.NEUROLOGICO C.BESTA-MI,LOM,50-59,1,1,0,2,0,0,0,1,1,2,Lombardia,ITC4
2021-01-18,PF/BT,030923,FOND.IRCCS IST.NAZ.NEUROLOGICO C.BESTA-MI,LOM,60-69,0,2,0,1,1,0,0,1,1,2,Lombardia,ITC4
2021-01-18,PF/BT,1965,RESIDENZA SANITARIA ASSISTENZIALE FONDAZIONE LUIGI BONI ONLUS,LOM,30-39,1,0,0,0,0,0,1,1,0,1,Lombardia,ITC4
2021-01-18,PF/BT,1965,RESIDENZA SANITARIA ASSISTENZIALE FONDAZIONE LUIGI BONI ONLUS,LOM,40-49,0,2,0,2,0,0,0,2,0,2,Lombardia,ITC4
2021-01-18,PF/BT,1965,RESIDENZA SANITARIA ASSISTENZIALE FONDAZIONE LUIGI BONI ONLUS,LOM,60-69,0,1,0,0,0,1,0,1,0,1,Lombardia,ITC4
2021-01-18,PF/BT,1965,RESIDENZA SANITARIA ASSISTENZIALE FONDAZIONE LUIGI BONI ONLUS,LOM,80-89,0,1,0,0,0,1,0,1,0,1,Lombardia,ITC4
2021-01-18,PF/BT,1965,RESIDENZA SANITARIA ASSISTENZIALE FONDAZIONE LUIGI BONI ONLUS,LOM,90+,0,1,0,0,0,1,0,1,0,1,Lombardia,ITC4
2021-01-18,PF/BT,322000875,RSA   FONDAZIONE RAIMONDI,LOM,20-29,3,3,0,6,0,0,0,6,0,6,Lombardia,ITC4
2021-01-18,PF/BT,322000875,RSA   FONDAZIONE RAIMONDI,LOM,30-39,3,6,0,8,1,0,0,9,0,9,Lombardia,ITC4
2021-01-18,PF/BT,322000875,RSA   FONDAZIONE RAIMONDI,LOM,40-49,0,12,0,9,3,0,0,12,0,12,Lombardia,ITC4
2021-01-18,PF/BT,322000875,RSA   FONDAZIONE RAIMONDI,LOM,50-59,3,15,0,15,3,0,0,18,0,18,Lombardia,ITC4
2021-01-18,PF/BT,322000875,RSA   FONDAZIONE RAIMONDI,LOM,60-69,1,2,0,3,0,0,0,3,0,3,Lombardia,ITC4
2021-01-18,PF/BT,680,"RSA GIUSEPPE GEROSA BRICHETTO  VIA MECENATE,96 MILANO",LOM,60-69,0,1,0,0,0,1,0,1,0,1,Lombardia,ITC4
2021-01-18,PF/BT,680,"RSA GIUSEPPE GEROSA BRICHETTO  VIA MECENATE,96 MILANO",LOM,70-79,2,1,0,0,0,3,0,3,0,3,Lombardia,ITC4
2021-01-18,PF/BT,680,"RSA GIUSEPPE GEROSA BRICHETTO  VIA MECENATE,96 MILANO",LOM,80-89,1,4,0,0,0,5,0,5,0,5,Lombardia,ITC4
2021-01-18,PF/BT,680,"RSA GIUSEPPE GEROSA BRICHETTO  VIA MECENATE,96 MILANO",LOM,90+,0,3,0,0,0,3,0,3,0,3,Lombardia,ITC4
2021-01-18,PF/BT,STS11,FONDAZIONE CASA DI RIPOSO DI ROBECCO D'OGLIO,LOM,20-29,1,5,0,6,0,0,0,6,0,6,Lombardia,ITC4
2021-01-18,PF/BT,STS11,FONDAZIONE CASA DI RIPOSO DI ROBECCO D'OGLIO,LOM,30-39,1,3,0,3,1,0,0,4,0,4,Lombardia,ITC4
2021-01-18,PF/BT,STS11,FONDAZIONE CASA DI RIPOSO DI ROBECCO D'OGLIO,LOM,40-49,2,6,0,6,2,0,0,8,0,8,Lombardia,ITC4
2021-01-18,PF/BT,STS11,FONDAZIONE CASA DI RIPOSO DI ROBECCO D'OGLIO,LOM,50-59,0,9,0,5,4,0,0,9,0,9,Lombardia,ITC4
2021-01-18,PF/BT,STS11,FONDAZIONE CASA DI RIPOSO DI ROBECCO D'OGLIO,LOM,60-69,1,4,0,3,2,0,0,5,0,5,Lombardia,ITC4
2021-01-18,PF/BT,STS11,FONDAZIONE CASA DI RIPOSO DI ROBECCO D'OGLIO,LOM,90+,0,4,0,0,0,4,0,4,0,4,Lombardia,ITC4
