TML_DTA_SOMM,TML_VAX_FORNITORE,TML_COD_STRUTTURA,TML_DES_STRUTTURA,TML_AREA,TML_FASCIA_ETA,TML_SESSO_M,TML_SESSO_F,TML_GRAVIDANZA,TML_CAT_OSS,TML_CAT_PERSONALE,TML_CAT_RSA_OSPITI,TML_CAT_ALTRO,TML_DOSE_1,TML_DOSE_2,TML_TOT_SOMM,TML_REGIONE,TML_NUTS
2020-12-27,PF/BT,140 001,P.O. ANTONIO CARDARELLI,MOL,20-29,0,2,0,2,0,0,0,2,0,2,Molise,ITF2
2020-12-27,PF/BT,140 001,P.O. ANTONIO CARDARELLI,MOL,30-39,3,5,0,8,0,0,0,8,0,8,Molise,ITF2
2020-12-27,PF/BT,140 001,P.O. ANTONIO CARDARELLI,MOL,40-49,4,3,0,7,0,0,0,7,0,7,Molise,ITF2
2020-12-27,PF/BT,140 001,P.O. ANTONIO CARDARELLI,MOL,50-59,5,5,0,10,0,0,0,10,0,10,Molise,ITF2
2020-12-27,PF/BT,140 001,P.O. ANTONIO CARDARELLI,MOL,60-69,3,0,0,3,0,0,0,3,0,3,Molise,ITF2
2020-12-27,PF/BT,201,"Casa di riposo ""Cannavina"" - Ripalimosani",MOL,20-29,0,2,0,2,0,0,0,2,0,2,Molise,ITF2
2020-12-27,PF/BT,201,"Casa di riposo ""Cannavina"" - Ripalimosani",MOL,30-39,1,0,0,0,0,0,1,1,0,1,Molise,ITF2
2020-12-27,PF/BT,201,"Casa di riposo ""Cannavina"" - Ripalimosani",MOL,60-69,1,0,0,0,0,1,0,1,0,1,Molise,ITF2
2020-12-27,PF/BT,201,"Casa di riposo ""Cannavina"" - Ripalimosani",MOL,70-79,1,3,0,0,0,4,0,4,0,4,Molise,ITF2
2020-12-27,PF/BT,201,"Casa di riposo ""Cannavina"" - Ripalimosani",MOL,80-89,0,6,0,0,0,6,0,6,0,6,Molise,ITF2
2020-12-27,PF/BT,201,"Casa di riposo ""Cannavina"" - Ripalimosani",MOL,90+,2,4,0,0,0,6,0,6,0,6,Molise,ITF2
2021-01-04,PF/BT,14000100,P.O. A.CARDARELLI-CAMPOBASSO,MOL,20-29,3,7,0,10,0,0,0,10,0,10,Molise,ITF2
2021-01-04,PF/BT,14000100,P.O. A.CARDARELLI-CAMPOBASSO,MOL,30-39,13,11,0,23,0,0,1,24,0,24,Molise,ITF2
2021-01-04,PF/BT,14000100,P.O. A.CARDARELLI-CAMPOBASSO,MOL,40-49,9,14,0,23,0,0,0,23,0,23,Molise,ITF2
2021-01-04,PF/BT,14000100,P.O. A.CARDARELLI-CAMPOBASSO,MOL,50-59,6,19,0,25,0,0,0,25,0,25,Molise,ITF2
2021-01-04,PF/BT,14000100,P.O. A.CARDARELLI-CAMPOBASSO,MOL,60-69,9,7,0,16,0,0,0,16,0,16,Molise,ITF2
2021-01-04,PF/BT,14000100,P.O. A.CARDARELLI-CAMPOBASSO,MOL,70-79,1,0,0,1,0,0,0,1,0,1,Molise,ITF2
2021-01-04,PF/BT,14000200,P.O. SAN TIMOTEO - TERMOLI,MOL,20-29,2,3,0,5,0,0,0,5,0,5,Molise,ITF2
2021-01-04,PF/BT,14000200,P.O. SAN TIMOTEO - TERMOLI,MOL,30-39,4,8,0,12,0,0,0,12,0,12,Molise,ITF2
2021-01-04,PF/BT,14000200,P.O. SAN TIMOTEO - TERMOLI,MOL,40-49,10,22,0,32,0,0,0,32,0,32,Molise,ITF2
2021-01-04,PF/BT,14000200,P.O. SAN TIMOTEO - TERMOLI,MOL,50-59,24,26,0,46,0,0,4,50,0,50,Molise,ITF2
2021-01-04,PF/BT,14000200,P.O. SAN TIMOTEO - TERMOLI,MOL,60-69,14,9,0,22,0,0,1,23,0,23,Molise,ITF2
2021-01-04,PF/BT,14000301,P.O.ISERNIA,MOL,20-29,2,1,0,3,0,0,0,3,0,3,Molise,ITF2
2021-01-04,PF/BT,14000301,P.O.ISERNIA,MOL,30-39,4,7,0,10,0,0,1,11,0,11,Molise,ITF2
2021-01-04,PF/BT,14000301,P.O.ISERNIA,MOL,40-49,4,31,0,31,1,0,3,35,0,35,Molise,ITF2
2021-01-04,PF/BT,14000301,P.O.ISERNIA,MOL,50-59,14,11,0,21,0,0,4,25,0,25,Molise,ITF2
2021-01-04,PF/BT,14000301,P.O.ISERNIA,MOL,60-69,11,2,0,12,1,0,0,13,0,13,Molise,ITF2
2021-01-05,PF/BT,14000100,P.O. A.CARDARELLI-CAMPOBASSO,MOL,20-29,5,6,0,11,0,0,0,11,0,11,Molise,ITF2
2021-01-05,PF/BT,14000100,P.O. A.CARDARELLI-CAMPOBASSO,MOL,30-39,9,23,0,32,0,0,0,32,0,32,Molise,ITF2
2021-01-05,PF/BT,14000100,P.O. A.CARDARELLI-CAMPOBASSO,MOL,40-49,20,27,0,47,0,0,0,47,0,47,Molise,ITF2
2021-01-05,PF/BT,14000100,P.O. A.CARDARELLI-CAMPOBASSO,MOL,50-59,26,33,0,58,0,0,1,59,0,59,Molise,ITF2
2021-01-05,PF/BT,14000100,P.O. A.CARDARELLI-CAMPOBASSO,MOL,60-69,24,14,0,38,0,0,0,38,0,38,Molise,ITF2
2021-01-05,PF/BT,14000200,P.O. SAN TIMOTEO - TERMOLI,MOL,20-29,2,4,0,6,0,0,0,6,0,6,Molise,ITF2
2021-01-05,PF/BT,14000200,P.O. SAN TIMOTEO - TERMOLI,MOL,30-39,9,12,0,21,0,0,0,21,0,21,Molise,ITF2
2021-01-05,PF/BT,14000200,P.O. SAN TIMOTEO - TERMOLI,MOL,40-49,9,32,0,41,0,0,0,41,0,41,Molise,ITF2
2021-01-05,PF/BT,14000200,P.O. SAN TIMOTEO - TERMOLI,MOL,50-59,27,42,0,69,0,0,0,69,0,69,Molise,ITF2
2021-01-05,PF/BT,14000200,P.O. SAN TIMOTEO - TERMOLI,MOL,60-69,16,18,0,34,0,0,0,34,0,34,Molise,ITF2
2021-01-05,PF/BT,14000200,P.O. SAN TIMOTEO - TERMOLI,MOL,70-79,1,0,0,1,0,0,0,1,0,1,Molise,ITF2
2021-01-05,PF/BT,14000301,P.O.ISERNIA,MOL,30-39,2,2,0,4,0,0,0,4,0,4,Molise,ITF2
2021-01-05,PF/BT,14000301,P.O.ISERNIA,MOL,40-49,7,13,0,16,0,0,4,20,0,20,Molise,ITF2
2021-01-05,PF/BT,14000301,P.O.ISERNIA,MOL,50-59,9,27,0,34,0,0,2,36,0,36,Molise,ITF2
2021-01-05,PF/BT,14000301,P.O.ISERNIA,MOL,60-69,14,15,0,28,0,0,1,29,0,29,Molise,ITF2
2021-01-06,PF/BT,14000100,P.O. A.CARDARELLI-CAMPOBASSO,MOL,16-19,1,0,0,0,1,0,0,1,0,1,Molise,ITF2
2021-01-06,PF/BT,14000100,P.O. A.CARDARELLI-CAMPOBASSO,MOL,20-29,10,11,0,19,2,0,0,21,0,21,Molise,ITF2
2021-01-06,PF/BT,14000100,P.O. A.CARDARELLI-CAMPOBASSO,MOL,30-39,19,20,0,38,1,0,0,39,0,39,Molise,ITF2
2021-01-06,PF/BT,14000100,P.O. A.CARDARELLI-CAMPOBASSO,MOL,40-49,23,24,0,46,1,0,0,47,0,47,Molise,ITF2
2021-01-06,PF/BT,14000100,P.O. A.CARDARELLI-CAMPOBASSO,MOL,50-59,32,27,0,56,2,0,1,59,0,59,Molise,ITF2
2021-01-06,PF/BT,14000100,P.O. A.CARDARELLI-CAMPOBASSO,MOL,60-69,24,18,0,41,1,0,0,42,0,42,Molise,ITF2
2021-01-06,PF/BT,14000200,P.O. SAN TIMOTEO - TERMOLI,MOL,20-29,4,6,0,10,0,0,0,10,0,10,Molise,ITF2
2021-01-06,PF/BT,14000200,P.O. SAN TIMOTEO - TERMOLI,MOL,30-39,12,17,0,28,0,0,1,29,0,29,Molise,ITF2
2021-01-06,PF/BT,14000200,P.O. SAN TIMOTEO - TERMOLI,MOL,40-49,6,21,0,24,2,0,1,27,0,27,Molise,ITF2
2021-01-06,PF/BT,14000200,P.O. SAN TIMOTEO - TERMOLI,MOL,50-59,19,39,0,53,5,0,0,58,0,58,Molise,ITF2
2021-01-06,PF/BT,14000200,P.O. SAN TIMOTEO - TERMOLI,MOL,60-69,12,21,0,32,1,0,0,33,0,33,Molise,ITF2
2021-01-06,PF/BT,14000200,P.O. SAN TIMOTEO - TERMOLI,MOL,70-79,1,2,0,2,1,0,0,3,0,3,Molise,ITF2
2021-01-06,PF/BT,14000200,P.O. SAN TIMOTEO - TERMOLI,MOL,80-89,1,0,0,0,1,0,0,1,0,1,Molise,ITF2
2021-01-06,PF/BT,14000301,P.O.ISERNIA,MOL,20-29,0,2,0,2,0,0,0,2,0,2,Molise,ITF2
2021-01-06,PF/BT,14000301,P.O.ISERNIA,MOL,30-39,4,6,0,9,0,0,1,10,0,10,Molise,ITF2
2021-01-06,PF/BT,14000301,P.O.ISERNIA,MOL,40-49,5,18,0,22,1,0,0,23,0,23,Molise,ITF2
2021-01-06,PF/BT,14000301,P.O.ISERNIA,MOL,50-59,8,18,0,24,0,0,2,26,0,26,Molise,ITF2
2021-01-06,PF/BT,14000301,P.O.ISERNIA,MOL,60-69,11,17,0,28,0,0,0,28,0,28,Molise,ITF2
2021-01-06,PF/BT,140201,CASA DI RIPOSO DON CARLO PISTILLI CB,MOL,50-59,2,3,0,3,2,0,0,5,0,5,Molise,ITF2
2021-01-06,PF/BT,140201,CASA DI RIPOSO DON CARLO PISTILLI CB,MOL,60-69,1,1,0,2,0,0,0,2,0,2,Molise,ITF2
2021-01-06,PF/BT,140201,CASA DI RIPOSO DON CARLO PISTILLI CB,MOL,70-79,3,2,0,0,0,5,0,5,0,5,Molise,ITF2
2021-01-06,PF/BT,140201,CASA DI RIPOSO DON CARLO PISTILLI CB,MOL,80-89,6,25,0,0,0,30,1,31,0,31,Molise,ITF2
2021-01-06,PF/BT,140201,CASA DI RIPOSO DON CARLO PISTILLI CB,MOL,90+,11,25,0,0,0,36,0,36,0,36,Molise,ITF2
2021-01-06,PF/BT,140201,CASA DI RIPOSO LA RESIDENZA DE SAGGI MONTERODUNI (IS),MOL,20-29,0,1,0,0,1,0,0,1,0,1,Molise,ITF2
2021-01-06,PF/BT,140201,CASA DI RIPOSO LA RESIDENZA DE SAGGI MONTERODUNI (IS),MOL,30-39,1,0,0,1,0,0,0,1,0,1,Molise,ITF2
2021-01-06,PF/BT,140201,CASA DI RIPOSO LA RESIDENZA DE SAGGI MONTERODUNI (IS),MOL,40-49,2,0,0,2,0,0,0,2,0,2,Molise,ITF2
2021-01-06,PF/BT,140201,CASA DI RIPOSO LA RESIDENZA DE SAGGI MONTERODUNI (IS),MOL,50-59,2,3,0,1,4,0,0,5,0,5,Molise,ITF2
2021-01-06,PF/BT,140201,CASA DI RIPOSO LA RESIDENZA DE SAGGI MONTERODUNI (IS),MOL,60-69,2,1,0,0,0,3,0,3,0,3,Molise,ITF2
2021-01-06,PF/BT,140201,CASA DI RIPOSO LA RESIDENZA DE SAGGI MONTERODUNI (IS),MOL,70-79,2,5,0,0,0,7,0,7,0,7,Molise,ITF2
2021-01-06,PF/BT,140201,CASA DI RIPOSO LA RESIDENZA DE SAGGI MONTERODUNI (IS),MOL,80-89,5,10,0,0,0,15,0,15,0,15,Molise,ITF2
2021-01-06,PF/BT,140201,CASA DI RIPOSO LA RESIDENZA DE SAGGI MONTERODUNI (IS),MOL,90+,4,11,0,0,0,15,0,15,0,15,Molise,ITF2
2021-01-06,PF/BT,140201,CASA DI RIPOSO VILLA SANTA MARIA MONTENERO DI BISACCIA (CB),MOL,30-39,0,1,0,0,1,0,0,1,0,1,Molise,ITF2
2021-01-06,PF/BT,140201,CASA DI RIPOSO VILLA SANTA MARIA MONTENERO DI BISACCIA (CB),MOL,50-59,0,1,0,0,1,0,0,1,0,1,Molise,ITF2
2021-01-06,PF/BT,140201,CASA DI RIPOSO VILLA SANTA MARIA MONTENERO DI BISACCIA (CB),MOL,60-69,1,1,0,0,2,0,0,2,0,2,Molise,ITF2
2021-01-06,PF/BT,140201,CASA DI RIPOSO VILLA SANTA MARIA MONTENERO DI BISACCIA (CB),MOL,70-79,4,5,0,0,0,7,2,9,0,9,Molise,ITF2
2021-01-06,PF/BT,140201,CASA DI RIPOSO VILLA SANTA MARIA MONTENERO DI BISACCIA (CB),MOL,80-89,15,27,0,0,2,30,10,42,0,42,Molise,ITF2
2021-01-06,PF/BT,140201,CASA DI RIPOSO VILLA SANTA MARIA MONTENERO DI BISACCIA (CB),MOL,90+,4,34,0,0,0,33,5,38,0,38,Molise,ITF2
2021-01-07,PF/BT,000921,RSA FONDAZIONE OPERA SERENA,MOL,50-59,1,0,0,0,0,1,0,1,0,1,Molise,ITF2
2021-01-07,PF/BT,000921,RSA FONDAZIONE OPERA SERENA,MOL,60-69,3,2,0,0,0,5,0,5,0,5,Molise,ITF2
2021-01-07,PF/BT,000921,RSA FONDAZIONE OPERA SERENA,MOL,70-79,3,4,0,0,0,7,0,7,0,7,Molise,ITF2
2021-01-07,PF/BT,000921,RSA FONDAZIONE OPERA SERENA,MOL,80-89,8,20,0,0,0,28,0,28,0,28,Molise,ITF2
2021-01-07,PF/BT,000921,RSA FONDAZIONE OPERA SERENA,MOL,90+,5,22,0,0,0,27,0,27,0,27,Molise,ITF2
2021-01-07,PF/BT,14000100,P.O. A.CARDARELLI-CAMPOBASSO,MOL,20-29,7,4,0,8,3,0,0,11,0,11,Molise,ITF2
2021-01-07,PF/BT,14000100,P.O. A.CARDARELLI-CAMPOBASSO,MOL,30-39,9,21,0,25,4,0,1,30,0,30,Molise,ITF2
2021-01-07,PF/BT,14000100,P.O. A.CARDARELLI-CAMPOBASSO,MOL,40-49,12,26,0,32,2,0,4,38,0,38,Molise,ITF2
2021-01-07,PF/BT,14000100,P.O. A.CARDARELLI-CAMPOBASSO,MOL,50-59,20,45,0,59,0,0,6,65,0,65,Molise,ITF2
2021-01-07,PF/BT,14000100,P.O. A.CARDARELLI-CAMPOBASSO,MOL,60-69,17,18,0,31,1,0,3,35,0,35,Molise,ITF2
2021-01-07,PF/BT,14000100,P.O. A.CARDARELLI-CAMPOBASSO,MOL,70-79,1,0,0,1,0,0,0,1,0,1,Molise,ITF2
2021-01-07,PF/BT,14000200,P.O TIMOTEO- TERMOLI,MOL,20-29,0,5,0,2,3,0,0,5,0,5,Molise,ITF2
2021-01-07,PF/BT,14000200,P.O TIMOTEO- TERMOLI,MOL,30-39,7,6,0,8,1,0,4,13,0,13,Molise,ITF2
2021-01-07,PF/BT,14000200,P.O TIMOTEO- TERMOLI,MOL,40-49,8,23,0,26,4,0,1,31,0,31,Molise,ITF2
2021-01-07,PF/BT,14000200,P.O TIMOTEO- TERMOLI,MOL,50-59,17,41,0,49,5,0,4,58,0,58,Molise,ITF2
2021-01-07,PF/BT,14000200,P.O TIMOTEO- TERMOLI,MOL,60-69,15,25,0,38,1,0,1,40,0,40,Molise,ITF2
2021-01-07,PF/BT,14000200,P.O TIMOTEO- TERMOLI,MOL,70-79,1,0,0,0,1,0,0,1,0,1,Molise,ITF2
2021-01-07,PF/BT,14000301,P.O. ISERNIA,MOL,20-29,7,1,0,7,1,0,0,8,0,8,Molise,ITF2
2021-01-07,PF/BT,14000301,P.O. ISERNIA,MOL,30-39,14,4,0,18,0,0,0,18,0,18,Molise,ITF2
2021-01-07,PF/BT,14000301,P.O. ISERNIA,MOL,40-49,11,11,0,20,0,0,2,22,0,22,Molise,ITF2
2021-01-07,PF/BT,14000301,P.O. ISERNIA,MOL,50-59,14,25,0,35,2,0,2,39,0,39,Molise,ITF2
2021-01-07,PF/BT,14000301,P.O. ISERNIA,MOL,60-69,9,12,0,21,0,0,0,21,0,21,Molise,ITF2
2021-01-07,PF/BT,140201,Casa Di Riposo Villa Anna,MOL,20-29,0,1,0,1,0,0,0,1,0,1,Molise,ITF2
2021-01-07,PF/BT,140201,Casa Di Riposo Villa Anna,MOL,40-49,0,1,0,1,0,0,0,1,0,1,Molise,ITF2
2021-01-07,PF/BT,140201,Casa Di Riposo Villa Anna,MOL,50-59,0,2,0,2,0,0,0,2,0,2,Molise,ITF2
2021-01-07,PF/BT,140201,Casa Di Riposo Villa Anna,MOL,60-69,1,0,0,0,0,1,0,1,0,1,Molise,ITF2
2021-01-07,PF/BT,140201,Casa Di Riposo Villa Anna,MOL,70-79,0,2,0,0,0,2,0,2,0,2,Molise,ITF2
2021-01-07,PF/BT,140201,Casa Di Riposo Villa Anna,MOL,80-89,5,8,0,0,0,13,0,13,0,13,Molise,ITF2
2021-01-07,PF/BT,140201,Casa Di Riposo Villa Anna,MOL,90+,2,14,0,0,0,16,0,16,0,16,Molise,ITF2
2021-01-07,PF/BT,140201,Villa Le Ginestre Casa Di Riposo Per Anziani,MOL,20-29,0,1,0,1,0,0,0,1,0,1,Molise,ITF2
2021-01-07,PF/BT,140201,Villa Le Ginestre Casa Di Riposo Per Anziani,MOL,40-49,1,1,0,1,1,0,0,2,0,2,Molise,ITF2
2021-01-07,PF/BT,140201,Villa Le Ginestre Casa Di Riposo Per Anziani,MOL,50-59,0,1,0,0,0,0,1,1,0,1,Molise,ITF2
2021-01-07,PF/BT,140201,Villa Le Ginestre Casa Di Riposo Per Anziani,MOL,60-69,0,2,0,0,0,2,0,2,0,2,Molise,ITF2
2021-01-07,PF/BT,140201,Villa Le Ginestre Casa Di Riposo Per Anziani,MOL,70-79,6,6,0,0,0,12,0,12,0,12,Molise,ITF2
2021-01-07,PF/BT,140201,Villa Le Ginestre Casa Di Riposo Per Anziani,MOL,80-89,3,16,0,0,0,16,3,19,0,19,Molise,ITF2
2021-01-07,PF/BT,140201,Villa Le Ginestre Casa Di Riposo Per Anziani,MOL,90+,1,16,0,0,0,16,1,17,0,17,Molise,ITF2
2021-01-08,PF/BT,14000100,P.O. A.CARDARELLI-CAMPOBASSO,MOL,16-19,0,1,0,0,1,0,0,1,0,1,Molise,ITF2
2021-01-08,PF/BT,14000100,P.O. A.CARDARELLI-CAMPOBASSO,MOL,20-29,1,4,0,2,2,0,1,5,0,5,Molise,ITF2
2021-01-08,PF/BT,14000100,P.O. A.CARDARELLI-CAMPOBASSO,MOL,30-39,9,13,0,19,0,0,3,22,0,22,Molise,ITF2
2021-01-08,PF/BT,14000100,P.O. A.CARDARELLI-CAMPOBASSO,MOL,40-49,14,24,0,22,1,0,15,38,0,38,Molise,ITF2
2021-01-08,PF/BT,14000100,P.O. A.CARDARELLI-CAMPOBASSO,MOL,50-59,27,42,0,43,1,0,25,69,0,69,Molise,ITF2
2021-01-08,PF/BT,14000100,P.O. A.CARDARELLI-CAMPOBASSO,MOL,60-69,16,30,0,35,0,0,11,46,0,46,Molise,ITF2
2021-01-08,PF/BT,14000200,P.O TIMOTEO- TERMOLI,MOL,20-29,1,0,0,0,1,0,0,1,0,1,Molise,ITF2
2021-01-08,PF/BT,14000200,P.O TIMOTEO- TERMOLI,MOL,30-39,1,1,0,1,1,0,0,2,0,2,Molise,ITF2
2021-01-08,PF/BT,14000200,P.O TIMOTEO- TERMOLI,MOL,40-49,0,5,0,4,1,0,0,5,0,5,Molise,ITF2
2021-01-08,PF/BT,14000200,P.O TIMOTEO- TERMOLI,MOL,50-59,8,5,0,10,3,0,0,13,0,13,Molise,ITF2
2021-01-08,PF/BT,14000200,P.O TIMOTEO- TERMOLI,MOL,60-69,12,2,0,13,0,0,1,14,0,14,Molise,ITF2
2021-01-08,PF/BT,14000200,P.O TIMOTEO- TERMOLI,MOL,70-79,1,0,0,0,1,0,0,1,0,1,Molise,ITF2
2021-01-08,PF/BT,14000301,P.O. ISERNIA,MOL,20-29,1,0,0,1,0,0,0,1,0,1,Molise,ITF2
2021-01-08,PF/BT,14000301,P.O. ISERNIA,MOL,40-49,5,12,0,17,0,0,0,17,0,17,Molise,ITF2
2021-01-08,PF/BT,14000301,P.O. ISERNIA,MOL,50-59,3,28,0,31,0,0,0,31,0,31,Molise,ITF2
2021-01-08,PF/BT,14000301,P.O. ISERNIA,MOL,60-69,8,22,0,30,0,0,0,30,0,30,Molise,ITF2
2021-01-08,PF/BT,140201,Casa Di Riposo Asilo Senile Argento Vivo,MOL,20-29,1,0,0,0,1,0,0,1,0,1,Molise,ITF2
2021-01-08,PF/BT,140201,Casa Di Riposo Asilo Senile Argento Vivo,MOL,30-39,1,0,0,0,1,0,0,1,0,1,Molise,ITF2
2021-01-08,PF/BT,140201,Casa Di Riposo Asilo Senile Argento Vivo,MOL,40-49,0,1,0,0,1,0,0,1,0,1,Molise,ITF2
2021-01-08,PF/BT,140201,Casa Di Riposo Asilo Senile Argento Vivo,MOL,50-59,0,2,0,0,2,0,0,2,0,2,Molise,ITF2
2021-01-08,PF/BT,140201,Casa Di Riposo Asilo Senile Argento Vivo,MOL,60-69,1,1,0,0,0,2,0,2,0,2,Molise,ITF2
2021-01-08,PF/BT,140201,Casa Di Riposo Asilo Senile Argento Vivo,MOL,70-79,1,1,0,0,0,2,0,2,0,2,Molise,ITF2
2021-01-08,PF/BT,140201,Casa Di Riposo Asilo Senile Argento Vivo,MOL,80-89,5,8,0,0,0,13,0,13,0,13,Molise,ITF2
2021-01-08,PF/BT,140201,Casa Di Riposo Asilo Senile Argento Vivo,MOL,90+,2,12,0,0,0,14,0,14,0,14,Molise,ITF2
2021-01-08,PF/BT,140201,CASA FAMIGLIA SAN MARTINO IN PENSILIS,MOL,20-29,1,0,0,0,0,1,0,1,0,1,Molise,ITF2
2021-01-08,PF/BT,140201,CASA FAMIGLIA SAN MARTINO IN PENSILIS,MOL,30-39,0,2,0,0,0,2,0,2,0,2,Molise,ITF2
2021-01-08,PF/BT,140201,CASA FAMIGLIA SAN MARTINO IN PENSILIS,MOL,40-49,1,0,0,0,0,1,0,1,0,1,Molise,ITF2
2021-01-08,PF/BT,140201,CASA FAMIGLIA SAN MARTINO IN PENSILIS,MOL,50-59,0,2,0,0,0,2,0,2,0,2,Molise,ITF2
2021-01-08,PF/BT,140201,CASA FAMIGLIA SAN MARTINO IN PENSILIS,MOL,60-69,4,0,0,0,0,4,0,4,0,4,Molise,ITF2
2021-01-08,PF/BT,140201,CASA FAMIGLIA SAN MARTINO IN PENSILIS,MOL,70-79,0,3,0,0,0,3,0,3,0,3,Molise,ITF2
2021-01-08,PF/BT,140201,CASA FAMIGLIA SAN MARTINO IN PENSILIS,MOL,80-89,2,12,0,0,0,14,0,14,0,14,Molise,ITF2
2021-01-08,PF/BT,140201,CASA FAMIGLIA SAN MARTINO IN PENSILIS,MOL,90+,0,4,0,0,0,4,0,4,0,4,Molise,ITF2
2021-01-08,PF/BT,140201,COMUNITA' ALLOGGIO - SANTA MARIA DELLE GRAZIE,MOL,40-49,0,1,0,0,0,1,0,1,0,1,Molise,ITF2
2021-01-08,PF/BT,140201,COMUNITA' ALLOGGIO - SANTA MARIA DELLE GRAZIE,MOL,50-59,0,2,0,0,0,2,0,2,0,2,Molise,ITF2
2021-01-08,PF/BT,140201,COMUNITA' ALLOGGIO - SANTA MARIA DELLE GRAZIE,MOL,70-79,1,0,0,0,0,1,0,1,0,1,Molise,ITF2
2021-01-08,PF/BT,140201,COMUNITA' ALLOGGIO - SANTA MARIA DELLE GRAZIE,MOL,80-89,1,4,0,0,0,5,0,5,0,5,Molise,ITF2
2021-01-08,PF/BT,140201,COMUNITA' ALLOGGIO - SANTA MARIA DELLE GRAZIE,MOL,90+,0,3,0,0,0,3,0,3,0,3,Molise,ITF2
2021-01-08,PF/BT,140201,Comunita Alloggio Temenos,MOL,30-39,0,1,0,0,1,0,0,1,0,1,Molise,ITF2
2021-01-08,PF/BT,140201,Comunita Alloggio Temenos,MOL,40-49,0,1,0,1,0,0,0,1,0,1,Molise,ITF2
2021-01-08,PF/BT,140201,Comunita Alloggio Temenos,MOL,50-59,0,1,0,1,0,0,0,1,0,1,Molise,ITF2
2021-01-08,PF/BT,140201,Comunita Alloggio Temenos,MOL,60-69,0,2,0,0,0,2,0,2,0,2,Molise,ITF2
2021-01-08,PF/BT,140201,Comunita Alloggio Temenos,MOL,80-89,1,3,0,0,0,4,0,4,0,4,Molise,ITF2
2021-01-08,PF/BT,140201,Comunita Alloggio Temenos,MOL,90+,2,1,0,0,0,3,0,3,0,3,Molise,ITF2
2021-01-08,PF/BT,140201,Villa Le Ginestre Casa Di Riposo Per Anziani,MOL,80-89,0,1,0,0,0,1,0,1,0,1,Molise,ITF2
2021-01-08,PF/BT,922,FONDAZIONE PADRE PIO ONLUS R2 CASA MIA IS,MOL,40-49,0,1,0,1,0,0,0,1,0,1,Molise,ITF2
2021-01-08,PF/BT,922,FONDAZIONE PADRE PIO ONLUS R2 CASA MIA IS,MOL,60-69,1,0,0,1,0,0,0,1,0,1,Molise,ITF2
2021-01-08,PF/BT,922,FONDAZIONE PADRE PIO ONLUS R2 CASA MIA IS,MOL,70-79,0,3,0,2,0,1,0,3,0,3,Molise,ITF2
2021-01-08,PF/BT,922,FONDAZIONE PADRE PIO ONLUS R2 CASA MIA IS,MOL,80-89,5,9,0,0,1,13,0,14,0,14,Molise,ITF2
2021-01-08,PF/BT,922,FONDAZIONE PADRE PIO ONLUS R2 CASA MIA IS,MOL,90+,3,19,0,0,0,22,0,22,0,22,Molise,ITF2
2021-01-09,PF/BT,14000100,P.O. A.CARDARELLI-CAMPOBASSO,MOL,20-29,2,1,0,1,0,0,2,3,0,3,Molise,ITF2
2021-01-09,PF/BT,14000100,P.O. A.CARDARELLI-CAMPOBASSO,MOL,30-39,0,7,0,7,0,0,0,7,0,7,Molise,ITF2
2021-01-09,PF/BT,14000100,P.O. A.CARDARELLI-CAMPOBASSO,MOL,40-49,8,19,0,22,0,0,5,27,0,27,Molise,ITF2
2021-01-09,PF/BT,14000100,P.O. A.CARDARELLI-CAMPOBASSO,MOL,50-59,22,36,0,45,0,0,13,58,0,58,Molise,ITF2
2021-01-09,PF/BT,14000100,P.O. A.CARDARELLI-CAMPOBASSO,MOL,60-69,7,18,0,19,2,0,4,25,0,25,Molise,ITF2
2021-01-09,PF/BT,14000200,P.O TIMOTEO- TERMOLI,MOL,20-29,0,1,0,1,0,0,0,1,0,1,Molise,ITF2
2021-01-09,PF/BT,14000200,P.O TIMOTEO- TERMOLI,MOL,30-39,2,1,0,2,1,0,0,3,0,3,Molise,ITF2
2021-01-09,PF/BT,14000200,P.O TIMOTEO- TERMOLI,MOL,40-49,1,1,0,1,1,0,0,2,0,2,Molise,ITF2
2021-01-09,PF/BT,14000200,P.O TIMOTEO- TERMOLI,MOL,50-59,6,4,0,7,3,0,0,10,0,10,Molise,ITF2
2021-01-09,PF/BT,14000200,P.O TIMOTEO- TERMOLI,MOL,60-69,2,0,0,2,0,0,0,2,0,2,Molise,ITF2
2021-01-09,PF/BT,14000301,P.O. ISERNIA,MOL,20-29,2,3,0,2,3,0,0,5,0,5,Molise,ITF2
2021-01-09,PF/BT,14000301,P.O. ISERNIA,MOL,30-39,6,9,0,11,4,0,0,15,0,15,Molise,ITF2
2021-01-09,PF/BT,14000301,P.O. ISERNIA,MOL,40-49,6,13,0,15,4,0,0,19,0,19,Molise,ITF2
2021-01-09,PF/BT,14000301,P.O. ISERNIA,MOL,50-59,10,34,0,33,11,0,0,44,0,44,Molise,ITF2
2021-01-09,PF/BT,14000301,P.O. ISERNIA,MOL,60-69,11,8,0,16,3,0,0,19,0,19,Molise,ITF2
2021-01-09,PF/BT,140201,Casa Di Riposo Mater Dei,MOL,30-39,1,1,0,2,0,0,0,2,0,2,Molise,ITF2
2021-01-09,PF/BT,140201,Casa Di Riposo Mater Dei,MOL,40-49,0,3,0,2,0,1,0,3,0,3,Molise,ITF2
2021-01-09,PF/BT,140201,Casa Di Riposo Mater Dei,MOL,50-59,1,2,0,0,0,3,0,3,0,3,Molise,ITF2
2021-01-09,PF/BT,140201,Casa Di Riposo Mater Dei,MOL,60-69,2,1,0,0,0,3,0,3,0,3,Molise,ITF2
2021-01-09,PF/BT,140201,Casa Di Riposo Mater Dei,MOL,80-89,3,6,0,0,0,9,0,9,0,9,Molise,ITF2
2021-01-09,PF/BT,140201,Casa Di Riposo Mater Dei,MOL,90+,1,8,0,0,0,9,0,9,0,9,Molise,ITF2
2021-01-09,PF/BT,140201,Casa Di Riposo Protetta Padre Minozzi,MOL,50-59,0,2,0,1,0,1,0,2,0,2,Molise,ITF2
2021-01-09,PF/BT,140201,Casa Di Riposo Protetta Padre Minozzi,MOL,60-69,3,2,0,0,0,5,0,5,0,5,Molise,ITF2
2021-01-09,PF/BT,140201,Casa Di Riposo Protetta Padre Minozzi,MOL,70-79,1,4,0,0,0,5,0,5,0,5,Molise,ITF2
2021-01-09,PF/BT,140201,Casa Di Riposo Protetta Padre Minozzi,MOL,80-89,7,13,0,0,0,20,0,20,0,20,Molise,ITF2
2021-01-09,PF/BT,140201,Casa Di Riposo Protetta Padre Minozzi,MOL,90+,5,11,0,0,0,16,0,16,0,16,Molise,ITF2
2021-01-09,PF/BT,140201,Casa Di Riposo Punta Paradiso,MOL,20-29,0,2,0,2,0,0,0,2,0,2,Molise,ITF2
2021-01-09,PF/BT,140201,Casa Di Riposo Punta Paradiso,MOL,30-39,0,1,0,1,0,0,0,1,0,1,Molise,ITF2
2021-01-09,PF/BT,140201,Casa Di Riposo Punta Paradiso,MOL,70-79,1,0,0,0,0,1,0,1,0,1,Molise,ITF2
2021-01-09,PF/BT,140201,Casa Di Riposo Punta Paradiso,MOL,80-89,1,0,0,0,0,1,0,1,0,1,Molise,ITF2
2021-01-09,PF/BT,140201,Casa Di Riposo Punta Paradiso,MOL,90+,24,37,0,0,0,61,0,61,0,61,Molise,ITF2
2021-01-09,PF/BT,140201,Villa Paradiso Delle Mainarde,MOL,20-29,0,1,0,1,0,0,0,1,0,1,Molise,ITF2
2021-01-09,PF/BT,140201,Villa Paradiso Delle Mainarde,MOL,30-39,0,1,0,1,0,0,0,1,0,1,Molise,ITF2
2021-01-09,PF/BT,140201,Villa Paradiso Delle Mainarde,MOL,50-59,0,1,0,1,0,0,0,1,0,1,Molise,ITF2
2021-01-09,PF/BT,140201,Villa Paradiso Delle Mainarde,MOL,80-89,1,2,0,0,0,3,0,3,0,3,Molise,ITF2
2021-01-09,PF/BT,140201,Villa Paradiso Delle Mainarde,MOL,90+,0,6,0,0,0,6,0,6,0,6,Molise,ITF2
2021-01-09,PF/BT,926,Gea Medica Srl,MOL,30-39,1,0,0,0,0,1,0,1,0,1,Molise,ITF2
2021-01-09,PF/BT,926,Gea Medica Srl,MOL,50-59,2,0,0,0,0,2,0,2,0,2,Molise,ITF2
2021-01-09,PF/BT,926,Gea Medica Srl,MOL,60-69,2,2,0,1,0,3,0,4,0,4,Molise,ITF2
2021-01-09,PF/BT,926,Gea Medica Srl,MOL,70-79,0,2,0,0,0,2,0,2,0,2,Molise,ITF2
2021-01-09,PF/BT,926,Gea Medica Srl,MOL,80-89,2,12,0,1,0,13,0,14,0,14,Molise,ITF2
2021-01-09,PF/BT,926,Gea Medica Srl,MOL,90+,9,22,0,17,1,13,0,31,0,31,Molise,ITF2
2021-01-10,PF/BT,14000400,Casa Di Cura Villa Maria,MOL,60-69,0,2,0,1,1,0,0,2,0,2,Molise,ITF2
2021-01-10,PF/BT,14000400,Casa Di Cura Villa Maria,MOL,90+,16,30,0,38,8,0,0,46,0,46,Molise,ITF2
2021-01-10,PF/BT,14000500,"Casa Di Cura ""Villa Esther""",MOL,20-29,0,1,0,1,0,0,0,1,0,1,Molise,ITF2
2021-01-10,PF/BT,14000500,"Casa Di Cura ""Villa Esther""",MOL,30-39,3,7,0,8,2,0,0,10,0,10,Molise,ITF2
2021-01-10,PF/BT,14000500,"Casa Di Cura ""Villa Esther""",MOL,40-49,3,9,0,9,3,0,0,12,0,12,Molise,ITF2
2021-01-10,PF/BT,14000500,"Casa Di Cura ""Villa Esther""",MOL,50-59,8,9,0,13,4,0,0,17,0,17,Molise,ITF2
2021-01-10,PF/BT,14000500,"Casa Di Cura ""Villa Esther""",MOL,60-69,3,3,0,5,1,0,0,6,0,6,Molise,ITF2
2021-01-10,PF/BT,14000500,"Casa Di Cura ""Villa Esther""",MOL,70-79,2,0,0,2,0,0,0,2,0,2,Molise,ITF2
2021-01-10,PF/BT,140201,Casa Di Riposo “Villa Immacolata”,MOL,30-39,0,2,0,2,0,0,0,2,0,2,Molise,ITF2
2021-01-10,PF/BT,140201,Casa Di Riposo “Villa Immacolata”,MOL,40-49,0,1,0,0,0,1,0,1,0,1,Molise,ITF2
2021-01-10,PF/BT,140201,Casa Di Riposo “Villa Immacolata”,MOL,50-59,0,2,0,2,0,0,0,2,0,2,Molise,ITF2
2021-01-10,PF/BT,140201,Casa Di Riposo “Villa Immacolata”,MOL,60-69,1,3,0,1,0,3,0,4,0,4,Molise,ITF2
2021-01-10,PF/BT,140201,Casa Di Riposo “Villa Immacolata”,MOL,70-79,1,5,0,0,0,6,0,6,0,6,Molise,ITF2
2021-01-10,PF/BT,140201,Casa Di Riposo “Villa Immacolata”,MOL,80-89,4,18,0,0,0,22,0,22,0,22,Molise,ITF2
2021-01-10,PF/BT,140201,Casa Di Riposo “Villa Immacolata”,MOL,90+,5,12,0,0,0,17,0,17,0,17,Molise,ITF2
2021-01-10,PF/BT,140201,"Casa Di Riposo Hotel Sporting ""Villa Delle Rose""",MOL,50-59,1,1,0,0,0,2,0,2,0,2,Molise,ITF2
2021-01-10,PF/BT,140201,"Casa Di Riposo Hotel Sporting ""Villa Delle Rose""",MOL,60-69,3,2,0,0,0,5,0,5,0,5,Molise,ITF2
2021-01-10,PF/BT,140201,"Casa Di Riposo Hotel Sporting ""Villa Delle Rose""",MOL,70-79,1,6,0,0,0,7,0,7,0,7,Molise,ITF2
2021-01-10,PF/BT,140201,"Casa Di Riposo Hotel Sporting ""Villa Delle Rose""",MOL,80-89,3,22,0,0,0,25,0,25,0,25,Molise,ITF2
2021-01-10,PF/BT,140201,"Casa Di Riposo Hotel Sporting ""Villa Delle Rose""",MOL,90+,3,18,0,0,0,21,0,21,0,21,Molise,ITF2
2021-01-10,PF/BT,140201,COMUNITA' ALLOGGIO - SAN GIULIANO DI PUGLIA (ARCOBALENO),MOL,50-59,1,0,0,0,0,1,0,1,0,1,Molise,ITF2
2021-01-10,PF/BT,140201,COMUNITA' ALLOGGIO - SAN GIULIANO DI PUGLIA (ARCOBALENO),MOL,60-69,1,0,0,0,0,1,0,1,0,1,Molise,ITF2
2021-01-10,PF/BT,140201,COMUNITA' ALLOGGIO - SAN GIULIANO DI PUGLIA (ARCOBALENO),MOL,70-79,0,1,0,0,0,1,0,1,0,1,Molise,ITF2
2021-01-10,PF/BT,140201,COMUNITA' ALLOGGIO - SAN GIULIANO DI PUGLIA (ARCOBALENO),MOL,80-89,2,6,0,0,0,8,0,8,0,8,Molise,ITF2
2021-01-10,PF/BT,140201,COMUNITA' ALLOGGIO - SAN GIULIANO DI PUGLIA (ARCOBALENO),MOL,90+,3,4,0,0,0,7,0,7,0,7,Molise,ITF2
2021-01-10,PF/BT,140201,"Istituto ""Sacro Cuore""",MOL,40-49,0,2,0,0,0,2,0,2,0,2,Molise,ITF2
2021-01-10,PF/BT,140201,"Istituto ""Sacro Cuore""",MOL,50-59,1,2,0,0,0,3,0,3,0,3,Molise,ITF2
2021-01-10,PF/BT,140201,"Istituto ""Sacro Cuore""",MOL,60-69,1,1,0,0,0,2,0,2,0,2,Molise,ITF2
2021-01-10,PF/BT,140201,"Istituto ""Sacro Cuore""",MOL,70-79,0,7,0,0,0,7,0,7,0,7,Molise,ITF2
2021-01-10,PF/BT,140201,"Istituto ""Sacro Cuore""",MOL,80-89,2,10,0,0,0,12,0,12,0,12,Molise,ITF2
2021-01-10,PF/BT,140201,"Istituto ""Sacro Cuore""",MOL,90+,4,11,0,0,0,15,0,15,0,15,Molise,ITF2
2021-01-11,PF/BT,14000100,P.O. A.CARDARELLI-CAMPOBASSO,MOL,20-29,4,5,0,0,8,0,1,9,0,9,Molise,ITF2
2021-01-11,PF/BT,14000100,P.O. A.CARDARELLI-CAMPOBASSO,MOL,30-39,10,22,0,5,27,0,0,32,0,32,Molise,ITF2
2021-01-11,PF/BT,14000100,P.O. A.CARDARELLI-CAMPOBASSO,MOL,40-49,6,34,0,8,32,0,0,40,0,40,Molise,ITF2
2021-01-11,PF/BT,14000100,P.O. A.CARDARELLI-CAMPOBASSO,MOL,50-59,13,34,0,10,32,2,3,47,0,47,Molise,ITF2
2021-01-11,PF/BT,14000100,P.O. A.CARDARELLI-CAMPOBASSO,MOL,60-69,9,25,0,12,21,0,1,34,0,34,Molise,ITF2
2021-01-11,PF/BT,14000200,P.O TIMOTEO- TERMOLI,MOL,20-29,2,0,0,0,2,0,0,2,0,2,Molise,ITF2
2021-01-11,PF/BT,14000200,P.O TIMOTEO- TERMOLI,MOL,30-39,6,5,0,1,10,0,0,11,0,11,Molise,ITF2
2021-01-11,PF/BT,14000200,P.O TIMOTEO- TERMOLI,MOL,40-49,5,13,0,5,12,0,1,18,0,18,Molise,ITF2
2021-01-11,PF/BT,14000200,P.O TIMOTEO- TERMOLI,MOL,50-59,12,23,0,5,30,0,0,35,0,35,Molise,ITF2
2021-01-11,PF/BT,14000200,P.O TIMOTEO- TERMOLI,MOL,60-69,6,6,0,8,4,0,0,12,0,12,Molise,ITF2
2021-01-11,PF/BT,14000301,P.O. ISERNIA,MOL,20-29,0,1,0,0,1,0,0,1,0,1,Molise,ITF2
2021-01-11,PF/BT,14000301,P.O. ISERNIA,MOL,30-39,3,5,0,4,4,0,0,8,0,8,Molise,ITF2
2021-01-11,PF/BT,14000301,P.O. ISERNIA,MOL,40-49,8,13,0,9,12,0,0,21,0,21,Molise,ITF2
2021-01-11,PF/BT,14000301,P.O. ISERNIA,MOL,50-59,14,19,0,21,12,0,0,33,0,33,Molise,ITF2
2021-01-11,PF/BT,14000301,P.O. ISERNIA,MOL,60-69,6,15,0,19,2,0,0,21,0,21,Molise,ITF2
2021-01-11,PF/BT,14000301,P.O. ISERNIA,MOL,90+,7,5,0,10,2,0,0,12,0,12,Molise,ITF2
2021-01-11,PF/BT,14000400,Casa Di Cura Villa Maria,MOL,60-69,2,1,0,1,2,0,0,3,0,3,Molise,ITF2
2021-01-11,PF/BT,14000400,Casa Di Cura Villa Maria,MOL,90+,19,19,0,18,19,1,0,38,0,38,Molise,ITF2
2021-01-11,PF/BT,14000500,"Casa Di Cura ""Villa Esther""",MOL,20-29,2,2,0,3,1,0,0,4,0,4,Molise,ITF2
2021-01-11,PF/BT,14000500,"Casa Di Cura ""Villa Esther""",MOL,30-39,5,5,0,9,1,0,0,10,0,10,Molise,ITF2
2021-01-11,PF/BT,14000500,"Casa Di Cura ""Villa Esther""",MOL,40-49,4,7,0,10,1,0,0,11,0,11,Molise,ITF2
2021-01-11,PF/BT,14000500,"Casa Di Cura ""Villa Esther""",MOL,50-59,6,8,0,9,5,0,0,14,0,14,Molise,ITF2
2021-01-11,PF/BT,14000500,"Casa Di Cura ""Villa Esther""",MOL,60-69,9,0,0,9,0,0,0,9,0,9,Molise,ITF2
2021-01-11,PF/BT,140201,Casa Dei Nonni (Talita' Kum),MOL,40-49,0,1,0,1,0,0,0,1,0,1,Molise,ITF2
2021-01-11,PF/BT,140201,Casa Dei Nonni (Talita' Kum),MOL,50-59,0,2,0,2,0,0,0,2,0,2,Molise,ITF2
2021-01-11,PF/BT,140201,Casa Dei Nonni (Talita' Kum),MOL,60-69,0,3,0,2,0,1,0,3,0,3,Molise,ITF2
2021-01-11,PF/BT,140201,Casa Dei Nonni (Talita' Kum),MOL,70-79,1,2,0,0,0,3,0,3,0,3,Molise,ITF2
2021-01-11,PF/BT,140201,Casa Dei Nonni (Talita' Kum),MOL,80-89,0,7,0,0,0,7,0,7,0,7,Molise,ITF2
2021-01-11,PF/BT,140201,Casa Dei Nonni (Talita' Kum),MOL,90+,0,2,0,0,0,2,0,2,0,2,Molise,ITF2
2021-01-11,PF/BT,140201,"Casa Di Riposo ""Arnaldo De Lisio""",MOL,20-29,0,1,0,0,1,0,0,1,0,1,Molise,ITF2
2021-01-11,PF/BT,140201,"Casa Di Riposo ""Arnaldo De Lisio""",MOL,30-39,1,1,0,2,0,0,0,2,0,2,Molise,ITF2
2021-01-11,PF/BT,140201,"Casa Di Riposo ""Arnaldo De Lisio""",MOL,40-49,0,1,0,1,0,0,0,1,0,1,Molise,ITF2
2021-01-11,PF/BT,140201,"Casa Di Riposo ""Arnaldo De Lisio""",MOL,50-59,0,1,0,1,0,0,0,1,0,1,Molise,ITF2
2021-01-11,PF/BT,140201,"Casa Di Riposo ""Arnaldo De Lisio""",MOL,60-69,2,0,0,0,0,2,0,2,0,2,Molise,ITF2
2021-01-11,PF/BT,140201,"Casa Di Riposo ""Arnaldo De Lisio""",MOL,70-79,1,0,0,0,0,1,0,1,0,1,Molise,ITF2
2021-01-11,PF/BT,140201,"Casa Di Riposo ""Arnaldo De Lisio""",MOL,80-89,6,7,0,0,0,13,0,13,0,13,Molise,ITF2
2021-01-11,PF/BT,140201,"Casa Di Riposo ""Arnaldo De Lisio""",MOL,90+,2,1,0,0,0,3,0,3,0,3,Molise,ITF2
2021-01-11,PF/BT,140201,Casa Di Riposo Giovanni Paolo II,MOL,50-59,1,2,0,0,2,1,0,3,0,3,Molise,ITF2
2021-01-11,PF/BT,140201,Casa Di Riposo Giovanni Paolo II,MOL,60-69,0,1,0,0,0,1,0,1,0,1,Molise,ITF2
2021-01-11,PF/BT,140201,Casa Di Riposo Giovanni Paolo II,MOL,70-79,1,3,0,0,0,4,0,4,0,4,Molise,ITF2
2021-01-11,PF/BT,140201,Casa Di Riposo Giovanni Paolo II,MOL,80-89,0,2,0,0,0,2,0,2,0,2,Molise,ITF2
2021-01-11,PF/BT,140201,Casa Di Riposo Giovanni Paolo II,MOL,90+,2,6,0,0,0,8,0,8,0,8,Molise,ITF2
2021-01-11,PF/BT,140201,Casa San Bernardino - Agnone,MOL,30-39,0,1,0,1,0,0,0,1,0,1,Molise,ITF2
2021-01-11,PF/BT,140201,Casa San Bernardino - Agnone,MOL,40-49,0,5,0,1,3,1,0,5,0,5,Molise,ITF2
2021-01-11,PF/BT,140201,Casa San Bernardino - Agnone,MOL,50-59,1,1,0,1,0,1,0,2,0,2,Molise,ITF2
2021-01-11,PF/BT,140201,Casa San Bernardino - Agnone,MOL,60-69,0,1,0,0,0,1,0,1,0,1,Molise,ITF2
2021-01-11,PF/BT,140201,Casa San Bernardino - Agnone,MOL,70-79,2,2,0,0,0,4,0,4,0,4,Molise,ITF2
2021-01-11,PF/BT,140201,Casa San Bernardino - Agnone,MOL,80-89,3,9,0,0,0,12,0,12,0,12,Molise,ITF2
2021-01-11,PF/BT,140201,Casa San Bernardino - Agnone,MOL,90+,4,7,0,0,0,11,0,11,0,11,Molise,ITF2
2021-01-11,PF/BT,140201,COMUNITA' ALLOGGIO - DON CRESCENZO SELVAGGIO,MOL,50-59,1,2,0,0,2,1,0,3,0,3,Molise,ITF2
2021-01-11,PF/BT,140201,COMUNITA' ALLOGGIO - DON CRESCENZO SELVAGGIO,MOL,60-69,1,3,0,0,1,3,0,4,0,4,Molise,ITF2
2021-01-11,PF/BT,140201,COMUNITA' ALLOGGIO - DON CRESCENZO SELVAGGIO,MOL,70-79,0,2,0,0,0,2,0,2,0,2,Molise,ITF2
2021-01-11,PF/BT,140201,COMUNITA' ALLOGGIO - DON CRESCENZO SELVAGGIO,MOL,80-89,1,5,0,0,0,6,0,6,0,6,Molise,ITF2
2021-01-11,PF/BT,140201,COMUNITA' ALLOGGIO - DON CRESCENZO SELVAGGIO,MOL,90+,1,2,0,0,0,3,0,3,0,3,Molise,ITF2
2021-01-11,PF/BT,140201,Comunita Alloggio Nicolino De Rubertis,MOL,30-39,0,1,0,1,0,0,0,1,0,1,Molise,ITF2
2021-01-11,PF/BT,140201,Comunita Alloggio Nicolino De Rubertis,MOL,50-59,1,1,0,1,0,1,0,2,0,2,Molise,ITF2
2021-01-11,PF/BT,140201,Comunita Alloggio Nicolino De Rubertis,MOL,60-69,1,0,0,0,0,1,0,1,0,1,Molise,ITF2
2021-01-11,PF/BT,140201,Comunita Alloggio Nicolino De Rubertis,MOL,70-79,3,0,0,0,0,3,0,3,0,3,Molise,ITF2
2021-01-11,PF/BT,140201,Comunita Alloggio Nicolino De Rubertis,MOL,80-89,0,4,0,0,0,4,0,4,0,4,Molise,ITF2
2021-01-11,PF/BT,140201,Comunita Alloggio Nicolino De Rubertis,MOL,90+,0,7,0,0,1,6,0,7,0,7,Molise,ITF2
2021-01-12,PF/BT,14000100,P.O. A.CARDARELLI-CAMPOBASSO,MOL,20-29,0,4,0,0,4,0,0,4,0,4,Molise,ITF2
2021-01-12,PF/BT,14000100,P.O. A.CARDARELLI-CAMPOBASSO,MOL,30-39,5,9,0,7,7,0,0,14,0,14,Molise,ITF2
2021-01-12,PF/BT,14000100,P.O. A.CARDARELLI-CAMPOBASSO,MOL,40-49,4,9,0,2,10,0,1,13,0,13,Molise,ITF2
2021-01-12,PF/BT,14000100,P.O. A.CARDARELLI-CAMPOBASSO,MOL,50-59,4,17,0,7,14,0,0,21,0,21,Molise,ITF2
2021-01-12,PF/BT,14000100,P.O. A.CARDARELLI-CAMPOBASSO,MOL,60-69,5,3,0,3,5,0,0,8,0,8,Molise,ITF2
2021-01-12,PF/BT,14000301,P.O. ISERNIA,MOL,20-29,2,3,0,3,2,0,0,5,0,5,Molise,ITF2
2021-01-12,PF/BT,14000301,P.O. ISERNIA,MOL,30-39,4,4,0,5,3,0,0,8,0,8,Molise,ITF2
2021-01-12,PF/BT,14000301,P.O. ISERNIA,MOL,40-49,2,11,0,5,8,0,0,13,0,13,Molise,ITF2
2021-01-12,PF/BT,14000301,P.O. ISERNIA,MOL,50-59,7,15,0,12,10,0,0,22,0,22,Molise,ITF2
2021-01-12,PF/BT,14000301,P.O. ISERNIA,MOL,60-69,4,4,0,6,2,0,0,8,0,8,Molise,ITF2
2021-01-12,PF/BT,14000301,P.O. ISERNIA,MOL,70-79,2,0,0,1,1,0,0,2,0,2,Molise,ITF2
2021-01-12,PF/BT,14000301,P.O. ISERNIA,MOL,90+,1,1,0,1,1,0,0,2,0,2,Molise,ITF2
2021-01-12,PF/BT,140201,CASA DELLA CARITA',MOL,60-69,0,2,0,0,1,1,0,2,0,2,Molise,ITF2
2021-01-12,PF/BT,140201,CASA DELLA CARITA',MOL,70-79,0,7,0,0,0,7,0,7,0,7,Molise,ITF2
2021-01-12,PF/BT,140201,CASA DELLA CARITA',MOL,80-89,0,8,0,0,1,7,0,8,0,8,Molise,ITF2
2021-01-12,PF/BT,140201,CASA DELLA CARITA',MOL,90+,0,7,0,0,1,6,0,7,0,7,Molise,ITF2
2021-01-12,PF/BT,140201,Casa Di Riposo Cardinal Seper,MOL,40-49,0,2,0,1,1,0,0,2,0,2,Molise,ITF2
2021-01-12,PF/BT,140201,Casa Di Riposo Cardinal Seper,MOL,50-59,0,2,0,1,1,0,0,2,0,2,Molise,ITF2
2021-01-12,PF/BT,140201,Casa Di Riposo Cardinal Seper,MOL,60-69,2,1,0,1,0,2,0,3,0,3,Molise,ITF2
2021-01-12,PF/BT,140201,Casa Di Riposo Cardinal Seper,MOL,70-79,4,1,0,0,0,5,0,5,0,5,Molise,ITF2
2021-01-12,PF/BT,140201,Casa Di Riposo Cardinal Seper,MOL,80-89,4,11,0,0,0,15,0,15,0,15,Molise,ITF2
2021-01-12,PF/BT,140201,Casa Di Riposo Cardinal Seper,MOL,90+,2,7,0,0,0,9,0,9,0,9,Molise,ITF2
2021-01-12,PF/BT,140201,Casa Di Riposo Villa Anna,MOL,90+,0,1,0,0,0,1,0,1,0,1,Molise,ITF2
2021-01-12,PF/BT,140201,Casa Di Riposo Villa Santa Maria,MOL,40-49,1,2,0,2,0,1,0,3,0,3,Molise,ITF2
2021-01-12,PF/BT,140201,Casa Di Riposo Villa Santa Maria,MOL,60-69,1,1,0,0,1,1,0,2,0,2,Molise,ITF2
2021-01-12,PF/BT,140201,Casa Di Riposo Villa Santa Maria,MOL,70-79,2,3,0,0,0,5,0,5,0,5,Molise,ITF2
2021-01-12,PF/BT,140201,Casa Di Riposo Villa Santa Maria,MOL,80-89,1,16,0,0,0,17,0,17,0,17,Molise,ITF2
2021-01-12,PF/BT,140201,Casa Di Riposo Villa Santa Maria,MOL,90+,3,11,0,0,0,14,0,14,0,14,Molise,ITF2
2021-01-12,PF/BT,140201,Comunita' Alloggio La Sfinge,MOL,20-29,1,0,0,0,1,0,0,1,0,1,Molise,ITF2
2021-01-12,PF/BT,140201,Comunita' Alloggio La Sfinge,MOL,30-39,0,1,0,1,0,0,0,1,0,1,Molise,ITF2
2021-01-12,PF/BT,140201,Comunita' Alloggio La Sfinge,MOL,50-59,0,2,0,1,0,1,0,2,0,2,Molise,ITF2
2021-01-12,PF/BT,140201,Comunita' Alloggio La Sfinge,MOL,60-69,1,1,0,0,0,2,0,2,0,2,Molise,ITF2
2021-01-12,PF/BT,140201,Comunita' Alloggio La Sfinge,MOL,80-89,2,3,0,0,0,5,0,5,0,5,Molise,ITF2
2021-01-12,PF/BT,140201,Comunita' Alloggio La Sfinge,MOL,90+,5,8,0,0,0,13,0,13,0,13,Molise,ITF2
2021-01-12,PF/BT,140201,Comunita' Alloggio Madonna Delle Grazie,MOL,60-69,1,0,0,0,0,1,0,1,0,1,Molise,ITF2
2021-01-12,PF/BT,140201,Comunita' Alloggio Madonna Delle Grazie,MOL,70-79,0,2,0,0,0,2,0,2,0,2,Molise,ITF2
2021-01-12,PF/BT,140201,Comunita' Alloggio Madonna Delle Grazie,MOL,80-89,4,4,0,0,0,8,0,8,0,8,Molise,ITF2
2021-01-12,PF/BT,140201,Comunita' Alloggio Madonna Delle Grazie,MOL,90+,1,6,0,0,0,7,0,7,0,7,Molise,ITF2
2021-01-12,PF/BT,14091100,NEUROMED I.R.C.C.S.,MOL,20-29,6,6,0,12,0,0,0,12,0,12,Molise,ITF2
2021-01-12,PF/BT,14091100,NEUROMED I.R.C.C.S.,MOL,30-39,15,13,0,28,0,0,0,28,0,28,Molise,ITF2
2021-01-12,PF/BT,14091100,NEUROMED I.R.C.C.S.,MOL,40-49,10,8,0,18,0,0,0,18,0,18,Molise,ITF2
2021-01-12,PF/BT,14091100,NEUROMED I.R.C.C.S.,MOL,50-59,4,6,0,10,0,0,0,10,0,10,Molise,ITF2
2021-01-12,PF/BT,14091100,NEUROMED I.R.C.C.S.,MOL,60-69,2,0,0,2,0,0,0,2,0,2,Molise,ITF2
2021-01-12,PF/BT,14091100,NEUROMED I.R.C.C.S.,MOL,70-79,2,0,0,2,0,0,0,2,0,2,Molise,ITF2
2021-01-13,PF/BT,14000200,P.O TIMOTEO- TERMOLI,MOL,16-19,1,0,0,0,1,0,0,1,0,1,Molise,ITF2
2021-01-13,PF/BT,14000200,P.O TIMOTEO- TERMOLI,MOL,20-29,2,7,0,7,2,0,0,9,0,9,Molise,ITF2
2021-01-13,PF/BT,14000200,P.O TIMOTEO- TERMOLI,MOL,30-39,10,14,0,17,6,0,1,24,0,24,Molise,ITF2
2021-01-13,PF/BT,14000200,P.O TIMOTEO- TERMOLI,MOL,40-49,4,18,0,12,10,0,0,22,0,22,Molise,ITF2
2021-01-13,PF/BT,14000200,P.O TIMOTEO- TERMOLI,MOL,50-59,3,25,0,16,12,0,0,28,0,28,Molise,ITF2
2021-01-13,PF/BT,14000200,P.O TIMOTEO- TERMOLI,MOL,60-69,8,15,0,14,7,1,1,23,0,23,Molise,ITF2
2021-01-13,PF/BT,14000200,P.O TIMOTEO- TERMOLI,MOL,70-79,2,2,0,0,2,1,1,4,0,4,Molise,ITF2
2021-01-13,PF/BT,14000200,P.O TIMOTEO- TERMOLI,MOL,80-89,0,3,0,0,0,3,0,3,0,3,Molise,ITF2
2021-01-13,PF/BT,14000301,P.O. ISERNIA,MOL,20-29,1,2,0,3,0,0,0,3,0,3,Molise,ITF2
2021-01-13,PF/BT,14000301,P.O. ISERNIA,MOL,30-39,4,5,0,7,2,0,0,9,0,9,Molise,ITF2
2021-01-13,PF/BT,14000301,P.O. ISERNIA,MOL,40-49,5,2,0,2,5,0,0,7,0,7,Molise,ITF2
2021-01-13,PF/BT,14000301,P.O. ISERNIA,MOL,50-59,1,9,0,5,5,0,0,10,0,10,Molise,ITF2
2021-01-13,PF/BT,14000301,P.O. ISERNIA,MOL,60-69,2,4,0,4,2,0,0,6,0,6,Molise,ITF2
2021-01-13,PF/BT,14000301,P.O. ISERNIA,MOL,70-79,1,0,0,1,0,0,0,1,0,1,Molise,ITF2
2021-01-13,PF/BT,14000700,GEMELLI MOLISE S.P.A.,MOL,40-49,3,4,0,7,0,0,0,7,0,7,Molise,ITF2
2021-01-13,PF/BT,14000700,GEMELLI MOLISE S.P.A.,MOL,50-59,25,25,0,50,0,0,0,50,0,50,Molise,ITF2
2021-01-13,PF/BT,14000700,GEMELLI MOLISE S.P.A.,MOL,60-69,9,4,0,13,0,0,0,13,0,13,Molise,ITF2
2021-01-13,PF/BT,14000700,GEMELLI MOLISE S.P.A.,MOL,70-79,2,0,0,2,0,0,0,2,0,2,Molise,ITF2
2021-01-13,PF/BT,140201,Casa Di Riposo Famiglia Leccesse,MOL,30-39,0,1,0,1,0,0,0,1,0,1,Molise,ITF2
2021-01-13,PF/BT,140201,Casa Di Riposo Famiglia Leccesse,MOL,50-59,0,2,0,2,0,0,0,2,0,2,Molise,ITF2
2021-01-13,PF/BT,140201,Casa Di Riposo Famiglia Leccesse,MOL,60-69,2,2,0,1,0,3,0,4,0,4,Molise,ITF2
2021-01-13,PF/BT,140201,Casa Di Riposo Famiglia Leccesse,MOL,70-79,1,1,0,0,0,2,0,2,0,2,Molise,ITF2
2021-01-13,PF/BT,140201,Casa Di Riposo Famiglia Leccesse,MOL,80-89,2,9,0,0,0,11,0,11,0,11,Molise,ITF2
2021-01-13,PF/BT,140201,Casa Di Riposo Famiglia Leccesse,MOL,90+,4,6,0,0,0,10,0,10,0,10,Molise,ITF2
2021-01-13,PF/BT,140201,Casa Di Riposo Maria De Horatiis,MOL,20-29,0,1,0,1,0,0,0,1,0,1,Molise,ITF2
2021-01-13,PF/BT,140201,Casa Di Riposo Maria De Horatiis,MOL,30-39,0,5,0,3,2,0,0,5,0,5,Molise,ITF2
2021-01-13,PF/BT,140201,Casa Di Riposo Maria De Horatiis,MOL,40-49,0,8,0,2,6,0,0,8,0,8,Molise,ITF2
2021-01-13,PF/BT,140201,Casa Di Riposo Maria De Horatiis,MOL,50-59,3,2,0,3,2,0,0,5,0,5,Molise,ITF2
2021-01-13,PF/BT,140201,Casa Di Riposo Maria De Horatiis,MOL,60-69,1,4,0,2,2,1,0,5,0,5,Molise,ITF2
2021-01-13,PF/BT,140201,Casa Di Riposo Maria De Horatiis,MOL,70-79,1,2,0,1,0,2,0,3,0,3,Molise,ITF2
2021-01-13,PF/BT,140201,Casa Di Riposo Maria De Horatiis,MOL,80-89,3,2,0,0,0,5,0,5,0,5,Molise,ITF2
2021-01-13,PF/BT,140201,Casa Di Riposo Maria De Horatiis,MOL,90+,1,9,0,0,0,10,0,10,0,10,Molise,ITF2
2021-01-13,PF/BT,140201,Comunità Alloggio Sant'Amico,MOL,30-39,1,0,0,0,1,0,0,1,0,1,Molise,ITF2
2021-01-13,PF/BT,140201,Comunità Alloggio Sant'Amico,MOL,40-49,2,1,0,1,1,1,0,3,0,3,Molise,ITF2
2021-01-13,PF/BT,140201,Comunità Alloggio Sant'Amico,MOL,50-59,0,1,0,1,0,0,0,1,0,1,Molise,ITF2
2021-01-13,PF/BT,140201,Comunità Alloggio Sant'Amico,MOL,70-79,1,1,0,0,0,2,0,2,0,2,Molise,ITF2
2021-01-13,PF/BT,140201,Comunità Alloggio Sant'Amico,MOL,80-89,0,7,0,0,0,7,0,7,0,7,Molise,ITF2
2021-01-13,PF/BT,140201,Comunità Alloggio Sant'Amico,MOL,90+,0,4,0,0,0,4,0,4,0,4,Molise,ITF2
2021-01-13,PF/BT,140201,Comunità Alloggio Villa Adriatica,MOL,50-59,2,0,0,0,1,1,0,2,0,2,Molise,ITF2
2021-01-13,PF/BT,140201,Comunità Alloggio Villa Adriatica,MOL,60-69,1,0,0,0,0,1,0,1,0,1,Molise,ITF2
2021-01-13,PF/BT,140201,Comunità Alloggio Villa Adriatica,MOL,70-79,1,2,0,0,0,3,0,3,0,3,Molise,ITF2
2021-01-13,PF/BT,140201,Comunità Alloggio Villa Adriatica,MOL,80-89,3,6,0,0,0,9,0,9,0,9,Molise,ITF2
2021-01-13,PF/BT,140201,Comunità Alloggio Villa Adriatica,MOL,90+,1,7,0,0,0,8,0,8,0,8,Molise,ITF2
2021-01-13,PF/BT,140201,Karol Wojtyla,MOL,80-89,3,7,0,0,0,10,0,10,0,10,Molise,ITF2
2021-01-13,PF/BT,140201,Karol Wojtyla,MOL,90+,1,7,0,0,0,8,0,8,0,8,Molise,ITF2
2021-01-13,PF/BT,140201,S. Felice Papa,MOL,70-79,1,0,0,0,0,1,0,1,0,1,Molise,ITF2
2021-01-13,PF/BT,140201,S. Felice Papa,MOL,80-89,3,8,0,0,0,11,0,11,0,11,Molise,ITF2
2021-01-13,PF/BT,140201,S. Felice Papa,MOL,90+,1,4,0,0,0,5,0,5,0,5,Molise,ITF2
2021-01-13,PF/BT,140201,Villa S. Clemente,MOL,30-39,0,1,0,1,0,0,0,1,0,1,Molise,ITF2
2021-01-13,PF/BT,140201,Villa S. Clemente,MOL,40-49,0,2,0,2,0,0,0,2,0,2,Molise,ITF2
2021-01-13,PF/BT,140201,Villa S. Clemente,MOL,50-59,1,5,0,4,0,2,0,6,0,6,Molise,ITF2
2021-01-13,PF/BT,140201,Villa S. Clemente,MOL,60-69,1,1,0,1,0,1,0,2,0,2,Molise,ITF2
2021-01-13,PF/BT,140201,Villa S. Clemente,MOL,70-79,2,3,0,0,0,5,0,5,0,5,Molise,ITF2
2021-01-13,PF/BT,140201,Villa S. Clemente,MOL,80-89,3,6,0,0,0,9,0,9,0,9,Molise,ITF2
2021-01-13,PF/BT,140201,Villa S. Clemente,MOL,90+,1,4,0,0,0,5,0,5,0,5,Molise,ITF2
2021-01-13,PF/BT,14091100,NEUROMED I.R.C.C.S.,MOL,20-29,6,7,0,13,0,0,0,13,0,13,Molise,ITF2
2021-01-13,PF/BT,14091100,NEUROMED I.R.C.C.S.,MOL,30-39,5,10,0,15,0,0,0,15,0,15,Molise,ITF2
2021-01-13,PF/BT,14091100,NEUROMED I.R.C.C.S.,MOL,40-49,6,10,0,16,0,0,0,16,0,16,Molise,ITF2
2021-01-13,PF/BT,14091100,NEUROMED I.R.C.C.S.,MOL,50-59,2,12,0,14,0,0,0,14,0,14,Molise,ITF2
2021-01-13,PF/BT,14091100,NEUROMED I.R.C.C.S.,MOL,60-69,9,4,0,11,2,0,0,13,0,13,Molise,ITF2
2021-01-13,PF/BT,14091100,NEUROMED I.R.C.C.S.,MOL,70-79,1,0,0,1,0,0,0,1,0,1,Molise,ITF2
2021-01-14,PF/BT,14000100,P.O. A.CARDARELLI-CAMPOBASSO,MOL,20-29,1,4,0,2,1,2,0,5,0,5,Molise,ITF2
2021-01-14,PF/BT,14000100,P.O. A.CARDARELLI-CAMPOBASSO,MOL,30-39,8,13,0,17,3,1,0,21,0,21,Molise,ITF2
2021-01-14,PF/BT,14000100,P.O. A.CARDARELLI-CAMPOBASSO,MOL,40-49,12,15,0,13,6,1,7,27,0,27,Molise,ITF2
2021-01-14,PF/BT,14000100,P.O. A.CARDARELLI-CAMPOBASSO,MOL,50-59,8,27,0,27,4,1,3,35,0,35,Molise,ITF2
2021-01-14,PF/BT,14000100,P.O. A.CARDARELLI-CAMPOBASSO,MOL,60-69,34,21,0,39,15,0,1,55,0,55,Molise,ITF2
2021-01-14,PF/BT,14000100,P.O. A.CARDARELLI-CAMPOBASSO,MOL,70-79,0,1,0,1,0,0,0,1,0,1,Molise,ITF2
2021-01-14,PF/BT,14000200,P.O TIMOTEO- TERMOLI,MOL,20-29,1,3,0,1,3,0,0,4,0,4,Molise,ITF2
2021-01-14,PF/BT,14000200,P.O TIMOTEO- TERMOLI,MOL,30-39,3,14,0,8,8,1,0,17,0,17,Molise,ITF2
2021-01-14,PF/BT,14000200,P.O TIMOTEO- TERMOLI,MOL,40-49,9,13,0,16,6,0,0,22,0,22,Molise,ITF2
2021-01-14,PF/BT,14000200,P.O TIMOTEO- TERMOLI,MOL,50-59,9,27,0,23,13,0,0,36,0,36,Molise,ITF2
2021-01-14,PF/BT,14000200,P.O TIMOTEO- TERMOLI,MOL,60-69,10,12,0,16,6,0,0,22,0,22,Molise,ITF2
2021-01-14,PF/BT,14000200,P.O TIMOTEO- TERMOLI,MOL,70-79,0,1,0,0,1,0,0,1,0,1,Molise,ITF2
2021-01-14,PF/BT,14000301,P.O. ISERNIA,MOL,20-29,0,7,0,3,4,0,0,7,0,7,Molise,ITF2
2021-01-14,PF/BT,14000301,P.O. ISERNIA,MOL,30-39,10,15,0,14,11,0,0,25,0,25,Molise,ITF2
2021-01-14,PF/BT,14000301,P.O. ISERNIA,MOL,40-49,5,15,0,14,6,0,0,20,0,20,Molise,ITF2
2021-01-14,PF/BT,14000301,P.O. ISERNIA,MOL,50-59,3,12,0,10,4,1,0,15,0,15,Molise,ITF2
2021-01-14,PF/BT,14000301,P.O. ISERNIA,MOL,60-69,0,5,0,3,2,0,0,5,0,5,Molise,ITF2
2021-01-14,PF/BT,140201,CASA ALBERGO MORRONE,MOL,30-39,0,1,0,0,1,0,0,1,0,1,Molise,ITF2
2021-01-14,PF/BT,140201,CASA ALBERGO MORRONE,MOL,60-69,0,4,0,0,4,0,0,4,0,4,Molise,ITF2
2021-01-14,PF/BT,140201,CASA ALBERGO MORRONE,MOL,70-79,3,0,0,0,0,3,0,3,0,3,Molise,ITF2
2021-01-14,PF/BT,140201,CASA ALBERGO MORRONE,MOL,80-89,4,6,0,0,0,10,0,10,0,10,Molise,ITF2
2021-01-14,PF/BT,140201,CASA ALBERGO MORRONE,MOL,90+,1,11,0,0,0,12,0,12,0,12,Molise,ITF2
2021-01-14,PF/BT,140201,Casa Famiglia San Giuseppe,MOL,70-79,0,3,0,0,0,3,0,3,0,3,Molise,ITF2
2021-01-14,PF/BT,140201,Casa Famiglia San Giuseppe,MOL,80-89,1,7,0,0,0,8,0,8,0,8,Molise,ITF2
2021-01-14,PF/BT,140201,Casa Famiglia San Giuseppe,MOL,90+,1,5,0,0,0,6,0,6,0,6,Molise,ITF2
2021-01-14,PF/BT,140201,Comunità Alloggio Centro Agora' - La Canonica,MOL,20-29,2,1,0,3,0,0,0,3,0,3,Molise,ITF2
2021-01-14,PF/BT,140201,Comunità Alloggio Centro Agora' - La Canonica,MOL,30-39,0,1,0,1,0,0,0,1,0,1,Molise,ITF2
2021-01-14,PF/BT,140201,Comunità Alloggio Centro Agora' - La Canonica,MOL,40-49,2,4,0,6,0,0,0,6,0,6,Molise,ITF2
2021-01-14,PF/BT,140201,Comunità Alloggio Centro Agora' - La Canonica,MOL,50-59,2,1,0,2,0,1,0,3,0,3,Molise,ITF2
2021-01-14,PF/BT,140201,Comunità Alloggio Centro Agora' - La Canonica,MOL,60-69,0,2,0,1,0,1,0,2,0,2,Molise,ITF2
2021-01-14,PF/BT,140201,Comunità Alloggio Centro Agora' - La Canonica,MOL,70-79,2,5,0,0,1,6,0,7,0,7,Molise,ITF2
2021-01-14,PF/BT,140201,Comunità Alloggio Centro Agora' - La Canonica,MOL,80-89,5,9,0,0,0,14,0,14,0,14,Molise,ITF2
2021-01-14,PF/BT,140201,Comunità Alloggio Centro Agora' - La Canonica,MOL,90+,1,5,0,0,0,6,0,6,0,6,Molise,ITF2
2021-01-14,PF/BT,140201,GEMELLI MOLISE S.P.A.,MOL,30-39,2,8,0,10,0,0,0,10,0,10,Molise,ITF2
2021-01-14,PF/BT,140201,GEMELLI MOLISE S.P.A.,MOL,40-49,45,59,0,104,0,0,0,104,0,104,Molise,ITF2
2021-01-14,PF/BT,140201,GEMELLI MOLISE S.P.A.,MOL,50-59,2,4,0,6,0,0,0,6,0,6,Molise,ITF2
2021-01-14,PF/BT,140201,NEUROMED I.R.C.C.S.,MOL,20-29,0,5,0,5,0,0,0,5,0,5,Molise,ITF2
2021-01-14,PF/BT,140201,NEUROMED I.R.C.C.S.,MOL,30-39,7,8,0,15,0,0,0,15,0,15,Molise,ITF2
2021-01-14,PF/BT,140201,NEUROMED I.R.C.C.S.,MOL,40-49,7,17,0,24,0,0,0,24,0,24,Molise,ITF2
2021-01-14,PF/BT,140201,NEUROMED I.R.C.C.S.,MOL,50-59,6,8,0,14,0,0,0,14,0,14,Molise,ITF2
2021-01-14,PF/BT,140201,NEUROMED I.R.C.C.S.,MOL,60-69,9,3,0,12,0,0,0,12,0,12,Molise,ITF2
2021-01-14,PF/BT,140201,NEUROMED I.R.C.C.S.,MOL,70-79,1,0,0,1,0,0,0,1,0,1,Molise,ITF2
2021-01-14,PF/BT,140201,NEUROMED I.R.C.C.S.,MOL,80-89,1,0,0,1,0,0,0,1,0,1,Molise,ITF2
2021-01-14,PF/BT,140201,Residenza Per Anziani Villa Vittoria,MOL,20-29,1,0,0,0,1,0,0,1,0,1,Molise,ITF2
2021-01-14,PF/BT,140201,Residenza Per Anziani Villa Vittoria,MOL,30-39,0,1,0,0,1,0,0,1,0,1,Molise,ITF2
2021-01-14,PF/BT,140201,Residenza Per Anziani Villa Vittoria,MOL,40-49,0,2,0,0,2,0,0,2,0,2,Molise,ITF2
2021-01-14,PF/BT,140201,Residenza Per Anziani Villa Vittoria,MOL,50-59,0,3,0,0,3,0,0,3,0,3,Molise,ITF2
2021-01-14,PF/BT,140201,Residenza Per Anziani Villa Vittoria,MOL,60-69,2,1,0,0,0,3,0,3,0,3,Molise,ITF2
2021-01-14,PF/BT,140201,Residenza Per Anziani Villa Vittoria,MOL,70-79,3,0,0,0,0,3,0,3,0,3,Molise,ITF2
2021-01-14,PF/BT,140201,Residenza Per Anziani Villa Vittoria,MOL,80-89,1,3,0,0,0,4,0,4,0,4,Molise,ITF2
2021-01-14,PF/BT,140201,Residenza Per Anziani Villa Vittoria,MOL,90+,0,7,0,0,0,7,0,7,0,7,Molise,ITF2
2021-01-14,PF/BT,140201,Santa Cristina (l'Ulivo),MOL,20-29,1,0,0,0,0,1,0,1,0,1,Molise,ITF2
2021-01-14,PF/BT,140201,Santa Cristina (l'Ulivo),MOL,40-49,0,1,0,0,0,1,0,1,0,1,Molise,ITF2
2021-01-14,PF/BT,140201,Santa Cristina (l'Ulivo),MOL,50-59,2,3,0,0,0,5,0,5,0,5,Molise,ITF2
2021-01-14,PF/BT,140201,Santa Cristina (l'Ulivo),MOL,60-69,6,3,0,0,0,9,0,9,0,9,Molise,ITF2
2021-01-14,PF/BT,140201,Santa Cristina (l'Ulivo),MOL,70-79,3,0,0,0,0,3,0,3,0,3,Molise,ITF2
2021-01-14,PF/BT,140201,Santa Cristina (l'Ulivo),MOL,80-89,3,1,0,0,0,4,0,4,0,4,Molise,ITF2
2021-01-14,PF/BT,140201,Santa Cristina (l'Ulivo),MOL,90+,0,1,0,0,0,1,0,1,0,1,Molise,ITF2
2021-01-15,PF/BT,14000100,P.O. A.CARDARELLI-CAMPOBASSO,MOL,20-29,4,3,0,7,0,0,0,7,0,7,Molise,ITF2
2021-01-15,PF/BT,14000100,P.O. A.CARDARELLI-CAMPOBASSO,MOL,30-39,3,5,0,7,0,0,1,8,0,8,Molise,ITF2
2021-01-15,PF/BT,14000100,P.O. A.CARDARELLI-CAMPOBASSO,MOL,40-49,6,10,0,13,1,0,2,16,0,16,Molise,ITF2
2021-01-15,PF/BT,14000100,P.O. A.CARDARELLI-CAMPOBASSO,MOL,50-59,5,29,0,26,2,0,6,34,0,34,Molise,ITF2
2021-01-15,PF/BT,14000100,P.O. A.CARDARELLI-CAMPOBASSO,MOL,60-69,36,18,0,51,0,0,3,54,0,54,Molise,ITF2
2021-01-15,PF/BT,14000100,P.O. A.CARDARELLI-CAMPOBASSO,MOL,90+,0,1,0,0,0,1,0,1,0,1,Molise,ITF2
2021-01-15,PF/BT,14000200,P.O TIMOTEO- TERMOLI,MOL,20-29,4,1,0,4,1,0,0,5,0,5,Molise,ITF2
2021-01-15,PF/BT,14000200,P.O TIMOTEO- TERMOLI,MOL,30-39,3,5,0,8,0,0,0,8,0,8,Molise,ITF2
2021-01-15,PF/BT,14000200,P.O TIMOTEO- TERMOLI,MOL,40-49,4,1,0,5,0,0,0,5,0,5,Molise,ITF2
2021-01-15,PF/BT,14000200,P.O TIMOTEO- TERMOLI,MOL,50-59,6,21,0,27,0,0,0,27,0,27,Molise,ITF2
2021-01-15,PF/BT,14000200,P.O TIMOTEO- TERMOLI,MOL,60-69,16,10,0,26,0,0,0,26,0,26,Molise,ITF2
2021-01-15,PF/BT,14000200,P.O TIMOTEO- TERMOLI,MOL,70-79,1,0,0,1,0,0,0,1,0,1,Molise,ITF2
2021-01-15,PF/BT,14000301,P.O. ISERNIA,MOL,30-39,5,4,0,6,3,0,0,9,0,9,Molise,ITF2
2021-01-15,PF/BT,14000301,P.O. ISERNIA,MOL,40-49,1,4,0,3,1,1,0,5,0,5,Molise,ITF2
2021-01-15,PF/BT,14000301,P.O. ISERNIA,MOL,50-59,3,10,0,10,3,0,0,13,0,13,Molise,ITF2
2021-01-15,PF/BT,14000301,P.O. ISERNIA,MOL,60-69,28,5,0,32,1,0,0,33,0,33,Molise,ITF2
2021-01-15,PF/BT,14000700,GEMELLI MOLISE S.P.A.,MOL,20-29,3,2,0,5,0,0,0,5,0,5,Molise,ITF2
2021-01-15,PF/BT,14000700,GEMELLI MOLISE S.P.A.,MOL,30-39,17,24,0,40,0,0,1,41,0,41,Molise,ITF2
2021-01-15,PF/BT,14000700,GEMELLI MOLISE S.P.A.,MOL,40-49,20,28,0,32,0,0,16,48,0,48,Molise,ITF2
2021-01-15,PF/BT,14000700,GEMELLI MOLISE S.P.A.,MOL,50-59,7,16,0,13,0,0,10,23,0,23,Molise,ITF2
2021-01-15,PF/BT,14000700,GEMELLI MOLISE S.P.A.,MOL,60-69,3,0,0,0,0,0,3,3,0,3,Molise,ITF2
2021-01-15,PF/BT,140201,Casa Alloggio Domus Mariae,MOL,30-39,1,4,0,2,1,2,0,5,0,5,Molise,ITF2
2021-01-15,PF/BT,140201,Casa Alloggio Domus Mariae,MOL,40-49,0,1,0,1,0,0,0,1,0,1,Molise,ITF2
2021-01-15,PF/BT,140201,Casa Alloggio Domus Mariae,MOL,50-59,2,2,0,1,0,3,0,4,0,4,Molise,ITF2
2021-01-15,PF/BT,140201,Casa Alloggio Domus Mariae,MOL,60-69,2,2,0,1,0,3,0,4,0,4,Molise,ITF2
2021-01-15,PF/BT,140201,Casa Alloggio Domus Mariae,MOL,70-79,1,2,0,0,0,3,0,3,0,3,Molise,ITF2
2021-01-15,PF/BT,140201,Casa Alloggio Domus Mariae,MOL,80-89,4,2,0,0,0,6,0,6,0,6,Molise,ITF2
2021-01-15,PF/BT,140201,Casa Alloggio Domus Mariae,MOL,90+,0,1,0,0,0,1,0,1,0,1,Molise,ITF2
2021-01-15,PF/BT,140201,Casa Alloggio Suor Luigina,MOL,60-69,1,0,0,1,0,0,0,1,0,1,Molise,ITF2
2021-01-15,PF/BT,140201,Casa Alloggio Suor Luigina,MOL,80-89,1,3,0,0,0,4,0,4,0,4,Molise,ITF2
2021-01-15,PF/BT,140201,Casa Alloggio Suor Luigina,MOL,90+,0,1,0,0,0,1,0,1,0,1,Molise,ITF2
2021-01-15,PF/BT,140201,Casa Di Riposo Giovanni Paolo II,MOL,30-39,1,0,0,1,0,0,0,1,0,1,Molise,ITF2
2021-01-15,PF/BT,140201,Casa Di Riposo Giovanni Paolo II,MOL,40-49,0,2,0,2,0,0,0,2,0,2,Molise,ITF2
2021-01-15,PF/BT,140201,Casa Di Riposo Giovanni Paolo II,MOL,50-59,0,1,0,1,0,0,0,1,0,1,Molise,ITF2
2021-01-15,PF/BT,140201,Casa Di Riposo Giovanni Paolo II,MOL,70-79,0,1,0,0,0,1,0,1,0,1,Molise,ITF2
2021-01-15,PF/BT,140201,Casa Di Riposo Giovanni Paolo II,MOL,80-89,1,2,0,0,0,3,0,3,0,3,Molise,ITF2
2021-01-15,PF/BT,140201,Casa Di Riposo Giovanni Paolo II,MOL,90+,1,9,0,0,0,10,0,10,0,10,Molise,ITF2
2021-01-15,PF/BT,140201,Comunita' Alloggio Nuovi Orizzonti,MOL,20-29,0,1,0,0,1,0,0,1,0,1,Molise,ITF2
2021-01-15,PF/BT,140201,Comunita' Alloggio Nuovi Orizzonti,MOL,40-49,0,1,0,0,1,0,0,1,0,1,Molise,ITF2
2021-01-15,PF/BT,140201,Comunita' Alloggio Nuovi Orizzonti,MOL,60-69,1,3,0,2,2,0,0,4,0,4,Molise,ITF2
2021-01-15,PF/BT,140201,Comunita' Alloggio Nuovi Orizzonti,MOL,80-89,0,2,0,0,0,2,0,2,0,2,Molise,ITF2
2021-01-15,PF/BT,140201,Comunita' Alloggio Nuovi Orizzonti,MOL,90+,2,2,0,0,0,4,0,4,0,4,Molise,ITF2
2021-01-15,PF/BT,140201,Comunita' Alloggio Villa Liliana - Villa Francesco,MOL,50-59,0,1,0,0,0,1,0,1,0,1,Molise,ITF2
2021-01-15,PF/BT,140201,Comunita' Alloggio Villa Liliana - Villa Francesco,MOL,60-69,1,1,0,0,0,2,0,2,0,2,Molise,ITF2
2021-01-15,PF/BT,140201,Comunita' Alloggio Villa Liliana - Villa Francesco,MOL,70-79,4,5,0,0,0,9,0,9,0,9,Molise,ITF2
2021-01-15,PF/BT,140201,Comunita' Alloggio Villa Liliana - Villa Francesco,MOL,80-89,2,5,0,0,0,7,0,7,0,7,Molise,ITF2
2021-01-15,PF/BT,140201,Comunita' Alloggio Villa Liliana - Villa Francesco,MOL,90+,1,4,0,0,0,5,0,5,0,5,Molise,ITF2
2021-01-15,PF/BT,140201,R.S.A. LARINO,MOL,20-29,1,0,0,0,0,1,0,1,0,1,Molise,ITF2
2021-01-15,PF/BT,140201,R.S.A. LARINO,MOL,30-39,1,0,0,0,0,1,0,1,0,1,Molise,ITF2
2021-01-15,PF/BT,140201,R.S.A. LARINO,MOL,50-59,1,0,0,0,0,1,0,1,0,1,Molise,ITF2
2021-01-15,PF/BT,140201,R.S.A. LARINO,MOL,80-89,1,3,0,0,0,4,0,4,0,4,Molise,ITF2
2021-01-15,PF/BT,140201,R.S.A. LARINO,MOL,90+,1,4,0,0,0,5,0,5,0,5,Molise,ITF2
2021-01-15,PF/BT,14091100,NEUROMED I.R.C.C.S.,MOL,20-29,7,5,0,12,0,0,0,12,0,12,Molise,ITF2
2021-01-15,PF/BT,14091100,NEUROMED I.R.C.C.S.,MOL,30-39,13,14,0,27,0,0,0,27,0,27,Molise,ITF2
2021-01-15,PF/BT,14091100,NEUROMED I.R.C.C.S.,MOL,40-49,8,9,0,17,0,0,0,17,0,17,Molise,ITF2
2021-01-15,PF/BT,14091100,NEUROMED I.R.C.C.S.,MOL,50-59,3,4,0,7,0,0,0,7,0,7,Molise,ITF2
2021-01-15,PF/BT,14091100,NEUROMED I.R.C.C.S.,MOL,60-69,4,3,0,6,1,0,0,7,0,7,Molise,ITF2
2021-01-15,PF/BT,14091100,NEUROMED I.R.C.C.S.,MOL,70-79,2,0,0,2,0,0,0,2,0,2,Molise,ITF2
2021-01-16,PF/BT,14000100,P.O. A.CARDARELLI-CAMPOBASSO,MOL,20-29,1,1,0,2,0,0,0,2,0,2,Molise,ITF2
2021-01-16,PF/BT,14000100,P.O. A.CARDARELLI-CAMPOBASSO,MOL,30-39,1,7,0,8,0,0,0,8,0,8,Molise,ITF2
2021-01-16,PF/BT,14000100,P.O. A.CARDARELLI-CAMPOBASSO,MOL,40-49,5,8,0,9,0,0,4,13,0,13,Molise,ITF2
2021-01-16,PF/BT,14000100,P.O. A.CARDARELLI-CAMPOBASSO,MOL,50-59,9,12,0,19,0,0,2,21,0,21,Molise,ITF2
2021-01-16,PF/BT,14000100,P.O. A.CARDARELLI-CAMPOBASSO,MOL,60-69,36,15,0,50,0,0,1,51,0,51,Molise,ITF2
2021-01-16,PF/BT,14000100,P.O. A.CARDARELLI-CAMPOBASSO,MOL,70-79,1,0,0,1,0,0,0,1,0,1,Molise,ITF2
2021-01-16,PF/BT,14000200,P.O TIMOTEO- TERMOLI,MOL,30-39,1,1,0,2,0,0,0,2,0,2,Molise,ITF2
2021-01-16,PF/BT,14000200,P.O TIMOTEO- TERMOLI,MOL,40-49,2,12,0,12,2,0,0,14,0,14,Molise,ITF2
2021-01-16,PF/BT,14000200,P.O TIMOTEO- TERMOLI,MOL,50-59,10,23,0,30,3,0,0,33,0,33,Molise,ITF2
2021-01-16,PF/BT,14000200,P.O TIMOTEO- TERMOLI,MOL,60-69,34,30,0,64,0,0,0,64,0,64,Molise,ITF2
2021-01-16,PF/BT,14000200,P.O TIMOTEO- TERMOLI,MOL,70-79,1,0,0,1,0,0,0,1,0,1,Molise,ITF2
2021-01-16,PF/BT,14000301,P.O. ISERNIA,MOL,20-29,1,1,0,2,0,0,0,2,0,2,Molise,ITF2
2021-01-16,PF/BT,14000301,P.O. ISERNIA,MOL,30-39,1,0,0,1,0,0,0,1,0,1,Molise,ITF2
2021-01-16,PF/BT,14000301,P.O. ISERNIA,MOL,40-49,2,5,0,6,1,0,0,7,0,7,Molise,ITF2
2021-01-16,PF/BT,14000301,P.O. ISERNIA,MOL,50-59,8,18,0,26,0,0,0,26,0,26,Molise,ITF2
2021-01-16,PF/BT,14000301,P.O. ISERNIA,MOL,60-69,24,12,0,36,0,0,0,36,0,36,Molise,ITF2
2021-01-16,PF/BT,140201,CASA ALLOGGIO CIVITANOVA DEL SANNIO,MOL,50-59,0,3,0,0,0,3,0,3,0,3,Molise,ITF2
2021-01-16,PF/BT,140201,CASA ALLOGGIO CIVITANOVA DEL SANNIO,MOL,60-69,4,3,0,0,0,7,0,7,0,7,Molise,ITF2
2021-01-16,PF/BT,140201,CASA ALLOGGIO CIVITANOVA DEL SANNIO,MOL,70-79,2,4,0,0,0,6,0,6,0,6,Molise,ITF2
2021-01-16,PF/BT,140201,CASA ALLOGGIO CIVITANOVA DEL SANNIO,MOL,90+,0,1,0,0,0,1,0,1,0,1,Molise,ITF2
2021-01-16,PF/BT,140201,Casa Di Riposo Albergo Dei Nonni,MOL,20-29,1,0,0,0,1,0,0,1,0,1,Molise,ITF2
2021-01-16,PF/BT,140201,Casa Di Riposo Albergo Dei Nonni,MOL,40-49,0,2,0,0,1,1,0,2,0,2,Molise,ITF2
2021-01-16,PF/BT,140201,Casa Di Riposo Albergo Dei Nonni,MOL,50-59,1,2,0,0,2,1,0,3,0,3,Molise,ITF2
2021-01-16,PF/BT,140201,Casa Di Riposo Albergo Dei Nonni,MOL,60-69,0,1,0,0,0,1,0,1,0,1,Molise,ITF2
2021-01-16,PF/BT,140201,Casa Di Riposo Albergo Dei Nonni,MOL,70-79,0,4,0,0,0,4,0,4,0,4,Molise,ITF2
2021-01-16,PF/BT,140201,Casa Di Riposo Albergo Dei Nonni,MOL,80-89,3,10,0,0,0,13,0,13,0,13,Molise,ITF2
2021-01-16,PF/BT,140201,Casa Di Riposo Albergo Dei Nonni,MOL,90+,3,3,0,0,0,6,0,6,0,6,Molise,ITF2
2021-01-16,PF/BT,140201,Casa Di Riposo Il Giardino Dei Gelsi,MOL,60-69,1,1,0,0,0,2,0,2,0,2,Molise,ITF2
2021-01-16,PF/BT,140201,Casa Di Riposo Il Giardino Dei Gelsi,MOL,70-79,3,3,0,0,0,6,0,6,0,6,Molise,ITF2
2021-01-16,PF/BT,140201,Casa Di Riposo Il Giardino Dei Gelsi,MOL,80-89,1,4,0,0,0,5,0,5,0,5,Molise,ITF2
2021-01-16,PF/BT,140201,Casa Di Riposo Il Giardino Dei Gelsi,MOL,90+,2,4,0,0,0,6,0,6,0,6,Molise,ITF2
2021-01-16,PF/BT,140201,Casa Di Riposo Villa Serena,MOL,70-79,0,1,0,0,0,1,0,1,0,1,Molise,ITF2
2021-01-16,PF/BT,140201,Casa Di Riposo Villa Serena,MOL,80-89,0,9,0,0,0,9,0,9,0,9,Molise,ITF2
2021-01-16,PF/BT,140201,Casa Di Riposo Villa Serena,MOL,90+,0,8,0,0,0,8,0,8,0,8,Molise,ITF2
2021-01-16,PF/BT,140201,Istituto Capozio R.A.,MOL,30-39,0,2,0,0,1,1,0,2,0,2,Molise,ITF2
2021-01-16,PF/BT,140201,Istituto Capozio R.A.,MOL,70-79,0,1,0,0,0,1,0,1,0,1,Molise,ITF2
2021-01-16,PF/BT,140201,Istituto Capozio R.A.,MOL,80-89,0,5,0,0,0,5,0,5,0,5,Molise,ITF2
2021-01-16,PF/BT,140201,Istituto Capozio R.A.,MOL,90+,0,10,0,0,1,9,0,10,0,10,Molise,ITF2
2021-01-16,PF/BT,140201,Istituto Geriadrico Sant'Anna,MOL,20-29,0,1,0,0,1,0,0,1,0,1,Molise,ITF2
2021-01-16,PF/BT,140201,Istituto Geriadrico Sant'Anna,MOL,30-39,0,1,0,0,1,0,0,1,0,1,Molise,ITF2
2021-01-16,PF/BT,140201,Istituto Geriadrico Sant'Anna,MOL,40-49,1,1,0,1,0,1,0,2,0,2,Molise,ITF2
2021-01-16,PF/BT,140201,Istituto Geriadrico Sant'Anna,MOL,50-59,0,3,0,0,2,1,0,3,0,3,Molise,ITF2
2021-01-16,PF/BT,140201,Istituto Geriadrico Sant'Anna,MOL,70-79,2,1,0,0,0,3,0,3,0,3,Molise,ITF2
2021-01-16,PF/BT,140201,Istituto Geriadrico Sant'Anna,MOL,80-89,2,9,0,0,0,11,0,11,0,11,Molise,ITF2
2021-01-16,PF/BT,140201,Istituto Geriadrico Sant'Anna,MOL,90+,2,1,0,0,0,3,0,3,0,3,Molise,ITF2
2021-01-16,PF/BT,140201,Villa Rosa,MOL,50-59,0,1,0,0,0,1,0,1,0,1,Molise,ITF2
2021-01-16,PF/BT,140201,Villa Rosa,MOL,60-69,1,2,0,0,0,3,0,3,0,3,Molise,ITF2
2021-01-16,PF/BT,140201,Villa Rosa,MOL,70-79,1,2,0,0,0,3,0,3,0,3,Molise,ITF2
2021-01-16,PF/BT,140201,Villa Rosa,MOL,80-89,3,14,0,0,0,17,0,17,0,17,Molise,ITF2
2021-01-16,PF/BT,140201,Villa Rosa,MOL,90+,1,5,0,0,0,6,0,6,0,6,Molise,ITF2
2021-01-17,PF/BT,14000301,P.O. ISERNIA,MOL,30-39,0,1,0,1,0,0,0,1,0,1,Molise,ITF2
2021-01-17,PF/BT,14000301,P.O. ISERNIA,MOL,40-49,2,4,0,6,0,0,0,6,0,6,Molise,ITF2
2021-01-17,PF/BT,14000301,P.O. ISERNIA,MOL,50-59,8,8,0,16,0,0,0,16,0,16,Molise,ITF2
2021-01-17,PF/BT,14000301,P.O. ISERNIA,MOL,60-69,12,12,0,24,0,0,0,24,0,24,Molise,ITF2
2021-01-17,PF/BT,14000301,P.O. ISERNIA,MOL,70-79,1,0,0,1,0,0,0,1,0,1,Molise,ITF2
