TML_DTA_SOMM,TML_VAX_FORNITORE,TML_COD_STRUTTURA,TML_DES_STRUTTURA,TML_AREA,TML_FASCIA_ETA,TML_SESSO_M,TML_SESSO_F,TML_GRAVIDANZA,TML_CAT_OSS,TML_CAT_PERSONALE,TML_CAT_RSA_OSPITI,TML_CAT_ALTRO,TML_DOSE_1,TML_DOSE_2,TML_TOT_SOMM,TML_REGIONE,TML_NUTS
2020-12-27,PF/BT,200036,P.O. A. BUSINCO - AOB,SAR,20-29,0,1,0,1,0,0,0,1,0,1,Sardegna,ITG2
2020-12-27,PF/BT,200036,P.O. A. BUSINCO - AOB,SAR,30-39,0,3,0,3,0,0,0,3,0,3,Sardegna,ITG2
2020-12-27,PF/BT,200036,P.O. A. BUSINCO - AOB,SAR,40-49,2,3,0,5,0,0,0,5,0,5,Sardegna,ITG2
2020-12-27,PF/BT,200036,P.O. A. BUSINCO - AOB,SAR,50-59,6,5,0,11,0,0,0,11,0,11,Sardegna,ITG2
2020-12-27,PF/BT,200036,P.O. A. BUSINCO - AOB,SAR,60-69,6,4,0,10,0,0,0,10,0,10,Sardegna,ITG2
2020-12-27,PF/BT,200904,P.O. SAN MICHELE - AOB,SAR,20-29,0,4,0,4,0,0,0,4,0,4,Sardegna,ITG2
2020-12-27,PF/BT,200904,P.O. SAN MICHELE - AOB,SAR,40-49,1,4,0,5,0,0,0,5,0,5,Sardegna,ITG2
2020-12-27,PF/BT,200904,P.O. SAN MICHELE - AOB,SAR,50-59,6,3,0,9,0,0,0,9,0,9,Sardegna,ITG2
2020-12-27,PF/BT,200904,P.O. SAN MICHELE - AOB,SAR,60-69,12,4,0,16,0,0,0,16,0,16,Sardegna,ITG2
2020-12-27,PF/BT,200904,P.O. SAN MICHELE - AOB,SAR,70-79,1,0,0,1,0,0,0,1,0,1,Sardegna,ITG2
2020-12-28,PF/BT,200036,P.O. A. BUSINCO - AOB,SAR,20-29,0,1,0,1,0,0,0,1,0,1,Sardegna,ITG2
2020-12-28,PF/BT,200036,P.O. A. BUSINCO - AOB,SAR,30-39,0,1,0,1,0,0,0,1,0,1,Sardegna,ITG2
2020-12-28,PF/BT,200036,P.O. A. BUSINCO - AOB,SAR,40-49,0,7,0,7,0,0,0,7,0,7,Sardegna,ITG2
2020-12-28,PF/BT,200036,P.O. A. BUSINCO - AOB,SAR,50-59,1,8,0,9,0,0,0,9,0,9,Sardegna,ITG2
2020-12-28,PF/BT,200036,P.O. A. BUSINCO - AOB,SAR,60-69,4,8,0,12,0,0,0,12,0,12,Sardegna,ITG2
2020-12-28,PF/BT,200904,P.O. SAN MICHELE - AOB,SAR,30-39,3,1,0,4,0,0,0,4,0,4,Sardegna,ITG2
2020-12-28,PF/BT,200904,P.O. SAN MICHELE - AOB,SAR,40-49,8,4,0,12,0,0,0,12,0,12,Sardegna,ITG2
2020-12-28,PF/BT,200904,P.O. SAN MICHELE - AOB,SAR,50-59,8,7,0,15,0,0,0,15,0,15,Sardegna,ITG2
2020-12-28,PF/BT,200904,P.O. SAN MICHELE - AOB,SAR,60-69,1,3,0,4,0,0,0,4,0,4,Sardegna,ITG2
2020-12-29,PF/BT,200904,P.O. SAN MICHELE - AOB,SAR,20-29,2,1,0,3,0,0,0,3,0,3,Sardegna,ITG2
2020-12-29,PF/BT,200904,P.O. SAN MICHELE - AOB,SAR,30-39,1,2,0,3,0,0,0,3,0,3,Sardegna,ITG2
2020-12-29,PF/BT,200904,P.O. SAN MICHELE - AOB,SAR,40-49,6,4,0,10,0,0,0,10,0,10,Sardegna,ITG2
2020-12-29,PF/BT,200904,P.O. SAN MICHELE - AOB,SAR,50-59,8,11,0,18,1,0,0,19,0,19,Sardegna,ITG2
2020-12-29,PF/BT,200904,P.O. SAN MICHELE - AOB,SAR,60-69,12,3,0,15,0,0,0,15,0,15,Sardegna,ITG2
2020-12-31,PF/BT,200905,AZIENDA OSPEDALIERO UNIVERSITARIA SS,SAR,30-39,0,1,0,1,0,0,0,1,0,1,Sardegna,ITG2
2020-12-31,PF/BT,200905,AZIENDA OSPEDALIERO UNIVERSITARIA SS,SAR,40-49,1,2,0,2,1,0,0,3,0,3,Sardegna,ITG2
2020-12-31,PF/BT,200905,AZIENDA OSPEDALIERO UNIVERSITARIA SS,SAR,50-59,2,5,0,3,3,0,1,7,0,7,Sardegna,ITG2
2020-12-31,PF/BT,200905,AZIENDA OSPEDALIERO UNIVERSITARIA SS,SAR,60-69,1,0,0,1,0,0,0,1,0,1,Sardegna,ITG2
2020-12-31,PF/BT,200906,A.O.U. Cagliari,SAR,30-39,1,1,0,2,0,0,0,2,0,2,Sardegna,ITG2
2020-12-31,PF/BT,200906,A.O.U. Cagliari,SAR,40-49,1,1,0,2,0,0,0,2,0,2,Sardegna,ITG2
2020-12-31,PF/BT,200906,A.O.U. Cagliari,SAR,50-59,4,5,0,9,0,0,0,9,0,9,Sardegna,ITG2
2020-12-31,PF/BT,200906,A.O.U. Cagliari,SAR,60-69,5,1,0,6,0,0,0,6,0,6,Sardegna,ITG2
2020-12-31,PF/BT,200906,A.O.U. Cagliari,SAR,70-79,1,0,0,1,0,0,0,1,0,1,Sardegna,ITG2
2021-01-01,PF/BT,200025,P.O. R.BINAGHI CAGLIARI,SAR,20-29,1,0,0,1,0,0,0,1,0,1,Sardegna,ITG2
2021-01-01,PF/BT,200025,P.O. R.BINAGHI CAGLIARI,SAR,30-39,2,2,0,4,0,0,0,4,0,4,Sardegna,ITG2
2021-01-01,PF/BT,200025,P.O. R.BINAGHI CAGLIARI,SAR,40-49,3,5,0,8,0,0,0,8,0,8,Sardegna,ITG2
2021-01-01,PF/BT,200025,P.O. R.BINAGHI CAGLIARI,SAR,50-59,3,7,0,10,0,0,0,10,0,10,Sardegna,ITG2
2021-01-01,PF/BT,200025,P.O. R.BINAGHI CAGLIARI,SAR,60-69,7,0,0,7,0,0,0,7,0,7,Sardegna,ITG2
2021-01-02,PF/BT,200025,P.O. R.BINAGHI CAGLIARI,SAR,20-29,0,3,0,3,0,0,0,3,0,3,Sardegna,ITG2
2021-01-02,PF/BT,200025,P.O. R.BINAGHI CAGLIARI,SAR,30-39,1,5,0,6,0,0,0,6,0,6,Sardegna,ITG2
2021-01-02,PF/BT,200025,P.O. R.BINAGHI CAGLIARI,SAR,40-49,3,11,0,14,0,0,0,14,0,14,Sardegna,ITG2
2021-01-02,PF/BT,200025,P.O. R.BINAGHI CAGLIARI,SAR,50-59,10,15,0,25,0,0,0,25,0,25,Sardegna,ITG2
2021-01-02,PF/BT,200025,P.O. R.BINAGHI CAGLIARI,SAR,60-69,7,5,0,12,0,0,0,12,0,12,Sardegna,ITG2
2021-01-03,PF/BT,200025,P.O. R.BINAGHI CAGLIARI,SAR,20-29,2,7,0,9,0,0,0,9,0,9,Sardegna,ITG2
2021-01-03,PF/BT,200025,P.O. R.BINAGHI CAGLIARI,SAR,30-39,5,6,0,11,0,0,0,11,0,11,Sardegna,ITG2
2021-01-03,PF/BT,200025,P.O. R.BINAGHI CAGLIARI,SAR,40-49,7,12,0,19,0,0,0,19,0,19,Sardegna,ITG2
2021-01-03,PF/BT,200025,P.O. R.BINAGHI CAGLIARI,SAR,50-59,10,16,0,26,0,0,0,26,0,26,Sardegna,ITG2
2021-01-03,PF/BT,200025,P.O. R.BINAGHI CAGLIARI,SAR,60-69,11,13,0,23,1,0,0,24,0,24,Sardegna,ITG2
2021-01-03,PF/BT,200025,P.O. R.BINAGHI CAGLIARI,SAR,70-79,1,0,0,1,0,0,0,1,0,1,Sardegna,ITG2
2021-01-04,PF/BT,200002,OSPEDALE CIVILE ALGHERO,SAR,20-29,3,19,0,22,0,0,0,22,0,22,Sardegna,ITG2
2021-01-04,PF/BT,200002,OSPEDALE CIVILE ALGHERO,SAR,30-39,18,24,0,42,0,0,0,42,0,42,Sardegna,ITG2
2021-01-04,PF/BT,200002,OSPEDALE CIVILE ALGHERO,SAR,40-49,10,38,0,48,0,0,0,48,0,48,Sardegna,ITG2
2021-01-04,PF/BT,200002,OSPEDALE CIVILE ALGHERO,SAR,50-59,12,34,0,45,1,0,0,46,0,46,Sardegna,ITG2
2021-01-04,PF/BT,200002,OSPEDALE CIVILE ALGHERO,SAR,60-69,14,8,0,22,0,0,0,22,0,22,Sardegna,ITG2
2021-01-04,PF/BT,200025,P.O. R.BINAGHI CAGLIARI,SAR,20-29,1,2,0,2,1,0,0,3,0,3,Sardegna,ITG2
2021-01-04,PF/BT,200025,P.O. R.BINAGHI CAGLIARI,SAR,30-39,4,14,0,18,0,0,0,18,0,18,Sardegna,ITG2
2021-01-04,PF/BT,200025,P.O. R.BINAGHI CAGLIARI,SAR,40-49,2,9,0,8,3,0,0,11,0,11,Sardegna,ITG2
2021-01-04,PF/BT,200025,P.O. R.BINAGHI CAGLIARI,SAR,50-59,2,16,0,16,2,0,0,18,0,18,Sardegna,ITG2
2021-01-04,PF/BT,200025,P.O. R.BINAGHI CAGLIARI,SAR,60-69,4,6,0,10,0,0,0,10,0,10,Sardegna,ITG2
2021-01-04,PF/BT,200026,P.O. MARINO CAGLIARI,SAR,40-49,2,1,0,2,1,0,0,3,0,3,Sardegna,ITG2
2021-01-04,PF/BT,200026,P.O. MARINO CAGLIARI,SAR,50-59,4,3,0,5,2,0,0,7,0,7,Sardegna,ITG2
2021-01-04,PF/BT,200026,P.O. MARINO CAGLIARI,SAR,60-69,4,4,0,8,0,0,0,8,0,8,Sardegna,ITG2
2021-01-04,PF/BT,200031,P.O. SS. TRINITA` CAGLIARI,SAR,30-39,3,1,0,3,1,0,0,4,0,4,Sardegna,ITG2
2021-01-04,PF/BT,200031,P.O. SS. TRINITA` CAGLIARI,SAR,40-49,1,3,0,4,0,0,0,4,0,4,Sardegna,ITG2
2021-01-04,PF/BT,200031,P.O. SS. TRINITA` CAGLIARI,SAR,50-59,5,4,0,7,2,0,0,9,0,9,Sardegna,ITG2
2021-01-04,PF/BT,200031,P.O. SS. TRINITA` CAGLIARI,SAR,60-69,4,3,0,5,2,0,0,7,0,7,Sardegna,ITG2
2021-01-04,PF/BT,200904,P.O. SAN MICHELE - AOB,SAR,20-29,0,1,0,1,0,0,0,1,0,1,Sardegna,ITG2
2021-01-04,PF/BT,200904,P.O. SAN MICHELE - AOB,SAR,30-39,2,1,0,3,0,0,0,3,0,3,Sardegna,ITG2
2021-01-04,PF/BT,200904,P.O. SAN MICHELE - AOB,SAR,40-49,2,1,0,3,0,0,0,3,0,3,Sardegna,ITG2
2021-01-04,PF/BT,200904,P.O. SAN MICHELE - AOB,SAR,50-59,2,6,0,8,0,0,0,8,0,8,Sardegna,ITG2
2021-01-04,PF/BT,200904,P.O. SAN MICHELE - AOB,SAR,60-69,3,2,0,5,0,0,0,5,0,5,Sardegna,ITG2
2021-01-04,PF/BT,200905,AZIENDA OSPEDALIERO UNIVERSITARIA SS,SAR,20-29,4,8,0,12,0,0,0,12,0,12,Sardegna,ITG2
2021-01-04,PF/BT,200905,AZIENDA OSPEDALIERO UNIVERSITARIA SS,SAR,30-39,18,22,0,39,1,0,0,40,0,40,Sardegna,ITG2
2021-01-04,PF/BT,200905,AZIENDA OSPEDALIERO UNIVERSITARIA SS,SAR,40-49,11,22,0,31,1,0,1,33,0,33,Sardegna,ITG2
2021-01-04,PF/BT,200905,AZIENDA OSPEDALIERO UNIVERSITARIA SS,SAR,50-59,14,23,0,35,2,0,0,37,0,37,Sardegna,ITG2
2021-01-04,PF/BT,200905,AZIENDA OSPEDALIERO UNIVERSITARIA SS,SAR,60-69,10,6,0,16,0,0,0,16,0,16,Sardegna,ITG2
2021-01-04,PF/BT,200905,AZIENDA OSPEDALIERO UNIVERSITARIA SS,SAR,90+,1,0,0,1,0,0,0,1,0,1,Sardegna,ITG2
2021-01-04,PF/BT,200906,A.O.U. Cagliari,SAR,20-29,2,8,0,10,0,0,0,10,0,10,Sardegna,ITG2
2021-01-04,PF/BT,200906,A.O.U. Cagliari,SAR,30-39,10,12,0,21,1,0,0,22,0,22,Sardegna,ITG2
2021-01-04,PF/BT,200906,A.O.U. Cagliari,SAR,40-49,9,18,0,27,0,0,0,27,0,27,Sardegna,ITG2
2021-01-04,PF/BT,200906,A.O.U. Cagliari,SAR,50-59,19,24,0,43,0,0,0,43,0,43,Sardegna,ITG2
2021-01-04,PF/BT,200906,A.O.U. Cagliari,SAR,60-69,12,18,0,30,0,0,0,30,0,30,Sardegna,ITG2
2021-01-05,PF/BT,200006,P.O. PAOLO DETTORI - TEMPIO P.,SAR,30-39,1,2,0,3,0,0,0,3,0,3,Sardegna,ITG2
2021-01-05,PF/BT,200006,P.O. PAOLO DETTORI - TEMPIO P.,SAR,40-49,4,10,0,13,1,0,0,14,0,14,Sardegna,ITG2
2021-01-05,PF/BT,200006,P.O. PAOLO DETTORI - TEMPIO P.,SAR,50-59,4,5,0,8,1,0,0,9,0,9,Sardegna,ITG2
2021-01-05,PF/BT,200006,P.O. PAOLO DETTORI - TEMPIO P.,SAR,60-69,3,1,0,4,0,0,0,4,0,4,Sardegna,ITG2
2021-01-05,PF/BT,200012,P.O.  GIOVANNI PAOLO II  OLBIA,SAR,20-29,0,3,0,3,0,0,0,3,0,3,Sardegna,ITG2
2021-01-05,PF/BT,200012,P.O.  GIOVANNI PAOLO II  OLBIA,SAR,30-39,9,14,0,23,0,0,0,23,0,23,Sardegna,ITG2
2021-01-05,PF/BT,200012,P.O.  GIOVANNI PAOLO II  OLBIA,SAR,40-49,11,26,0,37,0,0,0,37,0,37,Sardegna,ITG2
2021-01-05,PF/BT,200012,P.O.  GIOVANNI PAOLO II  OLBIA,SAR,50-59,6,32,0,38,0,0,0,38,0,38,Sardegna,ITG2
2021-01-05,PF/BT,200012,P.O.  GIOVANNI PAOLO II  OLBIA,SAR,60-69,8,11,0,19,0,0,0,19,0,19,Sardegna,ITG2
2021-01-05,PF/BT,200025,P.O. R.BINAGHI CAGLIARI,SAR,20-29,8,9,0,10,7,0,0,17,0,17,Sardegna,ITG2
2021-01-05,PF/BT,200025,P.O. R.BINAGHI CAGLIARI,SAR,30-39,9,10,0,13,6,0,0,19,0,19,Sardegna,ITG2
2021-01-05,PF/BT,200025,P.O. R.BINAGHI CAGLIARI,SAR,40-49,11,10,0,15,6,0,0,21,0,21,Sardegna,ITG2
2021-01-05,PF/BT,200025,P.O. R.BINAGHI CAGLIARI,SAR,50-59,15,18,0,27,6,0,0,33,0,33,Sardegna,ITG2
2021-01-05,PF/BT,200025,P.O. R.BINAGHI CAGLIARI,SAR,60-69,10,8,0,15,3,0,0,18,0,18,Sardegna,ITG2
2021-01-05,PF/BT,200026,P.O. MARINO CAGLIARI,SAR,20-29,1,2,0,2,1,0,0,3,0,3,Sardegna,ITG2
2021-01-05,PF/BT,200026,P.O. MARINO CAGLIARI,SAR,30-39,0,6,0,6,0,0,0,6,0,6,Sardegna,ITG2
2021-01-05,PF/BT,200026,P.O. MARINO CAGLIARI,SAR,40-49,5,5,0,10,0,0,0,10,0,10,Sardegna,ITG2
2021-01-05,PF/BT,200026,P.O. MARINO CAGLIARI,SAR,50-59,6,19,0,25,0,0,0,25,0,25,Sardegna,ITG2
2021-01-05,PF/BT,200026,P.O. MARINO CAGLIARI,SAR,60-69,5,5,0,9,1,0,0,10,0,10,Sardegna,ITG2
2021-01-05,PF/BT,200031,P.O. SS. TRINITA` CAGLIARI,SAR,20-29,1,2,0,3,0,0,0,3,0,3,Sardegna,ITG2
2021-01-05,PF/BT,200031,P.O. SS. TRINITA` CAGLIARI,SAR,30-39,6,6,0,12,0,0,0,12,0,12,Sardegna,ITG2
2021-01-05,PF/BT,200031,P.O. SS. TRINITA` CAGLIARI,SAR,40-49,1,13,0,14,0,0,0,14,0,14,Sardegna,ITG2
2021-01-05,PF/BT,200031,P.O. SS. TRINITA` CAGLIARI,SAR,50-59,4,17,0,21,0,0,0,21,0,21,Sardegna,ITG2
2021-01-05,PF/BT,200031,P.O. SS. TRINITA` CAGLIARI,SAR,60-69,6,4,0,10,0,0,0,10,0,10,Sardegna,ITG2
2021-01-05,PF/BT,200052,P.O. SAN MARTINO ORISTANO,SAR,20-29,1,1,0,2,0,0,0,2,0,2,Sardegna,ITG2
2021-01-05,PF/BT,200052,P.O. SAN MARTINO ORISTANO,SAR,30-39,3,7,0,10,0,0,0,10,0,10,Sardegna,ITG2
2021-01-05,PF/BT,200052,P.O. SAN MARTINO ORISTANO,SAR,40-49,5,17,0,22,0,0,0,22,0,22,Sardegna,ITG2
2021-01-05,PF/BT,200052,P.O. SAN MARTINO ORISTANO,SAR,50-59,13,15,0,28,0,0,0,28,0,28,Sardegna,ITG2
2021-01-05,PF/BT,200052,P.O. SAN MARTINO ORISTANO,SAR,60-69,3,7,0,10,0,0,0,10,0,10,Sardegna,ITG2
2021-01-05,PF/BT,200904,P.O. SAN MICHELE - AOB,SAR,20-29,1,2,0,3,0,0,0,3,0,3,Sardegna,ITG2
2021-01-05,PF/BT,200904,P.O. SAN MICHELE - AOB,SAR,30-39,2,2,0,4,0,0,0,4,0,4,Sardegna,ITG2
2021-01-05,PF/BT,200904,P.O. SAN MICHELE - AOB,SAR,40-49,2,5,0,7,0,0,0,7,0,7,Sardegna,ITG2
2021-01-05,PF/BT,200904,P.O. SAN MICHELE - AOB,SAR,50-59,0,6,0,6,0,0,0,6,0,6,Sardegna,ITG2
2021-01-05,PF/BT,200904,P.O. SAN MICHELE - AOB,SAR,60-69,3,0,0,3,0,0,0,3,0,3,Sardegna,ITG2
2021-01-05,PF/BT,200905,AZIENDA OSPEDALIERO UNIVERSITARIA SS,SAR,20-29,6,18,0,24,0,0,0,24,0,24,Sardegna,ITG2
2021-01-05,PF/BT,200905,AZIENDA OSPEDALIERO UNIVERSITARIA SS,SAR,30-39,23,44,0,67,0,0,0,67,0,67,Sardegna,ITG2
2021-01-05,PF/BT,200905,AZIENDA OSPEDALIERO UNIVERSITARIA SS,SAR,40-49,19,62,0,81,0,0,0,81,0,81,Sardegna,ITG2
2021-01-05,PF/BT,200905,AZIENDA OSPEDALIERO UNIVERSITARIA SS,SAR,50-59,15,45,0,59,0,0,1,60,0,60,Sardegna,ITG2
2021-01-05,PF/BT,200905,AZIENDA OSPEDALIERO UNIVERSITARIA SS,SAR,60-69,10,16,0,23,0,0,3,26,0,26,Sardegna,ITG2
2021-01-05,PF/BT,200906,A.O.U. Cagliari,SAR,20-29,3,5,0,8,0,0,0,8,0,8,Sardegna,ITG2
2021-01-05,PF/BT,200906,A.O.U. Cagliari,SAR,30-39,10,17,0,27,0,0,0,27,0,27,Sardegna,ITG2
2021-01-05,PF/BT,200906,A.O.U. Cagliari,SAR,40-49,12,28,0,40,0,0,0,40,0,40,Sardegna,ITG2
2021-01-05,PF/BT,200906,A.O.U. Cagliari,SAR,50-59,22,54,0,76,0,0,0,76,0,76,Sardegna,ITG2
2021-01-05,PF/BT,200906,A.O.U. Cagliari,SAR,60-69,26,21,0,47,0,0,0,47,0,47,Sardegna,ITG2
2021-01-06,PF/BT,10036,SISP-SASSARI,SAR,20-29,8,10,0,16,2,0,0,18,0,18,Sardegna,ITG2
2021-01-06,PF/BT,10036,SISP-SASSARI,SAR,30-39,12,16,0,27,1,0,0,28,0,28,Sardegna,ITG2
2021-01-06,PF/BT,10036,SISP-SASSARI,SAR,40-49,6,11,0,14,1,0,2,17,0,17,Sardegna,ITG2
2021-01-06,PF/BT,10036,SISP-SASSARI,SAR,50-59,4,8,0,10,0,0,2,12,0,12,Sardegna,ITG2
2021-01-06,PF/BT,10036,SISP-SASSARI,SAR,60-69,14,13,0,21,2,0,4,27,0,27,Sardegna,ITG2
2021-01-06,PF/BT,200006,P.O. PAOLO DETTORI - TEMPIO P.,SAR,20-29,2,1,0,3,0,0,0,3,0,3,Sardegna,ITG2
2021-01-06,PF/BT,200006,P.O. PAOLO DETTORI - TEMPIO P.,SAR,30-39,3,8,0,11,0,0,0,11,0,11,Sardegna,ITG2
2021-01-06,PF/BT,200006,P.O. PAOLO DETTORI - TEMPIO P.,SAR,40-49,6,9,0,10,3,0,2,15,0,15,Sardegna,ITG2
2021-01-06,PF/BT,200006,P.O. PAOLO DETTORI - TEMPIO P.,SAR,50-59,11,17,0,18,7,0,3,28,0,28,Sardegna,ITG2
2021-01-06,PF/BT,200006,P.O. PAOLO DETTORI - TEMPIO P.,SAR,60-69,7,8,0,11,3,0,1,15,0,15,Sardegna,ITG2
2021-01-06,PF/BT,200011,P.O. PAOLO MERLO LA MADDALENA,SAR,20-29,0,1,0,1,0,0,0,1,0,1,Sardegna,ITG2
2021-01-06,PF/BT,200011,P.O. PAOLO MERLO LA MADDALENA,SAR,30-39,0,1,0,1,0,0,0,1,0,1,Sardegna,ITG2
2021-01-06,PF/BT,200011,P.O. PAOLO MERLO LA MADDALENA,SAR,40-49,4,4,0,7,1,0,0,8,0,8,Sardegna,ITG2
2021-01-06,PF/BT,200011,P.O. PAOLO MERLO LA MADDALENA,SAR,50-59,4,5,0,7,2,0,0,9,0,9,Sardegna,ITG2
2021-01-06,PF/BT,200011,P.O. PAOLO MERLO LA MADDALENA,SAR,60-69,4,2,0,6,0,0,0,6,0,6,Sardegna,ITG2
2021-01-06,PF/BT,200012,P.O.  GIOVANNI PAOLO II  OLBIA,SAR,20-29,3,5,0,8,0,0,0,8,0,8,Sardegna,ITG2
2021-01-06,PF/BT,200012,P.O.  GIOVANNI PAOLO II  OLBIA,SAR,30-39,12,33,0,45,0,0,0,45,0,45,Sardegna,ITG2
2021-01-06,PF/BT,200012,P.O.  GIOVANNI PAOLO II  OLBIA,SAR,40-49,12,27,0,38,1,0,0,39,0,39,Sardegna,ITG2
2021-01-06,PF/BT,200012,P.O.  GIOVANNI PAOLO II  OLBIA,SAR,50-59,10,37,0,47,0,0,0,47,0,47,Sardegna,ITG2
2021-01-06,PF/BT,200012,P.O.  GIOVANNI PAOLO II  OLBIA,SAR,60-69,10,7,0,17,0,0,0,17,0,17,Sardegna,ITG2
2021-01-06,PF/BT,200017,P.O.  SAN FRANCESCO,SAR,20-29,3,10,0,13,0,0,0,13,0,13,Sardegna,ITG2
2021-01-06,PF/BT,200017,P.O.  SAN FRANCESCO,SAR,30-39,7,17,0,24,0,0,0,24,0,24,Sardegna,ITG2
2021-01-06,PF/BT,200017,P.O.  SAN FRANCESCO,SAR,40-49,4,24,0,28,0,0,0,28,0,28,Sardegna,ITG2
2021-01-06,PF/BT,200017,P.O.  SAN FRANCESCO,SAR,50-59,6,34,0,40,0,0,0,40,0,40,Sardegna,ITG2
2021-01-06,PF/BT,200017,P.O.  SAN FRANCESCO,SAR,60-69,3,10,0,12,1,0,0,13,0,13,Sardegna,ITG2
2021-01-06,PF/BT,200025,P.O. R.BINAGHI CAGLIARI,SAR,20-29,8,18,0,20,6,0,0,26,0,26,Sardegna,ITG2
2021-01-06,PF/BT,200025,P.O. R.BINAGHI CAGLIARI,SAR,30-39,12,18,0,25,5,0,0,30,0,30,Sardegna,ITG2
2021-01-06,PF/BT,200025,P.O. R.BINAGHI CAGLIARI,SAR,40-49,15,26,0,32,9,0,0,41,0,41,Sardegna,ITG2
2021-01-06,PF/BT,200025,P.O. R.BINAGHI CAGLIARI,SAR,50-59,37,38,0,54,21,0,0,75,0,75,Sardegna,ITG2
2021-01-06,PF/BT,200025,P.O. R.BINAGHI CAGLIARI,SAR,60-69,27,14,0,32,9,0,0,41,0,41,Sardegna,ITG2
2021-01-06,PF/BT,200025,P.O. R.BINAGHI CAGLIARI,SAR,70-79,3,0,0,3,0,0,0,3,0,3,Sardegna,ITG2
2021-01-06,PF/BT,200026,P.O. MARINO CAGLIARI,SAR,20-29,2,4,0,6,0,0,0,6,0,6,Sardegna,ITG2
2021-01-06,PF/BT,200026,P.O. MARINO CAGLIARI,SAR,30-39,3,5,0,8,0,0,0,8,0,8,Sardegna,ITG2
2021-01-06,PF/BT,200026,P.O. MARINO CAGLIARI,SAR,40-49,4,5,0,9,0,0,0,9,0,9,Sardegna,ITG2
2021-01-06,PF/BT,200026,P.O. MARINO CAGLIARI,SAR,50-59,4,13,0,17,0,0,0,17,0,17,Sardegna,ITG2
2021-01-06,PF/BT,200026,P.O. MARINO CAGLIARI,SAR,60-69,4,4,0,8,0,0,0,8,0,8,Sardegna,ITG2
2021-01-06,PF/BT,200030,P.O.CTO,SAR,20-29,2,3,0,5,0,0,0,5,0,5,Sardegna,ITG2
2021-01-06,PF/BT,200030,P.O.CTO,SAR,30-39,2,9,0,10,1,0,0,11,0,11,Sardegna,ITG2
2021-01-06,PF/BT,200030,P.O.CTO,SAR,40-49,11,18,0,26,3,0,0,29,0,29,Sardegna,ITG2
2021-01-06,PF/BT,200030,P.O.CTO,SAR,50-59,16,35,0,46,5,0,0,51,0,51,Sardegna,ITG2
2021-01-06,PF/BT,200030,P.O.CTO,SAR,60-69,19,16,0,34,1,0,0,35,0,35,Sardegna,ITG2
2021-01-06,PF/BT,200031,P.O. SS. TRINITA` CAGLIARI,SAR,20-29,1,3,0,4,0,0,0,4,0,4,Sardegna,ITG2
2021-01-06,PF/BT,200031,P.O. SS. TRINITA` CAGLIARI,SAR,30-39,4,8,0,11,1,0,0,12,0,12,Sardegna,ITG2
2021-01-06,PF/BT,200031,P.O. SS. TRINITA` CAGLIARI,SAR,40-49,8,12,0,17,3,0,0,20,0,20,Sardegna,ITG2
2021-01-06,PF/BT,200031,P.O. SS. TRINITA` CAGLIARI,SAR,50-59,8,16,0,22,2,0,0,24,0,24,Sardegna,ITG2
2021-01-06,PF/BT,200031,P.O. SS. TRINITA` CAGLIARI,SAR,60-69,8,16,0,24,0,0,0,24,0,24,Sardegna,ITG2
2021-01-06,PF/BT,200034,PRESIDIO OSPEDALIERO N.S. DI BONARIA,SAR,20-29,0,2,0,2,0,0,0,2,0,2,Sardegna,ITG2
2021-01-06,PF/BT,200034,PRESIDIO OSPEDALIERO N.S. DI BONARIA,SAR,30-39,6,2,0,8,0,0,0,8,0,8,Sardegna,ITG2
2021-01-06,PF/BT,200034,PRESIDIO OSPEDALIERO N.S. DI BONARIA,SAR,40-49,2,9,0,11,0,0,0,11,0,11,Sardegna,ITG2
2021-01-06,PF/BT,200034,PRESIDIO OSPEDALIERO N.S. DI BONARIA,SAR,50-59,1,13,0,14,0,0,0,14,0,14,Sardegna,ITG2
2021-01-06,PF/BT,200034,PRESIDIO OSPEDALIERO N.S. DI BONARIA,SAR,60-69,4,3,0,7,0,0,0,7,0,7,Sardegna,ITG2
2021-01-06,PF/BT,200052,P.O. SAN MARTINO ORISTANO,SAR,20-29,2,4,0,6,0,0,0,6,0,6,Sardegna,ITG2
2021-01-06,PF/BT,200052,P.O. SAN MARTINO ORISTANO,SAR,30-39,3,22,0,25,0,0,0,25,0,25,Sardegna,ITG2
2021-01-06,PF/BT,200052,P.O. SAN MARTINO ORISTANO,SAR,40-49,9,13,0,22,0,0,0,22,0,22,Sardegna,ITG2
2021-01-06,PF/BT,200052,P.O. SAN MARTINO ORISTANO,SAR,50-59,7,19,0,26,0,0,0,26,0,26,Sardegna,ITG2
2021-01-06,PF/BT,200052,P.O. SAN MARTINO ORISTANO,SAR,60-69,5,6,0,11,0,0,0,11,0,11,Sardegna,ITG2
2021-01-06,PF/BT,200904,P.O. SAN MICHELE - AOB,SAR,20-29,3,10,0,13,0,0,0,13,0,13,Sardegna,ITG2
2021-01-06,PF/BT,200904,P.O. SAN MICHELE - AOB,SAR,30-39,14,30,0,44,0,0,0,44,0,44,Sardegna,ITG2
2021-01-06,PF/BT,200904,P.O. SAN MICHELE - AOB,SAR,40-49,17,33,0,50,0,0,0,50,0,50,Sardegna,ITG2
2021-01-06,PF/BT,200904,P.O. SAN MICHELE - AOB,SAR,50-59,14,31,0,45,0,0,0,45,0,45,Sardegna,ITG2
2021-01-06,PF/BT,200904,P.O. SAN MICHELE - AOB,SAR,60-69,3,9,0,12,0,0,0,12,0,12,Sardegna,ITG2
2021-01-06,PF/BT,200905,AZIENDA OSPEDALIERO UNIVERSITARIA SS,SAR,20-29,10,37,0,46,0,0,1,47,0,47,Sardegna,ITG2
2021-01-06,PF/BT,200905,AZIENDA OSPEDALIERO UNIVERSITARIA SS,SAR,30-39,26,44,0,67,0,0,3,70,0,70,Sardegna,ITG2
2021-01-06,PF/BT,200905,AZIENDA OSPEDALIERO UNIVERSITARIA SS,SAR,40-49,24,62,0,84,0,0,2,86,0,86,Sardegna,ITG2
2021-01-06,PF/BT,200905,AZIENDA OSPEDALIERO UNIVERSITARIA SS,SAR,50-59,20,67,0,86,0,0,1,87,0,87,Sardegna,ITG2
2021-01-06,PF/BT,200905,AZIENDA OSPEDALIERO UNIVERSITARIA SS,SAR,60-69,6,18,0,22,0,0,2,24,0,24,Sardegna,ITG2
2021-01-06,PF/BT,200905,AZIENDA OSPEDALIERO UNIVERSITARIA SS,SAR,80-89,1,0,0,1,0,0,0,1,0,1,Sardegna,ITG2
2021-01-06,PF/BT,200906,A.O.U. Cagliari,SAR,20-29,0,4,0,4,0,0,0,4,0,4,Sardegna,ITG2
2021-01-06,PF/BT,200906,A.O.U. Cagliari,SAR,30-39,5,1,0,6,0,0,0,6,0,6,Sardegna,ITG2
2021-01-06,PF/BT,200906,A.O.U. Cagliari,SAR,40-49,0,3,0,3,0,0,0,3,0,3,Sardegna,ITG2
2021-01-06,PF/BT,200906,A.O.U. Cagliari,SAR,50-59,3,7,0,10,0,0,0,10,0,10,Sardegna,ITG2
2021-01-06,PF/BT,200906,A.O.U. Cagliari,SAR,60-69,1,0,0,1,0,0,0,1,0,1,Sardegna,ITG2
2021-01-07,PF/BT,10036,SISP-SASSARI COVID,SAR,20-29,2,4,0,5,1,0,0,6,0,6,Sardegna,ITG2
2021-01-07,PF/BT,10036,SISP-SASSARI COVID,SAR,30-39,6,15,0,15,6,0,0,21,0,21,Sardegna,ITG2
2021-01-07,PF/BT,10036,SISP-SASSARI COVID,SAR,40-49,8,18,0,22,3,0,1,26,0,26,Sardegna,ITG2
2021-01-07,PF/BT,10036,SISP-SASSARI COVID,SAR,50-59,18,33,0,41,8,0,2,51,0,51,Sardegna,ITG2
2021-01-07,PF/BT,10036,SISP-SASSARI COVID,SAR,60-69,24,16,0,36,3,0,1,40,0,40,Sardegna,ITG2
2021-01-07,PF/BT,200002,OSPEDALE CIVILE ALGHERO,SAR,16-19,0,1,0,1,0,0,0,1,0,1,Sardegna,ITG2
2021-01-07,PF/BT,200002,OSPEDALE CIVILE ALGHERO,SAR,20-29,9,12,0,14,7,0,0,21,0,21,Sardegna,ITG2
2021-01-07,PF/BT,200002,OSPEDALE CIVILE ALGHERO,SAR,30-39,29,31,0,23,37,0,0,60,0,60,Sardegna,ITG2
2021-01-07,PF/BT,200002,OSPEDALE CIVILE ALGHERO,SAR,40-49,34,56,0,34,55,0,1,90,0,90,Sardegna,ITG2
2021-01-07,PF/BT,200002,OSPEDALE CIVILE ALGHERO,SAR,50-59,37,81,0,59,54,0,5,118,0,118,Sardegna,ITG2
2021-01-07,PF/BT,200002,OSPEDALE CIVILE ALGHERO,SAR,60-69,22,35,0,37,17,0,3,57,0,57,Sardegna,ITG2
2021-01-07,PF/BT,200002,OSPEDALE CIVILE ALGHERO,SAR,70-79,1,0,0,1,0,0,0,1,0,1,Sardegna,ITG2
2021-01-07,PF/BT,200003,OSPEDALE CIVILE OZIERI,SAR,20-29,6,3,0,9,0,0,0,9,0,9,Sardegna,ITG2
2021-01-07,PF/BT,200003,OSPEDALE CIVILE OZIERI,SAR,30-39,9,14,0,23,0,0,0,23,0,23,Sardegna,ITG2
2021-01-07,PF/BT,200003,OSPEDALE CIVILE OZIERI,SAR,40-49,8,17,0,18,7,0,0,25,0,25,Sardegna,ITG2
2021-01-07,PF/BT,200003,OSPEDALE CIVILE OZIERI,SAR,50-59,5,25,0,26,4,0,0,30,0,30,Sardegna,ITG2
2021-01-07,PF/BT,200003,OSPEDALE CIVILE OZIERI,SAR,60-69,9,6,0,13,2,0,0,15,0,15,Sardegna,ITG2
2021-01-07,PF/BT,200011,P.O. PAOLO MERLO LA MADDALENA,SAR,20-29,1,0,0,1,0,0,0,1,0,1,Sardegna,ITG2
2021-01-07,PF/BT,200011,P.O. PAOLO MERLO LA MADDALENA,SAR,40-49,1,2,0,3,0,0,0,3,0,3,Sardegna,ITG2
2021-01-07,PF/BT,200011,P.O. PAOLO MERLO LA MADDALENA,SAR,50-59,3,1,0,3,1,0,0,4,0,4,Sardegna,ITG2
2021-01-07,PF/BT,200011,P.O. PAOLO MERLO LA MADDALENA,SAR,60-69,1,2,0,3,0,0,0,3,0,3,Sardegna,ITG2
2021-01-07,PF/BT,200012,P.O.  GIOVANNI PAOLO II  OLBIA,SAR,20-29,4,9,0,13,0,0,0,13,0,13,Sardegna,ITG2
2021-01-07,PF/BT,200012,P.O.  GIOVANNI PAOLO II  OLBIA,SAR,30-39,20,40,0,60,0,0,0,60,0,60,Sardegna,ITG2
2021-01-07,PF/BT,200012,P.O.  GIOVANNI PAOLO II  OLBIA,SAR,40-49,24,42,0,66,0,0,0,66,0,66,Sardegna,ITG2
2021-01-07,PF/BT,200012,P.O.  GIOVANNI PAOLO II  OLBIA,SAR,50-59,23,59,0,82,0,0,0,82,0,82,Sardegna,ITG2
2021-01-07,PF/BT,200012,P.O.  GIOVANNI PAOLO II  OLBIA,SAR,60-69,14,17,0,31,0,0,0,31,0,31,Sardegna,ITG2
2021-01-07,PF/BT,200017,P.O.  SAN FRANCESCO,SAR,20-29,1,8,0,9,0,0,0,9,0,9,Sardegna,ITG2
2021-01-07,PF/BT,200017,P.O.  SAN FRANCESCO,SAR,30-39,3,18,0,21,0,0,0,21,0,21,Sardegna,ITG2
2021-01-07,PF/BT,200017,P.O.  SAN FRANCESCO,SAR,40-49,6,13,0,19,0,0,0,19,0,19,Sardegna,ITG2
2021-01-07,PF/BT,200017,P.O.  SAN FRANCESCO,SAR,50-59,4,7,0,11,0,0,0,11,0,11,Sardegna,ITG2
2021-01-07,PF/BT,200017,P.O.  SAN FRANCESCO,SAR,60-69,1,5,0,6,0,0,0,6,0,6,Sardegna,ITG2
2021-01-07,PF/BT,200019,P.O. NOSTRA SIGNORA DELLA MERCEDE,SAR,20-29,5,10,0,15,0,0,0,15,0,15,Sardegna,ITG2
2021-01-07,PF/BT,200019,P.O. NOSTRA SIGNORA DELLA MERCEDE,SAR,30-39,7,25,0,32,0,0,0,32,0,32,Sardegna,ITG2
2021-01-07,PF/BT,200019,P.O. NOSTRA SIGNORA DELLA MERCEDE,SAR,40-49,8,21,0,29,0,0,0,29,0,29,Sardegna,ITG2
2021-01-07,PF/BT,200019,P.O. NOSTRA SIGNORA DELLA MERCEDE,SAR,50-59,11,41,0,52,0,0,0,52,0,52,Sardegna,ITG2
2021-01-07,PF/BT,200019,P.O. NOSTRA SIGNORA DELLA MERCEDE,SAR,60-69,13,18,0,31,0,0,0,31,0,31,Sardegna,ITG2
2021-01-07,PF/BT,200019,P.O. NOSTRA SIGNORA DELLA MERCEDE,SAR,70-79,1,1,0,2,0,0,0,2,0,2,Sardegna,ITG2
2021-01-07,PF/BT,200025,P.O. R.BINAGHI CAGLIARI,SAR,20-29,16,37,0,47,6,0,0,53,0,53,Sardegna,ITG2
2021-01-07,PF/BT,200025,P.O. R.BINAGHI CAGLIARI,SAR,30-39,23,39,0,50,12,0,0,62,0,62,Sardegna,ITG2
2021-01-07,PF/BT,200025,P.O. R.BINAGHI CAGLIARI,SAR,40-49,16,45,0,48,13,0,0,61,0,61,Sardegna,ITG2
2021-01-07,PF/BT,200025,P.O. R.BINAGHI CAGLIARI,SAR,50-59,29,54,0,61,22,0,0,83,0,83,Sardegna,ITG2
2021-01-07,PF/BT,200025,P.O. R.BINAGHI CAGLIARI,SAR,60-69,16,18,0,22,12,0,0,34,0,34,Sardegna,ITG2
2021-01-07,PF/BT,200025,P.O. R.BINAGHI CAGLIARI,SAR,70-79,1,0,0,1,0,0,0,1,0,1,Sardegna,ITG2
2021-01-07,PF/BT,200026,P.O. MARINO CAGLIARI,SAR,20-29,3,4,0,6,1,0,0,7,0,7,Sardegna,ITG2
2021-01-07,PF/BT,200026,P.O. MARINO CAGLIARI,SAR,30-39,6,5,0,8,3,0,0,11,0,11,Sardegna,ITG2
2021-01-07,PF/BT,200026,P.O. MARINO CAGLIARI,SAR,40-49,9,13,0,17,5,0,0,22,0,22,Sardegna,ITG2
2021-01-07,PF/BT,200026,P.O. MARINO CAGLIARI,SAR,50-59,9,22,0,22,9,0,0,31,0,31,Sardegna,ITG2
2021-01-07,PF/BT,200026,P.O. MARINO CAGLIARI,SAR,60-69,8,5,0,9,4,0,0,13,0,13,Sardegna,ITG2
2021-01-07,PF/BT,200030,P.O.CTO,SAR,20-29,2,3,0,4,1,0,0,5,0,5,Sardegna,ITG2
2021-01-07,PF/BT,200030,P.O.CTO,SAR,30-39,1,2,0,2,1,0,0,3,0,3,Sardegna,ITG2
2021-01-07,PF/BT,200030,P.O.CTO,SAR,40-49,1,5,0,6,0,0,0,6,0,6,Sardegna,ITG2
2021-01-07,PF/BT,200030,P.O.CTO,SAR,50-59,8,13,0,20,1,0,0,21,0,21,Sardegna,ITG2
2021-01-07,PF/BT,200030,P.O.CTO,SAR,60-69,5,8,0,13,0,0,0,13,0,13,Sardegna,ITG2
2021-01-07,PF/BT,200031,P.O. SS. TRINITA` CAGLIARI,SAR,20-29,4,7,0,11,0,0,0,11,0,11,Sardegna,ITG2
2021-01-07,PF/BT,200031,P.O. SS. TRINITA` CAGLIARI,SAR,30-39,8,12,0,18,2,0,0,20,0,20,Sardegna,ITG2
2021-01-07,PF/BT,200031,P.O. SS. TRINITA` CAGLIARI,SAR,40-49,9,19,0,23,5,0,0,28,0,28,Sardegna,ITG2
2021-01-07,PF/BT,200031,P.O. SS. TRINITA` CAGLIARI,SAR,50-59,12,34,0,38,8,0,0,46,0,46,Sardegna,ITG2
2021-01-07,PF/BT,200031,P.O. SS. TRINITA` CAGLIARI,SAR,60-69,12,9,0,18,3,0,0,21,0,21,Sardegna,ITG2
2021-01-07,PF/BT,200034,PRESIDIO OSPEDALIERO N.S. DI BONARIA,SAR,20-29,1,3,0,4,0,0,0,4,0,4,Sardegna,ITG2
2021-01-07,PF/BT,200034,PRESIDIO OSPEDALIERO N.S. DI BONARIA,SAR,30-39,1,14,0,15,0,0,0,15,0,15,Sardegna,ITG2
2021-01-07,PF/BT,200034,PRESIDIO OSPEDALIERO N.S. DI BONARIA,SAR,40-49,7,13,0,20,0,0,0,20,0,20,Sardegna,ITG2
2021-01-07,PF/BT,200034,PRESIDIO OSPEDALIERO N.S. DI BONARIA,SAR,50-59,13,29,0,42,0,0,0,42,0,42,Sardegna,ITG2
2021-01-07,PF/BT,200034,PRESIDIO OSPEDALIERO N.S. DI BONARIA,SAR,60-69,11,4,0,15,0,0,0,15,0,15,Sardegna,ITG2
2021-01-07,PF/BT,200035,P.O. SAN MARCELLINO MURAVERA,SAR,20-29,0,1,0,1,0,0,0,1,0,1,Sardegna,ITG2
2021-01-07,PF/BT,200035,P.O. SAN MARCELLINO MURAVERA,SAR,30-39,3,3,0,6,0,0,0,6,0,6,Sardegna,ITG2
2021-01-07,PF/BT,200035,P.O. SAN MARCELLINO MURAVERA,SAR,40-49,1,4,0,3,2,0,0,5,0,5,Sardegna,ITG2
2021-01-07,PF/BT,200035,P.O. SAN MARCELLINO MURAVERA,SAR,50-59,4,6,0,7,3,0,0,10,0,10,Sardegna,ITG2
2021-01-07,PF/BT,200035,P.O. SAN MARCELLINO MURAVERA,SAR,60-69,4,4,0,7,1,0,0,8,0,8,Sardegna,ITG2
2021-01-07,PF/BT,200036,OSPEDALE BUSINCO,SAR,20-29,0,4,0,4,0,0,0,4,0,4,Sardegna,ITG2
2021-01-07,PF/BT,200036,OSPEDALE BUSINCO,SAR,30-39,5,10,0,13,2,0,0,15,0,15,Sardegna,ITG2
2021-01-07,PF/BT,200036,OSPEDALE BUSINCO,SAR,40-49,4,20,0,24,0,0,0,24,0,24,Sardegna,ITG2
2021-01-07,PF/BT,200036,OSPEDALE BUSINCO,SAR,50-59,10,40,0,50,0,0,0,50,0,50,Sardegna,ITG2
2021-01-07,PF/BT,200036,OSPEDALE BUSINCO,SAR,60-69,9,16,0,25,0,0,0,25,0,25,Sardegna,ITG2
2021-01-07,PF/BT,200052,P.O. SAN MARTINO ORISTANO,SAR,20-29,0,5,0,5,0,0,0,5,0,5,Sardegna,ITG2
2021-01-07,PF/BT,200052,P.O. SAN MARTINO ORISTANO,SAR,30-39,1,0,0,1,0,0,0,1,0,1,Sardegna,ITG2
2021-01-07,PF/BT,200052,P.O. SAN MARTINO ORISTANO,SAR,40-49,0,2,0,2,0,0,0,2,0,2,Sardegna,ITG2
2021-01-07,PF/BT,200052,P.O. SAN MARTINO ORISTANO,SAR,50-59,0,6,0,6,0,0,0,6,0,6,Sardegna,ITG2
2021-01-07,PF/BT,200052,P.O. SAN MARTINO ORISTANO,SAR,60-69,3,1,0,3,0,0,1,4,0,4,Sardegna,ITG2
2021-01-07,PF/BT,200904,P.O. SAN MICHELE - AOB,SAR,20-29,10,14,0,24,0,0,0,24,0,24,Sardegna,ITG2
2021-01-07,PF/BT,200904,P.O. SAN MICHELE - AOB,SAR,30-39,35,44,0,79,0,0,0,79,0,79,Sardegna,ITG2
2021-01-07,PF/BT,200904,P.O. SAN MICHELE - AOB,SAR,40-49,20,42,0,62,0,0,0,62,0,62,Sardegna,ITG2
2021-01-07,PF/BT,200904,P.O. SAN MICHELE - AOB,SAR,50-59,38,63,0,101,0,0,0,101,0,101,Sardegna,ITG2
2021-01-07,PF/BT,200904,P.O. SAN MICHELE - AOB,SAR,60-69,18,29,0,47,0,0,0,47,0,47,Sardegna,ITG2
2021-01-07,PF/BT,200905,AOU DI SASSARI,SAR,20-29,25,34,1,59,0,0,0,59,0,59,Sardegna,ITG2
2021-01-07,PF/BT,200905,AOU DI SASSARI,SAR,30-39,42,75,1,110,0,0,7,117,0,117,Sardegna,ITG2
2021-01-07,PF/BT,200905,AOU DI SASSARI,SAR,40-49,50,115,1,149,0,0,16,165,0,165,Sardegna,ITG2
2021-01-07,PF/BT,200905,AOU DI SASSARI,SAR,50-59,45,116,1,142,0,0,19,161,0,161,Sardegna,ITG2
2021-01-07,PF/BT,200905,AOU DI SASSARI,SAR,60-69,23,41,1,63,0,0,1,64,0,64,Sardegna,ITG2
2021-01-07,PF/BT,200905,AOU DI SASSARI,SAR,70-79,1,0,1,0,0,0,1,1,0,1,Sardegna,ITG2
2021-01-07,PF/BT,200906,"AOU CAGLIARI P.O. “D. CASULA""",SAR,20-29,0,12,0,12,0,0,0,12,0,12,Sardegna,ITG2
2021-01-07,PF/BT,200906,"AOU CAGLIARI P.O. “D. CASULA""",SAR,30-39,17,27,0,44,0,0,0,44,0,44,Sardegna,ITG2
2021-01-07,PF/BT,200906,"AOU CAGLIARI P.O. “D. CASULA""",SAR,40-49,23,42,0,65,0,0,0,65,0,65,Sardegna,ITG2
2021-01-07,PF/BT,200906,"AOU CAGLIARI P.O. “D. CASULA""",SAR,50-59,37,81,0,118,0,0,0,118,0,118,Sardegna,ITG2
2021-01-07,PF/BT,200906,"AOU CAGLIARI P.O. “D. CASULA""",SAR,60-69,23,26,0,49,0,0,0,49,0,49,Sardegna,ITG2
2021-01-08,PF/BT,10036,SISP-SASSARI COVID,SAR,20-29,6,14,0,18,2,0,0,20,0,20,Sardegna,ITG2
2021-01-08,PF/BT,10036,SISP-SASSARI COVID,SAR,30-39,15,14,0,22,7,0,0,29,0,29,Sardegna,ITG2
2021-01-08,PF/BT,10036,SISP-SASSARI COVID,SAR,40-49,11,20,0,25,6,0,0,31,0,31,Sardegna,ITG2
2021-01-08,PF/BT,10036,SISP-SASSARI COVID,SAR,50-59,24,38,0,53,7,0,2,62,0,62,Sardegna,ITG2
2021-01-08,PF/BT,10036,SISP-SASSARI COVID,SAR,60-69,28,26,0,50,3,0,1,54,0,54,Sardegna,ITG2
2021-01-08,PF/BT,10036,SISP-SASSARI COVID,SAR,70-79,1,0,0,1,0,0,0,1,0,1,Sardegna,ITG2
2021-01-08,PF/BT,101,P.O. SAN FRANCESCO - AMBULATORIO NUORO,SAR,20-29,7,17,0,24,0,0,0,24,0,24,Sardegna,ITG2
2021-01-08,PF/BT,101,P.O. SAN FRANCESCO - AMBULATORIO NUORO,SAR,30-39,10,32,0,41,1,0,0,42,0,42,Sardegna,ITG2
2021-01-08,PF/BT,101,P.O. SAN FRANCESCO - AMBULATORIO NUORO,SAR,40-49,17,26,0,42,1,0,0,43,0,43,Sardegna,ITG2
2021-01-08,PF/BT,101,P.O. SAN FRANCESCO - AMBULATORIO NUORO,SAR,50-59,27,60,0,84,3,0,0,87,0,87,Sardegna,ITG2
2021-01-08,PF/BT,101,P.O. SAN FRANCESCO - AMBULATORIO NUORO,SAR,60-69,12,14,0,23,3,0,0,26,0,26,Sardegna,ITG2
2021-01-08,PF/BT,120010, P.O. GIOVANNI PAOLO II - OLBIA,SAR,20-29,1,1,0,2,0,0,0,2,0,2,Sardegna,ITG2
2021-01-08,PF/BT,120010, P.O. GIOVANNI PAOLO II - OLBIA,SAR,30-39,3,7,0,10,0,0,0,10,0,10,Sardegna,ITG2
2021-01-08,PF/BT,120010, P.O. GIOVANNI PAOLO II - OLBIA,SAR,40-49,1,2,0,3,0,0,0,3,0,3,Sardegna,ITG2
2021-01-08,PF/BT,120010, P.O. GIOVANNI PAOLO II - OLBIA,SAR,50-59,5,7,0,12,0,0,0,12,0,12,Sardegna,ITG2
2021-01-08,PF/BT,120010, P.O. GIOVANNI PAOLO II - OLBIA,SAR,60-69,2,1,0,3,0,0,0,3,0,3,Sardegna,ITG2
2021-01-08,PF/BT,200003,OSPEDALE CIVILE OZIERI,SAR,20-29,3,11,0,14,0,0,0,14,0,14,Sardegna,ITG2
2021-01-08,PF/BT,200003,OSPEDALE CIVILE OZIERI,SAR,30-39,4,11,0,15,0,0,0,15,0,15,Sardegna,ITG2
2021-01-08,PF/BT,200003,OSPEDALE CIVILE OZIERI,SAR,40-49,6,24,0,30,0,0,0,30,0,30,Sardegna,ITG2
2021-01-08,PF/BT,200003,OSPEDALE CIVILE OZIERI,SAR,50-59,6,40,0,43,3,0,0,46,0,46,Sardegna,ITG2
2021-01-08,PF/BT,200003,OSPEDALE CIVILE OZIERI,SAR,60-69,5,10,0,13,2,0,0,15,0,15,Sardegna,ITG2
2021-01-08,PF/BT,200019,P.O. NOSTRA SIGNORA DELLA MERCEDE,SAR,20-29,5,13,0,14,4,0,0,18,0,18,Sardegna,ITG2
2021-01-08,PF/BT,200019,P.O. NOSTRA SIGNORA DELLA MERCEDE,SAR,30-39,12,29,0,36,5,0,0,41,0,41,Sardegna,ITG2
2021-01-08,PF/BT,200019,P.O. NOSTRA SIGNORA DELLA MERCEDE,SAR,40-49,12,31,0,38,5,0,0,43,0,43,Sardegna,ITG2
2021-01-08,PF/BT,200019,P.O. NOSTRA SIGNORA DELLA MERCEDE,SAR,50-59,21,45,0,60,4,0,2,66,0,66,Sardegna,ITG2
2021-01-08,PF/BT,200019,P.O. NOSTRA SIGNORA DELLA MERCEDE,SAR,60-69,27,19,0,43,3,0,0,46,0,46,Sardegna,ITG2
2021-01-08,PF/BT,200025,P.O. R.BINAGHI CAGLIARI,SAR,20-29,18,31,0,40,9,0,0,49,0,49,Sardegna,ITG2
2021-01-08,PF/BT,200025,P.O. R.BINAGHI CAGLIARI,SAR,30-39,34,51,0,71,14,0,0,85,0,85,Sardegna,ITG2
2021-01-08,PF/BT,200025,P.O. R.BINAGHI CAGLIARI,SAR,40-49,28,97,0,95,30,0,0,125,0,125,Sardegna,ITG2
2021-01-08,PF/BT,200025,P.O. R.BINAGHI CAGLIARI,SAR,50-59,68,108,0,143,32,0,1,176,0,176,Sardegna,ITG2
2021-01-08,PF/BT,200025,P.O. R.BINAGHI CAGLIARI,SAR,60-69,33,27,0,49,11,0,0,60,0,60,Sardegna,ITG2
2021-01-08,PF/BT,200025,P.O. R.BINAGHI CAGLIARI,SAR,70-79,14,1,0,12,3,0,0,15,0,15,Sardegna,ITG2
2021-01-08,PF/BT,200026,P.O. MARINO CAGLIARI,SAR,20-29,8,12,0,17,0,0,3,20,0,20,Sardegna,ITG2
2021-01-08,PF/BT,200026,P.O. MARINO CAGLIARI,SAR,30-39,19,11,0,20,5,0,5,30,0,30,Sardegna,ITG2
2021-01-08,PF/BT,200026,P.O. MARINO CAGLIARI,SAR,40-49,16,21,0,20,6,0,11,37,0,37,Sardegna,ITG2
2021-01-08,PF/BT,200026,P.O. MARINO CAGLIARI,SAR,50-59,22,16,0,25,10,0,3,38,0,38,Sardegna,ITG2
2021-01-08,PF/BT,200026,P.O. MARINO CAGLIARI,SAR,60-69,11,13,0,16,7,0,1,24,0,24,Sardegna,ITG2
2021-01-08,PF/BT,200026,P.O. MARINO CAGLIARI,SAR,70-79,5,2,0,6,1,0,0,7,0,7,Sardegna,ITG2
2021-01-08,PF/BT,200031,P.O. SS. TRINITA` CAGLIARI,SAR,20-29,6,19,0,25,0,0,0,25,0,25,Sardegna,ITG2
2021-01-08,PF/BT,200031,P.O. SS. TRINITA` CAGLIARI,SAR,30-39,10,27,0,33,4,0,0,37,0,37,Sardegna,ITG2
2021-01-08,PF/BT,200031,P.O. SS. TRINITA` CAGLIARI,SAR,40-49,18,27,0,41,4,0,0,45,0,45,Sardegna,ITG2
2021-01-08,PF/BT,200031,P.O. SS. TRINITA` CAGLIARI,SAR,50-59,28,49,0,70,7,0,0,77,0,77,Sardegna,ITG2
2021-01-08,PF/BT,200031,P.O. SS. TRINITA` CAGLIARI,SAR,60-69,24,26,0,42,8,0,0,50,0,50,Sardegna,ITG2
2021-01-08,PF/BT,200034,PRESIDIO OSPEDALIERO N.S. DI BONARIA,SAR,20-29,0,1,0,1,0,0,0,1,0,1,Sardegna,ITG2
2021-01-08,PF/BT,200034,PRESIDIO OSPEDALIERO N.S. DI BONARIA,SAR,30-39,1,7,0,8,0,0,0,8,0,8,Sardegna,ITG2
2021-01-08,PF/BT,200034,PRESIDIO OSPEDALIERO N.S. DI BONARIA,SAR,40-49,1,8,0,9,0,0,0,9,0,9,Sardegna,ITG2
2021-01-08,PF/BT,200034,PRESIDIO OSPEDALIERO N.S. DI BONARIA,SAR,50-59,6,3,0,9,0,0,0,9,0,9,Sardegna,ITG2
2021-01-08,PF/BT,200034,PRESIDIO OSPEDALIERO N.S. DI BONARIA,SAR,60-69,2,1,0,3,0,0,0,3,0,3,Sardegna,ITG2
2021-01-08,PF/BT,200035,P.O. SAN MARCELLINO MURAVERA,SAR,30-39,2,1,0,3,0,0,0,3,0,3,Sardegna,ITG2
2021-01-08,PF/BT,200035,P.O. SAN MARCELLINO MURAVERA,SAR,40-49,3,4,0,6,1,0,0,7,0,7,Sardegna,ITG2
2021-01-08,PF/BT,200035,P.O. SAN MARCELLINO MURAVERA,SAR,50-59,10,16,0,22,4,0,0,26,0,26,Sardegna,ITG2
2021-01-08,PF/BT,200035,P.O. SAN MARCELLINO MURAVERA,SAR,60-69,7,5,0,10,2,0,0,12,0,12,Sardegna,ITG2
2021-01-08,PF/BT,200036,OSPEDALE BUSINCO,SAR,20-29,0,4,0,4,0,0,0,4,0,4,Sardegna,ITG2
2021-01-08,PF/BT,200036,OSPEDALE BUSINCO,SAR,30-39,5,9,0,14,0,0,0,14,0,14,Sardegna,ITG2
2021-01-08,PF/BT,200036,OSPEDALE BUSINCO,SAR,40-49,6,24,0,30,0,0,0,30,0,30,Sardegna,ITG2
2021-01-08,PF/BT,200036,OSPEDALE BUSINCO,SAR,50-59,13,40,0,53,0,0,0,53,0,53,Sardegna,ITG2
2021-01-08,PF/BT,200036,OSPEDALE BUSINCO,SAR,60-69,11,14,0,25,0,0,0,25,0,25,Sardegna,ITG2
2021-01-08,PF/BT,200052,P.O. SAN MARTINO ORISTANO,SAR,20-29,11,4,0,15,0,0,0,15,0,15,Sardegna,ITG2
2021-01-08,PF/BT,200052,P.O. SAN MARTINO ORISTANO,SAR,30-39,15,6,0,21,0,0,0,21,0,21,Sardegna,ITG2
2021-01-08,PF/BT,200052,P.O. SAN MARTINO ORISTANO,SAR,40-49,17,11,0,28,0,0,0,28,0,28,Sardegna,ITG2
2021-01-08,PF/BT,200052,P.O. SAN MARTINO ORISTANO,SAR,50-59,24,16,0,40,0,0,0,40,0,40,Sardegna,ITG2
2021-01-08,PF/BT,200052,P.O. SAN MARTINO ORISTANO,SAR,60-69,3,7,0,10,0,0,0,10,0,10,Sardegna,ITG2
2021-01-08,PF/BT,200904,P.O. SAN MICHELE - AOB,SAR,20-29,13,27,0,39,1,0,0,40,0,40,Sardegna,ITG2
2021-01-08,PF/BT,200904,P.O. SAN MICHELE - AOB,SAR,30-39,25,30,0,54,1,0,0,55,0,55,Sardegna,ITG2
2021-01-08,PF/BT,200904,P.O. SAN MICHELE - AOB,SAR,40-49,20,49,0,63,6,0,0,69,0,69,Sardegna,ITG2
2021-01-08,PF/BT,200904,P.O. SAN MICHELE - AOB,SAR,50-59,31,59,0,86,4,0,0,90,0,90,Sardegna,ITG2
2021-01-08,PF/BT,200904,P.O. SAN MICHELE - AOB,SAR,60-69,19,31,0,48,2,0,0,50,0,50,Sardegna,ITG2
2021-01-08,PF/BT,200905,AOU DI SASSARI,SAR,20-29,17,30,1,43,0,0,4,47,0,47,Sardegna,ITG2
2021-01-08,PF/BT,200905,AOU DI SASSARI,SAR,30-39,50,100,1,138,0,0,12,150,0,150,Sardegna,ITG2
2021-01-08,PF/BT,200905,AOU DI SASSARI,SAR,40-49,46,82,1,112,0,0,16,128,0,128,Sardegna,ITG2
2021-01-08,PF/BT,200905,AOU DI SASSARI,SAR,50-59,58,121,1,151,0,0,28,179,0,179,Sardegna,ITG2
2021-01-08,PF/BT,200905,AOU DI SASSARI,SAR,60-69,34,49,1,72,0,0,11,83,0,83,Sardegna,ITG2
2021-01-08,PF/BT,200905,AOU DI SASSARI,SAR,80-89,0,1,1,0,0,0,1,1,0,1,Sardegna,ITG2
2021-01-08,PF/BT,200905,AOU DI SASSARI,SAR,90+,0,1,1,1,0,0,0,1,0,1,Sardegna,ITG2
2021-01-08,PF/BT,20090602,POLICLINICO MONSERRATO-AOU CAGLIARI,SAR,16-19,1,0,0,1,0,0,0,1,0,1,Sardegna,ITG2
2021-01-08,PF/BT,20090602,POLICLINICO MONSERRATO-AOU CAGLIARI,SAR,20-29,1,15,0,16,0,0,0,16,0,16,Sardegna,ITG2
2021-01-08,PF/BT,20090602,POLICLINICO MONSERRATO-AOU CAGLIARI,SAR,30-39,18,38,0,56,0,0,0,56,0,56,Sardegna,ITG2
2021-01-08,PF/BT,20090602,POLICLINICO MONSERRATO-AOU CAGLIARI,SAR,40-49,30,52,0,82,0,0,0,82,0,82,Sardegna,ITG2
2021-01-08,PF/BT,20090602,POLICLINICO MONSERRATO-AOU CAGLIARI,SAR,50-59,42,89,0,131,0,0,0,131,0,131,Sardegna,ITG2
2021-01-08,PF/BT,20090602,POLICLINICO MONSERRATO-AOU CAGLIARI,SAR,60-69,30,31,0,61,0,0,0,61,0,61,Sardegna,ITG2
2021-01-08,PF/BT,20090602,POLICLINICO MONSERRATO-AOU CAGLIARI,SAR,70-79,1,0,0,1,0,0,0,1,0,1,Sardegna,ITG2
2021-01-09,PF/BT,10036,SISP-SASSARI COVID,SAR,20-29,3,18,0,21,0,0,0,21,0,21,Sardegna,ITG2
2021-01-09,PF/BT,10036,SISP-SASSARI COVID,SAR,30-39,17,32,0,43,6,0,0,49,0,49,Sardegna,ITG2
2021-01-09,PF/BT,10036,SISP-SASSARI COVID,SAR,40-49,10,33,0,35,8,0,0,43,0,43,Sardegna,ITG2
2021-01-09,PF/BT,10036,SISP-SASSARI COVID,SAR,50-59,18,39,0,43,14,0,0,57,0,57,Sardegna,ITG2
2021-01-09,PF/BT,10036,SISP-SASSARI COVID,SAR,60-69,10,17,0,25,2,0,0,27,0,27,Sardegna,ITG2
2021-01-09,PF/BT,10036,SISP-SASSARI COVID,SAR,70-79,1,0,0,1,0,0,0,1,0,1,Sardegna,ITG2
2021-01-09,PF/BT,101,P.O.  SAN FRANCESCO,SAR,20-29,5,26,0,28,3,0,0,31,0,31,Sardegna,ITG2
2021-01-09,PF/BT,101,P.O.  SAN FRANCESCO,SAR,30-39,12,33,0,43,2,0,0,45,0,45,Sardegna,ITG2
2021-01-09,PF/BT,101,P.O.  SAN FRANCESCO,SAR,40-49,23,46,0,65,4,0,0,69,0,69,Sardegna,ITG2
2021-01-09,PF/BT,101,P.O.  SAN FRANCESCO,SAR,50-59,20,55,0,72,3,0,0,75,0,75,Sardegna,ITG2
2021-01-09,PF/BT,101,P.O.  SAN FRANCESCO,SAR,60-69,12,20,0,29,3,0,0,32,0,32,Sardegna,ITG2
2021-01-09,PF/BT,120010,AMBULATORIO SPECIALISTICO P.O. - OLBIA,SAR,20-29,4,6,0,10,0,0,0,10,0,10,Sardegna,ITG2
2021-01-09,PF/BT,120010,AMBULATORIO SPECIALISTICO P.O. - OLBIA,SAR,30-39,10,20,0,28,0,0,2,30,0,30,Sardegna,ITG2
2021-01-09,PF/BT,120010,AMBULATORIO SPECIALISTICO P.O. - OLBIA,SAR,40-49,14,34,0,46,0,0,2,48,0,48,Sardegna,ITG2
2021-01-09,PF/BT,120010,AMBULATORIO SPECIALISTICO P.O. - OLBIA,SAR,50-59,27,39,0,64,0,0,2,66,0,66,Sardegna,ITG2
2021-01-09,PF/BT,120010,AMBULATORIO SPECIALISTICO P.O. - OLBIA,SAR,60-69,41,33,0,72,0,0,2,74,0,74,Sardegna,ITG2
2021-01-09,PF/BT,120011,AMBULATORIO SPECIALISTICO P.O. PAOLO DETTORI - TEMPIO,SAR,20-29,1,2,0,3,0,0,0,3,0,3,Sardegna,ITG2
2021-01-09,PF/BT,120011,AMBULATORIO SPECIALISTICO P.O. PAOLO DETTORI - TEMPIO,SAR,30-39,1,11,0,12,0,0,0,12,0,12,Sardegna,ITG2
2021-01-09,PF/BT,120011,AMBULATORIO SPECIALISTICO P.O. PAOLO DETTORI - TEMPIO,SAR,40-49,4,11,0,15,0,0,0,15,0,15,Sardegna,ITG2
2021-01-09,PF/BT,120011,AMBULATORIO SPECIALISTICO P.O. PAOLO DETTORI - TEMPIO,SAR,50-59,7,12,0,15,0,0,4,19,0,19,Sardegna,ITG2
2021-01-09,PF/BT,120011,AMBULATORIO SPECIALISTICO P.O. PAOLO DETTORI - TEMPIO,SAR,60-69,5,6,0,7,0,0,4,11,0,11,Sardegna,ITG2
2021-01-09,PF/BT,200002,OSPEDALE CIVILE ALGHERO,SAR,16-19,0,1,0,0,1,0,0,1,0,1,Sardegna,ITG2
2021-01-09,PF/BT,200002,OSPEDALE CIVILE ALGHERO,SAR,20-29,8,16,0,21,3,0,0,24,0,24,Sardegna,ITG2
2021-01-09,PF/BT,200002,OSPEDALE CIVILE ALGHERO,SAR,30-39,27,48,0,55,20,0,0,75,0,75,Sardegna,ITG2
2021-01-09,PF/BT,200002,OSPEDALE CIVILE ALGHERO,SAR,40-49,34,81,0,85,30,0,0,115,0,115,Sardegna,ITG2
2021-01-09,PF/BT,200002,OSPEDALE CIVILE ALGHERO,SAR,50-59,55,111,0,117,49,0,0,166,0,166,Sardegna,ITG2
2021-01-09,PF/BT,200002,OSPEDALE CIVILE ALGHERO,SAR,60-69,57,56,0,94,19,0,0,113,0,113,Sardegna,ITG2
2021-01-09,PF/BT,200002,OSPEDALE CIVILE ALGHERO,SAR,70-79,2,1,0,3,0,0,0,3,0,3,Sardegna,ITG2
2021-01-09,PF/BT,200002,OSPEDALE CIVILE ALGHERO,SAR,80-89,0,1,0,0,1,0,0,1,0,1,Sardegna,ITG2
2021-01-09,PF/BT,200003,OSPEDALE CIVILE OZIERI,SAR,20-29,11,14,0,16,9,0,0,25,0,25,Sardegna,ITG2
2021-01-09,PF/BT,200003,OSPEDALE CIVILE OZIERI,SAR,30-39,20,31,0,24,27,0,0,51,0,51,Sardegna,ITG2
2021-01-09,PF/BT,200003,OSPEDALE CIVILE OZIERI,SAR,40-49,20,48,0,32,36,0,0,68,0,68,Sardegna,ITG2
2021-01-09,PF/BT,200003,OSPEDALE CIVILE OZIERI,SAR,50-59,47,105,0,83,69,0,0,152,0,152,Sardegna,ITG2
2021-01-09,PF/BT,200003,OSPEDALE CIVILE OZIERI,SAR,60-69,49,54,0,73,30,0,0,103,0,103,Sardegna,ITG2
2021-01-09,PF/BT,200003,OSPEDALE CIVILE OZIERI,SAR,80-89,1,0,0,0,1,0,0,1,0,1,Sardegna,ITG2
2021-01-09,PF/BT,200019,AMBULATORI PO LANUSEI,SAR,20-29,11,18,0,22,7,0,0,29,0,29,Sardegna,ITG2
2021-01-09,PF/BT,200019,AMBULATORI PO LANUSEI,SAR,30-39,13,25,0,25,12,0,1,38,0,38,Sardegna,ITG2
2021-01-09,PF/BT,200019,AMBULATORI PO LANUSEI,SAR,40-49,14,45,0,35,21,0,3,59,0,59,Sardegna,ITG2
2021-01-09,PF/BT,200019,AMBULATORI PO LANUSEI,SAR,50-59,27,50,0,47,28,0,2,77,0,77,Sardegna,ITG2
2021-01-09,PF/BT,200019,AMBULATORI PO LANUSEI,SAR,60-69,14,21,0,16,17,0,2,35,0,35,Sardegna,ITG2
2021-01-09,PF/BT,200019,AMBULATORI PO LANUSEI,SAR,70-79,3,0,0,3,0,0,0,3,0,3,Sardegna,ITG2
2021-01-09,PF/BT,200019,AMBULATORI PO LANUSEI,SAR,80-89,1,0,0,0,1,0,0,1,0,1,Sardegna,ITG2
2021-01-09,PF/BT,200025,P.O. R.BINAGHI CAGLIARI,SAR,20-29,5,12,0,17,0,0,0,17,0,17,Sardegna,ITG2
2021-01-09,PF/BT,200025,P.O. R.BINAGHI CAGLIARI,SAR,30-39,12,17,0,24,5,0,0,29,0,29,Sardegna,ITG2
2021-01-09,PF/BT,200025,P.O. R.BINAGHI CAGLIARI,SAR,40-49,16,33,0,39,10,0,0,49,0,49,Sardegna,ITG2
2021-01-09,PF/BT,200025,P.O. R.BINAGHI CAGLIARI,SAR,50-59,43,45,0,74,14,0,0,88,0,88,Sardegna,ITG2
2021-01-09,PF/BT,200025,P.O. R.BINAGHI CAGLIARI,SAR,60-69,42,35,0,74,3,0,0,77,0,77,Sardegna,ITG2
2021-01-09,PF/BT,200025,P.O. R.BINAGHI CAGLIARI,SAR,70-79,3,1,0,3,1,0,0,4,0,4,Sardegna,ITG2
2021-01-09,PF/BT,200026,P.O. MARINO CAGLIARI,SAR,16-19,1,0,0,1,0,0,0,1,0,1,Sardegna,ITG2
2021-01-09,PF/BT,200026,P.O. MARINO CAGLIARI,SAR,20-29,13,7,0,16,4,0,0,20,0,20,Sardegna,ITG2
2021-01-09,PF/BT,200026,P.O. MARINO CAGLIARI,SAR,30-39,12,15,0,19,7,0,1,27,0,27,Sardegna,ITG2
2021-01-09,PF/BT,200026,P.O. MARINO CAGLIARI,SAR,40-49,11,8,0,10,5,0,4,19,0,19,Sardegna,ITG2
2021-01-09,PF/BT,200026,P.O. MARINO CAGLIARI,SAR,50-59,13,8,0,13,5,0,3,21,0,21,Sardegna,ITG2
2021-01-09,PF/BT,200026,P.O. MARINO CAGLIARI,SAR,60-69,1,1,0,1,1,0,0,2,0,2,Sardegna,ITG2
2021-01-09,PF/BT,200028,P.O.SIRAI CARBONIA,SAR,20-29,2,2,0,4,0,0,0,4,0,4,Sardegna,ITG2
2021-01-09,PF/BT,200028,P.O.SIRAI CARBONIA,SAR,30-39,4,16,0,20,0,0,0,20,0,20,Sardegna,ITG2
2021-01-09,PF/BT,200028,P.O.SIRAI CARBONIA,SAR,40-49,9,18,0,27,0,0,0,27,0,27,Sardegna,ITG2
2021-01-09,PF/BT,200028,P.O.SIRAI CARBONIA,SAR,50-59,10,29,0,39,0,0,0,39,0,39,Sardegna,ITG2
2021-01-09,PF/BT,200028,P.O.SIRAI CARBONIA,SAR,60-69,8,4,0,12,0,0,0,12,0,12,Sardegna,ITG2
2021-01-09,PF/BT,200031,P.O. SS. TRINITA` CAGLIARI,SAR,20-29,1,11,0,10,2,0,0,12,0,12,Sardegna,ITG2
2021-01-09,PF/BT,200031,P.O. SS. TRINITA` CAGLIARI,SAR,30-39,8,19,0,25,2,0,0,27,0,27,Sardegna,ITG2
2021-01-09,PF/BT,200031,P.O. SS. TRINITA` CAGLIARI,SAR,40-49,11,13,0,22,2,0,0,24,0,24,Sardegna,ITG2
2021-01-09,PF/BT,200031,P.O. SS. TRINITA` CAGLIARI,SAR,50-59,9,18,0,24,3,0,0,27,0,27,Sardegna,ITG2
2021-01-09,PF/BT,200031,P.O. SS. TRINITA` CAGLIARI,SAR,60-69,5,7,0,8,4,0,0,12,0,12,Sardegna,ITG2
2021-01-09,PF/BT,200034,PRESIDIO OSPEDALIERO N.S. DI BONARIA,SAR,20-29,0,7,0,7,0,0,0,7,0,7,Sardegna,ITG2
2021-01-09,PF/BT,200034,PRESIDIO OSPEDALIERO N.S. DI BONARIA,SAR,30-39,7,12,0,19,0,0,0,19,0,19,Sardegna,ITG2
2021-01-09,PF/BT,200034,PRESIDIO OSPEDALIERO N.S. DI BONARIA,SAR,40-49,5,21,0,26,0,0,0,26,0,26,Sardegna,ITG2
2021-01-09,PF/BT,200034,PRESIDIO OSPEDALIERO N.S. DI BONARIA,SAR,50-59,5,10,0,15,0,0,0,15,0,15,Sardegna,ITG2
2021-01-09,PF/BT,200034,PRESIDIO OSPEDALIERO N.S. DI BONARIA,SAR,60-69,3,2,0,5,0,0,0,5,0,5,Sardegna,ITG2
2021-01-09,PF/BT,200035,P.O. SAN MARCELLINO MURAVERA,SAR,20-29,0,1,0,1,0,0,0,1,0,1,Sardegna,ITG2
2021-01-09,PF/BT,200035,P.O. SAN MARCELLINO MURAVERA,SAR,30-39,1,0,0,1,0,0,0,1,0,1,Sardegna,ITG2
2021-01-09,PF/BT,200035,P.O. SAN MARCELLINO MURAVERA,SAR,40-49,1,2,0,2,1,0,0,3,0,3,Sardegna,ITG2
2021-01-09,PF/BT,200035,P.O. SAN MARCELLINO MURAVERA,SAR,50-59,4,5,0,8,1,0,0,9,0,9,Sardegna,ITG2
2021-01-09,PF/BT,200035,P.O. SAN MARCELLINO MURAVERA,SAR,60-69,2,2,0,4,0,0,0,4,0,4,Sardegna,ITG2
2021-01-09,PF/BT,200036,OSPEDALE BUSINCO,SAR,20-29,4,10,0,14,0,0,0,14,0,14,Sardegna,ITG2
2021-01-09,PF/BT,200036,OSPEDALE BUSINCO,SAR,30-39,5,18,0,22,1,0,0,23,0,23,Sardegna,ITG2
2021-01-09,PF/BT,200036,OSPEDALE BUSINCO,SAR,40-49,4,23,0,26,1,0,0,27,0,27,Sardegna,ITG2
2021-01-09,PF/BT,200036,OSPEDALE BUSINCO,SAR,50-59,6,34,0,39,1,0,0,40,0,40,Sardegna,ITG2
2021-01-09,PF/BT,200036,OSPEDALE BUSINCO,SAR,60-69,7,9,0,15,1,0,0,16,0,16,Sardegna,ITG2
2021-01-09,PF/BT,200052,P.O. SAN MARTINO ORISTANO,SAR,20-29,2,9,0,11,0,0,0,11,0,11,Sardegna,ITG2
2021-01-09,PF/BT,200052,P.O. SAN MARTINO ORISTANO,SAR,30-39,9,15,0,24,0,0,0,24,0,24,Sardegna,ITG2
2021-01-09,PF/BT,200052,P.O. SAN MARTINO ORISTANO,SAR,40-49,6,29,0,35,0,0,0,35,0,35,Sardegna,ITG2
2021-01-09,PF/BT,200052,P.O. SAN MARTINO ORISTANO,SAR,50-59,12,56,0,68,0,0,0,68,0,68,Sardegna,ITG2
2021-01-09,PF/BT,200052,P.O. SAN MARTINO ORISTANO,SAR,60-69,31,34,0,65,0,0,0,65,0,65,Sardegna,ITG2
2021-01-09,PF/BT,200052,P.O. SAN MARTINO ORISTANO,SAR,70-79,1,0,0,1,0,0,0,1,0,1,Sardegna,ITG2
2021-01-09,PF/BT,200053,P.O. DELOGU GHILARZA,SAR,20-29,0,6,0,6,0,0,0,6,0,6,Sardegna,ITG2
2021-01-09,PF/BT,200053,P.O. DELOGU GHILARZA,SAR,30-39,2,3,0,4,1,0,0,5,0,5,Sardegna,ITG2
2021-01-09,PF/BT,200053,P.O. DELOGU GHILARZA,SAR,40-49,3,9,0,11,1,0,0,12,0,12,Sardegna,ITG2
2021-01-09,PF/BT,200053,P.O. DELOGU GHILARZA,SAR,50-59,5,14,0,18,1,0,0,19,0,19,Sardegna,ITG2
2021-01-09,PF/BT,200053,P.O. DELOGU GHILARZA,SAR,60-69,3,3,0,6,0,0,0,6,0,6,Sardegna,ITG2
2021-01-09,PF/BT,200904,P.O. SAN MICHELE - AOB,SAR,20-29,5,22,0,27,0,0,0,27,0,27,Sardegna,ITG2
2021-01-09,PF/BT,200904,P.O. SAN MICHELE - AOB,SAR,30-39,20,22,0,41,1,0,0,42,0,42,Sardegna,ITG2
2021-01-09,PF/BT,200904,P.O. SAN MICHELE - AOB,SAR,40-49,16,34,0,49,1,0,0,50,0,50,Sardegna,ITG2
2021-01-09,PF/BT,200904,P.O. SAN MICHELE - AOB,SAR,50-59,19,45,0,63,1,0,0,64,0,64,Sardegna,ITG2
2021-01-09,PF/BT,200904,P.O. SAN MICHELE - AOB,SAR,60-69,10,11,0,20,1,0,0,21,0,21,Sardegna,ITG2
2021-01-09,PF/BT,200905,AOU DI SASSARI,SAR,20-29,5,15,0,18,1,0,1,20,0,20,Sardegna,ITG2
2021-01-09,PF/BT,200905,AOU DI SASSARI,SAR,30-39,21,50,0,57,1,0,13,71,0,71,Sardegna,ITG2
2021-01-09,PF/BT,200905,AOU DI SASSARI,SAR,40-49,45,102,0,95,2,0,50,147,0,147,Sardegna,ITG2
2021-01-09,PF/BT,200905,AOU DI SASSARI,SAR,50-59,55,136,0,152,3,0,36,191,0,191,Sardegna,ITG2
2021-01-09,PF/BT,200905,AOU DI SASSARI,SAR,60-69,30,54,0,63,3,0,18,84,0,84,Sardegna,ITG2
2021-01-09,PF/BT,200905,AOU DI SASSARI,SAR,70-79,0,1,0,0,0,0,1,1,0,1,Sardegna,ITG2
2021-01-09,PF/BT,200905,AOU DI SASSARI,SAR,90+,0,1,0,1,0,0,0,1,0,1,Sardegna,ITG2
2021-01-09,PF/BT,20090602,POLICLINICO MONSERRATO-AOU CAGLIARI,SAR,20-29,7,13,0,15,5,0,0,20,0,20,Sardegna,ITG2
2021-01-09,PF/BT,20090602,POLICLINICO MONSERRATO-AOU CAGLIARI,SAR,30-39,31,35,0,45,21,0,0,66,0,66,Sardegna,ITG2
2021-01-09,PF/BT,20090602,POLICLINICO MONSERRATO-AOU CAGLIARI,SAR,40-49,42,62,0,59,45,0,0,104,0,104,Sardegna,ITG2
2021-01-09,PF/BT,20090602,POLICLINICO MONSERRATO-AOU CAGLIARI,SAR,50-59,41,88,0,85,44,0,0,129,0,129,Sardegna,ITG2
2021-01-09,PF/BT,20090602,POLICLINICO MONSERRATO-AOU CAGLIARI,SAR,60-69,33,32,0,39,26,0,0,65,0,65,Sardegna,ITG2
2021-01-10,PF/BT,101,P.O.  SAN FRANCESCO,SAR,20-29,17,12,0,29,0,0,0,29,0,29,Sardegna,ITG2
2021-01-10,PF/BT,101,P.O.  SAN FRANCESCO,SAR,30-39,3,26,0,29,0,0,0,29,0,29,Sardegna,ITG2
2021-01-10,PF/BT,101,P.O.  SAN FRANCESCO,SAR,40-49,5,33,0,36,2,0,0,38,0,38,Sardegna,ITG2
2021-01-10,PF/BT,101,P.O.  SAN FRANCESCO,SAR,50-59,15,41,0,53,3,0,0,56,0,56,Sardegna,ITG2
2021-01-10,PF/BT,101,P.O.  SAN FRANCESCO,SAR,60-69,23,29,0,48,4,0,0,52,0,52,Sardegna,ITG2
2021-01-10,PF/BT,120010,AMBULATORIO SPECIALISTICO P.O. - OLBIA,SAR,16-19,0,1,0,1,0,0,0,1,0,1,Sardegna,ITG2
2021-01-10,PF/BT,120010,AMBULATORIO SPECIALISTICO P.O. - OLBIA,SAR,20-29,22,52,0,73,0,0,1,74,0,74,Sardegna,ITG2
2021-01-10,PF/BT,120010,AMBULATORIO SPECIALISTICO P.O. - OLBIA,SAR,30-39,29,64,0,93,0,0,0,93,0,93,Sardegna,ITG2
2021-01-10,PF/BT,120010,AMBULATORIO SPECIALISTICO P.O. - OLBIA,SAR,40-49,20,57,0,75,0,0,2,77,0,77,Sardegna,ITG2
2021-01-10,PF/BT,120010,AMBULATORIO SPECIALISTICO P.O. - OLBIA,SAR,50-59,16,65,0,78,0,0,3,81,0,81,Sardegna,ITG2
2021-01-10,PF/BT,120010,AMBULATORIO SPECIALISTICO P.O. - OLBIA,SAR,60-69,26,19,0,44,0,0,1,45,0,45,Sardegna,ITG2
2021-01-10,PF/BT,120010,AMBULATORIO SPECIALISTICO P.O. - OLBIA,SAR,70-79,2,0,0,2,0,0,0,2,0,2,Sardegna,ITG2
2021-01-10,PF/BT,120011,P.O. PAOLO DETTORI - TEMPIO P.,SAR,20-29,3,1,0,1,0,0,3,4,0,4,Sardegna,ITG2
2021-01-10,PF/BT,120011,P.O. PAOLO DETTORI - TEMPIO P.,SAR,30-39,8,8,0,9,0,0,7,16,0,16,Sardegna,ITG2
2021-01-10,PF/BT,120011,P.O. PAOLO DETTORI - TEMPIO P.,SAR,40-49,11,23,0,16,0,0,18,34,0,34,Sardegna,ITG2
2021-01-10,PF/BT,120011,P.O. PAOLO DETTORI - TEMPIO P.,SAR,50-59,10,48,0,37,0,0,21,58,0,58,Sardegna,ITG2
2021-01-10,PF/BT,120011,P.O. PAOLO DETTORI - TEMPIO P.,SAR,60-69,9,22,0,20,0,0,11,31,0,31,Sardegna,ITG2
2021-01-10,PF/BT,120011,P.O. PAOLO DETTORI - TEMPIO P.,SAR,80-89,1,0,0,0,0,0,1,1,0,1,Sardegna,ITG2
2021-01-10,PF/BT,200002,OSPEDALE CIVILE ALGHERO,SAR,16-19,1,1,0,2,0,0,0,2,0,2,Sardegna,ITG2
2021-01-10,PF/BT,200002,OSPEDALE CIVILE ALGHERO,SAR,20-29,6,10,0,13,3,0,0,16,0,16,Sardegna,ITG2
2021-01-10,PF/BT,200002,OSPEDALE CIVILE ALGHERO,SAR,30-39,3,14,0,11,6,0,0,17,0,17,Sardegna,ITG2
2021-01-10,PF/BT,200002,OSPEDALE CIVILE ALGHERO,SAR,40-49,7,15,0,13,9,0,0,22,0,22,Sardegna,ITG2
2021-01-10,PF/BT,200002,OSPEDALE CIVILE ALGHERO,SAR,50-59,10,22,0,20,12,0,0,32,0,32,Sardegna,ITG2
2021-01-10,PF/BT,200002,OSPEDALE CIVILE ALGHERO,SAR,60-69,5,7,0,10,2,0,0,12,0,12,Sardegna,ITG2
2021-01-10,PF/BT,200002,OSPEDALE CIVILE ALGHERO,SAR,70-79,0,1,0,1,0,0,0,1,0,1,Sardegna,ITG2
2021-01-10,PF/BT,200019,AMBULATORI PO LANUSEI,SAR,20-29,3,6,0,5,4,0,0,9,0,9,Sardegna,ITG2
2021-01-10,PF/BT,200019,AMBULATORI PO LANUSEI,SAR,30-39,6,12,0,14,4,0,0,18,0,18,Sardegna,ITG2
2021-01-10,PF/BT,200019,AMBULATORI PO LANUSEI,SAR,40-49,14,21,0,30,5,0,0,35,0,35,Sardegna,ITG2
2021-01-10,PF/BT,200019,AMBULATORI PO LANUSEI,SAR,50-59,14,29,0,33,9,0,1,43,0,43,Sardegna,ITG2
2021-01-10,PF/BT,200019,AMBULATORI PO LANUSEI,SAR,60-69,4,9,0,11,2,0,0,13,0,13,Sardegna,ITG2
2021-01-10,PF/BT,200028,P.O.SIRAI CARBONIA,SAR,30-39,2,6,0,8,0,0,0,8,0,8,Sardegna,ITG2
2021-01-10,PF/BT,200028,P.O.SIRAI CARBONIA,SAR,40-49,9,12,0,20,1,0,0,21,0,21,Sardegna,ITG2
2021-01-10,PF/BT,200028,P.O.SIRAI CARBONIA,SAR,50-59,18,24,0,42,0,0,0,42,0,42,Sardegna,ITG2
2021-01-10,PF/BT,200028,P.O.SIRAI CARBONIA,SAR,60-69,16,14,0,30,0,0,0,30,0,30,Sardegna,ITG2
2021-01-10,PF/BT,200031,P.O. SS. TRINITA` CAGLIARI,SAR,20-29,6,10,0,12,4,0,0,16,0,16,Sardegna,ITG2
2021-01-10,PF/BT,200031,P.O. SS. TRINITA` CAGLIARI,SAR,30-39,11,24,0,30,5,0,0,35,0,35,Sardegna,ITG2
2021-01-10,PF/BT,200031,P.O. SS. TRINITA` CAGLIARI,SAR,40-49,19,40,0,35,24,0,0,59,0,59,Sardegna,ITG2
2021-01-10,PF/BT,200031,P.O. SS. TRINITA` CAGLIARI,SAR,50-59,19,42,0,51,10,0,0,61,0,61,Sardegna,ITG2
2021-01-10,PF/BT,200031,P.O. SS. TRINITA` CAGLIARI,SAR,60-69,15,18,0,30,3,0,0,33,0,33,Sardegna,ITG2
2021-01-10,PF/BT,200036,OSPEDALE BUSINCO,SAR,20-29,2,7,0,8,1,0,0,9,0,9,Sardegna,ITG2
2021-01-10,PF/BT,200036,OSPEDALE BUSINCO,SAR,30-39,4,15,0,19,0,0,0,19,0,19,Sardegna,ITG2
2021-01-10,PF/BT,200036,OSPEDALE BUSINCO,SAR,40-49,6,18,0,22,2,0,0,24,0,24,Sardegna,ITG2
2021-01-10,PF/BT,200036,OSPEDALE BUSINCO,SAR,50-59,7,21,0,26,2,0,0,28,0,28,Sardegna,ITG2
2021-01-10,PF/BT,200036,OSPEDALE BUSINCO,SAR,60-69,12,15,0,23,4,0,0,27,0,27,Sardegna,ITG2
2021-01-10,PF/BT,200052,P.O. SAN MARTINO ORISTANO,SAR,20-29,2,4,0,6,0,0,0,6,0,6,Sardegna,ITG2
2021-01-10,PF/BT,200052,P.O. SAN MARTINO ORISTANO,SAR,30-39,7,11,0,18,0,0,0,18,0,18,Sardegna,ITG2
2021-01-10,PF/BT,200052,P.O. SAN MARTINO ORISTANO,SAR,40-49,5,29,0,34,0,0,0,34,0,34,Sardegna,ITG2
2021-01-10,PF/BT,200052,P.O. SAN MARTINO ORISTANO,SAR,50-59,23,38,0,60,0,0,1,61,0,61,Sardegna,ITG2
2021-01-10,PF/BT,200052,P.O. SAN MARTINO ORISTANO,SAR,60-69,33,27,0,60,0,0,0,60,0,60,Sardegna,ITG2
2021-01-10,PF/BT,200052,P.O. SAN MARTINO ORISTANO,SAR,70-79,0,1,0,1,0,0,0,1,0,1,Sardegna,ITG2
2021-01-10,PF/BT,200905,AOU DI SASSARI,SAR,20-29,15,15,0,24,0,0,6,30,0,30,Sardegna,ITG2
2021-01-10,PF/BT,200905,AOU DI SASSARI,SAR,30-39,30,29,0,35,1,0,23,59,0,59,Sardegna,ITG2
2021-01-10,PF/BT,200905,AOU DI SASSARI,SAR,40-49,39,71,0,51,1,0,58,110,0,110,Sardegna,ITG2
2021-01-10,PF/BT,200905,AOU DI SASSARI,SAR,50-59,36,120,0,85,1,0,70,156,0,156,Sardegna,ITG2
2021-01-10,PF/BT,200905,AOU DI SASSARI,SAR,60-69,23,48,0,42,1,0,28,71,0,71,Sardegna,ITG2
2021-01-10,PF/BT,20090602,POLICLINICO MONSERRATO-AOU CAGLIARI,SAR,20-29,7,6,0,9,4,0,0,13,0,13,Sardegna,ITG2
2021-01-10,PF/BT,20090602,POLICLINICO MONSERRATO-AOU CAGLIARI,SAR,30-39,16,14,0,17,13,0,0,30,0,30,Sardegna,ITG2
2021-01-10,PF/BT,20090602,POLICLINICO MONSERRATO-AOU CAGLIARI,SAR,40-49,22,38,0,24,36,0,0,60,0,60,Sardegna,ITG2
2021-01-10,PF/BT,20090602,POLICLINICO MONSERRATO-AOU CAGLIARI,SAR,50-59,30,42,0,29,43,0,0,72,0,72,Sardegna,ITG2
2021-01-10,PF/BT,20090602,POLICLINICO MONSERRATO-AOU CAGLIARI,SAR,60-69,18,19,0,20,17,0,0,37,0,37,Sardegna,ITG2
2021-01-10,PF/BT,20090602,POLICLINICO MONSERRATO-AOU CAGLIARI,SAR,70-79,1,0,0,0,1,0,0,1,0,1,Sardegna,ITG2
2021-01-10,PF/BT,20090602,POLICLINICO MONSERRATO-AOU CAGLIARI,SAR,80-89,0,1,0,0,1,0,0,1,0,1,Sardegna,ITG2
2021-01-11,PF/BT,120010,P.O.  GIOVANNI PAOLO II  OLBIA,SAR,20-29,5,13,0,18,0,0,0,18,0,18,Sardegna,ITG2
2021-01-11,PF/BT,120010,P.O.  GIOVANNI PAOLO II  OLBIA,SAR,30-39,18,38,0,56,0,0,0,56,0,56,Sardegna,ITG2
2021-01-11,PF/BT,120010,P.O.  GIOVANNI PAOLO II  OLBIA,SAR,40-49,11,38,0,49,0,0,0,49,0,49,Sardegna,ITG2
2021-01-11,PF/BT,120010,P.O.  GIOVANNI PAOLO II  OLBIA,SAR,50-59,6,28,0,34,0,0,0,34,0,34,Sardegna,ITG2
2021-01-11,PF/BT,120010,P.O.  GIOVANNI PAOLO II  OLBIA,SAR,60-69,3,14,0,17,0,0,0,17,0,17,Sardegna,ITG2
2021-01-11,PF/BT,120011,P.O. PAOLO DETTORI - TEMPIO P.,SAR,20-29,0,1,0,0,0,0,1,1,0,1,Sardegna,ITG2
2021-01-11,PF/BT,120011,P.O. PAOLO DETTORI - TEMPIO P.,SAR,30-39,1,0,0,0,0,0,1,1,0,1,Sardegna,ITG2
2021-01-11,PF/BT,120011,P.O. PAOLO DETTORI - TEMPIO P.,SAR,40-49,0,7,0,3,1,0,3,7,0,7,Sardegna,ITG2
2021-01-11,PF/BT,120011,P.O. PAOLO DETTORI - TEMPIO P.,SAR,50-59,3,12,0,5,0,0,10,15,0,15,Sardegna,ITG2
2021-01-11,PF/BT,120011,P.O. PAOLO DETTORI - TEMPIO P.,SAR,60-69,7,5,0,8,0,0,4,12,0,12,Sardegna,ITG2
2021-01-11,PF/BT,200019,AMBULATORI PO LANUSEI,SAR,20-29,0,1,0,1,0,0,0,1,0,1,Sardegna,ITG2
2021-01-11,PF/BT,200019,AMBULATORI PO LANUSEI,SAR,30-39,0,2,0,2,0,0,0,2,0,2,Sardegna,ITG2
2021-01-11,PF/BT,200019,AMBULATORI PO LANUSEI,SAR,40-49,1,5,0,6,0,0,0,6,0,6,Sardegna,ITG2
2021-01-11,PF/BT,200019,AMBULATORI PO LANUSEI,SAR,50-59,3,8,0,9,2,0,0,11,0,11,Sardegna,ITG2
2021-01-11,PF/BT,200019,AMBULATORI PO LANUSEI,SAR,60-69,1,2,0,3,0,0,0,3,0,3,Sardegna,ITG2
2021-01-11,PF/BT,200031,P.O. SS. TRINITA` CAGLIARI,SAR,20-29,1,5,0,5,1,0,0,6,0,6,Sardegna,ITG2
2021-01-11,PF/BT,200031,P.O. SS. TRINITA` CAGLIARI,SAR,30-39,9,8,0,6,11,0,0,17,0,17,Sardegna,ITG2
2021-01-11,PF/BT,200031,P.O. SS. TRINITA` CAGLIARI,SAR,40-49,30,18,0,23,25,0,0,48,0,48,Sardegna,ITG2
2021-01-11,PF/BT,200031,P.O. SS. TRINITA` CAGLIARI,SAR,50-59,17,20,0,22,15,0,0,37,0,37,Sardegna,ITG2
2021-01-11,PF/BT,200031,P.O. SS. TRINITA` CAGLIARI,SAR,60-69,6,6,0,10,2,0,0,12,0,12,Sardegna,ITG2
2021-01-11,PF/BT,200036,OSPEDALE BUSINCO,SAR,20-29,1,10,0,10,1,0,0,11,0,11,Sardegna,ITG2
2021-01-11,PF/BT,200036,OSPEDALE BUSINCO,SAR,30-39,2,6,0,7,1,0,0,8,0,8,Sardegna,ITG2
2021-01-11,PF/BT,200036,OSPEDALE BUSINCO,SAR,40-49,8,26,0,18,16,0,0,34,0,34,Sardegna,ITG2
2021-01-11,PF/BT,200036,OSPEDALE BUSINCO,SAR,50-59,10,39,0,36,13,0,0,49,0,49,Sardegna,ITG2
2021-01-11,PF/BT,200036,OSPEDALE BUSINCO,SAR,60-69,7,16,0,17,6,0,0,23,0,23,Sardegna,ITG2
2021-01-11,PF/BT,200904,P.O. SAN MICHELE - AOB,SAR,20-29,4,3,0,7,0,0,0,7,0,7,Sardegna,ITG2
2021-01-11,PF/BT,200904,P.O. SAN MICHELE - AOB,SAR,30-39,13,16,0,27,2,0,0,29,0,29,Sardegna,ITG2
2021-01-11,PF/BT,200904,P.O. SAN MICHELE - AOB,SAR,40-49,12,25,0,36,1,0,0,37,0,37,Sardegna,ITG2
2021-01-11,PF/BT,200904,P.O. SAN MICHELE - AOB,SAR,50-59,26,26,0,46,6,0,0,52,0,52,Sardegna,ITG2
2021-01-11,PF/BT,200904,P.O. SAN MICHELE - AOB,SAR,60-69,19,18,0,33,4,0,0,37,0,37,Sardegna,ITG2
2021-01-11,PF/BT,200905,AZIENDA OSPEDALIERO UNIVERSITARIA DI SAS,SAR,20-29,20,13,0,11,0,0,22,33,0,33,Sardegna,ITG2
2021-01-11,PF/BT,200905,AZIENDA OSPEDALIERO UNIVERSITARIA DI SAS,SAR,30-39,40,32,0,19,0,0,53,72,0,72,Sardegna,ITG2
2021-01-11,PF/BT,200905,AZIENDA OSPEDALIERO UNIVERSITARIA DI SAS,SAR,40-49,75,53,0,17,0,0,111,128,0,128,Sardegna,ITG2
2021-01-11,PF/BT,200905,AZIENDA OSPEDALIERO UNIVERSITARIA DI SAS,SAR,50-59,77,69,0,28,0,0,118,146,0,146,Sardegna,ITG2
2021-01-11,PF/BT,200905,AZIENDA OSPEDALIERO UNIVERSITARIA DI SAS,SAR,60-69,22,23,0,16,0,0,29,45,0,45,Sardegna,ITG2
2021-01-11,PF/BT,200905,AZIENDA OSPEDALIERO UNIVERSITARIA DI SAS,SAR,70-79,1,0,0,0,0,0,1,1,0,1,Sardegna,ITG2
2021-01-11,PF/BT,20090602,POLICLINICO MONSERRATO-AOU CAGLIARI,SAR,16-19,0,1,0,0,1,0,0,1,0,1,Sardegna,ITG2
2021-01-11,PF/BT,20090602,POLICLINICO MONSERRATO-AOU CAGLIARI,SAR,20-29,1,3,0,3,1,0,0,4,0,4,Sardegna,ITG2
2021-01-11,PF/BT,20090602,POLICLINICO MONSERRATO-AOU CAGLIARI,SAR,30-39,7,11,0,12,6,0,0,18,0,18,Sardegna,ITG2
2021-01-11,PF/BT,20090602,POLICLINICO MONSERRATO-AOU CAGLIARI,SAR,40-49,16,20,0,23,13,0,0,36,0,36,Sardegna,ITG2
2021-01-11,PF/BT,20090602,POLICLINICO MONSERRATO-AOU CAGLIARI,SAR,50-59,12,21,0,27,6,0,0,33,0,33,Sardegna,ITG2
2021-01-11,PF/BT,20090602,POLICLINICO MONSERRATO-AOU CAGLIARI,SAR,60-69,9,13,0,17,5,0,0,22,0,22,Sardegna,ITG2
2021-01-12,PF/BT,120010,P.O. GIOVANNI PAOLO II OLBIA,SAR,20-29,8,12,0,10,0,0,10,20,0,20,Sardegna,ITG2
2021-01-12,PF/BT,120010,P.O. GIOVANNI PAOLO II OLBIA,SAR,30-39,20,32,0,34,0,0,18,52,0,52,Sardegna,ITG2
2021-01-12,PF/BT,120010,P.O. GIOVANNI PAOLO II OLBIA,SAR,40-49,20,29,0,31,0,0,18,49,0,49,Sardegna,ITG2
2021-01-12,PF/BT,120010,P.O. GIOVANNI PAOLO II OLBIA,SAR,50-59,12,25,0,25,0,0,12,37,0,37,Sardegna,ITG2
2021-01-12,PF/BT,120010,P.O. GIOVANNI PAOLO II OLBIA,SAR,60-69,7,7,0,10,0,0,4,14,0,14,Sardegna,ITG2
2021-01-12,PF/BT,120010,P.O. GIOVANNI PAOLO II OLBIA,SAR,70-79,2,0,0,2,0,0,0,2,0,2,Sardegna,ITG2
2021-01-12,PF/BT,120011,P.O. PAOLO DETTORI - TEMPIO P.,SAR,30-39,0,1,0,1,0,0,0,1,0,1,Sardegna,ITG2
2021-01-12,PF/BT,120011,P.O. PAOLO DETTORI - TEMPIO P.,SAR,50-59,2,6,0,8,0,0,0,8,0,8,Sardegna,ITG2
2021-01-12,PF/BT,120011,P.O. PAOLO DETTORI - TEMPIO P.,SAR,60-69,2,1,0,3,0,0,0,3,0,3,Sardegna,ITG2
2021-01-12,PF/BT,200031,P.O. SS. TRINITA` CAGLIARI,SAR,20-29,4,9,0,12,1,0,0,13,0,13,Sardegna,ITG2
2021-01-12,PF/BT,200031,P.O. SS. TRINITA` CAGLIARI,SAR,30-39,10,8,0,13,5,0,0,18,0,18,Sardegna,ITG2
2021-01-12,PF/BT,200031,P.O. SS. TRINITA` CAGLIARI,SAR,40-49,18,19,0,19,18,0,0,37,0,37,Sardegna,ITG2
2021-01-12,PF/BT,200031,P.O. SS. TRINITA` CAGLIARI,SAR,50-59,12,26,0,25,13,0,0,38,0,38,Sardegna,ITG2
2021-01-12,PF/BT,200031,P.O. SS. TRINITA` CAGLIARI,SAR,60-69,11,7,0,15,3,0,0,18,0,18,Sardegna,ITG2
2021-01-12,PF/BT,200031,P.O. SS. TRINITA` CAGLIARI,SAR,70-79,2,0,0,2,0,0,0,2,0,2,Sardegna,ITG2
2021-01-12,PF/BT,200036,OSPEDALE BUSINCO,SAR,20-29,1,5,0,5,1,0,0,6,0,6,Sardegna,ITG2
2021-01-12,PF/BT,200036,OSPEDALE BUSINCO,SAR,30-39,3,9,0,11,1,0,0,12,0,12,Sardegna,ITG2
2021-01-12,PF/BT,200036,OSPEDALE BUSINCO,SAR,40-49,4,20,0,18,6,0,0,24,0,24,Sardegna,ITG2
2021-01-12,PF/BT,200036,OSPEDALE BUSINCO,SAR,50-59,15,37,0,46,6,0,0,52,0,52,Sardegna,ITG2
2021-01-12,PF/BT,200036,OSPEDALE BUSINCO,SAR,60-69,12,14,0,23,3,0,0,26,0,26,Sardegna,ITG2
2021-01-12,PF/BT,200904,P.O. SAN MICHELE - AOB,SAR,20-29,1,2,0,3,0,0,0,3,0,3,Sardegna,ITG2
2021-01-12,PF/BT,200904,P.O. SAN MICHELE - AOB,SAR,30-39,7,5,0,11,1,0,0,12,0,12,Sardegna,ITG2
2021-01-12,PF/BT,200904,P.O. SAN MICHELE - AOB,SAR,40-49,5,5,0,9,1,0,0,10,0,10,Sardegna,ITG2
2021-01-12,PF/BT,200904,P.O. SAN MICHELE - AOB,SAR,50-59,6,13,0,17,2,0,0,19,0,19,Sardegna,ITG2
2021-01-12,PF/BT,200904,P.O. SAN MICHELE - AOB,SAR,60-69,11,6,0,13,4,0,0,17,0,17,Sardegna,ITG2
2021-01-12,PF/BT,200905,AZIENDA OSPEDALIERO UNIVERSITARIA DI SAS,SAR,20-29,20,8,0,7,0,0,21,28,0,28,Sardegna,ITG2
2021-01-12,PF/BT,200905,AZIENDA OSPEDALIERO UNIVERSITARIA DI SAS,SAR,30-39,40,12,0,8,0,0,44,52,0,52,Sardegna,ITG2
2021-01-12,PF/BT,200905,AZIENDA OSPEDALIERO UNIVERSITARIA DI SAS,SAR,40-49,43,22,0,20,0,0,45,65,0,65,Sardegna,ITG2
2021-01-12,PF/BT,200905,AZIENDA OSPEDALIERO UNIVERSITARIA DI SAS,SAR,50-59,30,36,0,19,0,0,47,66,0,66,Sardegna,ITG2
2021-01-12,PF/BT,200905,AZIENDA OSPEDALIERO UNIVERSITARIA DI SAS,SAR,60-69,18,10,0,12,0,0,16,28,0,28,Sardegna,ITG2
2021-01-12,PF/BT,200905,AZIENDA OSPEDALIERO UNIVERSITARIA DI SAS,SAR,70-79,1,0,0,0,0,0,1,1,0,1,Sardegna,ITG2
2021-01-12,PF/BT,20090602,POLICLINICO MONSERRATO-AOU CAGLIARI,SAR,20-29,6,7,0,13,0,0,0,13,0,13,Sardegna,ITG2
2021-01-12,PF/BT,20090602,POLICLINICO MONSERRATO-AOU CAGLIARI,SAR,30-39,10,15,0,20,5,0,0,25,0,25,Sardegna,ITG2
2021-01-12,PF/BT,20090602,POLICLINICO MONSERRATO-AOU CAGLIARI,SAR,40-49,6,9,0,12,3,0,0,15,0,15,Sardegna,ITG2
2021-01-12,PF/BT,20090602,POLICLINICO MONSERRATO-AOU CAGLIARI,SAR,50-59,12,16,0,20,8,0,0,28,0,28,Sardegna,ITG2
2021-01-12,PF/BT,20090602,POLICLINICO MONSERRATO-AOU CAGLIARI,SAR,60-69,7,7,0,7,7,0,0,14,0,14,Sardegna,ITG2
2021-01-12,PF/BT,20090602,POLICLINICO MONSERRATO-AOU CAGLIARI,SAR,70-79,1,0,0,1,0,0,0,1,0,1,Sardegna,ITG2
2021-01-12,PF/BT,510100,P.O. SAN MARTINO ORISTANO,SAR,20-29,1,2,0,3,0,0,0,3,0,3,Sardegna,ITG2
2021-01-12,PF/BT,510100,P.O. SAN MARTINO ORISTANO,SAR,30-39,8,7,0,15,0,0,0,15,0,15,Sardegna,ITG2
2021-01-12,PF/BT,510100,P.O. SAN MARTINO ORISTANO,SAR,40-49,3,4,0,7,0,0,0,7,0,7,Sardegna,ITG2
2021-01-12,PF/BT,510100,P.O. SAN MARTINO ORISTANO,SAR,50-59,2,2,0,4,0,0,0,4,0,4,Sardegna,ITG2
2021-01-12,PF/BT,510100,P.O. SAN MARTINO ORISTANO,SAR,60-69,5,2,0,7,0,0,0,7,0,7,Sardegna,ITG2
2021-01-13,PF/BT,200025,P.O. R.BINAGHI CAGLIARI,SAR,20-29,4,1,0,2,3,0,0,5,0,5,Sardegna,ITG2
2021-01-13,PF/BT,200025,P.O. R.BINAGHI CAGLIARI,SAR,30-39,11,4,0,6,9,0,0,15,0,15,Sardegna,ITG2
2021-01-13,PF/BT,200025,P.O. R.BINAGHI CAGLIARI,SAR,40-49,4,12,0,11,5,0,0,16,0,16,Sardegna,ITG2
2021-01-13,PF/BT,200025,P.O. R.BINAGHI CAGLIARI,SAR,50-59,6,13,0,12,7,0,0,19,0,19,Sardegna,ITG2
2021-01-13,PF/BT,200025,P.O. R.BINAGHI CAGLIARI,SAR,60-69,2,21,0,20,3,0,0,23,0,23,Sardegna,ITG2
2021-01-13,PF/BT,200031,P.O. SS. TRINITA` CAGLIARI,SAR,16-19,0,2,0,2,0,0,0,2,0,2,Sardegna,ITG2
2021-01-13,PF/BT,200031,P.O. SS. TRINITA` CAGLIARI,SAR,20-29,11,9,0,19,1,0,0,20,0,20,Sardegna,ITG2
2021-01-13,PF/BT,200031,P.O. SS. TRINITA` CAGLIARI,SAR,30-39,12,9,0,20,1,0,0,21,0,21,Sardegna,ITG2
2021-01-13,PF/BT,200031,P.O. SS. TRINITA` CAGLIARI,SAR,40-49,9,13,0,14,8,0,0,22,0,22,Sardegna,ITG2
2021-01-13,PF/BT,200031,P.O. SS. TRINITA` CAGLIARI,SAR,50-59,8,11,0,17,2,0,0,19,0,19,Sardegna,ITG2
2021-01-13,PF/BT,200031,P.O. SS. TRINITA` CAGLIARI,SAR,60-69,8,9,0,16,1,0,0,17,0,17,Sardegna,ITG2
2021-01-13,PF/BT,200031,P.O. SS. TRINITA` CAGLIARI,SAR,70-79,1,0,0,1,0,0,0,1,0,1,Sardegna,ITG2
2021-01-13,PF/BT,200036,OSPEDALE BUSINCO,SAR,20-29,1,6,0,6,1,0,0,7,0,7,Sardegna,ITG2
2021-01-13,PF/BT,200036,OSPEDALE BUSINCO,SAR,30-39,2,13,0,10,5,0,0,15,0,15,Sardegna,ITG2
2021-01-13,PF/BT,200036,OSPEDALE BUSINCO,SAR,40-49,2,23,0,19,6,0,0,25,0,25,Sardegna,ITG2
2021-01-13,PF/BT,200036,OSPEDALE BUSINCO,SAR,50-59,5,25,0,22,8,0,0,30,0,30,Sardegna,ITG2
2021-01-13,PF/BT,200036,OSPEDALE BUSINCO,SAR,60-69,7,12,0,15,4,0,0,19,0,19,Sardegna,ITG2
2021-01-13,PF/BT,200904,P.O. SAN MICHELE - AOB,SAR,20-29,8,12,0,20,0,0,0,20,0,20,Sardegna,ITG2
2021-01-13,PF/BT,200904,P.O. SAN MICHELE - AOB,SAR,30-39,9,18,0,25,1,0,1,27,0,27,Sardegna,ITG2
2021-01-13,PF/BT,200904,P.O. SAN MICHELE - AOB,SAR,40-49,12,25,0,34,2,0,1,37,0,37,Sardegna,ITG2
2021-01-13,PF/BT,200904,P.O. SAN MICHELE - AOB,SAR,50-59,17,42,0,53,6,0,0,59,0,59,Sardegna,ITG2
2021-01-13,PF/BT,200904,P.O. SAN MICHELE - AOB,SAR,60-69,12,21,0,28,3,0,2,33,0,33,Sardegna,ITG2
2021-01-13,PF/BT,510100,P.O. SAN MARTINO ORISTANO,SAR,20-29,7,3,0,10,0,0,0,10,0,10,Sardegna,ITG2
2021-01-13,PF/BT,510100,P.O. SAN MARTINO ORISTANO,SAR,30-39,9,4,0,13,0,0,0,13,0,13,Sardegna,ITG2
2021-01-13,PF/BT,510100,P.O. SAN MARTINO ORISTANO,SAR,40-49,22,4,0,26,0,0,0,26,0,26,Sardegna,ITG2
2021-01-13,PF/BT,510100,P.O. SAN MARTINO ORISTANO,SAR,50-59,43,8,0,51,0,0,0,51,0,51,Sardegna,ITG2
2021-01-13,PF/BT,510100,P.O. SAN MARTINO ORISTANO,SAR,60-69,12,8,0,20,0,0,0,20,0,20,Sardegna,ITG2
2021-01-14,PF/BT,200022,P.O. SAN GIUSEPPE ISILI,SAR,30-39,1,0,0,1,0,0,0,1,0,1,Sardegna,ITG2
2021-01-14,PF/BT,200022,P.O. SAN GIUSEPPE ISILI,SAR,40-49,1,6,0,7,0,0,0,7,0,7,Sardegna,ITG2
2021-01-14,PF/BT,200022,P.O. SAN GIUSEPPE ISILI,SAR,50-59,6,13,0,19,0,0,0,19,0,19,Sardegna,ITG2
2021-01-14,PF/BT,200022,P.O. SAN GIUSEPPE ISILI,SAR,60-69,3,6,0,9,0,0,0,9,0,9,Sardegna,ITG2
2021-01-14,PF/BT,200025,P.O. R.BINAGHI CAGLIARI,SAR,20-29,0,2,0,2,0,0,0,2,0,2,Sardegna,ITG2
2021-01-14,PF/BT,200025,P.O. R.BINAGHI CAGLIARI,SAR,30-39,3,5,0,8,0,0,0,8,0,8,Sardegna,ITG2
2021-01-14,PF/BT,200025,P.O. R.BINAGHI CAGLIARI,SAR,40-49,5,14,0,16,3,0,0,19,0,19,Sardegna,ITG2
2021-01-14,PF/BT,200025,P.O. R.BINAGHI CAGLIARI,SAR,50-59,19,34,0,51,2,0,0,53,0,53,Sardegna,ITG2
2021-01-14,PF/BT,200025,P.O. R.BINAGHI CAGLIARI,SAR,60-69,51,51,0,100,2,0,0,102,0,102,Sardegna,ITG2
2021-01-14,PF/BT,200025,P.O. R.BINAGHI CAGLIARI,SAR,70-79,1,1,0,2,0,0,0,2,0,2,Sardegna,ITG2
2021-01-14,PF/BT,200026,P.O. MARINO CAGLIARI,SAR,20-29,2,1,0,3,0,0,0,3,0,3,Sardegna,ITG2
2021-01-14,PF/BT,200026,P.O. MARINO CAGLIARI,SAR,30-39,3,9,0,11,1,0,0,12,0,12,Sardegna,ITG2
2021-01-14,PF/BT,200026,P.O. MARINO CAGLIARI,SAR,40-49,6,13,0,19,0,0,0,19,0,19,Sardegna,ITG2
2021-01-14,PF/BT,200026,P.O. MARINO CAGLIARI,SAR,50-59,6,4,0,9,1,0,0,10,0,10,Sardegna,ITG2
2021-01-14,PF/BT,200026,P.O. MARINO CAGLIARI,SAR,60-69,5,4,0,8,1,0,0,9,0,9,Sardegna,ITG2
2021-01-14,PF/BT,200026,P.O. MARINO CAGLIARI,SAR,70-79,7,0,0,7,0,0,0,7,0,7,Sardegna,ITG2
2021-01-14,PF/BT,200031,P.O. SS. TRINITA` CAGLIARI,SAR,20-29,0,1,0,1,0,0,0,1,0,1,Sardegna,ITG2
2021-01-14,PF/BT,200031,P.O. SS. TRINITA` CAGLIARI,SAR,30-39,1,5,0,4,2,0,0,6,0,6,Sardegna,ITG2
2021-01-14,PF/BT,200031,P.O. SS. TRINITA` CAGLIARI,SAR,40-49,8,11,0,16,3,0,0,19,0,19,Sardegna,ITG2
2021-01-14,PF/BT,200031,P.O. SS. TRINITA` CAGLIARI,SAR,50-59,2,12,0,13,1,0,0,14,0,14,Sardegna,ITG2
2021-01-14,PF/BT,200031,P.O. SS. TRINITA` CAGLIARI,SAR,60-69,2,6,0,6,2,0,0,8,0,8,Sardegna,ITG2
2021-01-14,PF/BT,200034,PRESIDIO OSPEDALIERO N.S. DI BONARIA,SAR,20-29,1,11,0,12,0,0,0,12,0,12,Sardegna,ITG2
2021-01-14,PF/BT,200034,PRESIDIO OSPEDALIERO N.S. DI BONARIA,SAR,30-39,7,18,0,25,0,0,0,25,0,25,Sardegna,ITG2
2021-01-14,PF/BT,200034,PRESIDIO OSPEDALIERO N.S. DI BONARIA,SAR,40-49,1,22,0,23,0,0,0,23,0,23,Sardegna,ITG2
2021-01-14,PF/BT,200034,PRESIDIO OSPEDALIERO N.S. DI BONARIA,SAR,50-59,11,39,0,49,1,0,0,50,0,50,Sardegna,ITG2
2021-01-14,PF/BT,200034,PRESIDIO OSPEDALIERO N.S. DI BONARIA,SAR,60-69,6,4,0,9,1,0,0,10,0,10,Sardegna,ITG2
2021-01-14,PF/BT,200035,P.O. SAN MARCELLINO MURAVERA,SAR,20-29,2,2,0,4,0,0,0,4,0,4,Sardegna,ITG2
2021-01-14,PF/BT,200035,P.O. SAN MARCELLINO MURAVERA,SAR,30-39,2,0,0,2,0,0,0,2,0,2,Sardegna,ITG2
2021-01-14,PF/BT,200035,P.O. SAN MARCELLINO MURAVERA,SAR,40-49,3,2,0,4,1,0,0,5,0,5,Sardegna,ITG2
2021-01-14,PF/BT,200035,P.O. SAN MARCELLINO MURAVERA,SAR,50-59,4,13,0,16,1,0,0,17,0,17,Sardegna,ITG2
2021-01-14,PF/BT,200035,P.O. SAN MARCELLINO MURAVERA,SAR,60-69,4,4,0,8,0,0,0,8,0,8,Sardegna,ITG2
2021-01-14,PF/BT,200036,OSPEDALE BUSINCO,SAR,30-39,4,7,0,5,6,0,0,11,0,11,Sardegna,ITG2
2021-01-14,PF/BT,200036,OSPEDALE BUSINCO,SAR,40-49,7,19,0,11,15,0,0,26,0,26,Sardegna,ITG2
2021-01-14,PF/BT,200036,OSPEDALE BUSINCO,SAR,50-59,12,33,0,29,16,0,0,45,0,45,Sardegna,ITG2
2021-01-14,PF/BT,200036,OSPEDALE BUSINCO,SAR,60-69,13,12,0,12,13,0,0,25,0,25,Sardegna,ITG2
2021-01-14,PF/BT,200904,P.O. SAN MICHELE - AOB,SAR,20-29,4,8,0,11,1,0,0,12,0,12,Sardegna,ITG2
2021-01-14,PF/BT,200904,P.O. SAN MICHELE - AOB,SAR,30-39,19,16,0,27,8,0,0,35,0,35,Sardegna,ITG2
2021-01-14,PF/BT,200904,P.O. SAN MICHELE - AOB,SAR,40-49,18,14,0,21,10,0,1,32,0,32,Sardegna,ITG2
2021-01-14,PF/BT,200904,P.O. SAN MICHELE - AOB,SAR,50-59,19,37,0,44,12,0,0,56,0,56,Sardegna,ITG2
2021-01-14,PF/BT,200904,P.O. SAN MICHELE - AOB,SAR,60-69,8,15,0,16,7,0,0,23,0,23,Sardegna,ITG2
2021-01-14,PF/BT,200905,AZIENDA OSPEDALIERO UNIVERSITARIA DI SAS,SAR,20-29,6,4,0,6,0,0,4,10,0,10,Sardegna,ITG2
2021-01-14,PF/BT,200905,AZIENDA OSPEDALIERO UNIVERSITARIA DI SAS,SAR,30-39,10,5,0,6,0,0,9,15,0,15,Sardegna,ITG2
2021-01-14,PF/BT,200905,AZIENDA OSPEDALIERO UNIVERSITARIA DI SAS,SAR,40-49,15,9,0,5,0,0,19,24,0,24,Sardegna,ITG2
2021-01-14,PF/BT,200905,AZIENDA OSPEDALIERO UNIVERSITARIA DI SAS,SAR,50-59,10,11,0,11,0,0,10,21,0,21,Sardegna,ITG2
2021-01-14,PF/BT,200905,AZIENDA OSPEDALIERO UNIVERSITARIA DI SAS,SAR,60-69,2,4,0,0,0,0,6,6,0,6,Sardegna,ITG2
2021-01-14,PF/BT,20090602,POLICLINICO MONSERRATO-AOU CAGLIARI,SAR,20-29,35,31,0,66,0,0,0,66,0,66,Sardegna,ITG2
2021-01-14,PF/BT,20090602,POLICLINICO MONSERRATO-AOU CAGLIARI,SAR,30-39,29,51,0,79,1,0,0,80,0,80,Sardegna,ITG2
2021-01-14,PF/BT,20090602,POLICLINICO MONSERRATO-AOU CAGLIARI,SAR,40-49,3,2,0,5,0,0,0,5,0,5,Sardegna,ITG2
2021-01-14,PF/BT,20090602,POLICLINICO MONSERRATO-AOU CAGLIARI,SAR,50-59,0,1,0,1,0,0,0,1,0,1,Sardegna,ITG2
2021-01-14,PF/BT,20090602,POLICLINICO MONSERRATO-AOU CAGLIARI,SAR,60-69,2,0,0,1,1,0,0,2,0,2,Sardegna,ITG2
2021-01-14,PF/BT,20090602,POLICLINICO MONSERRATO-AOU CAGLIARI,SAR,70-79,1,1,0,2,0,0,0,2,0,2,Sardegna,ITG2
2021-01-14,PF/BT,510100,P.O. SAN MARTINO ORISTANO,SAR,20-29,2,3,0,5,0,0,0,5,0,5,Sardegna,ITG2
2021-01-14,PF/BT,510100,P.O. SAN MARTINO ORISTANO,SAR,30-39,4,5,0,4,5,0,0,9,0,9,Sardegna,ITG2
2021-01-14,PF/BT,510100,P.O. SAN MARTINO ORISTANO,SAR,40-49,11,29,0,20,20,0,0,40,0,40,Sardegna,ITG2
2021-01-14,PF/BT,510100,P.O. SAN MARTINO ORISTANO,SAR,50-59,10,33,0,21,22,0,0,43,0,43,Sardegna,ITG2
2021-01-14,PF/BT,510100,P.O. SAN MARTINO ORISTANO,SAR,60-69,5,12,0,9,8,0,0,17,0,17,Sardegna,ITG2
2021-01-15,PF/BT,101,P.O.  SAN FRANCESCO,SAR,20-29,4,19,0,23,0,0,0,23,0,23,Sardegna,ITG2
2021-01-15,PF/BT,101,P.O.  SAN FRANCESCO,SAR,30-39,10,38,0,46,2,0,0,48,0,48,Sardegna,ITG2
2021-01-15,PF/BT,101,P.O.  SAN FRANCESCO,SAR,40-49,21,47,0,59,9,0,0,68,0,68,Sardegna,ITG2
2021-01-15,PF/BT,101,P.O.  SAN FRANCESCO,SAR,50-59,32,89,0,112,9,0,0,121,0,121,Sardegna,ITG2
2021-01-15,PF/BT,101,P.O.  SAN FRANCESCO,SAR,60-69,15,30,0,44,1,0,0,45,0,45,Sardegna,ITG2
2021-01-15,PF/BT,110125,P.O. PAOLO MERLO LA MADDALENA,SAR,30-39,0,1,0,1,0,0,0,1,0,1,Sardegna,ITG2
2021-01-15,PF/BT,110125,P.O. PAOLO MERLO LA MADDALENA,SAR,40-49,0,3,0,3,0,0,0,3,0,3,Sardegna,ITG2
2021-01-15,PF/BT,110125,P.O. PAOLO MERLO LA MADDALENA,SAR,50-59,0,5,0,5,0,0,0,5,0,5,Sardegna,ITG2
2021-01-15,PF/BT,110125,P.O. PAOLO MERLO LA MADDALENA,SAR,60-69,4,4,0,8,0,0,0,8,0,8,Sardegna,ITG2
2021-01-15,PF/BT,110125,P.O. PAOLO MERLO LA MADDALENA,SAR,70-79,1,0,0,1,0,0,0,1,0,1,Sardegna,ITG2
2021-01-15,PF/BT,120010,P.O. GIOVANNI PAOLO II OLBIA,SAR,16-19,1,0,0,0,0,0,1,1,0,1,Sardegna,ITG2
2021-01-15,PF/BT,120010,P.O. GIOVANNI PAOLO II OLBIA,SAR,20-29,3,5,0,7,0,0,1,8,0,8,Sardegna,ITG2
2021-01-15,PF/BT,120010,P.O. GIOVANNI PAOLO II OLBIA,SAR,30-39,10,11,0,14,0,0,7,21,0,21,Sardegna,ITG2
2021-01-15,PF/BT,120010,P.O. GIOVANNI PAOLO II OLBIA,SAR,40-49,10,20,0,24,0,0,6,30,0,30,Sardegna,ITG2
2021-01-15,PF/BT,120010,P.O. GIOVANNI PAOLO II OLBIA,SAR,50-59,9,22,0,22,0,0,9,31,0,31,Sardegna,ITG2
2021-01-15,PF/BT,120010,P.O. GIOVANNI PAOLO II OLBIA,SAR,60-69,1,10,0,10,0,0,1,11,0,11,Sardegna,ITG2
2021-01-15,PF/BT,120011,P.O. PAOLO DETTORI - TEMPIO P.,SAR,20-29,1,0,0,0,0,0,1,1,0,1,Sardegna,ITG2
2021-01-15,PF/BT,120011,P.O. PAOLO DETTORI - TEMPIO P.,SAR,30-39,2,0,0,2,0,0,0,2,0,2,Sardegna,ITG2
2021-01-15,PF/BT,120011,P.O. PAOLO DETTORI - TEMPIO P.,SAR,40-49,2,5,0,3,0,0,4,7,0,7,Sardegna,ITG2
2021-01-15,PF/BT,120011,P.O. PAOLO DETTORI - TEMPIO P.,SAR,50-59,4,9,0,8,0,0,5,13,0,13,Sardegna,ITG2
2021-01-15,PF/BT,120011,P.O. PAOLO DETTORI - TEMPIO P.,SAR,60-69,4,3,0,3,0,0,4,7,0,7,Sardegna,ITG2
2021-01-15,PF/BT,200003,OSPEDALE CIVILE OZIERI,SAR,20-29,6,5,0,6,5,0,0,11,0,11,Sardegna,ITG2
2021-01-15,PF/BT,200003,OSPEDALE CIVILE OZIERI,SAR,30-39,2,11,0,7,6,0,0,13,0,13,Sardegna,ITG2
2021-01-15,PF/BT,200003,OSPEDALE CIVILE OZIERI,SAR,40-49,7,24,0,20,11,0,0,31,0,31,Sardegna,ITG2
2021-01-15,PF/BT,200003,OSPEDALE CIVILE OZIERI,SAR,50-59,11,24,0,21,14,0,0,35,0,35,Sardegna,ITG2
2021-01-15,PF/BT,200003,OSPEDALE CIVILE OZIERI,SAR,60-69,7,11,0,11,7,0,0,18,0,18,Sardegna,ITG2
2021-01-15,PF/BT,200022,P.O. SAN GIUSEPPE ISILI,SAR,30-39,0,6,0,5,1,0,0,6,0,6,Sardegna,ITG2
2021-01-15,PF/BT,200022,P.O. SAN GIUSEPPE ISILI,SAR,40-49,4,3,0,5,2,0,0,7,0,7,Sardegna,ITG2
2021-01-15,PF/BT,200022,P.O. SAN GIUSEPPE ISILI,SAR,50-59,3,18,0,19,2,0,0,21,0,21,Sardegna,ITG2
2021-01-15,PF/BT,200022,P.O. SAN GIUSEPPE ISILI,SAR,60-69,2,6,0,5,3,0,0,8,0,8,Sardegna,ITG2
2021-01-15,PF/BT,200025,P.O. R.BINAGHI CAGLIARI,SAR,16-19,1,0,0,1,0,0,0,1,0,1,Sardegna,ITG2
2021-01-15,PF/BT,200025,P.O. R.BINAGHI CAGLIARI,SAR,20-29,2,11,0,9,4,0,0,13,0,13,Sardegna,ITG2
2021-01-15,PF/BT,200025,P.O. R.BINAGHI CAGLIARI,SAR,30-39,11,16,0,18,9,0,0,27,0,27,Sardegna,ITG2
2021-01-15,PF/BT,200025,P.O. R.BINAGHI CAGLIARI,SAR,40-49,11,25,0,30,6,0,0,36,0,36,Sardegna,ITG2
2021-01-15,PF/BT,200025,P.O. R.BINAGHI CAGLIARI,SAR,50-59,11,28,0,27,12,0,0,39,0,39,Sardegna,ITG2
2021-01-15,PF/BT,200025,P.O. R.BINAGHI CAGLIARI,SAR,60-69,31,27,0,52,6,0,0,58,0,58,Sardegna,ITG2
2021-01-15,PF/BT,200025,P.O. R.BINAGHI CAGLIARI,SAR,70-79,6,0,0,6,0,0,0,6,0,6,Sardegna,ITG2
2021-01-15,PF/BT,200026,P.O. MARINO CAGLIARI,SAR,20-29,5,7,0,11,1,0,0,12,0,12,Sardegna,ITG2
2021-01-15,PF/BT,200026,P.O. MARINO CAGLIARI,SAR,30-39,6,11,0,14,3,0,0,17,0,17,Sardegna,ITG2
2021-01-15,PF/BT,200026,P.O. MARINO CAGLIARI,SAR,40-49,11,18,0,22,7,0,0,29,0,29,Sardegna,ITG2
2021-01-15,PF/BT,200026,P.O. MARINO CAGLIARI,SAR,50-59,4,9,0,9,4,0,0,13,0,13,Sardegna,ITG2
2021-01-15,PF/BT,200026,P.O. MARINO CAGLIARI,SAR,60-69,5,4,0,9,0,0,0,9,0,9,Sardegna,ITG2
2021-01-15,PF/BT,200026,P.O. MARINO CAGLIARI,SAR,70-79,4,0,0,4,0,0,0,4,0,4,Sardegna,ITG2
2021-01-15,PF/BT,200031,P.O. SS. TRINITA` CAGLIARI,SAR,20-29,0,2,0,1,1,0,0,2,0,2,Sardegna,ITG2
2021-01-15,PF/BT,200031,P.O. SS. TRINITA` CAGLIARI,SAR,30-39,7,9,0,12,4,0,0,16,0,16,Sardegna,ITG2
2021-01-15,PF/BT,200031,P.O. SS. TRINITA` CAGLIARI,SAR,40-49,9,14,0,22,1,0,0,23,0,23,Sardegna,ITG2
2021-01-15,PF/BT,200031,P.O. SS. TRINITA` CAGLIARI,SAR,50-59,18,15,0,32,1,0,0,33,0,33,Sardegna,ITG2
2021-01-15,PF/BT,200031,P.O. SS. TRINITA` CAGLIARI,SAR,60-69,12,16,0,22,6,0,0,28,0,28,Sardegna,ITG2
2021-01-15,PF/BT,200031,P.O. SS. TRINITA` CAGLIARI,SAR,70-79,6,0,0,6,0,0,0,6,0,6,Sardegna,ITG2
2021-01-15,PF/BT,200035,P.O. SAN MARCELLINO MURAVERA,SAR,20-29,1,3,0,4,0,0,0,4,0,4,Sardegna,ITG2
2021-01-15,PF/BT,200035,P.O. SAN MARCELLINO MURAVERA,SAR,30-39,1,1,0,2,0,0,0,2,0,2,Sardegna,ITG2
2021-01-15,PF/BT,200035,P.O. SAN MARCELLINO MURAVERA,SAR,40-49,1,6,0,5,2,0,0,7,0,7,Sardegna,ITG2
2021-01-15,PF/BT,200035,P.O. SAN MARCELLINO MURAVERA,SAR,50-59,8,10,0,15,3,0,0,18,0,18,Sardegna,ITG2
2021-01-15,PF/BT,200035,P.O. SAN MARCELLINO MURAVERA,SAR,60-69,2,3,0,5,0,0,0,5,0,5,Sardegna,ITG2
2021-01-15,PF/BT,200052,P. OSPEDALIERO 'SAN MARTINO' - ORISTANO,SAR,20-29,2,1,0,1,2,0,0,3,0,3,Sardegna,ITG2
2021-01-15,PF/BT,200052,P. OSPEDALIERO 'SAN MARTINO' - ORISTANO,SAR,30-39,2,3,0,1,4,0,0,5,0,5,Sardegna,ITG2
2021-01-15,PF/BT,200052,P. OSPEDALIERO 'SAN MARTINO' - ORISTANO,SAR,40-49,6,3,0,3,6,0,0,9,0,9,Sardegna,ITG2
2021-01-15,PF/BT,200052,P. OSPEDALIERO 'SAN MARTINO' - ORISTANO,SAR,50-59,10,1,0,2,9,0,0,11,0,11,Sardegna,ITG2
2021-01-15,PF/BT,200052,P. OSPEDALIERO 'SAN MARTINO' - ORISTANO,SAR,60-69,6,2,0,2,6,0,0,8,0,8,Sardegna,ITG2
2021-01-15,PF/BT,200904,P.O. SAN MICHELE - AOB,SAR,20-29,4,4,0,4,4,0,0,8,0,8,Sardegna,ITG2
2021-01-15,PF/BT,200904,P.O. SAN MICHELE - AOB,SAR,30-39,25,9,0,14,20,0,0,34,0,34,Sardegna,ITG2
2021-01-15,PF/BT,200904,P.O. SAN MICHELE - AOB,SAR,40-49,14,20,0,12,22,0,0,34,0,34,Sardegna,ITG2
2021-01-15,PF/BT,200904,P.O. SAN MICHELE - AOB,SAR,50-59,19,24,0,23,20,0,0,43,0,43,Sardegna,ITG2
2021-01-15,PF/BT,200904,P.O. SAN MICHELE - AOB,SAR,60-69,10,9,0,7,12,0,0,19,0,19,Sardegna,ITG2
2021-01-15,PF/BT,20090602,POLICLINICO MONSERRATO-AOU CAGLIARI,SAR,20-29,14,9,0,23,0,0,0,23,0,23,Sardegna,ITG2
2021-01-15,PF/BT,20090602,POLICLINICO MONSERRATO-AOU CAGLIARI,SAR,30-39,14,14,0,26,2,0,0,28,0,28,Sardegna,ITG2
2021-01-15,PF/BT,20090602,POLICLINICO MONSERRATO-AOU CAGLIARI,SAR,40-49,4,13,0,12,5,0,0,17,0,17,Sardegna,ITG2
2021-01-15,PF/BT,20090602,POLICLINICO MONSERRATO-AOU CAGLIARI,SAR,50-59,2,10,0,9,3,0,0,12,0,12,Sardegna,ITG2
2021-01-15,PF/BT,20090602,POLICLINICO MONSERRATO-AOU CAGLIARI,SAR,60-69,2,8,0,9,1,0,0,10,0,10,Sardegna,ITG2
2021-01-15,PF/BT,30101,P.O. SAN CAMILLO - AMBULATORIO,SAR,30-39,0,2,0,2,0,0,0,2,0,2,Sardegna,ITG2
2021-01-15,PF/BT,30101,P.O. SAN CAMILLO - AMBULATORIO,SAR,40-49,3,18,0,20,1,0,0,21,0,21,Sardegna,ITG2
2021-01-15,PF/BT,30101,P.O. SAN CAMILLO - AMBULATORIO,SAR,50-59,16,47,0,56,7,0,0,63,0,63,Sardegna,ITG2
2021-01-15,PF/BT,30101,P.O. SAN CAMILLO - AMBULATORIO,SAR,60-69,9,13,0,20,2,0,0,22,0,22,Sardegna,ITG2
2021-01-16,PF/BT,10036,SISP-SASSARI COVID,SAR,20-29,1,14,0,14,1,0,0,15,0,15,Sardegna,ITG2
2021-01-16,PF/BT,10036,SISP-SASSARI COVID,SAR,30-39,23,23,0,44,2,0,0,46,0,46,Sardegna,ITG2
2021-01-16,PF/BT,10036,SISP-SASSARI COVID,SAR,40-49,11,44,0,49,5,0,1,55,0,55,Sardegna,ITG2
2021-01-16,PF/BT,10036,SISP-SASSARI COVID,SAR,50-59,22,62,0,73,10,0,1,84,0,84,Sardegna,ITG2
2021-01-16,PF/BT,10036,SISP-SASSARI COVID,SAR,60-69,39,51,0,86,3,0,1,90,0,90,Sardegna,ITG2
2021-01-16,PF/BT,10036,SISP-SASSARI COVID,SAR,70-79,3,1,0,3,0,0,1,4,0,4,Sardegna,ITG2
2021-01-16,PF/BT,101,P.O.  SAN FRANCESCO,SAR,20-29,2,2,0,2,2,0,0,4,0,4,Sardegna,ITG2
2021-01-16,PF/BT,101,P.O.  SAN FRANCESCO,SAR,30-39,5,5,0,10,0,0,0,10,0,10,Sardegna,ITG2
2021-01-16,PF/BT,101,P.O.  SAN FRANCESCO,SAR,40-49,7,12,0,18,1,0,0,19,0,19,Sardegna,ITG2
2021-01-16,PF/BT,101,P.O.  SAN FRANCESCO,SAR,50-59,3,19,0,20,2,0,0,22,0,22,Sardegna,ITG2
2021-01-16,PF/BT,101,P.O.  SAN FRANCESCO,SAR,60-69,1,9,0,7,3,0,0,10,0,10,Sardegna,ITG2
2021-01-16,PF/BT,101,P.O.  SAN FRANCESCO,SAR,70-79,1,0,0,1,0,0,0,1,0,1,Sardegna,ITG2
2021-01-16,PF/BT,110125,P.O. PAOLO MERLO LA MADDALENA,SAR,30-39,1,1,0,2,0,0,0,2,0,2,Sardegna,ITG2
2021-01-16,PF/BT,110125,P.O. PAOLO MERLO LA MADDALENA,SAR,40-49,2,6,0,5,3,0,0,8,0,8,Sardegna,ITG2
2021-01-16,PF/BT,110125,P.O. PAOLO MERLO LA MADDALENA,SAR,50-59,2,10,0,11,1,0,0,12,0,12,Sardegna,ITG2
2021-01-16,PF/BT,110125,P.O. PAOLO MERLO LA MADDALENA,SAR,60-69,1,4,0,5,0,0,0,5,0,5,Sardegna,ITG2
2021-01-16,PF/BT,120011,P.O. PAOLO DETTORI - TEMPIO P.,SAR,20-29,3,1,0,1,0,0,3,4,0,4,Sardegna,ITG2
2021-01-16,PF/BT,120011,P.O. PAOLO DETTORI - TEMPIO P.,SAR,30-39,6,5,0,4,0,0,7,11,0,11,Sardegna,ITG2
2021-01-16,PF/BT,120011,P.O. PAOLO DETTORI - TEMPIO P.,SAR,40-49,4,5,0,2,0,0,7,9,0,9,Sardegna,ITG2
2021-01-16,PF/BT,120011,P.O. PAOLO DETTORI - TEMPIO P.,SAR,50-59,4,5,0,1,0,0,8,9,0,9,Sardegna,ITG2
2021-01-16,PF/BT,120011,P.O. PAOLO DETTORI - TEMPIO P.,SAR,60-69,1,2,0,1,0,0,2,3,0,3,Sardegna,ITG2
2021-01-16,PF/BT,200002,OSPEDALE CIVILE ALGHERO,SAR,20-29,0,1,0,1,0,0,0,1,0,1,Sardegna,ITG2
2021-01-16,PF/BT,200002,OSPEDALE CIVILE ALGHERO,SAR,30-39,5,2,0,3,4,0,0,7,0,7,Sardegna,ITG2
2021-01-16,PF/BT,200002,OSPEDALE CIVILE ALGHERO,SAR,40-49,6,8,0,10,4,0,0,14,0,14,Sardegna,ITG2
2021-01-16,PF/BT,200002,OSPEDALE CIVILE ALGHERO,SAR,50-59,1,8,0,8,1,0,0,9,0,9,Sardegna,ITG2
2021-01-16,PF/BT,200002,OSPEDALE CIVILE ALGHERO,SAR,60-69,1,4,0,4,1,0,0,5,0,5,Sardegna,ITG2
2021-01-16,PF/BT,200022,P.O. SAN GIUSEPPE ISILI,SAR,30-39,1,3,0,1,3,0,0,4,0,4,Sardegna,ITG2
2021-01-16,PF/BT,200022,P.O. SAN GIUSEPPE ISILI,SAR,40-49,3,6,0,2,7,0,0,9,0,9,Sardegna,ITG2
2021-01-16,PF/BT,200022,P.O. SAN GIUSEPPE ISILI,SAR,50-59,6,12,0,13,5,0,0,18,0,18,Sardegna,ITG2
2021-01-16,PF/BT,200022,P.O. SAN GIUSEPPE ISILI,SAR,60-69,4,7,0,9,2,0,0,11,0,11,Sardegna,ITG2
2021-01-16,PF/BT,200025,P.O. R.BINAGHI CAGLIARI,SAR,20-29,6,11,0,17,0,0,0,17,0,17,Sardegna,ITG2
2021-01-16,PF/BT,200025,P.O. R.BINAGHI CAGLIARI,SAR,30-39,6,8,0,10,4,0,0,14,0,14,Sardegna,ITG2
2021-01-16,PF/BT,200025,P.O. R.BINAGHI CAGLIARI,SAR,40-49,6,6,0,9,3,0,0,12,0,12,Sardegna,ITG2
2021-01-16,PF/BT,200025,P.O. R.BINAGHI CAGLIARI,SAR,50-59,9,26,0,32,3,0,0,35,0,35,Sardegna,ITG2
2021-01-16,PF/BT,200025,P.O. R.BINAGHI CAGLIARI,SAR,60-69,20,22,0,42,0,0,0,42,0,42,Sardegna,ITG2
2021-01-16,PF/BT,200026,P.O. MARINO CAGLIARI,SAR,20-29,1,3,0,1,3,0,0,4,0,4,Sardegna,ITG2
2021-01-16,PF/BT,200026,P.O. MARINO CAGLIARI,SAR,30-39,5,14,0,11,8,0,0,19,0,19,Sardegna,ITG2
2021-01-16,PF/BT,200026,P.O. MARINO CAGLIARI,SAR,40-49,9,10,0,9,10,0,0,19,0,19,Sardegna,ITG2
2021-01-16,PF/BT,200026,P.O. MARINO CAGLIARI,SAR,50-59,1,6,0,5,2,0,0,7,0,7,Sardegna,ITG2
2021-01-16,PF/BT,200026,P.O. MARINO CAGLIARI,SAR,60-69,3,4,0,4,3,0,0,7,0,7,Sardegna,ITG2
2021-01-16,PF/BT,200026,P.O. MARINO CAGLIARI,SAR,70-79,2,0,0,2,0,0,0,2,0,2,Sardegna,ITG2
2021-01-16,PF/BT,200026,P.O. MARINO CAGLIARI,SAR,80-89,2,0,0,1,1,0,0,2,0,2,Sardegna,ITG2
2021-01-16,PF/BT,200031,P.O. SS. TRINITA` CAGLIARI,SAR,20-29,2,4,0,6,0,0,0,6,0,6,Sardegna,ITG2
2021-01-16,PF/BT,200031,P.O. SS. TRINITA` CAGLIARI,SAR,30-39,5,4,0,9,0,0,0,9,0,9,Sardegna,ITG2
2021-01-16,PF/BT,200031,P.O. SS. TRINITA` CAGLIARI,SAR,40-49,8,14,0,22,0,0,0,22,0,22,Sardegna,ITG2
2021-01-16,PF/BT,200031,P.O. SS. TRINITA` CAGLIARI,SAR,50-59,5,10,0,15,0,0,0,15,0,15,Sardegna,ITG2
2021-01-16,PF/BT,200031,P.O. SS. TRINITA` CAGLIARI,SAR,60-69,7,3,0,10,0,0,0,10,0,10,Sardegna,ITG2
2021-01-16,PF/BT,200031,P.O. SS. TRINITA` CAGLIARI,SAR,70-79,4,0,0,4,0,0,0,4,0,4,Sardegna,ITG2
2021-01-16,PF/BT,200034,PRESIDIO OSPEDALIERO N.S. DI BONARIA,SAR,20-29,7,10,0,14,3,0,0,17,0,17,Sardegna,ITG2
2021-01-16,PF/BT,200034,PRESIDIO OSPEDALIERO N.S. DI BONARIA,SAR,30-39,5,7,0,5,7,0,0,12,0,12,Sardegna,ITG2
2021-01-16,PF/BT,200034,PRESIDIO OSPEDALIERO N.S. DI BONARIA,SAR,40-49,4,8,0,3,9,0,0,12,0,12,Sardegna,ITG2
2021-01-16,PF/BT,200034,PRESIDIO OSPEDALIERO N.S. DI BONARIA,SAR,50-59,7,9,0,11,5,0,0,16,0,16,Sardegna,ITG2
2021-01-16,PF/BT,200034,PRESIDIO OSPEDALIERO N.S. DI BONARIA,SAR,60-69,3,6,0,8,1,0,0,9,0,9,Sardegna,ITG2
2021-01-16,PF/BT,510100,P. OSPEDALIERO 'SAN MARTINO' - ORISTANO,SAR,20-29,5,3,0,8,0,0,0,8,0,8,Sardegna,ITG2
2021-01-16,PF/BT,510100,P. OSPEDALIERO 'SAN MARTINO' - ORISTANO,SAR,30-39,8,9,0,15,2,0,0,17,0,17,Sardegna,ITG2
2021-01-16,PF/BT,510100,P. OSPEDALIERO 'SAN MARTINO' - ORISTANO,SAR,40-49,8,13,0,16,5,0,0,21,0,21,Sardegna,ITG2
2021-01-16,PF/BT,510100,P. OSPEDALIERO 'SAN MARTINO' - ORISTANO,SAR,50-59,8,28,0,31,5,0,0,36,0,36,Sardegna,ITG2
2021-01-16,PF/BT,510100,P. OSPEDALIERO 'SAN MARTINO' - ORISTANO,SAR,60-69,3,15,0,16,2,0,0,18,0,18,Sardegna,ITG2
2021-01-16,PF/BT,510100,P. OSPEDALIERO 'SAN MARTINO' - ORISTANO,SAR,70-79,2,0,0,1,1,0,0,2,0,2,Sardegna,ITG2
2021-01-16,PF/BT,520403,AMB P.O. 'A.G. MASTINO' - BOSA,SAR,20-29,0,2,0,2,0,0,0,2,0,2,Sardegna,ITG2
2021-01-16,PF/BT,520403,AMB P.O. 'A.G. MASTINO' - BOSA,SAR,30-39,1,10,0,9,2,0,0,11,0,11,Sardegna,ITG2
2021-01-16,PF/BT,520403,AMB P.O. 'A.G. MASTINO' - BOSA,SAR,40-49,5,21,0,24,2,0,0,26,0,26,Sardegna,ITG2
2021-01-16,PF/BT,520403,AMB P.O. 'A.G. MASTINO' - BOSA,SAR,50-59,8,32,0,33,7,0,0,40,0,40,Sardegna,ITG2
2021-01-16,PF/BT,520403,AMB P.O. 'A.G. MASTINO' - BOSA,SAR,60-69,9,14,0,15,8,0,0,23,0,23,Sardegna,ITG2
2021-01-16,PF/BT,70001,PVT IGLESIAS,SAR,20-29,6,8,0,13,1,0,0,14,0,14,Sardegna,ITG2
2021-01-16,PF/BT,70001,PVT IGLESIAS,SAR,30-39,19,23,0,35,7,0,0,42,0,42,Sardegna,ITG2
2021-01-16,PF/BT,70001,PVT IGLESIAS,SAR,40-49,31,57,0,76,12,0,0,88,0,88,Sardegna,ITG2
2021-01-16,PF/BT,70001,PVT IGLESIAS,SAR,50-59,63,143,0,197,9,0,0,206,0,206,Sardegna,ITG2
2021-01-16,PF/BT,70001,PVT IGLESIAS,SAR,60-69,52,70,0,122,0,0,0,122,0,122,Sardegna,ITG2
2021-01-16,PF/BT,70001,PVT IGLESIAS,SAR,70-79,1,0,0,1,0,0,0,1,0,1,Sardegna,ITG2
2021-01-17,PF/BT,10036,SISP-SASSARI COVID,SAR,20-29,3,12,0,14,1,0,0,15,0,15,Sardegna,ITG2
2021-01-17,PF/BT,10036,SISP-SASSARI COVID,SAR,30-39,11,32,0,38,5,0,0,42,1,43,Sardegna,ITG2
2021-01-17,PF/BT,10036,SISP-SASSARI COVID,SAR,40-49,13,69,0,69,13,0,0,82,0,82,Sardegna,ITG2
2021-01-17,PF/BT,10036,SISP-SASSARI COVID,SAR,50-59,26,75,0,86,15,0,0,101,0,101,Sardegna,ITG2
2021-01-17,PF/BT,10036,SISP-SASSARI COVID,SAR,60-69,38,54,0,88,4,0,0,92,0,92,Sardegna,ITG2
2021-01-17,PF/BT,10036,SISP-SASSARI COVID,SAR,70-79,1,2,0,3,0,0,0,3,0,3,Sardegna,ITG2
2021-01-17,PF/BT,510100,P.O. SAN MARTINO ORISTANO,SAR,20-29,2,11,0,8,5,0,0,13,0,13,Sardegna,ITG2
2021-01-17,PF/BT,510100,P.O. SAN MARTINO ORISTANO,SAR,30-39,5,8,0,8,5,0,0,13,0,13,Sardegna,ITG2
2021-01-17,PF/BT,510100,P.O. SAN MARTINO ORISTANO,SAR,40-49,9,12,0,11,10,0,0,21,0,21,Sardegna,ITG2
2021-01-17,PF/BT,510100,P.O. SAN MARTINO ORISTANO,SAR,50-59,10,19,0,18,11,0,0,29,0,29,Sardegna,ITG2
2021-01-17,PF/BT,510100,P.O. SAN MARTINO ORISTANO,SAR,60-69,9,8,0,11,6,0,0,17,0,17,Sardegna,ITG2
2021-01-17,PF/BT,510100,P.O. SAN MARTINO ORISTANO,SAR,70-79,2,1,0,2,1,0,0,3,0,3,Sardegna,ITG2
2021-01-17,PF/BT,520403,AMB P.O. 'A.G. MASTINO' - BOSA,SAR,20-29,1,0,0,0,1,0,0,1,0,1,Sardegna,ITG2
2021-01-17,PF/BT,520403,AMB P.O. 'A.G. MASTINO' - BOSA,SAR,30-39,3,2,0,1,4,0,0,5,0,5,Sardegna,ITG2
2021-01-17,PF/BT,520403,AMB P.O. 'A.G. MASTINO' - BOSA,SAR,40-49,10,16,0,10,16,0,0,26,0,26,Sardegna,ITG2
2021-01-17,PF/BT,520403,AMB P.O. 'A.G. MASTINO' - BOSA,SAR,50-59,10,23,0,22,11,0,0,33,0,33,Sardegna,ITG2
2021-01-17,PF/BT,520403,AMB P.O. 'A.G. MASTINO' - BOSA,SAR,60-69,7,12,0,12,7,0,0,19,0,19,Sardegna,ITG2
2021-01-17,PF/BT,70001,PVT IGLESIAS,SAR,20-29,4,5,0,8,0,0,1,9,0,9,Sardegna,ITG2
2021-01-17,PF/BT,70001,PVT IGLESIAS,SAR,30-39,10,17,0,25,0,0,2,27,0,27,Sardegna,ITG2
2021-01-17,PF/BT,70001,PVT IGLESIAS,SAR,40-49,21,52,0,71,0,0,2,73,0,73,Sardegna,ITG2
2021-01-17,PF/BT,70001,PVT IGLESIAS,SAR,50-59,43,100,0,140,1,0,2,143,0,143,Sardegna,ITG2
2021-01-17,PF/BT,70001,PVT IGLESIAS,SAR,60-69,39,52,0,91,0,0,0,91,0,91,Sardegna,ITG2
