TML_DTA_SOMM,TML_VAX_FORNITORE,TML_COD_STRUTTURA,TML_DES_STRUTTURA,TML_AREA,TML_FASCIA_ETA,TML_SESSO_M,TML_SESSO_F,TML_GRAVIDANZA,TML_CAT_OSS,TML_CAT_PERSONALE,TML_CAT_RSA_OSPITI,TML_CAT_ALTRO,TML_DOSE_1,TML_DOSE_2,TML_TOT_SOMM,TML_REGIONE,TML_NUTS
2020-12-27,PF/BT,19092701.0,HSP11 - Ospedale Civico,SIC,20-29,0,2,0,2,0,0,0,2,0,2,Sicilia,ITG1
2020-12-27,PF/BT,19092701.0,HSP11 - Ospedale Civico,SIC,30-39,3,4,0,7,0,0,0,7,0,7,Sicilia,ITG1
2020-12-27,PF/BT,19092701.0,HSP11 - Ospedale Civico,SIC,40-49,8,4,0,11,0,0,1,12,0,12,Sicilia,ITG1
2020-12-27,PF/BT,19092701.0,HSP11 - Ospedale Civico,SIC,50-59,11,3,0,14,0,0,0,14,0,14,Sicilia,ITG1
2020-12-27,PF/BT,19092701.0,HSP11 - Ospedale Civico,SIC,60-69,18,4,0,22,0,0,0,22,0,22,Sicilia,ITG1
2020-12-27,PF/BT,19092701.0,HSP11 - Ospedale Civico,SIC,70-79,3,0,0,3,0,0,0,3,0,3,Sicilia,ITG1
2020-12-27,PF/BT,818000.0,STS11 - R.S.A. BUON PASTORE ONLUS,SIC,20-29,0,1,0,1,0,0,0,1,0,1,Sicilia,ITG1
2020-12-27,PF/BT,818000.0,STS11 - R.S.A. BUON PASTORE ONLUS,SIC,30-39,1,1,0,2,0,0,0,2,0,2,Sicilia,ITG1
2020-12-27,PF/BT,818000.0,STS11 - R.S.A. BUON PASTORE ONLUS,SIC,40-49,0,1,0,0,1,0,0,1,0,1,Sicilia,ITG1
2020-12-27,PF/BT,818000.0,STS11 - R.S.A. BUON PASTORE ONLUS,SIC,50-59,2,2,0,0,0,4,0,4,0,4,Sicilia,ITG1
2020-12-27,PF/BT,818000.0,STS11 - R.S.A. BUON PASTORE ONLUS,SIC,60-69,1,2,0,0,0,3,0,3,0,3,Sicilia,ITG1
2020-12-27,PF/BT,818000.0,STS11 - R.S.A. BUON PASTORE ONLUS,SIC,70-79,6,4,0,1,0,9,0,10,0,10,Sicilia,ITG1
2020-12-27,PF/BT,818000.0,STS11 - R.S.A. BUON PASTORE ONLUS,SIC,80-89,2,6,0,0,0,8,0,8,0,8,Sicilia,ITG1
2020-12-27,PF/BT,818000.0,STS11 - R.S.A. BUON PASTORE ONLUS,SIC,90+,0,1,0,0,0,1,0,1,0,1,Sicilia,ITG1
2020-12-28,PF/BT,190337.0,HSP11 - P.O. VILLA DELLE GINESTRE,SIC,20-29,5,3,0,8,0,0,0,8,0,8,Sicilia,ITG1
2020-12-28,PF/BT,190337.0,HSP11 - P.O. VILLA DELLE GINESTRE,SIC,30-39,5,4,0,9,0,0,0,9,0,9,Sicilia,ITG1
2020-12-28,PF/BT,190337.0,HSP11 - P.O. VILLA DELLE GINESTRE,SIC,40-49,7,3,0,10,0,0,0,10,0,10,Sicilia,ITG1
2020-12-28,PF/BT,190337.0,HSP11 - P.O. VILLA DELLE GINESTRE,SIC,50-59,6,6,0,10,2,0,0,12,0,12,Sicilia,ITG1
2020-12-28,PF/BT,190337.0,HSP11 - P.O. VILLA DELLE GINESTRE,SIC,60-69,12,4,0,16,0,0,0,16,0,16,Sicilia,ITG1
2020-12-28,PF/BT,19092601.0,HSP11 - P.O. Villa Sofia,SIC,20-29,1,1,0,2,0,0,0,2,0,2,Sicilia,ITG1
2020-12-28,PF/BT,19092601.0,HSP11 - P.O. Villa Sofia,SIC,30-39,3,2,0,5,0,0,0,5,0,5,Sicilia,ITG1
2020-12-28,PF/BT,19092601.0,HSP11 - P.O. Villa Sofia,SIC,40-49,6,6,0,12,0,0,0,12,0,12,Sicilia,ITG1
2020-12-28,PF/BT,19092601.0,HSP11 - P.O. Villa Sofia,SIC,50-59,12,8,0,20,0,0,0,20,0,20,Sicilia,ITG1
2020-12-28,PF/BT,19092601.0,HSP11 - P.O. Villa Sofia,SIC,60-69,7,8,0,15,0,0,0,15,0,15,Sicilia,ITG1
2020-12-28,PF/BT,19092701.0,HSP11 - Ospedale Civico,SIC,20-29,2,3,0,5,0,0,0,5,0,5,Sicilia,ITG1
2020-12-28,PF/BT,19092701.0,HSP11 - Ospedale Civico,SIC,30-39,12,5,0,17,0,0,0,17,0,17,Sicilia,ITG1
2020-12-28,PF/BT,19092701.0,HSP11 - Ospedale Civico,SIC,40-49,6,9,0,15,0,0,0,15,0,15,Sicilia,ITG1
2020-12-28,PF/BT,19092701.0,HSP11 - Ospedale Civico,SIC,50-59,8,1,0,9,0,0,0,9,0,9,Sicilia,ITG1
2020-12-28,PF/BT,19092701.0,HSP11 - Ospedale Civico,SIC,60-69,6,3,0,9,0,0,0,9,0,9,Sicilia,ITG1
2020-12-28,PF/BT,190928.0,HSP11 - AZ.OSP.UNIV.P.GIACCONE,SIC,20-29,6,7,0,13,0,0,0,13,0,13,Sicilia,ITG1
2020-12-28,PF/BT,190928.0,HSP11 - AZ.OSP.UNIV.P.GIACCONE,SIC,30-39,5,9,0,14,0,0,0,14,0,14,Sicilia,ITG1
2020-12-28,PF/BT,190928.0,HSP11 - AZ.OSP.UNIV.P.GIACCONE,SIC,40-49,4,2,0,6,0,0,0,6,0,6,Sicilia,ITG1
2020-12-28,PF/BT,190928.0,HSP11 - AZ.OSP.UNIV.P.GIACCONE,SIC,50-59,3,1,0,4,0,0,0,4,0,4,Sicilia,ITG1
2020-12-28,PF/BT,190928.0,HSP11 - AZ.OSP.UNIV.P.GIACCONE,SIC,60-69,12,1,0,13,0,0,0,13,0,13,Sicilia,ITG1
2020-12-29,PF/BT,190337.0,HSP11 - P.O. VILLA DELLE GINESTRE,SIC,20-29,2,2,0,4,0,0,0,4,0,4,Sicilia,ITG1
2020-12-29,PF/BT,190337.0,HSP11 - P.O. VILLA DELLE GINESTRE,SIC,30-39,4,5,0,9,0,0,0,9,0,9,Sicilia,ITG1
2020-12-29,PF/BT,190337.0,HSP11 - P.O. VILLA DELLE GINESTRE,SIC,40-49,8,5,0,13,0,0,0,13,0,13,Sicilia,ITG1
2020-12-29,PF/BT,190337.0,HSP11 - P.O. VILLA DELLE GINESTRE,SIC,50-59,4,5,0,9,0,0,0,9,0,9,Sicilia,ITG1
2020-12-29,PF/BT,190337.0,HSP11 - P.O. VILLA DELLE GINESTRE,SIC,60-69,18,7,0,25,0,0,0,25,0,25,Sicilia,ITG1
2020-12-29,PF/BT,19092601.0,HSP11 - P.O. Villa Sofia,SIC,20-29,2,1,0,3,0,0,0,3,0,3,Sicilia,ITG1
2020-12-29,PF/BT,19092601.0,HSP11 - P.O. Villa Sofia,SIC,30-39,4,2,0,6,0,0,0,6,0,6,Sicilia,ITG1
2020-12-29,PF/BT,19092601.0,HSP11 - P.O. Villa Sofia,SIC,40-49,9,6,0,15,0,0,0,15,0,15,Sicilia,ITG1
2020-12-29,PF/BT,19092601.0,HSP11 - P.O. Villa Sofia,SIC,50-59,11,5,0,16,0,0,0,16,0,16,Sicilia,ITG1
2020-12-29,PF/BT,19092601.0,HSP11 - P.O. Villa Sofia,SIC,60-69,11,4,0,15,0,0,0,15,0,15,Sicilia,ITG1
2020-12-29,PF/BT,19092701.0,HSP11 - Ospedale Civico,SIC,20-29,3,1,0,4,0,0,0,4,0,4,Sicilia,ITG1
2020-12-29,PF/BT,19092701.0,HSP11 - Ospedale Civico,SIC,30-39,9,4,0,13,0,0,0,13,0,13,Sicilia,ITG1
2020-12-29,PF/BT,19092701.0,HSP11 - Ospedale Civico,SIC,40-49,10,6,0,16,0,0,0,16,0,16,Sicilia,ITG1
2020-12-29,PF/BT,19092701.0,HSP11 - Ospedale Civico,SIC,50-59,12,3,0,15,0,0,0,15,0,15,Sicilia,ITG1
2020-12-29,PF/BT,19092701.0,HSP11 - Ospedale Civico,SIC,60-69,11,1,0,12,0,0,0,12,0,12,Sicilia,ITG1
2020-12-29,PF/BT,190928.0,HSP11 - AZ.OSP.UNIV.P.GIACCONE,SIC,20-29,2,3,0,5,0,0,0,5,0,5,Sicilia,ITG1
2020-12-29,PF/BT,190928.0,HSP11 - AZ.OSP.UNIV.P.GIACCONE,SIC,30-39,10,14,0,24,0,0,0,24,0,24,Sicilia,ITG1
2020-12-29,PF/BT,190928.0,HSP11 - AZ.OSP.UNIV.P.GIACCONE,SIC,40-49,7,4,0,11,0,0,0,11,0,11,Sicilia,ITG1
2020-12-29,PF/BT,190928.0,HSP11 - AZ.OSP.UNIV.P.GIACCONE,SIC,50-59,3,8,0,11,0,0,0,11,0,11,Sicilia,ITG1
2020-12-29,PF/BT,190928.0,HSP11 - AZ.OSP.UNIV.P.GIACCONE,SIC,60-69,6,3,0,9,0,0,0,9,0,9,Sicilia,ITG1
2020-12-30,PF/BT,190337.0,HSP11 - P.O. VILLA DELLE GINESTRE,SIC,20-29,3,2,0,4,1,0,0,5,0,5,Sicilia,ITG1
2020-12-30,PF/BT,190337.0,HSP11 - P.O. VILLA DELLE GINESTRE,SIC,30-39,8,12,0,20,0,0,0,20,0,20,Sicilia,ITG1
2020-12-30,PF/BT,190337.0,HSP11 - P.O. VILLA DELLE GINESTRE,SIC,40-49,6,10,0,14,2,0,0,16,0,16,Sicilia,ITG1
2020-12-30,PF/BT,190337.0,HSP11 - P.O. VILLA DELLE GINESTRE,SIC,50-59,10,5,0,12,3,0,0,15,0,15,Sicilia,ITG1
2020-12-30,PF/BT,190337.0,HSP11 - P.O. VILLA DELLE GINESTRE,SIC,60-69,10,5,0,14,1,0,0,15,0,15,Sicilia,ITG1
2020-12-30,PF/BT,19092601.0,HSP11 - P.O. Villa Sofia,SIC,20-29,12,5,0,11,0,0,6,17,0,17,Sicilia,ITG1
2020-12-30,PF/BT,19092601.0,HSP11 - P.O. Villa Sofia,SIC,30-39,9,8,0,17,0,0,0,17,0,17,Sicilia,ITG1
2020-12-30,PF/BT,19092601.0,HSP11 - P.O. Villa Sofia,SIC,40-49,8,3,0,11,0,0,0,11,0,11,Sicilia,ITG1
2020-12-30,PF/BT,19092601.0,HSP11 - P.O. Villa Sofia,SIC,50-59,5,4,0,9,0,0,0,9,0,9,Sicilia,ITG1
2020-12-30,PF/BT,19092601.0,HSP11 - P.O. Villa Sofia,SIC,60-69,3,3,0,5,1,0,0,6,0,6,Sicilia,ITG1
2020-12-30,PF/BT,19092701.0,HSP11 - Ospedale Civico,SIC,20-29,0,2,0,2,0,0,0,2,0,2,Sicilia,ITG1
2020-12-30,PF/BT,19092701.0,HSP11 - Ospedale Civico,SIC,30-39,7,6,0,13,0,0,0,13,0,13,Sicilia,ITG1
2020-12-30,PF/BT,19092701.0,HSP11 - Ospedale Civico,SIC,40-49,8,5,0,13,0,0,0,13,0,13,Sicilia,ITG1
2020-12-30,PF/BT,19092701.0,HSP11 - Ospedale Civico,SIC,50-59,12,2,0,14,0,0,0,14,0,14,Sicilia,ITG1
2020-12-30,PF/BT,19092701.0,HSP11 - Ospedale Civico,SIC,60-69,4,2,0,6,0,0,0,6,0,6,Sicilia,ITG1
2020-12-30,PF/BT,190928.0,HSP11 - AZ.OSP.UNIV.P.GIACCONE,SIC,20-29,12,5,0,11,0,0,6,17,0,17,Sicilia,ITG1
2020-12-30,PF/BT,190928.0,HSP11 - AZ.OSP.UNIV.P.GIACCONE,SIC,30-39,9,8,0,17,0,0,0,17,0,17,Sicilia,ITG1
2020-12-30,PF/BT,190928.0,HSP11 - AZ.OSP.UNIV.P.GIACCONE,SIC,40-49,8,3,0,11,0,0,0,11,0,11,Sicilia,ITG1
2020-12-30,PF/BT,190928.0,HSP11 - AZ.OSP.UNIV.P.GIACCONE,SIC,50-59,5,4,0,9,0,0,0,9,0,9,Sicilia,ITG1
2020-12-30,PF/BT,190928.0,HSP11 - AZ.OSP.UNIV.P.GIACCONE,SIC,60-69,3,3,0,5,1,0,0,6,0,6,Sicilia,ITG1
2020-12-31,PF/BT,190179.0,HSP11 - FOND. IST. S. RAFFAELE - GIGLIO,SIC,20-29,0,1,0,1,0,0,0,1,0,1,Sicilia,ITG1
2020-12-31,PF/BT,190179.0,HSP11 - FOND. IST. S. RAFFAELE - GIGLIO,SIC,30-39,9,18,1,27,0,0,0,27,0,27,Sicilia,ITG1
2020-12-31,PF/BT,190179.0,HSP11 - FOND. IST. S. RAFFAELE - GIGLIO,SIC,40-49,12,16,0,28,0,0,0,28,0,28,Sicilia,ITG1
2020-12-31,PF/BT,190179.0,HSP11 - FOND. IST. S. RAFFAELE - GIGLIO,SIC,50-59,6,7,0,13,0,0,0,13,0,13,Sicilia,ITG1
2020-12-31,PF/BT,190179.0,HSP11 - FOND. IST. S. RAFFAELE - GIGLIO,SIC,60-69,2,0,0,2,0,0,0,2,0,2,Sicilia,ITG1
2020-12-31,PF/BT,190179.0,HSP11 - FOND. IST. S. RAFFAELE - GIGLIO,SIC,70-79,1,0,0,1,0,0,0,1,0,1,Sicilia,ITG1
2020-12-31,PF/BT,190312.0,HSP11 - P.O. S. Marta e S. Venera Acireale,SIC,30-39,0,2,0,2,0,0,0,2,0,2,Sicilia,ITG1
2020-12-31,PF/BT,190312.0,HSP11 - P.O. S. Marta e S. Venera Acireale,SIC,40-49,1,2,0,3,0,0,0,3,0,3,Sicilia,ITG1
2020-12-31,PF/BT,190312.0,HSP11 - P.O. S. Marta e S. Venera Acireale,SIC,50-59,2,3,0,5,0,0,0,5,0,5,Sicilia,ITG1
2020-12-31,PF/BT,190312.0,HSP11 - P.O. S. Marta e S. Venera Acireale,SIC,60-69,1,0,0,1,0,0,0,1,0,1,Sicilia,ITG1
2020-12-31,PF/BT,190313.0,RIA11 - IST.RIAB.VILLAG. SAN GIUSEPPE,SIC,20-29,4,6,0,10,0,0,0,10,0,10,Sicilia,ITG1
2020-12-31,PF/BT,190313.0,RIA11 - IST.RIAB.VILLAG. SAN GIUSEPPE,SIC,30-39,2,0,0,2,0,0,0,2,0,2,Sicilia,ITG1
2020-12-31,PF/BT,190314.0,RIA11 - ASS.J.F.KENNEDY ACIREALE,SIC,40-49,2,2,0,4,0,0,0,4,0,4,Sicilia,ITG1
2020-12-31,PF/BT,190314.0,RIA11 - ASS.J.F.KENNEDY ACIREALE,SIC,50-59,3,2,0,5,0,0,0,5,0,5,Sicilia,ITG1
2020-12-31,PF/BT,190314.0,RIA11 - ASS.J.F.KENNEDY ACIREALE,SIC,60-69,3,0,0,3,0,0,0,3,0,3,Sicilia,ITG1
2020-12-31,PF/BT,190316.0,RIA11 - ASS.J.F.KENNEDY - C.RIAB.ONLUS,SIC,20-29,6,4,0,10,0,0,0,10,0,10,Sicilia,ITG1
2020-12-31,PF/BT,190316.0,RIA11 - ASS.J.F.KENNEDY - C.RIAB.ONLUS,SIC,30-39,0,1,0,1,0,0,0,1,0,1,Sicilia,ITG1
2020-12-31,PF/BT,190316.0,RIA11 - ASS.J.F.KENNEDY - C.RIAB.ONLUS,SIC,40-49,1,0,0,1,0,0,0,1,0,1,Sicilia,ITG1
2020-12-31,PF/BT,190317.0,HSP11 - P.O. Gravina e S. Pietro Caltagirone,SIC,20-29,8,4,0,12,0,0,0,12,0,12,Sicilia,ITG1
2020-12-31,PF/BT,190317.0,HSP11 - P.O. Gravina e S. Pietro Caltagirone,SIC,30-39,1,0,0,1,0,0,0,1,0,1,Sicilia,ITG1
2020-12-31,PF/BT,190317.0,HSP11 - P.O. Gravina e S. Pietro Caltagirone,SIC,40-49,0,2,0,2,0,0,0,2,0,2,Sicilia,ITG1
2020-12-31,PF/BT,190317.0,HSP11 - P.O. Gravina e S. Pietro Caltagirone,SIC,50-59,2,2,0,4,0,0,0,4,0,4,Sicilia,ITG1
2020-12-31,PF/BT,190317.0,HSP11 - P.O. Gravina e S. Pietro Caltagirone,SIC,60-69,4,0,0,4,0,0,0,4,0,4,Sicilia,ITG1
2020-12-31,PF/BT,190319.0,HSP11 - P. O. UMBERTO I,SIC,20-29,3,6,0,9,0,0,0,9,0,9,Sicilia,ITG1
2020-12-31,PF/BT,190319.0,HSP11 - P. O. UMBERTO I,SIC,30-39,2,0,0,2,0,0,0,2,0,2,Sicilia,ITG1
2020-12-31,PF/BT,190319.0,HSP11 - P. O. UMBERTO I,SIC,40-49,5,7,0,12,0,0,0,12,0,12,Sicilia,ITG1
2020-12-31,PF/BT,190319.0,HSP11 - P. O. UMBERTO I,SIC,50-59,11,8,0,19,0,0,0,19,0,19,Sicilia,ITG1
2020-12-31,PF/BT,190319.0,HSP11 - P. O. UMBERTO I,SIC,60-69,4,2,0,6,0,0,0,6,0,6,Sicilia,ITG1
2020-12-31,PF/BT,190330.0,HSP11 - P.O. DEI BIANCHI CORLEONE,SIC,30-39,1,1,0,2,0,0,0,2,0,2,Sicilia,ITG1
2020-12-31,PF/BT,190330.0,HSP11 - P.O. DEI BIANCHI CORLEONE,SIC,40-49,1,1,0,2,0,0,0,2,0,2,Sicilia,ITG1
2020-12-31,PF/BT,190330.0,HSP11 - P.O. DEI BIANCHI CORLEONE,SIC,50-59,6,0,0,4,2,0,0,6,0,6,Sicilia,ITG1
2020-12-31,PF/BT,190330.0,HSP11 - P.O. DEI BIANCHI CORLEONE,SIC,60-69,1,1,0,1,1,0,0,2,0,2,Sicilia,ITG1
2020-12-31,PF/BT,190332.0,HSP11 - P.O. CIVICO PARTINICO,SIC,20-29,0,3,0,3,0,0,0,3,0,3,Sicilia,ITG1
2020-12-31,PF/BT,190332.0,HSP11 - P.O. CIVICO PARTINICO,SIC,40-49,1,0,0,1,0,0,0,1,0,1,Sicilia,ITG1
2020-12-31,PF/BT,190332.0,HSP11 - P.O. CIVICO PARTINICO,SIC,50-59,1,0,0,1,0,0,0,1,0,1,Sicilia,ITG1
2020-12-31,PF/BT,190333.0,HSP11 - P.O. MADONNA DELLALTO - PETR. SOTTANA,SIC,20-29,5,7,0,12,0,0,0,12,0,12,Sicilia,ITG1
2020-12-31,PF/BT,190333.0,HSP11 - P.O. MADONNA DELLALTO - PETR. SOTTANA,SIC,30-39,4,6,0,10,0,0,0,10,0,10,Sicilia,ITG1
2020-12-31,PF/BT,190333.0,HSP11 - P.O. MADONNA DELLALTO - PETR. SOTTANA,SIC,40-49,8,8,0,16,0,0,0,16,0,16,Sicilia,ITG1
2020-12-31,PF/BT,190333.0,HSP11 - P.O. MADONNA DELLALTO - PETR. SOTTANA,SIC,50-59,20,10,0,29,0,0,1,30,0,30,Sicilia,ITG1
2020-12-31,PF/BT,190333.0,HSP11 - P.O. MADONNA DELLALTO - PETR. SOTTANA,SIC,60-69,7,3,0,10,0,0,0,10,0,10,Sicilia,ITG1
2020-12-31,PF/BT,190334.0,HSP11 - P.O. S. CIMINO TERMINI IMERESE,SIC,20-29,4,3,0,7,0,0,0,7,0,7,Sicilia,ITG1
2020-12-31,PF/BT,190334.0,HSP11 - P.O. S. CIMINO TERMINI IMERESE,SIC,30-39,2,2,0,4,0,0,0,4,0,4,Sicilia,ITG1
2020-12-31,PF/BT,190334.0,HSP11 - P.O. S. CIMINO TERMINI IMERESE,SIC,40-49,7,1,0,8,0,0,0,8,0,8,Sicilia,ITG1
2020-12-31,PF/BT,190334.0,HSP11 - P.O. S. CIMINO TERMINI IMERESE,SIC,50-59,8,7,0,15,0,0,0,15,0,15,Sicilia,ITG1
2020-12-31,PF/BT,190334.0,HSP11 - P.O. S. CIMINO TERMINI IMERESE,SIC,60-69,3,4,0,6,1,0,0,7,0,7,Sicilia,ITG1
2020-12-31,PF/BT,190335.0,HSP11 - P.O. G. F. INGRASSIA,SIC,20-29,1,1,0,0,0,0,2,2,0,2,Sicilia,ITG1
2020-12-31,PF/BT,190335.0,HSP11 - P.O. G. F. INGRASSIA,SIC,30-39,8,3,0,0,0,0,11,11,0,11,Sicilia,ITG1
2020-12-31,PF/BT,190335.0,HSP11 - P.O. G. F. INGRASSIA,SIC,40-49,2,7,0,0,0,0,9,9,0,9,Sicilia,ITG1
2020-12-31,PF/BT,190335.0,HSP11 - P.O. G. F. INGRASSIA,SIC,50-59,9,4,0,0,0,0,13,13,0,13,Sicilia,ITG1
2020-12-31,PF/BT,190335.0,HSP11 - P.O. G. F. INGRASSIA,SIC,60-69,3,2,0,0,0,0,5,5,0,5,Sicilia,ITG1
2020-12-31,PF/BT,190337.0,HSP11 - P.O. VILLA DELLE GINESTRE,SIC,16-19,2,0,0,0,0,0,2,2,0,2,Sicilia,ITG1
2020-12-31,PF/BT,190337.0,HSP11 - P.O. VILLA DELLE GINESTRE,SIC,20-29,12,13,0,24,0,0,1,25,0,25,Sicilia,ITG1
2020-12-31,PF/BT,190337.0,HSP11 - P.O. VILLA DELLE GINESTRE,SIC,30-39,12,20,0,32,0,0,0,32,0,32,Sicilia,ITG1
2020-12-31,PF/BT,190337.0,HSP11 - P.O. VILLA DELLE GINESTRE,SIC,40-49,6,8,0,14,0,0,0,14,0,14,Sicilia,ITG1
2020-12-31,PF/BT,190337.0,HSP11 - P.O. VILLA DELLE GINESTRE,SIC,50-59,13,17,0,30,0,0,0,30,0,30,Sicilia,ITG1
2020-12-31,PF/BT,190337.0,HSP11 - P.O. VILLA DELLE GINESTRE,SIC,60-69,34,22,0,56,0,0,0,56,0,56,Sicilia,ITG1
2020-12-31,PF/BT,190337.0,HSP11 - P.O. VILLA DELLE GINESTRE,SIC,70-79,2,0,0,2,0,0,0,2,0,2,Sicilia,ITG1
2020-12-31,PF/BT,190345.0,HSP11 - P.O. UMBERTO I (EX A.O.),SIC,20-29,1,8,0,9,0,0,0,9,0,9,Sicilia,ITG1
2020-12-31,PF/BT,190345.0,HSP11 - P.O. UMBERTO I (EX A.O.),SIC,30-39,4,2,0,6,0,0,0,6,0,6,Sicilia,ITG1
2020-12-31,PF/BT,190345.0,HSP11 - P.O. UMBERTO I (EX A.O.),SIC,40-49,3,3,0,6,0,0,0,6,0,6,Sicilia,ITG1
2020-12-31,PF/BT,190345.0,HSP11 - P.O. UMBERTO I (EX A.O.),SIC,50-59,4,4,0,8,0,0,0,8,0,8,Sicilia,ITG1
2020-12-31,PF/BT,190345.0,HSP11 - P.O. UMBERTO I (EX A.O.),SIC,60-69,1,0,0,1,0,0,0,1,0,1,Sicilia,ITG1
2020-12-31,PF/BT,190351.0,HSP11 - P.O. S. ANTONIO ABATE  - TRAPANI,SIC,20-29,2,1,0,3,0,0,0,3,0,3,Sicilia,ITG1
2020-12-31,PF/BT,190351.0,HSP11 - P.O. S. ANTONIO ABATE  - TRAPANI,SIC,30-39,4,1,0,5,0,0,0,5,0,5,Sicilia,ITG1
2020-12-31,PF/BT,190351.0,HSP11 - P.O. S. ANTONIO ABATE  - TRAPANI,SIC,40-49,9,3,0,12,0,0,0,12,0,12,Sicilia,ITG1
2020-12-31,PF/BT,190351.0,HSP11 - P.O. S. ANTONIO ABATE  - TRAPANI,SIC,50-59,7,1,0,8,0,0,0,8,0,8,Sicilia,ITG1
2020-12-31,PF/BT,190351.0,HSP11 - P.O. S. ANTONIO ABATE  - TRAPANI,SIC,60-69,8,3,0,11,0,0,0,11,0,11,Sicilia,ITG1
2020-12-31,PF/BT,190921.0,HSP11 - A.O. per lEmergenza Cannizzaro,SIC,20-29,3,4,0,7,0,0,0,7,0,7,Sicilia,ITG1
2020-12-31,PF/BT,190921.0,HSP11 - A.O. per lEmergenza Cannizzaro,SIC,30-39,2,3,0,5,0,0,0,5,0,5,Sicilia,ITG1
2020-12-31,PF/BT,190921.0,HSP11 - A.O. per lEmergenza Cannizzaro,SIC,40-49,3,5,0,8,0,0,0,8,0,8,Sicilia,ITG1
2020-12-31,PF/BT,190921.0,HSP11 - A.O. per lEmergenza Cannizzaro,SIC,50-59,5,2,0,7,0,0,0,7,0,7,Sicilia,ITG1
2020-12-31,PF/BT,190921.0,HSP11 - A.O. per lEmergenza Cannizzaro,SIC,60-69,2,1,0,3,0,0,0,3,0,3,Sicilia,ITG1
2020-12-31,PF/BT,19092204.0,HSP11 - NUOVO OSPEDALE GARIBALDI - NESIMA,SIC,20-29,2,0,0,2,0,0,0,2,0,2,Sicilia,ITG1
2020-12-31,PF/BT,19092204.0,HSP11 - NUOVO OSPEDALE GARIBALDI - NESIMA,SIC,30-39,3,1,0,4,0,0,0,4,0,4,Sicilia,ITG1
2020-12-31,PF/BT,19092204.0,HSP11 - NUOVO OSPEDALE GARIBALDI - NESIMA,SIC,40-49,3,3,0,6,0,0,0,6,0,6,Sicilia,ITG1
2020-12-31,PF/BT,19092204.0,HSP11 - NUOVO OSPEDALE GARIBALDI - NESIMA,SIC,50-59,2,1,0,3,0,0,0,3,0,3,Sicilia,ITG1
2020-12-31,PF/BT,19092204.0,HSP11 - NUOVO OSPEDALE GARIBALDI - NESIMA,SIC,60-69,8,1,0,9,0,0,0,9,0,9,Sicilia,ITG1
2020-12-31,PF/BT,19092301.0,HSP11 - PRESIDIO OSPEDALIERO GASPARE RODOLICO,SIC,30-39,1,1,0,2,0,0,0,2,0,2,Sicilia,ITG1
2020-12-31,PF/BT,19092301.0,HSP11 - PRESIDIO OSPEDALIERO GASPARE RODOLICO,SIC,40-49,1,1,0,2,0,0,0,2,0,2,Sicilia,ITG1
2020-12-31,PF/BT,19092301.0,HSP11 - PRESIDIO OSPEDALIERO GASPARE RODOLICO,SIC,50-59,4,3,0,7,0,0,0,7,0,7,Sicilia,ITG1
2020-12-31,PF/BT,19092304.0,HSP11 - PRESIDIO OSPEDALIERO S.MARCO,SIC,20-29,1,2,0,3,0,0,0,3,0,3,Sicilia,ITG1
2020-12-31,PF/BT,19092304.0,HSP11 - PRESIDIO OSPEDALIERO S.MARCO,SIC,30-39,1,1,0,2,0,0,0,2,0,2,Sicilia,ITG1
2020-12-31,PF/BT,19092304.0,HSP11 - PRESIDIO OSPEDALIERO S.MARCO,SIC,40-49,2,2,0,4,0,0,0,4,0,4,Sicilia,ITG1
2020-12-31,PF/BT,19092304.0,HSP11 - PRESIDIO OSPEDALIERO S.MARCO,SIC,50-59,4,3,0,7,0,0,0,7,0,7,Sicilia,ITG1
2020-12-31,PF/BT,19092304.0,HSP11 - PRESIDIO OSPEDALIERO S.MARCO,SIC,60-69,1,1,0,2,0,0,0,2,0,2,Sicilia,ITG1
2020-12-31,PF/BT,19092601.0,HSP11 - P.O. Villa Sofia,SIC,20-29,1,3,0,4,0,0,0,4,0,4,Sicilia,ITG1
2020-12-31,PF/BT,19092601.0,HSP11 - P.O. Villa Sofia,SIC,30-39,5,4,0,8,1,0,0,9,0,9,Sicilia,ITG1
2020-12-31,PF/BT,19092601.0,HSP11 - P.O. Villa Sofia,SIC,40-49,3,2,0,5,0,0,0,5,0,5,Sicilia,ITG1
2020-12-31,PF/BT,19092601.0,HSP11 - P.O. Villa Sofia,SIC,50-59,3,1,0,4,0,0,0,4,0,4,Sicilia,ITG1
2020-12-31,PF/BT,19092601.0,HSP11 - P.O. Villa Sofia,SIC,60-69,2,0,0,2,0,0,0,2,0,2,Sicilia,ITG1
2020-12-31,PF/BT,19092701.0,HSP11 - Ospedale Civico,SIC,20-29,10,9,0,19,0,0,0,19,0,19,Sicilia,ITG1
2020-12-31,PF/BT,19092701.0,HSP11 - Ospedale Civico,SIC,30-39,9,16,0,25,0,0,0,25,0,25,Sicilia,ITG1
2020-12-31,PF/BT,19092701.0,HSP11 - Ospedale Civico,SIC,40-49,17,18,0,34,0,0,1,35,0,35,Sicilia,ITG1
2020-12-31,PF/BT,19092701.0,HSP11 - Ospedale Civico,SIC,50-59,17,14,0,31,0,0,0,31,0,31,Sicilia,ITG1
2020-12-31,PF/BT,19092701.0,HSP11 - Ospedale Civico,SIC,60-69,5,8,0,13,0,0,0,13,0,13,Sicilia,ITG1
2020-12-31,PF/BT,190929.0,STS11 - IRCCS Ismett,SIC,20-29,0,5,0,5,0,0,0,5,0,5,Sicilia,ITG1
2020-12-31,PF/BT,190929.0,STS11 - IRCCS Ismett,SIC,30-39,8,3,0,11,0,0,0,11,0,11,Sicilia,ITG1
2020-12-31,PF/BT,190929.0,STS11 - IRCCS Ismett,SIC,40-49,13,7,0,20,0,0,0,20,0,20,Sicilia,ITG1
2020-12-31,PF/BT,190929.0,STS11 - IRCCS Ismett,SIC,50-59,9,7,0,16,0,0,0,16,0,16,Sicilia,ITG1
2020-12-31,PF/BT,190929.0,STS11 - IRCCS Ismett,SIC,60-69,3,1,0,3,1,0,0,4,0,4,Sicilia,ITG1
2020-12-31,PF/BT,190929.0,STS11 - IRCCS Ismett,SIC,70-79,3,0,0,3,0,0,0,3,0,3,Sicilia,ITG1
2020-12-31,PF/BT,19096001.0,HSP11 - IRCCS Centro Neurolesi,SIC,30-39,1,0,0,1,0,0,0,1,0,1,Sicilia,ITG1
2020-12-31,PF/BT,19096001.0,HSP11 - IRCCS Centro Neurolesi,SIC,40-49,2,3,0,5,0,0,0,5,0,5,Sicilia,ITG1
2020-12-31,PF/BT,19096001.0,HSP11 - IRCCS Centro Neurolesi,SIC,50-59,0,2,0,2,0,0,0,2,0,2,Sicilia,ITG1
2020-12-31,PF/BT,19096001.0,HSP11 - IRCCS Centro Neurolesi,SIC,60-69,1,1,0,2,0,0,0,2,0,2,Sicilia,ITG1
2021-01-01,PF/BT,190179.0,HSP11 - FOND. IST. S. RAFFAELE - GIGLIO,SIC,16-19,1,0,0,0,1,0,0,1,0,1,Sicilia,ITG1
2021-01-01,PF/BT,190179.0,HSP11 - FOND. IST. S. RAFFAELE - GIGLIO,SIC,20-29,4,9,0,10,3,0,0,13,0,13,Sicilia,ITG1
2021-01-01,PF/BT,190179.0,HSP11 - FOND. IST. S. RAFFAELE - GIGLIO,SIC,30-39,10,13,0,23,0,0,0,23,0,23,Sicilia,ITG1
2021-01-01,PF/BT,190179.0,HSP11 - FOND. IST. S. RAFFAELE - GIGLIO,SIC,40-49,23,18,0,41,0,0,0,41,0,41,Sicilia,ITG1
2021-01-01,PF/BT,190179.0,HSP11 - FOND. IST. S. RAFFAELE - GIGLIO,SIC,50-59,5,12,0,16,1,0,0,17,0,17,Sicilia,ITG1
2021-01-01,PF/BT,190179.0,HSP11 - FOND. IST. S. RAFFAELE - GIGLIO,SIC,60-69,3,0,0,3,0,0,0,3,0,3,Sicilia,ITG1
2021-01-01,PF/BT,190312.0,HSP11 - P.O. S. Marta e S. Venera Acireale,SIC,30-39,1,2,0,3,0,0,0,3,0,3,Sicilia,ITG1
2021-01-01,PF/BT,190312.0,HSP11 - P.O. S. Marta e S. Venera Acireale,SIC,40-49,0,5,0,5,0,0,0,5,0,5,Sicilia,ITG1
2021-01-01,PF/BT,190312.0,HSP11 - P.O. S. Marta e S. Venera Acireale,SIC,50-59,8,5,0,13,0,0,0,13,0,13,Sicilia,ITG1
2021-01-01,PF/BT,190312.0,HSP11 - P.O. S. Marta e S. Venera Acireale,SIC,60-69,3,0,0,3,0,0,0,3,0,3,Sicilia,ITG1
2021-01-01,PF/BT,190313.0,RIA11 - IST.RIAB.VILLAG. SAN GIUSEPPE,SIC,20-29,4,5,0,9,0,0,0,9,0,9,Sicilia,ITG1
2021-01-01,PF/BT,190313.0,RIA11 - IST.RIAB.VILLAG. SAN GIUSEPPE,SIC,30-39,0,2,0,2,0,0,0,2,0,2,Sicilia,ITG1
2021-01-01,PF/BT,190313.0,RIA11 - IST.RIAB.VILLAG. SAN GIUSEPPE,SIC,50-59,0,1,0,1,0,0,0,1,0,1,Sicilia,ITG1
2021-01-01,PF/BT,190314.0,RIA11 - ASS.J.F.KENNEDY ACIREALE,SIC,20-29,1,0,0,1,0,0,0,1,0,1,Sicilia,ITG1
2021-01-01,PF/BT,190314.0,RIA11 - ASS.J.F.KENNEDY ACIREALE,SIC,30-39,3,5,0,8,0,0,0,8,0,8,Sicilia,ITG1
2021-01-01,PF/BT,190314.0,RIA11 - ASS.J.F.KENNEDY ACIREALE,SIC,40-49,6,0,0,6,0,0,0,6,0,6,Sicilia,ITG1
2021-01-01,PF/BT,190314.0,RIA11 - ASS.J.F.KENNEDY ACIREALE,SIC,50-59,12,2,0,14,0,0,0,14,0,14,Sicilia,ITG1
2021-01-01,PF/BT,190314.0,RIA11 - ASS.J.F.KENNEDY ACIREALE,SIC,60-69,6,1,0,7,0,0,0,7,0,7,Sicilia,ITG1
2021-01-01,PF/BT,190316.0,RIA11 - ASS.J.F.KENNEDY - C.RIAB.ONLUS,SIC,20-29,5,7,0,12,0,0,0,12,0,12,Sicilia,ITG1
2021-01-01,PF/BT,190316.0,RIA11 - ASS.J.F.KENNEDY - C.RIAB.ONLUS,SIC,30-39,4,0,0,4,0,0,0,4,0,4,Sicilia,ITG1
2021-01-01,PF/BT,190316.0,RIA11 - ASS.J.F.KENNEDY - C.RIAB.ONLUS,SIC,40-49,1,1,0,2,0,0,0,2,0,2,Sicilia,ITG1
2021-01-01,PF/BT,190316.0,RIA11 - ASS.J.F.KENNEDY - C.RIAB.ONLUS,SIC,50-59,2,1,0,3,0,0,0,3,0,3,Sicilia,ITG1
2021-01-01,PF/BT,190316.0,RIA11 - ASS.J.F.KENNEDY - C.RIAB.ONLUS,SIC,60-69,3,0,0,3,0,0,0,3,0,3,Sicilia,ITG1
2021-01-01,PF/BT,190317.0,HSP11 - P.O. Gravina e S. Pietro Caltagirone,SIC,20-29,6,6,0,12,0,0,0,12,0,12,Sicilia,ITG1
2021-01-01,PF/BT,190317.0,HSP11 - P.O. Gravina e S. Pietro Caltagirone,SIC,30-39,2,1,0,3,0,0,0,3,0,3,Sicilia,ITG1
2021-01-01,PF/BT,190317.0,HSP11 - P.O. Gravina e S. Pietro Caltagirone,SIC,40-49,1,4,0,5,0,0,0,5,0,5,Sicilia,ITG1
2021-01-01,PF/BT,190317.0,HSP11 - P.O. Gravina e S. Pietro Caltagirone,SIC,50-59,9,9,0,17,1,0,0,18,0,18,Sicilia,ITG1
2021-01-01,PF/BT,190317.0,HSP11 - P.O. Gravina e S. Pietro Caltagirone,SIC,60-69,5,0,0,4,1,0,0,5,0,5,Sicilia,ITG1
2021-01-01,PF/BT,190330.0,HSP11 - P.O. DEI BIANCHI CORLEONE,SIC,20-29,2,0,0,2,0,0,0,2,0,2,Sicilia,ITG1
2021-01-01,PF/BT,190330.0,HSP11 - P.O. DEI BIANCHI CORLEONE,SIC,30-39,3,3,0,6,0,0,0,6,0,6,Sicilia,ITG1
2021-01-01,PF/BT,190330.0,HSP11 - P.O. DEI BIANCHI CORLEONE,SIC,40-49,12,2,0,13,0,0,1,14,0,14,Sicilia,ITG1
2021-01-01,PF/BT,190330.0,HSP11 - P.O. DEI BIANCHI CORLEONE,SIC,50-59,19,11,0,25,5,0,0,30,0,30,Sicilia,ITG1
2021-01-01,PF/BT,190330.0,HSP11 - P.O. DEI BIANCHI CORLEONE,SIC,60-69,18,4,0,18,4,0,0,22,0,22,Sicilia,ITG1
2021-01-01,PF/BT,190332.0,HSP11 - P.O. CIVICO PARTINICO,SIC,20-29,16,13,0,29,0,0,0,29,0,29,Sicilia,ITG1
2021-01-01,PF/BT,190332.0,HSP11 - P.O. CIVICO PARTINICO,SIC,30-39,18,7,0,25,0,0,0,25,0,25,Sicilia,ITG1
2021-01-01,PF/BT,190332.0,HSP11 - P.O. CIVICO PARTINICO,SIC,40-49,22,25,0,47,0,0,0,47,0,47,Sicilia,ITG1
2021-01-01,PF/BT,190332.0,HSP11 - P.O. CIVICO PARTINICO,SIC,50-59,21,19,0,40,0,0,0,40,0,40,Sicilia,ITG1
2021-01-01,PF/BT,190332.0,HSP11 - P.O. CIVICO PARTINICO,SIC,60-69,11,8,0,19,0,0,0,19,0,19,Sicilia,ITG1
2021-01-01,PF/BT,190335.0,HSP11 - P.O. G. F. INGRASSIA,SIC,20-29,2,2,0,0,0,0,4,4,0,4,Sicilia,ITG1
2021-01-01,PF/BT,190335.0,HSP11 - P.O. G. F. INGRASSIA,SIC,30-39,6,6,0,0,0,0,12,12,0,12,Sicilia,ITG1
2021-01-01,PF/BT,190335.0,HSP11 - P.O. G. F. INGRASSIA,SIC,40-49,6,3,0,0,0,0,9,9,0,9,Sicilia,ITG1
2021-01-01,PF/BT,190335.0,HSP11 - P.O. G. F. INGRASSIA,SIC,50-59,3,5,0,0,0,0,8,8,0,8,Sicilia,ITG1
2021-01-01,PF/BT,190335.0,HSP11 - P.O. G. F. INGRASSIA,SIC,60-69,5,3,0,0,0,0,8,8,0,8,Sicilia,ITG1
2021-01-01,PF/BT,190337.0,HSP11 - P.O. VILLA DELLE GINESTRE,SIC,20-29,19,28,0,47,0,0,0,47,0,47,Sicilia,ITG1
2021-01-01,PF/BT,190337.0,HSP11 - P.O. VILLA DELLE GINESTRE,SIC,30-39,13,13,0,26,0,0,0,26,0,26,Sicilia,ITG1
2021-01-01,PF/BT,190337.0,HSP11 - P.O. VILLA DELLE GINESTRE,SIC,40-49,0,5,0,2,1,0,2,5,0,5,Sicilia,ITG1
2021-01-01,PF/BT,190337.0,HSP11 - P.O. VILLA DELLE GINESTRE,SIC,50-59,7,7,0,11,1,0,2,14,0,14,Sicilia,ITG1
2021-01-01,PF/BT,190337.0,HSP11 - P.O. VILLA DELLE GINESTRE,SIC,60-69,16,12,0,28,0,0,0,28,0,28,Sicilia,ITG1
2021-01-01,PF/BT,190337.0,HSP11 - P.O. VILLA DELLE GINESTRE,SIC,70-79,8,0,0,8,0,0,0,8,0,8,Sicilia,ITG1
2021-01-01,PF/BT,19092204.0,HSP11 - NUOVO OSPEDALE GARIBALDI - NESIMA,SIC,20-29,0,3,0,3,0,0,0,3,0,3,Sicilia,ITG1
2021-01-01,PF/BT,19092204.0,HSP11 - NUOVO OSPEDALE GARIBALDI - NESIMA,SIC,30-39,4,3,0,7,0,0,0,7,0,7,Sicilia,ITG1
2021-01-01,PF/BT,19092204.0,HSP11 - NUOVO OSPEDALE GARIBALDI - NESIMA,SIC,40-49,3,6,0,9,0,0,0,9,0,9,Sicilia,ITG1
2021-01-01,PF/BT,19092204.0,HSP11 - NUOVO OSPEDALE GARIBALDI - NESIMA,SIC,50-59,2,1,0,3,0,0,0,3,0,3,Sicilia,ITG1
2021-01-01,PF/BT,19092204.0,HSP11 - NUOVO OSPEDALE GARIBALDI - NESIMA,SIC,60-69,4,2,0,6,0,0,0,6,0,6,Sicilia,ITG1
2021-01-01,PF/BT,19092701.0,HSP11 - Ospedale Civico,SIC,20-29,3,3,0,6,0,0,0,6,0,6,Sicilia,ITG1
2021-01-01,PF/BT,19092701.0,HSP11 - Ospedale Civico,SIC,30-39,3,9,0,12,0,0,0,12,0,12,Sicilia,ITG1
2021-01-01,PF/BT,19092701.0,HSP11 - Ospedale Civico,SIC,40-49,3,0,0,3,0,0,0,3,0,3,Sicilia,ITG1
2021-01-01,PF/BT,19092701.0,HSP11 - Ospedale Civico,SIC,50-59,2,2,0,4,0,0,0,4,0,4,Sicilia,ITG1
2021-01-01,PF/BT,19092701.0,HSP11 - Ospedale Civico,SIC,60-69,3,2,0,5,0,0,0,5,0,5,Sicilia,ITG1
2021-01-01,PF/BT,190929.0,STS11 - IRCCS Ismett,SIC,20-29,10,13,0,22,1,0,0,23,0,23,Sicilia,ITG1
2021-01-01,PF/BT,190929.0,STS11 - IRCCS Ismett,SIC,30-39,9,18,0,26,1,0,0,27,0,27,Sicilia,ITG1
2021-01-01,PF/BT,190929.0,STS11 - IRCCS Ismett,SIC,40-49,21,15,0,33,3,0,0,36,0,36,Sicilia,ITG1
2021-01-01,PF/BT,190929.0,STS11 - IRCCS Ismett,SIC,50-59,11,14,0,18,7,0,0,25,0,25,Sicilia,ITG1
2021-01-01,PF/BT,190929.0,STS11 - IRCCS Ismett,SIC,60-69,0,2,0,2,0,0,0,2,0,2,Sicilia,ITG1
2021-01-02,PF/BT,190179.0,HSP11 - FOND. IST. S. RAFFAELE - GIGLIO,SIC,20-29,9,17,0,24,2,0,0,26,0,26,Sicilia,ITG1
2021-01-02,PF/BT,190179.0,HSP11 - FOND. IST. S. RAFFAELE - GIGLIO,SIC,30-39,30,19,0,41,8,0,0,49,0,49,Sicilia,ITG1
2021-01-02,PF/BT,190179.0,HSP11 - FOND. IST. S. RAFFAELE - GIGLIO,SIC,40-49,39,33,0,54,18,0,0,72,0,72,Sicilia,ITG1
2021-01-02,PF/BT,190179.0,HSP11 - FOND. IST. S. RAFFAELE - GIGLIO,SIC,50-59,12,13,0,21,4,0,0,25,0,25,Sicilia,ITG1
2021-01-02,PF/BT,190179.0,HSP11 - FOND. IST. S. RAFFAELE - GIGLIO,SIC,60-69,5,3,0,6,2,0,0,8,0,8,Sicilia,ITG1
2021-01-02,PF/BT,190199.0,HSP11 - OSP. BUCCHERI LA FERLA FATEBENEFRATELLI,SIC,20-29,9,8,0,17,0,0,0,17,0,17,Sicilia,ITG1
2021-01-02,PF/BT,190199.0,HSP11 - OSP. BUCCHERI LA FERLA FATEBENEFRATELLI,SIC,30-39,7,17,0,24,0,0,0,24,0,24,Sicilia,ITG1
2021-01-02,PF/BT,190199.0,HSP11 - OSP. BUCCHERI LA FERLA FATEBENEFRATELLI,SIC,40-49,10,30,0,38,0,0,2,40,0,40,Sicilia,ITG1
2021-01-02,PF/BT,190199.0,HSP11 - OSP. BUCCHERI LA FERLA FATEBENEFRATELLI,SIC,50-59,46,24,0,67,0,0,3,70,0,70,Sicilia,ITG1
2021-01-02,PF/BT,190199.0,HSP11 - OSP. BUCCHERI LA FERLA FATEBENEFRATELLI,SIC,60-69,32,19,0,51,0,0,0,51,0,51,Sicilia,ITG1
2021-01-02,PF/BT,190199.0,HSP11 - OSP. BUCCHERI LA FERLA FATEBENEFRATELLI,SIC,80-89,1,0,0,0,0,0,1,1,0,1,Sicilia,ITG1
2021-01-02,PF/BT,190199.0,HSP11 - OSP. BUCCHERI LA FERLA FATEBENEFRATELLI,SIC,90+,1,0,0,0,0,0,1,1,0,1,Sicilia,ITG1
2021-01-02,PF/BT,190301.0,RIA11 - A.I.A.S.SEZ.DI AGRIGENTO ONLUS,SIC,20-29,6,8,0,14,0,0,0,14,0,14,Sicilia,ITG1
2021-01-02,PF/BT,190301.0,RIA11 - A.I.A.S.SEZ.DI AGRIGENTO ONLUS,SIC,30-39,10,11,0,21,0,0,0,21,0,21,Sicilia,ITG1
2021-01-02,PF/BT,190301.0,RIA11 - A.I.A.S.SEZ.DI AGRIGENTO ONLUS,SIC,40-49,11,12,0,23,0,0,0,23,0,23,Sicilia,ITG1
2021-01-02,PF/BT,190301.0,RIA11 - A.I.A.S.SEZ.DI AGRIGENTO ONLUS,SIC,50-59,21,9,0,30,0,0,0,30,0,30,Sicilia,ITG1
2021-01-02,PF/BT,190301.0,RIA11 - A.I.A.S.SEZ.DI AGRIGENTO ONLUS,SIC,60-69,2,6,0,8,0,0,0,8,0,8,Sicilia,ITG1
2021-01-02,PF/BT,190302.0,RIA11 - C.DELLA SPERANZA DON ANGELO G.,SIC,20-29,3,1,0,4,0,0,0,4,0,4,Sicilia,ITG1
2021-01-02,PF/BT,190302.0,RIA11 - C.DELLA SPERANZA DON ANGELO G.,SIC,30-39,6,2,0,8,0,0,0,8,0,8,Sicilia,ITG1
2021-01-02,PF/BT,190302.0,RIA11 - C.DELLA SPERANZA DON ANGELO G.,SIC,40-49,13,6,0,19,0,0,0,19,0,19,Sicilia,ITG1
2021-01-02,PF/BT,190302.0,RIA11 - C.DELLA SPERANZA DON ANGELO G.,SIC,50-59,6,6,0,10,2,0,0,12,0,12,Sicilia,ITG1
2021-01-02,PF/BT,190302.0,RIA11 - C.DELLA SPERANZA DON ANGELO G.,SIC,60-69,5,2,0,7,0,0,0,7,0,7,Sicilia,ITG1
2021-01-02,PF/BT,190303.0,RIA11 - COMUNITA` DELLA SPERANZA,SIC,20-29,1,0,0,1,0,0,0,1,0,1,Sicilia,ITG1
2021-01-02,PF/BT,190303.0,RIA11 - COMUNITA` DELLA SPERANZA,SIC,30-39,4,8,0,12,0,0,0,12,0,12,Sicilia,ITG1
2021-01-02,PF/BT,190303.0,RIA11 - COMUNITA` DELLA SPERANZA,SIC,40-49,6,15,0,21,0,0,0,21,0,21,Sicilia,ITG1
2021-01-02,PF/BT,190303.0,RIA11 - COMUNITA` DELLA SPERANZA,SIC,50-59,12,12,0,24,0,0,0,24,0,24,Sicilia,ITG1
2021-01-02,PF/BT,190303.0,RIA11 - COMUNITA` DELLA SPERANZA,SIC,60-69,9,3,0,12,0,0,0,12,0,12,Sicilia,ITG1
2021-01-02,PF/BT,190304.0,HSP11 - P.O.  F.LLI PARLAPIANO - RIBERA,SIC,20-29,6,6,0,11,0,0,1,12,0,12,Sicilia,ITG1
2021-01-02,PF/BT,190304.0,HSP11 - P.O.  F.LLI PARLAPIANO - RIBERA,SIC,30-39,11,7,0,16,2,0,0,18,0,18,Sicilia,ITG1
2021-01-02,PF/BT,190304.0,HSP11 - P.O.  F.LLI PARLAPIANO - RIBERA,SIC,40-49,7,10,0,12,4,0,1,17,0,17,Sicilia,ITG1
2021-01-02,PF/BT,190304.0,HSP11 - P.O.  F.LLI PARLAPIANO - RIBERA,SIC,50-59,22,17,0,27,7,0,5,39,0,39,Sicilia,ITG1
2021-01-02,PF/BT,190304.0,HSP11 - P.O.  F.LLI PARLAPIANO - RIBERA,SIC,60-69,7,8,0,14,1,0,0,15,0,15,Sicilia,ITG1
2021-01-02,PF/BT,190305.0,HSP11 - P.O. GIOVANNI PAOLO II,SIC,20-29,4,1,0,5,0,0,0,5,0,5,Sicilia,ITG1
2021-01-02,PF/BT,190305.0,HSP11 - P.O. GIOVANNI PAOLO II,SIC,30-39,11,6,0,17,0,0,0,17,0,17,Sicilia,ITG1
2021-01-02,PF/BT,190305.0,HSP11 - P.O. GIOVANNI PAOLO II,SIC,40-49,9,10,0,19,0,0,0,19,0,19,Sicilia,ITG1
2021-01-02,PF/BT,190305.0,HSP11 - P.O. GIOVANNI PAOLO II,SIC,50-59,13,7,0,20,0,0,0,20,0,20,Sicilia,ITG1
2021-01-02,PF/BT,190305.0,HSP11 - P.O. GIOVANNI PAOLO II,SIC,60-69,5,4,0,9,0,0,0,9,0,9,Sicilia,ITG1
2021-01-02,PF/BT,190306.0,RIA11 - ASS. CASA FAM.ROSETTA ONILUS,SIC,20-29,21,27,0,48,0,0,0,48,0,48,Sicilia,ITG1
2021-01-02,PF/BT,190306.0,RIA11 - ASS. CASA FAM.ROSETTA ONILUS,SIC,30-39,9,10,0,19,0,0,0,19,0,19,Sicilia,ITG1
2021-01-02,PF/BT,190306.0,RIA11 - ASS. CASA FAM.ROSETTA ONILUS,SIC,40-49,21,20,0,41,0,0,0,41,0,41,Sicilia,ITG1
2021-01-02,PF/BT,190306.0,RIA11 - ASS. CASA FAM.ROSETTA ONILUS,SIC,50-59,17,22,0,38,0,0,1,39,0,39,Sicilia,ITG1
2021-01-02,PF/BT,190306.0,RIA11 - ASS. CASA FAM.ROSETTA ONILUS,SIC,60-69,12,8,0,20,0,0,0,20,0,20,Sicilia,ITG1
2021-01-02,PF/BT,190309.0,HSP11 - P.O. VITTORIO EMANUELE (ex AO),SIC,20-29,6,6,0,12,0,0,0,12,0,12,Sicilia,ITG1
2021-01-02,PF/BT,190309.0,HSP11 - P.O. VITTORIO EMANUELE (ex AO),SIC,30-39,6,4,0,10,0,0,0,10,0,10,Sicilia,ITG1
2021-01-02,PF/BT,190309.0,HSP11 - P.O. VITTORIO EMANUELE (ex AO),SIC,40-49,7,6,0,13,0,0,0,13,0,13,Sicilia,ITG1
2021-01-02,PF/BT,190309.0,HSP11 - P.O. VITTORIO EMANUELE (ex AO),SIC,50-59,22,10,0,32,0,0,0,32,0,32,Sicilia,ITG1
2021-01-02,PF/BT,190309.0,HSP11 - P.O. VITTORIO EMANUELE (ex AO),SIC,60-69,12,3,0,15,0,0,0,15,0,15,Sicilia,ITG1
2021-01-02,PF/BT,190312.0,HSP11 - P.O. S. Marta e S. Venera Acireale,SIC,20-29,1,0,0,1,0,0,0,1,0,1,Sicilia,ITG1
2021-01-02,PF/BT,190312.0,HSP11 - P.O. S. Marta e S. Venera Acireale,SIC,30-39,4,4,0,8,0,0,0,8,0,8,Sicilia,ITG1
2021-01-02,PF/BT,190312.0,HSP11 - P.O. S. Marta e S. Venera Acireale,SIC,40-49,2,8,0,10,0,0,0,10,0,10,Sicilia,ITG1
2021-01-02,PF/BT,190312.0,HSP11 - P.O. S. Marta e S. Venera Acireale,SIC,50-59,6,8,0,14,0,0,0,14,0,14,Sicilia,ITG1
2021-01-02,PF/BT,190312.0,HSP11 - P.O. S. Marta e S. Venera Acireale,SIC,60-69,9,5,0,14,0,0,0,14,0,14,Sicilia,ITG1
2021-01-02,PF/BT,190313.0,RIA11 - IST.RIAB.VILLAG. SAN GIUSEPPE,SIC,20-29,8,8,0,16,0,0,0,16,0,16,Sicilia,ITG1
2021-01-02,PF/BT,190313.0,RIA11 - IST.RIAB.VILLAG. SAN GIUSEPPE,SIC,30-39,3,3,0,6,0,0,0,6,0,6,Sicilia,ITG1
2021-01-02,PF/BT,190313.0,RIA11 - IST.RIAB.VILLAG. SAN GIUSEPPE,SIC,40-49,0,2,0,2,0,0,0,2,0,2,Sicilia,ITG1
2021-01-02,PF/BT,190313.0,RIA11 - IST.RIAB.VILLAG. SAN GIUSEPPE,SIC,50-59,6,7,0,13,0,0,0,13,0,13,Sicilia,ITG1
2021-01-02,PF/BT,190313.0,RIA11 - IST.RIAB.VILLAG. SAN GIUSEPPE,SIC,60-69,10,7,0,17,0,0,0,17,0,17,Sicilia,ITG1
2021-01-02,PF/BT,190314.0,RIA11 - ASS.J.F.KENNEDY ACIREALE,SIC,20-29,3,2,0,5,0,0,0,5,0,5,Sicilia,ITG1
2021-01-02,PF/BT,190314.0,RIA11 - ASS.J.F.KENNEDY ACIREALE,SIC,30-39,11,9,0,20,0,0,0,20,0,20,Sicilia,ITG1
2021-01-02,PF/BT,190314.0,RIA11 - ASS.J.F.KENNEDY ACIREALE,SIC,40-49,9,13,0,22,0,0,0,22,0,22,Sicilia,ITG1
2021-01-02,PF/BT,190314.0,RIA11 - ASS.J.F.KENNEDY ACIREALE,SIC,50-59,3,8,0,11,0,0,0,11,0,11,Sicilia,ITG1
2021-01-02,PF/BT,190314.0,RIA11 - ASS.J.F.KENNEDY ACIREALE,SIC,60-69,5,2,0,7,0,0,0,7,0,7,Sicilia,ITG1
2021-01-02,PF/BT,190315.0,RIA11 - AIAS SEZ. ACIREALE,SIC,30-39,0,4,0,4,0,0,0,4,0,4,Sicilia,ITG1
2021-01-02,PF/BT,190315.0,RIA11 - AIAS SEZ. ACIREALE,SIC,40-49,2,3,0,5,0,0,0,5,0,5,Sicilia,ITG1
2021-01-02,PF/BT,190315.0,RIA11 - AIAS SEZ. ACIREALE,SIC,50-59,16,3,0,19,0,0,0,19,0,19,Sicilia,ITG1
2021-01-02,PF/BT,190315.0,RIA11 - AIAS SEZ. ACIREALE,SIC,60-69,5,3,0,8,0,0,0,8,0,8,Sicilia,ITG1
2021-01-02,PF/BT,190316.0,RIA11 - ASS.J.F.KENNEDY - C.RIAB.ONLUS,SIC,20-29,8,4,0,12,0,0,0,12,0,12,Sicilia,ITG1
2021-01-02,PF/BT,190316.0,RIA11 - ASS.J.F.KENNEDY - C.RIAB.ONLUS,SIC,30-39,2,4,0,6,0,0,0,6,0,6,Sicilia,ITG1
2021-01-02,PF/BT,190316.0,RIA11 - ASS.J.F.KENNEDY - C.RIAB.ONLUS,SIC,40-49,3,6,0,9,0,0,0,9,0,9,Sicilia,ITG1
2021-01-02,PF/BT,190316.0,RIA11 - ASS.J.F.KENNEDY - C.RIAB.ONLUS,SIC,50-59,9,5,0,14,0,0,0,14,0,14,Sicilia,ITG1
2021-01-02,PF/BT,190316.0,RIA11 - ASS.J.F.KENNEDY - C.RIAB.ONLUS,SIC,60-69,4,3,0,7,0,0,0,7,0,7,Sicilia,ITG1
2021-01-02,PF/BT,190317.0,HSP11 - P.O. Gravina e S. Pietro Caltagirone,SIC,20-29,3,2,0,5,0,0,0,5,0,5,Sicilia,ITG1
2021-01-02,PF/BT,190317.0,HSP11 - P.O. Gravina e S. Pietro Caltagirone,SIC,30-39,6,7,0,13,0,0,0,13,0,13,Sicilia,ITG1
2021-01-02,PF/BT,190317.0,HSP11 - P.O. Gravina e S. Pietro Caltagirone,SIC,40-49,9,5,0,14,0,0,0,14,0,14,Sicilia,ITG1
2021-01-02,PF/BT,190317.0,HSP11 - P.O. Gravina e S. Pietro Caltagirone,SIC,50-59,16,14,0,30,0,0,0,30,0,30,Sicilia,ITG1
2021-01-02,PF/BT,190317.0,HSP11 - P.O. Gravina e S. Pietro Caltagirone,SIC,60-69,14,9,0,22,1,0,0,23,0,23,Sicilia,ITG1
2021-01-02,PF/BT,190318.0,RIA11 - ASS.ISTITUTO REGINA VIRGINUM,SIC,30-39,6,3,0,9,0,0,0,9,0,9,Sicilia,ITG1
2021-01-02,PF/BT,190318.0,RIA11 - ASS.ISTITUTO REGINA VIRGINUM,SIC,40-49,12,4,0,16,0,0,0,16,0,16,Sicilia,ITG1
2021-01-02,PF/BT,190318.0,RIA11 - ASS.ISTITUTO REGINA VIRGINUM,SIC,50-59,7,10,0,16,1,0,0,17,0,17,Sicilia,ITG1
2021-01-02,PF/BT,190318.0,RIA11 - ASS.ISTITUTO REGINA VIRGINUM,SIC,60-69,11,1,0,11,1,0,0,12,0,12,Sicilia,ITG1
2021-01-02,PF/BT,190319.0,HSP11 - P. O. UMBERTO I,SIC,20-29,8,7,0,15,0,0,0,15,0,15,Sicilia,ITG1
2021-01-02,PF/BT,190319.0,HSP11 - P. O. UMBERTO I,SIC,30-39,3,2,0,5,0,0,0,5,0,5,Sicilia,ITG1
2021-01-02,PF/BT,190319.0,HSP11 - P. O. UMBERTO I,SIC,40-49,7,10,0,17,0,0,0,17,0,17,Sicilia,ITG1
2021-01-02,PF/BT,190319.0,HSP11 - P. O. UMBERTO I,SIC,50-59,9,9,0,18,0,0,0,18,0,18,Sicilia,ITG1
2021-01-02,PF/BT,190319.0,HSP11 - P. O. UMBERTO I,SIC,60-69,4,1,0,5,0,0,0,5,0,5,Sicilia,ITG1
2021-01-02,PF/BT,190330.0,HSP11 - P.O. DEI BIANCHI CORLEONE,SIC,20-29,0,1,0,1,0,0,0,1,0,1,Sicilia,ITG1
2021-01-02,PF/BT,190330.0,HSP11 - P.O. DEI BIANCHI CORLEONE,SIC,30-39,5,3,0,8,0,0,0,8,0,8,Sicilia,ITG1
2021-01-02,PF/BT,190330.0,HSP11 - P.O. DEI BIANCHI CORLEONE,SIC,40-49,16,2,0,17,1,0,0,18,0,18,Sicilia,ITG1
2021-01-02,PF/BT,190330.0,HSP11 - P.O. DEI BIANCHI CORLEONE,SIC,50-59,19,13,0,28,3,0,1,32,0,32,Sicilia,ITG1
2021-01-02,PF/BT,190330.0,HSP11 - P.O. DEI BIANCHI CORLEONE,SIC,60-69,17,4,0,19,2,0,0,21,0,21,Sicilia,ITG1
2021-01-02,PF/BT,190332.0,HSP11 - P.O. CIVICO PARTINICO,SIC,20-29,15,13,0,27,1,0,0,28,0,28,Sicilia,ITG1
2021-01-02,PF/BT,190332.0,HSP11 - P.O. CIVICO PARTINICO,SIC,30-39,27,24,0,46,4,0,1,51,0,51,Sicilia,ITG1
2021-01-02,PF/BT,190332.0,HSP11 - P.O. CIVICO PARTINICO,SIC,40-49,25,28,0,48,1,0,4,53,0,53,Sicilia,ITG1
2021-01-02,PF/BT,190332.0,HSP11 - P.O. CIVICO PARTINICO,SIC,50-59,43,55,0,83,15,0,0,98,0,98,Sicilia,ITG1
2021-01-02,PF/BT,190332.0,HSP11 - P.O. CIVICO PARTINICO,SIC,60-69,57,30,0,81,6,0,0,87,0,87,Sicilia,ITG1
2021-01-02,PF/BT,190332.0,HSP11 - P.O. CIVICO PARTINICO,SIC,70-79,1,0,0,1,0,0,0,1,0,1,Sicilia,ITG1
2021-01-02,PF/BT,190333.0,HSP11 - P.O. MADONNA DELLALTO - PETR. SOTTANA,SIC,20-29,17,13,0,0,0,0,30,30,0,30,Sicilia,ITG1
2021-01-02,PF/BT,190333.0,HSP11 - P.O. MADONNA DELLALTO - PETR. SOTTANA,SIC,30-39,19,25,0,0,0,0,44,44,0,44,Sicilia,ITG1
2021-01-02,PF/BT,190333.0,HSP11 - P.O. MADONNA DELLALTO - PETR. SOTTANA,SIC,40-49,19,25,0,0,0,0,44,44,0,44,Sicilia,ITG1
2021-01-02,PF/BT,190333.0,HSP11 - P.O. MADONNA DELLALTO - PETR. SOTTANA,SIC,50-59,27,30,0,0,0,0,57,57,0,57,Sicilia,ITG1
2021-01-02,PF/BT,190333.0,HSP11 - P.O. MADONNA DELLALTO - PETR. SOTTANA,SIC,60-69,28,16,0,0,0,0,44,44,0,44,Sicilia,ITG1
2021-01-02,PF/BT,190333.0,HSP11 - P.O. MADONNA DELLALTO - PETR. SOTTANA,SIC,70-79,3,1,0,0,0,0,4,4,0,4,Sicilia,ITG1
2021-01-02,PF/BT,190334.0,HSP11 - P.O. S. CIMINO TERMINI IMERESE,SIC,20-29,8,7,0,15,0,0,0,15,0,15,Sicilia,ITG1
2021-01-02,PF/BT,190334.0,HSP11 - P.O. S. CIMINO TERMINI IMERESE,SIC,30-39,8,7,0,14,0,0,1,15,0,15,Sicilia,ITG1
2021-01-02,PF/BT,190334.0,HSP11 - P.O. S. CIMINO TERMINI IMERESE,SIC,40-49,20,16,0,36,0,0,0,36,0,36,Sicilia,ITG1
2021-01-02,PF/BT,190334.0,HSP11 - P.O. S. CIMINO TERMINI IMERESE,SIC,50-59,22,25,0,44,1,0,2,47,0,47,Sicilia,ITG1
2021-01-02,PF/BT,190334.0,HSP11 - P.O. S. CIMINO TERMINI IMERESE,SIC,60-69,10,15,0,23,0,0,2,25,0,25,Sicilia,ITG1
2021-01-02,PF/BT,190335.0,HSP11 - P.O. G. F. INGRASSIA,SIC,20-29,2,5,0,0,0,0,7,7,0,7,Sicilia,ITG1
2021-01-02,PF/BT,190335.0,HSP11 - P.O. G. F. INGRASSIA,SIC,30-39,6,6,0,0,0,0,12,12,0,12,Sicilia,ITG1
2021-01-02,PF/BT,190335.0,HSP11 - P.O. G. F. INGRASSIA,SIC,40-49,7,11,0,0,0,0,18,18,0,18,Sicilia,ITG1
2021-01-02,PF/BT,190335.0,HSP11 - P.O. G. F. INGRASSIA,SIC,50-59,27,11,0,0,0,0,38,38,0,38,Sicilia,ITG1
2021-01-02,PF/BT,190335.0,HSP11 - P.O. G. F. INGRASSIA,SIC,60-69,13,7,0,0,0,0,20,20,0,20,Sicilia,ITG1
2021-01-02,PF/BT,190337.0,HSP11 - P.O. VILLA DELLE GINESTRE,SIC,16-19,1,3,0,0,3,0,1,4,0,4,Sicilia,ITG1
2021-01-02,PF/BT,190337.0,HSP11 - P.O. VILLA DELLE GINESTRE,SIC,20-29,27,31,0,55,3,0,0,58,0,58,Sicilia,ITG1
2021-01-02,PF/BT,190337.0,HSP11 - P.O. VILLA DELLE GINESTRE,SIC,30-39,33,24,0,54,3,0,0,57,0,57,Sicilia,ITG1
2021-01-02,PF/BT,190337.0,HSP11 - P.O. VILLA DELLE GINESTRE,SIC,40-49,17,18,0,29,5,0,1,35,0,35,Sicilia,ITG1
2021-01-02,PF/BT,190337.0,HSP11 - P.O. VILLA DELLE GINESTRE,SIC,50-59,49,62,0,95,14,0,2,111,0,111,Sicilia,ITG1
2021-01-02,PF/BT,190337.0,HSP11 - P.O. VILLA DELLE GINESTRE,SIC,60-69,78,71,0,142,6,0,1,149,0,149,Sicilia,ITG1
2021-01-02,PF/BT,190337.0,HSP11 - P.O. VILLA DELLE GINESTRE,SIC,70-79,3,1,0,4,0,0,0,4,0,4,Sicilia,ITG1
2021-01-02,PF/BT,190338.0,HSP11 - OSPEDALE Giovanni Paolo II° M.P. A.,SIC,20-29,11,6,0,17,0,0,0,17,0,17,Sicilia,ITG1
2021-01-02,PF/BT,190338.0,HSP11 - OSPEDALE Giovanni Paolo II° M.P. A.,SIC,30-39,11,7,0,18,0,0,0,18,0,18,Sicilia,ITG1
2021-01-02,PF/BT,190338.0,HSP11 - OSPEDALE Giovanni Paolo II° M.P. A.,SIC,40-49,17,10,0,27,0,0,0,27,0,27,Sicilia,ITG1
2021-01-02,PF/BT,190338.0,HSP11 - OSPEDALE Giovanni Paolo II° M.P. A.,SIC,50-59,26,14,0,39,1,0,0,40,0,40,Sicilia,ITG1
2021-01-02,PF/BT,190338.0,HSP11 - OSPEDALE Giovanni Paolo II° M.P. A.,SIC,60-69,12,4,0,16,0,0,0,16,0,16,Sicilia,ITG1
2021-01-02,PF/BT,190340.0,HSP11 - OSPEDALE MAGGIORE MODICA,SIC,20-29,0,3,0,3,0,0,0,3,0,3,Sicilia,ITG1
2021-01-02,PF/BT,190340.0,HSP11 - OSPEDALE MAGGIORE MODICA,SIC,30-39,4,4,0,8,0,0,0,8,0,8,Sicilia,ITG1
2021-01-02,PF/BT,190340.0,HSP11 - OSPEDALE MAGGIORE MODICA,SIC,40-49,7,9,0,15,1,0,0,16,0,16,Sicilia,ITG1
2021-01-02,PF/BT,190340.0,HSP11 - OSPEDALE MAGGIORE MODICA,SIC,50-59,8,14,0,22,0,0,0,22,0,22,Sicilia,ITG1
2021-01-02,PF/BT,190340.0,HSP11 - OSPEDALE MAGGIORE MODICA,SIC,60-69,7,3,0,10,0,0,0,10,0,10,Sicilia,ITG1
2021-01-02,PF/BT,190342.0,HSP11 - OSPEDALE GUZZARDI VITTORIA,SIC,20-29,2,5,0,7,0,0,0,7,0,7,Sicilia,ITG1
2021-01-02,PF/BT,190342.0,HSP11 - OSPEDALE GUZZARDI VITTORIA,SIC,30-39,4,7,0,11,0,0,0,11,0,11,Sicilia,ITG1
2021-01-02,PF/BT,190342.0,HSP11 - OSPEDALE GUZZARDI VITTORIA,SIC,40-49,7,6,0,12,1,0,0,13,0,13,Sicilia,ITG1
2021-01-02,PF/BT,190342.0,HSP11 - OSPEDALE GUZZARDI VITTORIA,SIC,50-59,19,9,0,28,0,0,0,28,0,28,Sicilia,ITG1
2021-01-02,PF/BT,190342.0,HSP11 - OSPEDALE GUZZARDI VITTORIA,SIC,60-69,13,3,0,16,0,0,0,16,0,16,Sicilia,ITG1
2021-01-02,PF/BT,190343.0,HSP11 - P.O. DI MARIA AVOLA,SIC,20-29,3,1,0,4,0,0,0,4,0,4,Sicilia,ITG1
2021-01-02,PF/BT,190343.0,HSP11 - P.O. DI MARIA AVOLA,SIC,30-39,3,2,0,5,0,0,0,5,0,5,Sicilia,ITG1
2021-01-02,PF/BT,190343.0,HSP11 - P.O. DI MARIA AVOLA,SIC,40-49,7,5,0,12,0,0,0,12,0,12,Sicilia,ITG1
2021-01-02,PF/BT,190343.0,HSP11 - P.O. DI MARIA AVOLA,SIC,50-59,7,7,0,14,0,0,0,14,0,14,Sicilia,ITG1
2021-01-02,PF/BT,190343.0,HSP11 - P.O. DI MARIA AVOLA,SIC,60-69,6,1,0,7,0,0,0,7,0,7,Sicilia,ITG1
2021-01-02,PF/BT,190345.0,HSP11 - P.O. UMBERTO I (EX A.O.),SIC,20-29,6,8,0,14,0,0,0,14,0,14,Sicilia,ITG1
2021-01-02,PF/BT,190345.0,HSP11 - P.O. UMBERTO I (EX A.O.),SIC,30-39,9,20,0,29,0,0,0,29,0,29,Sicilia,ITG1
2021-01-02,PF/BT,190345.0,HSP11 - P.O. UMBERTO I (EX A.O.),SIC,40-49,9,12,0,21,0,0,0,21,0,21,Sicilia,ITG1
2021-01-02,PF/BT,190345.0,HSP11 - P.O. UMBERTO I (EX A.O.),SIC,50-59,5,5,0,10,0,0,0,10,0,10,Sicilia,ITG1
2021-01-02,PF/BT,190345.0,HSP11 - P.O. UMBERTO I (EX A.O.),SIC,60-69,5,4,0,9,0,0,0,9,0,9,Sicilia,ITG1
2021-01-02,PF/BT,190346.0,HSP11 - P.O. MUSCATELLO AUGUSTA,SIC,30-39,0,1,0,1,0,0,0,1,0,1,Sicilia,ITG1
2021-01-02,PF/BT,190346.0,HSP11 - P.O. MUSCATELLO AUGUSTA,SIC,40-49,0,1,0,1,0,0,0,1,0,1,Sicilia,ITG1
2021-01-02,PF/BT,190346.0,HSP11 - P.O. MUSCATELLO AUGUSTA,SIC,50-59,0,1,0,1,0,0,0,1,0,1,Sicilia,ITG1
2021-01-02,PF/BT,190346.0,HSP11 - P.O. MUSCATELLO AUGUSTA,SIC,60-69,3,0,0,3,0,0,0,3,0,3,Sicilia,ITG1
2021-01-02,PF/BT,190349.0,HSP11 - P.O. SAN VITO E SANTO SPIRITO -ALCAMO,SIC,20-29,5,6,0,11,0,0,0,11,0,11,Sicilia,ITG1
2021-01-02,PF/BT,190349.0,HSP11 - P.O. SAN VITO E SANTO SPIRITO -ALCAMO,SIC,30-39,7,5,0,11,0,0,1,12,0,12,Sicilia,ITG1
2021-01-02,PF/BT,190349.0,HSP11 - P.O. SAN VITO E SANTO SPIRITO -ALCAMO,SIC,40-49,10,9,0,17,1,0,1,19,0,19,Sicilia,ITG1
2021-01-02,PF/BT,190349.0,HSP11 - P.O. SAN VITO E SANTO SPIRITO -ALCAMO,SIC,50-59,9,7,0,14,1,0,1,16,0,16,Sicilia,ITG1
2021-01-02,PF/BT,190349.0,HSP11 - P.O. SAN VITO E SANTO SPIRITO -ALCAMO,SIC,60-69,11,6,0,16,0,0,1,17,0,17,Sicilia,ITG1
2021-01-02,PF/BT,190349.0,HSP11 - P.O. SAN VITO E SANTO SPIRITO -ALCAMO,SIC,70-79,1,0,0,0,0,0,1,1,0,1,Sicilia,ITG1
2021-01-02,PF/BT,190351.0,HSP11 - P.O. S. ANTONIO ABATE  - TRAPANI,SIC,20-29,1,5,0,6,0,0,0,6,0,6,Sicilia,ITG1
2021-01-02,PF/BT,190351.0,HSP11 - P.O. S. ANTONIO ABATE  - TRAPANI,SIC,30-39,12,15,0,27,0,0,0,27,0,27,Sicilia,ITG1
2021-01-02,PF/BT,190351.0,HSP11 - P.O. S. ANTONIO ABATE  - TRAPANI,SIC,40-49,20,19,0,39,0,0,0,39,0,39,Sicilia,ITG1
2021-01-02,PF/BT,190351.0,HSP11 - P.O. S. ANTONIO ABATE  - TRAPANI,SIC,50-59,28,35,0,63,0,0,0,63,0,63,Sicilia,ITG1
2021-01-02,PF/BT,190351.0,HSP11 - P.O. S. ANTONIO ABATE  - TRAPANI,SIC,60-69,23,11,0,34,0,0,0,34,0,34,Sicilia,ITG1
2021-01-02,PF/BT,190352.0,HSP11 - P.O. V.EMANUELE II CASTELVETRANO,SIC,20-29,2,0,0,2,0,0,0,2,0,2,Sicilia,ITG1
2021-01-02,PF/BT,190352.0,HSP11 - P.O. V.EMANUELE II CASTELVETRANO,SIC,30-39,3,4,0,7,0,0,0,7,0,7,Sicilia,ITG1
2021-01-02,PF/BT,190352.0,HSP11 - P.O. V.EMANUELE II CASTELVETRANO,SIC,40-49,7,7,0,9,4,0,1,14,0,14,Sicilia,ITG1
2021-01-02,PF/BT,190352.0,HSP11 - P.O. V.EMANUELE II CASTELVETRANO,SIC,50-59,14,11,0,20,4,0,1,25,0,25,Sicilia,ITG1
2021-01-02,PF/BT,190352.0,HSP11 - P.O. V.EMANUELE II CASTELVETRANO,SIC,60-69,19,5,0,20,3,0,1,24,0,24,Sicilia,ITG1
2021-01-02,PF/BT,190353.0,HSP11 - P.O.PAOLO BORSELLINO - MARSALA,SIC,20-29,5,14,0,19,0,0,0,19,0,19,Sicilia,ITG1
2021-01-02,PF/BT,190353.0,HSP11 - P.O.PAOLO BORSELLINO - MARSALA,SIC,30-39,14,10,0,24,0,0,0,24,0,24,Sicilia,ITG1
2021-01-02,PF/BT,190353.0,HSP11 - P.O.PAOLO BORSELLINO - MARSALA,SIC,40-49,15,14,0,29,0,0,0,29,0,29,Sicilia,ITG1
2021-01-02,PF/BT,190353.0,HSP11 - P.O.PAOLO BORSELLINO - MARSALA,SIC,50-59,16,10,0,26,0,0,0,26,0,26,Sicilia,ITG1
2021-01-02,PF/BT,190353.0,HSP11 - P.O.PAOLO BORSELLINO - MARSALA,SIC,60-69,9,1,0,10,0,0,0,10,0,10,Sicilia,ITG1
2021-01-02,PF/BT,190354.0,HSP11 - P.O.ABELE AJELLO-MAZARA D.VALLO,SIC,20-29,1,6,0,7,0,0,0,7,0,7,Sicilia,ITG1
2021-01-02,PF/BT,190354.0,HSP11 - P.O.ABELE AJELLO-MAZARA D.VALLO,SIC,30-39,8,5,0,13,0,0,0,13,0,13,Sicilia,ITG1
2021-01-02,PF/BT,190354.0,HSP11 - P.O.ABELE AJELLO-MAZARA D.VALLO,SIC,40-49,12,13,0,25,0,0,0,25,0,25,Sicilia,ITG1
2021-01-02,PF/BT,190354.0,HSP11 - P.O.ABELE AJELLO-MAZARA D.VALLO,SIC,50-59,18,8,0,26,0,0,0,26,0,26,Sicilia,ITG1
2021-01-02,PF/BT,190354.0,HSP11 - P.O.ABELE AJELLO-MAZARA D.VALLO,SIC,60-69,12,7,0,19,0,0,0,19,0,19,Sicilia,ITG1
2021-01-02,PF/BT,190921.0,HSP11 - A.O. per lEmergenza Cannizzaro,SIC,20-29,1,7,0,8,0,0,0,8,0,8,Sicilia,ITG1
2021-01-02,PF/BT,190921.0,HSP11 - A.O. per lEmergenza Cannizzaro,SIC,30-39,8,6,0,14,0,0,0,14,0,14,Sicilia,ITG1
2021-01-02,PF/BT,190921.0,HSP11 - A.O. per lEmergenza Cannizzaro,SIC,40-49,5,9,0,14,0,0,0,14,0,14,Sicilia,ITG1
2021-01-02,PF/BT,190921.0,HSP11 - A.O. per lEmergenza Cannizzaro,SIC,50-59,10,4,0,14,0,0,0,14,0,14,Sicilia,ITG1
2021-01-02,PF/BT,190921.0,HSP11 - A.O. per lEmergenza Cannizzaro,SIC,60-69,8,2,0,10,0,0,0,10,0,10,Sicilia,ITG1
2021-01-02,PF/BT,19092204.0,HSP11 - NUOVO OSPEDALE GARIBALDI - NESIMA,SIC,20-29,2,4,0,6,0,0,0,6,0,6,Sicilia,ITG1
2021-01-02,PF/BT,19092204.0,HSP11 - NUOVO OSPEDALE GARIBALDI - NESIMA,SIC,30-39,2,8,0,10,0,0,0,10,0,10,Sicilia,ITG1
2021-01-02,PF/BT,19092204.0,HSP11 - NUOVO OSPEDALE GARIBALDI - NESIMA,SIC,40-49,3,11,0,14,0,0,0,14,0,14,Sicilia,ITG1
2021-01-02,PF/BT,19092204.0,HSP11 - NUOVO OSPEDALE GARIBALDI - NESIMA,SIC,50-59,5,3,0,8,0,0,0,8,0,8,Sicilia,ITG1
2021-01-02,PF/BT,19092204.0,HSP11 - NUOVO OSPEDALE GARIBALDI - NESIMA,SIC,60-69,2,1,0,3,0,0,0,3,0,3,Sicilia,ITG1
2021-01-02,PF/BT,19092204.0,HSP11 - NUOVO OSPEDALE GARIBALDI - NESIMA,SIC,70-79,0,1,0,1,0,0,0,1,0,1,Sicilia,ITG1
2021-01-02,PF/BT,19092301.0,HSP11 - PRESIDIO OSPEDALIERO GASPARE RODOLICO,SIC,20-29,1,1,0,2,0,0,0,2,0,2,Sicilia,ITG1
2021-01-02,PF/BT,19092301.0,HSP11 - PRESIDIO OSPEDALIERO GASPARE RODOLICO,SIC,30-39,2,4,0,6,0,0,0,6,0,6,Sicilia,ITG1
2021-01-02,PF/BT,19092301.0,HSP11 - PRESIDIO OSPEDALIERO GASPARE RODOLICO,SIC,40-49,7,7,0,14,0,0,0,14,0,14,Sicilia,ITG1
2021-01-02,PF/BT,19092301.0,HSP11 - PRESIDIO OSPEDALIERO GASPARE RODOLICO,SIC,50-59,7,2,0,9,0,0,0,9,0,9,Sicilia,ITG1
2021-01-02,PF/BT,19092301.0,HSP11 - PRESIDIO OSPEDALIERO GASPARE RODOLICO,SIC,60-69,5,5,0,10,0,0,0,10,0,10,Sicilia,ITG1
2021-01-02,PF/BT,19092304.0,HSP11 - PRESIDIO OSPEDALIERO S.MARCO,SIC,20-29,5,3,0,8,0,0,0,8,0,8,Sicilia,ITG1
2021-01-02,PF/BT,19092304.0,HSP11 - PRESIDIO OSPEDALIERO S.MARCO,SIC,30-39,8,13,0,21,0,0,0,21,0,21,Sicilia,ITG1
2021-01-02,PF/BT,19092304.0,HSP11 - PRESIDIO OSPEDALIERO S.MARCO,SIC,40-49,7,9,0,16,0,0,0,16,0,16,Sicilia,ITG1
2021-01-02,PF/BT,19092304.0,HSP11 - PRESIDIO OSPEDALIERO S.MARCO,SIC,50-59,10,14,0,24,0,0,0,24,0,24,Sicilia,ITG1
2021-01-02,PF/BT,19092304.0,HSP11 - PRESIDIO OSPEDALIERO S.MARCO,SIC,60-69,10,5,0,15,0,0,0,15,0,15,Sicilia,ITG1
2021-01-02,PF/BT,190924.0,HSP11 - Azienda Ospedaliera Papardo,SIC,40-49,2,1,0,3,0,0,0,3,0,3,Sicilia,ITG1
2021-01-02,PF/BT,190924.0,HSP11 - Azienda Ospedaliera Papardo,SIC,50-59,2,4,0,6,0,0,0,6,0,6,Sicilia,ITG1
2021-01-02,PF/BT,190924.0,HSP11 - Azienda Ospedaliera Papardo,SIC,60-69,1,2,0,3,0,0,0,3,0,3,Sicilia,ITG1
2021-01-02,PF/BT,19092501.0,HSP11 - COVID HOSPITAL,SIC,20-29,2,1,0,3,0,0,0,3,0,3,Sicilia,ITG1
2021-01-02,PF/BT,19092501.0,HSP11 - COVID HOSPITAL,SIC,30-39,3,9,0,12,0,0,0,12,0,12,Sicilia,ITG1
2021-01-02,PF/BT,19092501.0,HSP11 - COVID HOSPITAL,SIC,40-49,9,10,0,19,0,0,0,19,0,19,Sicilia,ITG1
2021-01-02,PF/BT,19092501.0,HSP11 - COVID HOSPITAL,SIC,50-59,10,7,0,17,0,0,0,17,0,17,Sicilia,ITG1
2021-01-02,PF/BT,19092501.0,HSP11 - COVID HOSPITAL,SIC,60-69,6,3,0,9,0,0,0,9,0,9,Sicilia,ITG1
2021-01-02,PF/BT,19092601.0,HSP11 - P.O. Villa Sofia,SIC,20-29,17,32,0,49,0,0,0,49,0,49,Sicilia,ITG1
2021-01-02,PF/BT,19092601.0,HSP11 - P.O. Villa Sofia,SIC,30-39,41,45,0,86,0,0,0,86,0,86,Sicilia,ITG1
2021-01-02,PF/BT,19092601.0,HSP11 - P.O. Villa Sofia,SIC,40-49,42,83,0,125,0,0,0,125,0,125,Sicilia,ITG1
2021-01-02,PF/BT,19092601.0,HSP11 - P.O. Villa Sofia,SIC,50-59,76,86,0,162,0,0,0,162,0,162,Sicilia,ITG1
2021-01-02,PF/BT,19092601.0,HSP11 - P.O. Villa Sofia,SIC,60-69,69,39,0,108,0,0,0,108,0,108,Sicilia,ITG1
2021-01-02,PF/BT,19092701.0,HSP11 - Ospedale Civico,SIC,20-29,5,12,0,17,0,0,0,17,0,17,Sicilia,ITG1
2021-01-02,PF/BT,19092701.0,HSP11 - Ospedale Civico,SIC,30-39,14,12,0,26,0,0,0,26,0,26,Sicilia,ITG1
2021-01-02,PF/BT,19092701.0,HSP11 - Ospedale Civico,SIC,40-49,10,6,0,16,0,0,0,16,0,16,Sicilia,ITG1
2021-01-02,PF/BT,19092701.0,HSP11 - Ospedale Civico,SIC,50-59,20,14,0,34,0,0,0,34,0,34,Sicilia,ITG1
2021-01-02,PF/BT,19092701.0,HSP11 - Ospedale Civico,SIC,60-69,13,2,0,15,0,0,0,15,0,15,Sicilia,ITG1
2021-01-02,PF/BT,19092702.0,HSP11 - Ospedale dei Bambini G. Di Cristina,SIC,20-29,1,4,0,5,0,0,0,5,0,5,Sicilia,ITG1
2021-01-02,PF/BT,19092702.0,HSP11 - Ospedale dei Bambini G. Di Cristina,SIC,30-39,6,4,0,10,0,0,0,10,0,10,Sicilia,ITG1
2021-01-02,PF/BT,19092702.0,HSP11 - Ospedale dei Bambini G. Di Cristina,SIC,40-49,3,12,0,15,0,0,0,15,0,15,Sicilia,ITG1
2021-01-02,PF/BT,19092702.0,HSP11 - Ospedale dei Bambini G. Di Cristina,SIC,50-59,5,12,0,17,0,0,0,17,0,17,Sicilia,ITG1
2021-01-02,PF/BT,19092702.0,HSP11 - Ospedale dei Bambini G. Di Cristina,SIC,60-69,5,6,0,11,0,0,0,11,0,11,Sicilia,ITG1
2021-01-02,PF/BT,190928.0,HSP11 - AZ.OSP.UNIV.P.GIACCONE,SIC,20-29,22,25,0,26,0,0,21,47,0,47,Sicilia,ITG1
2021-01-02,PF/BT,190928.0,HSP11 - AZ.OSP.UNIV.P.GIACCONE,SIC,30-39,25,28,0,37,0,0,16,53,0,53,Sicilia,ITG1
2021-01-02,PF/BT,190928.0,HSP11 - AZ.OSP.UNIV.P.GIACCONE,SIC,40-49,22,17,0,34,0,0,5,39,0,39,Sicilia,ITG1
2021-01-02,PF/BT,190928.0,HSP11 - AZ.OSP.UNIV.P.GIACCONE,SIC,50-59,23,14,0,25,0,0,12,37,0,37,Sicilia,ITG1
2021-01-02,PF/BT,190928.0,HSP11 - AZ.OSP.UNIV.P.GIACCONE,SIC,60-69,17,6,0,16,0,0,7,23,0,23,Sicilia,ITG1
2021-01-02,PF/BT,190928.0,HSP11 - AZ.OSP.UNIV.P.GIACCONE,SIC,70-79,1,0,0,0,0,0,1,1,0,1,Sicilia,ITG1
2021-01-02,PF/BT,190929.0,STS11 - IRCCS Ismett,SIC,20-29,6,10,0,16,0,0,0,16,0,16,Sicilia,ITG1
2021-01-02,PF/BT,190929.0,STS11 - IRCCS Ismett,SIC,30-39,12,13,0,25,0,0,0,25,0,25,Sicilia,ITG1
2021-01-02,PF/BT,190929.0,STS11 - IRCCS Ismett,SIC,40-49,24,21,0,38,7,0,0,45,0,45,Sicilia,ITG1
2021-01-02,PF/BT,190929.0,STS11 - IRCCS Ismett,SIC,50-59,14,6,0,14,6,0,0,20,0,20,Sicilia,ITG1
2021-01-02,PF/BT,190929.0,STS11 - IRCCS Ismett,SIC,60-69,1,1,0,1,1,0,0,2,0,2,Sicilia,ITG1
2021-01-02,PF/BT,19096001.0,HSP11 - IRCCS Centro Neurolesi,SIC,20-29,0,1,0,1,0,0,0,1,0,1,Sicilia,ITG1
2021-01-02,PF/BT,19096001.0,HSP11 - IRCCS Centro Neurolesi,SIC,30-39,5,3,0,8,0,0,0,8,0,8,Sicilia,ITG1
2021-01-02,PF/BT,19096001.0,HSP11 - IRCCS Centro Neurolesi,SIC,40-49,1,7,0,8,0,0,0,8,0,8,Sicilia,ITG1
2021-01-02,PF/BT,19096001.0,HSP11 - IRCCS Centro Neurolesi,SIC,50-59,4,5,0,9,0,0,0,9,0,9,Sicilia,ITG1
2021-01-02,PF/BT,19096001.0,HSP11 - IRCCS Centro Neurolesi,SIC,60-69,1,3,0,4,0,0,0,4,0,4,Sicilia,ITG1
2021-01-03,PF/BT,190179.0,HSP11 - FOND. IST. S. RAFFAELE - GIGLIO,SIC,16-19,0,1,0,0,1,0,0,1,0,1,Sicilia,ITG1
2021-01-03,PF/BT,190179.0,HSP11 - FOND. IST. S. RAFFAELE - GIGLIO,SIC,20-29,7,8,0,10,5,0,0,15,0,15,Sicilia,ITG1
2021-01-03,PF/BT,190179.0,HSP11 - FOND. IST. S. RAFFAELE - GIGLIO,SIC,30-39,22,17,0,30,9,0,0,39,0,39,Sicilia,ITG1
2021-01-03,PF/BT,190179.0,HSP11 - FOND. IST. S. RAFFAELE - GIGLIO,SIC,40-49,29,28,0,32,25,0,0,57,0,57,Sicilia,ITG1
2021-01-03,PF/BT,190179.0,HSP11 - FOND. IST. S. RAFFAELE - GIGLIO,SIC,50-59,16,11,0,17,10,0,0,27,0,27,Sicilia,ITG1
2021-01-03,PF/BT,190179.0,HSP11 - FOND. IST. S. RAFFAELE - GIGLIO,SIC,60-69,2,5,0,6,1,0,0,7,0,7,Sicilia,ITG1
2021-01-03,PF/BT,190179.0,HSP11 - FOND. IST. S. RAFFAELE - GIGLIO,SIC,70-79,3,0,0,2,1,0,0,3,0,3,Sicilia,ITG1
2021-01-03,PF/BT,190199.0,HSP11 - OSP. BUCCHERI LA FERLA FATEBENEFRATELLI,SIC,20-29,5,5,0,10,0,0,0,10,0,10,Sicilia,ITG1
2021-01-03,PF/BT,190199.0,HSP11 - OSP. BUCCHERI LA FERLA FATEBENEFRATELLI,SIC,30-39,12,11,0,23,0,0,0,23,0,23,Sicilia,ITG1
2021-01-03,PF/BT,190199.0,HSP11 - OSP. BUCCHERI LA FERLA FATEBENEFRATELLI,SIC,40-49,8,11,0,19,0,0,0,19,0,19,Sicilia,ITG1
2021-01-03,PF/BT,190199.0,HSP11 - OSP. BUCCHERI LA FERLA FATEBENEFRATELLI,SIC,50-59,12,7,0,19,0,0,0,19,0,19,Sicilia,ITG1
2021-01-03,PF/BT,190199.0,HSP11 - OSP. BUCCHERI LA FERLA FATEBENEFRATELLI,SIC,60-69,3,3,0,6,0,0,0,6,0,6,Sicilia,ITG1
2021-01-03,PF/BT,1902057.0,STRUTTURE PRIVATE NON CODIFICATE NSIS,SIC,20-29,1,2,0,3,0,0,0,3,0,3,Sicilia,ITG1
2021-01-03,PF/BT,1902057.0,STRUTTURE PRIVATE NON CODIFICATE NSIS,SIC,30-39,1,2,0,3,0,0,0,3,0,3,Sicilia,ITG1
2021-01-03,PF/BT,1902057.0,STRUTTURE PRIVATE NON CODIFICATE NSIS,SIC,50-59,1,0,0,0,0,0,1,1,0,1,Sicilia,ITG1
2021-01-03,PF/BT,1902057.0,STRUTTURE PRIVATE NON CODIFICATE NSIS,SIC,60-69,5,0,0,2,0,0,3,5,0,5,Sicilia,ITG1
2021-01-03,PF/BT,190301.0,RIA11 - A.I.A.S.SEZ.DI AGRIGENTO ONLUS,SIC,20-29,5,8,0,13,0,0,0,13,0,13,Sicilia,ITG1
2021-01-03,PF/BT,190301.0,RIA11 - A.I.A.S.SEZ.DI AGRIGENTO ONLUS,SIC,30-39,12,15,0,27,0,0,0,27,0,27,Sicilia,ITG1
2021-01-03,PF/BT,190301.0,RIA11 - A.I.A.S.SEZ.DI AGRIGENTO ONLUS,SIC,40-49,13,15,0,27,0,0,1,28,0,28,Sicilia,ITG1
2021-01-03,PF/BT,190301.0,RIA11 - A.I.A.S.SEZ.DI AGRIGENTO ONLUS,SIC,50-59,26,15,0,40,0,0,1,41,0,41,Sicilia,ITG1
2021-01-03,PF/BT,190301.0,RIA11 - A.I.A.S.SEZ.DI AGRIGENTO ONLUS,SIC,60-69,8,3,0,11,0,0,0,11,0,11,Sicilia,ITG1
2021-01-03,PF/BT,190302.0,RIA11 - C.DELLA SPERANZA DON ANGELO G.,SIC,20-29,4,4,0,8,0,0,0,8,0,8,Sicilia,ITG1
2021-01-03,PF/BT,190302.0,RIA11 - C.DELLA SPERANZA DON ANGELO G.,SIC,30-39,6,4,0,10,0,0,0,10,0,10,Sicilia,ITG1
2021-01-03,PF/BT,190302.0,RIA11 - C.DELLA SPERANZA DON ANGELO G.,SIC,40-49,11,10,0,19,0,0,2,21,0,21,Sicilia,ITG1
2021-01-03,PF/BT,190302.0,RIA11 - C.DELLA SPERANZA DON ANGELO G.,SIC,50-59,13,7,0,15,1,0,4,20,0,20,Sicilia,ITG1
2021-01-03,PF/BT,190302.0,RIA11 - C.DELLA SPERANZA DON ANGELO G.,SIC,60-69,4,3,0,7,0,0,0,7,0,7,Sicilia,ITG1
2021-01-03,PF/BT,190303.0,RIA11 - COMUNITA` DELLA SPERANZA,SIC,16-19,1,0,0,1,0,0,0,1,0,1,Sicilia,ITG1
2021-01-03,PF/BT,190303.0,RIA11 - COMUNITA` DELLA SPERANZA,SIC,20-29,6,4,0,10,0,0,0,10,0,10,Sicilia,ITG1
2021-01-03,PF/BT,190303.0,RIA11 - COMUNITA` DELLA SPERANZA,SIC,30-39,8,12,0,20,0,0,0,20,0,20,Sicilia,ITG1
2021-01-03,PF/BT,190303.0,RIA11 - COMUNITA` DELLA SPERANZA,SIC,40-49,8,12,0,20,0,0,0,20,0,20,Sicilia,ITG1
2021-01-03,PF/BT,190303.0,RIA11 - COMUNITA` DELLA SPERANZA,SIC,50-59,17,18,0,35,0,0,0,35,0,35,Sicilia,ITG1
2021-01-03,PF/BT,190303.0,RIA11 - COMUNITA` DELLA SPERANZA,SIC,60-69,7,3,0,10,0,0,0,10,0,10,Sicilia,ITG1
2021-01-03,PF/BT,190305.0,HSP11 - P.O. GIOVANNI PAOLO II,SIC,20-29,4,4,0,8,0,0,0,8,0,8,Sicilia,ITG1
2021-01-03,PF/BT,190305.0,HSP11 - P.O. GIOVANNI PAOLO II,SIC,30-39,8,9,0,17,0,0,0,17,0,17,Sicilia,ITG1
2021-01-03,PF/BT,190305.0,HSP11 - P.O. GIOVANNI PAOLO II,SIC,40-49,7,5,0,12,0,0,0,12,0,12,Sicilia,ITG1
2021-01-03,PF/BT,190305.0,HSP11 - P.O. GIOVANNI PAOLO II,SIC,50-59,12,13,0,25,0,0,0,25,0,25,Sicilia,ITG1
2021-01-03,PF/BT,190305.0,HSP11 - P.O. GIOVANNI PAOLO II,SIC,60-69,5,6,0,11,0,0,0,11,0,11,Sicilia,ITG1
2021-01-03,PF/BT,190306.0,RIA11 - ASS. CASA FAM.ROSETTA ONILUS,SIC,20-29,26,24,0,48,2,0,0,50,0,50,Sicilia,ITG1
2021-01-03,PF/BT,190306.0,RIA11 - ASS. CASA FAM.ROSETTA ONILUS,SIC,30-39,38,35,0,66,7,0,0,73,0,73,Sicilia,ITG1
2021-01-03,PF/BT,190306.0,RIA11 - ASS. CASA FAM.ROSETTA ONILUS,SIC,40-49,43,30,0,65,8,0,0,73,0,73,Sicilia,ITG1
2021-01-03,PF/BT,190306.0,RIA11 - ASS. CASA FAM.ROSETTA ONILUS,SIC,50-59,54,34,0,88,0,0,0,88,0,88,Sicilia,ITG1
2021-01-03,PF/BT,190306.0,RIA11 - ASS. CASA FAM.ROSETTA ONILUS,SIC,60-69,42,12,0,53,1,0,0,54,0,54,Sicilia,ITG1
2021-01-03,PF/BT,190306.0,RIA11 - ASS. CASA FAM.ROSETTA ONILUS,SIC,70-79,1,0,0,1,0,0,0,1,0,1,Sicilia,ITG1
2021-01-03,PF/BT,190309.0,HSP11 - P.O. VITTORIO EMANUELE (ex AO),SIC,20-29,8,8,0,16,0,0,0,16,0,16,Sicilia,ITG1
2021-01-03,PF/BT,190309.0,HSP11 - P.O. VITTORIO EMANUELE (ex AO),SIC,30-39,6,5,0,11,0,0,0,11,0,11,Sicilia,ITG1
2021-01-03,PF/BT,190309.0,HSP11 - P.O. VITTORIO EMANUELE (ex AO),SIC,40-49,14,15,0,28,0,0,1,29,0,29,Sicilia,ITG1
2021-01-03,PF/BT,190309.0,HSP11 - P.O. VITTORIO EMANUELE (ex AO),SIC,50-59,38,14,0,50,0,0,2,52,0,52,Sicilia,ITG1
2021-01-03,PF/BT,190309.0,HSP11 - P.O. VITTORIO EMANUELE (ex AO),SIC,60-69,19,15,0,29,0,0,5,34,0,34,Sicilia,ITG1
2021-01-03,PF/BT,190312.0,HSP11 - P.O. S. Marta e S. Venera Acireale,SIC,20-29,6,2,0,8,0,0,0,8,0,8,Sicilia,ITG1
2021-01-03,PF/BT,190312.0,HSP11 - P.O. S. Marta e S. Venera Acireale,SIC,30-39,5,9,0,14,0,0,0,14,0,14,Sicilia,ITG1
2021-01-03,PF/BT,190312.0,HSP11 - P.O. S. Marta e S. Venera Acireale,SIC,40-49,4,11,0,15,0,0,0,15,0,15,Sicilia,ITG1
2021-01-03,PF/BT,190312.0,HSP11 - P.O. S. Marta e S. Venera Acireale,SIC,50-59,16,13,0,29,0,0,0,29,0,29,Sicilia,ITG1
2021-01-03,PF/BT,190312.0,HSP11 - P.O. S. Marta e S. Venera Acireale,SIC,60-69,16,8,0,24,0,0,0,24,0,24,Sicilia,ITG1
2021-01-03,PF/BT,190313.0,RIA11 - IST.RIAB.VILLAG. SAN GIUSEPPE,SIC,20-29,9,10,0,19,0,0,0,19,0,19,Sicilia,ITG1
2021-01-03,PF/BT,190313.0,RIA11 - IST.RIAB.VILLAG. SAN GIUSEPPE,SIC,30-39,5,2,0,7,0,0,0,7,0,7,Sicilia,ITG1
2021-01-03,PF/BT,190313.0,RIA11 - IST.RIAB.VILLAG. SAN GIUSEPPE,SIC,40-49,2,3,0,5,0,0,0,5,0,5,Sicilia,ITG1
2021-01-03,PF/BT,190313.0,RIA11 - IST.RIAB.VILLAG. SAN GIUSEPPE,SIC,50-59,12,11,0,23,0,0,0,23,0,23,Sicilia,ITG1
2021-01-03,PF/BT,190313.0,RIA11 - IST.RIAB.VILLAG. SAN GIUSEPPE,SIC,60-69,13,4,0,17,0,0,0,17,0,17,Sicilia,ITG1
2021-01-03,PF/BT,190314.0,RIA11 - ASS.J.F.KENNEDY ACIREALE,SIC,20-29,1,2,0,3,0,0,0,3,0,3,Sicilia,ITG1
2021-01-03,PF/BT,190314.0,RIA11 - ASS.J.F.KENNEDY ACIREALE,SIC,30-39,8,10,0,18,0,0,0,18,0,18,Sicilia,ITG1
2021-01-03,PF/BT,190314.0,RIA11 - ASS.J.F.KENNEDY ACIREALE,SIC,40-49,5,8,0,13,0,0,0,13,0,13,Sicilia,ITG1
2021-01-03,PF/BT,190314.0,RIA11 - ASS.J.F.KENNEDY ACIREALE,SIC,50-59,10,13,0,23,0,0,0,23,0,23,Sicilia,ITG1
2021-01-03,PF/BT,190314.0,RIA11 - ASS.J.F.KENNEDY ACIREALE,SIC,60-69,17,10,0,27,0,0,0,27,0,27,Sicilia,ITG1
2021-01-03,PF/BT,190315.0,RIA11 - AIAS SEZ. ACIREALE,SIC,20-29,2,0,0,2,0,0,0,2,0,2,Sicilia,ITG1
2021-01-03,PF/BT,190315.0,RIA11 - AIAS SEZ. ACIREALE,SIC,30-39,2,3,0,5,0,0,0,5,0,5,Sicilia,ITG1
2021-01-03,PF/BT,190315.0,RIA11 - AIAS SEZ. ACIREALE,SIC,40-49,6,12,0,18,0,0,0,18,0,18,Sicilia,ITG1
2021-01-03,PF/BT,190315.0,RIA11 - AIAS SEZ. ACIREALE,SIC,50-59,7,16,0,23,0,0,0,23,0,23,Sicilia,ITG1
2021-01-03,PF/BT,190315.0,RIA11 - AIAS SEZ. ACIREALE,SIC,60-69,11,13,0,24,0,0,0,24,0,24,Sicilia,ITG1
2021-01-03,PF/BT,190316.0,RIA11 - ASS.J.F.KENNEDY - C.RIAB.ONLUS,SIC,20-29,7,5,0,12,0,0,0,12,0,12,Sicilia,ITG1
2021-01-03,PF/BT,190316.0,RIA11 - ASS.J.F.KENNEDY - C.RIAB.ONLUS,SIC,30-39,3,7,0,10,0,0,0,10,0,10,Sicilia,ITG1
2021-01-03,PF/BT,190316.0,RIA11 - ASS.J.F.KENNEDY - C.RIAB.ONLUS,SIC,40-49,3,9,0,12,0,0,0,12,0,12,Sicilia,ITG1
2021-01-03,PF/BT,190316.0,RIA11 - ASS.J.F.KENNEDY - C.RIAB.ONLUS,SIC,50-59,4,5,0,9,0,0,0,9,0,9,Sicilia,ITG1
2021-01-03,PF/BT,190316.0,RIA11 - ASS.J.F.KENNEDY - C.RIAB.ONLUS,SIC,60-69,7,10,0,17,0,0,0,17,0,17,Sicilia,ITG1
2021-01-03,PF/BT,190317.0,HSP11 - P.O. Gravina e S. Pietro Caltagirone,SIC,20-29,3,3,0,6,0,0,0,6,0,6,Sicilia,ITG1
2021-01-03,PF/BT,190317.0,HSP11 - P.O. Gravina e S. Pietro Caltagirone,SIC,30-39,5,3,0,8,0,0,0,8,0,8,Sicilia,ITG1
2021-01-03,PF/BT,190317.0,HSP11 - P.O. Gravina e S. Pietro Caltagirone,SIC,40-49,5,9,0,13,1,0,0,14,0,14,Sicilia,ITG1
2021-01-03,PF/BT,190317.0,HSP11 - P.O. Gravina e S. Pietro Caltagirone,SIC,50-59,25,22,0,42,5,0,0,47,0,47,Sicilia,ITG1
2021-01-03,PF/BT,190317.0,HSP11 - P.O. Gravina e S. Pietro Caltagirone,SIC,60-69,12,7,0,18,1,0,0,19,0,19,Sicilia,ITG1
2021-01-03,PF/BT,190318.0,RIA11 - ASS.ISTITUTO REGINA VIRGINUM,SIC,20-29,21,9,0,30,0,0,0,30,0,30,Sicilia,ITG1
2021-01-03,PF/BT,190318.0,RIA11 - ASS.ISTITUTO REGINA VIRGINUM,SIC,30-39,9,4,0,13,0,0,0,13,0,13,Sicilia,ITG1
2021-01-03,PF/BT,190318.0,RIA11 - ASS.ISTITUTO REGINA VIRGINUM,SIC,40-49,4,9,0,13,0,0,0,13,0,13,Sicilia,ITG1
2021-01-03,PF/BT,190318.0,RIA11 - ASS.ISTITUTO REGINA VIRGINUM,SIC,50-59,4,13,0,17,0,0,0,17,0,17,Sicilia,ITG1
2021-01-03,PF/BT,190318.0,RIA11 - ASS.ISTITUTO REGINA VIRGINUM,SIC,60-69,4,1,0,5,0,0,0,5,0,5,Sicilia,ITG1
2021-01-03,PF/BT,190319.0,HSP11 - P. O. UMBERTO I,SIC,16-19,1,0,0,0,0,0,1,1,0,1,Sicilia,ITG1
2021-01-03,PF/BT,190319.0,HSP11 - P. O. UMBERTO I,SIC,20-29,1,8,0,8,0,0,1,9,0,9,Sicilia,ITG1
2021-01-03,PF/BT,190319.0,HSP11 - P. O. UMBERTO I,SIC,30-39,8,6,0,14,0,0,0,14,0,14,Sicilia,ITG1
2021-01-03,PF/BT,190319.0,HSP11 - P. O. UMBERTO I,SIC,40-49,3,8,0,11,0,0,0,11,0,11,Sicilia,ITG1
2021-01-03,PF/BT,190319.0,HSP11 - P. O. UMBERTO I,SIC,50-59,24,15,0,38,0,0,1,39,0,39,Sicilia,ITG1
2021-01-03,PF/BT,190319.0,HSP11 - P. O. UMBERTO I,SIC,60-69,22,11,0,33,0,0,0,33,0,33,Sicilia,ITG1
2021-01-03,PF/BT,190319.0,HSP11 - P. O. UMBERTO I,SIC,70-79,1,0,0,1,0,0,0,1,0,1,Sicilia,ITG1
2021-01-03,PF/BT,190330.0,HSP11 - P.O. DEI BIANCHI CORLEONE,SIC,20-29,1,3,0,4,0,0,0,4,0,4,Sicilia,ITG1
2021-01-03,PF/BT,190330.0,HSP11 - P.O. DEI BIANCHI CORLEONE,SIC,30-39,5,3,0,8,0,0,0,8,0,8,Sicilia,ITG1
2021-01-03,PF/BT,190330.0,HSP11 - P.O. DEI BIANCHI CORLEONE,SIC,40-49,6,3,0,9,0,0,0,9,0,9,Sicilia,ITG1
2021-01-03,PF/BT,190330.0,HSP11 - P.O. DEI BIANCHI CORLEONE,SIC,50-59,11,6,0,16,1,0,0,17,0,17,Sicilia,ITG1
2021-01-03,PF/BT,190330.0,HSP11 - P.O. DEI BIANCHI CORLEONE,SIC,60-69,14,5,0,19,0,0,0,19,0,19,Sicilia,ITG1
2021-01-03,PF/BT,190330.0,HSP11 - P.O. DEI BIANCHI CORLEONE,SIC,70-79,1,0,0,1,0,0,0,1,0,1,Sicilia,ITG1
2021-01-03,PF/BT,190332.0,HSP11 - P.O. CIVICO PARTINICO,SIC,16-19,1,0,0,1,0,0,0,1,0,1,Sicilia,ITG1
2021-01-03,PF/BT,190332.0,HSP11 - P.O. CIVICO PARTINICO,SIC,20-29,10,14,0,21,3,0,0,24,0,24,Sicilia,ITG1
2021-01-03,PF/BT,190332.0,HSP11 - P.O. CIVICO PARTINICO,SIC,30-39,12,17,0,24,5,0,0,29,0,29,Sicilia,ITG1
2021-01-03,PF/BT,190332.0,HSP11 - P.O. CIVICO PARTINICO,SIC,40-49,22,20,0,28,14,0,0,42,0,42,Sicilia,ITG1
2021-01-03,PF/BT,190332.0,HSP11 - P.O. CIVICO PARTINICO,SIC,50-59,23,27,0,43,7,0,0,50,0,50,Sicilia,ITG1
2021-01-03,PF/BT,190332.0,HSP11 - P.O. CIVICO PARTINICO,SIC,60-69,22,14,0,32,4,0,0,36,0,36,Sicilia,ITG1
2021-01-03,PF/BT,190332.0,HSP11 - P.O. CIVICO PARTINICO,SIC,70-79,5,1,0,6,0,0,0,6,0,6,Sicilia,ITG1
2021-01-03,PF/BT,190334.0,HSP11 - P.O. S. CIMINO TERMINI IMERESE,SIC,20-29,4,6,0,10,0,0,0,10,0,10,Sicilia,ITG1
2021-01-03,PF/BT,190334.0,HSP11 - P.O. S. CIMINO TERMINI IMERESE,SIC,30-39,3,5,0,8,0,0,0,8,0,8,Sicilia,ITG1
2021-01-03,PF/BT,190334.0,HSP11 - P.O. S. CIMINO TERMINI IMERESE,SIC,40-49,8,4,0,12,0,0,0,12,0,12,Sicilia,ITG1
2021-01-03,PF/BT,190334.0,HSP11 - P.O. S. CIMINO TERMINI IMERESE,SIC,50-59,9,8,0,17,0,0,0,17,0,17,Sicilia,ITG1
2021-01-03,PF/BT,190334.0,HSP11 - P.O. S. CIMINO TERMINI IMERESE,SIC,60-69,2,3,0,5,0,0,0,5,0,5,Sicilia,ITG1
2021-01-03,PF/BT,190335.0,HSP11 - P.O. G. F. INGRASSIA,SIC,20-29,1,2,0,0,0,0,3,3,0,3,Sicilia,ITG1
2021-01-03,PF/BT,190335.0,HSP11 - P.O. G. F. INGRASSIA,SIC,30-39,6,7,0,0,0,0,13,13,0,13,Sicilia,ITG1
2021-01-03,PF/BT,190335.0,HSP11 - P.O. G. F. INGRASSIA,SIC,40-49,6,12,0,0,0,0,18,18,0,18,Sicilia,ITG1
2021-01-03,PF/BT,190335.0,HSP11 - P.O. G. F. INGRASSIA,SIC,50-59,6,13,0,0,0,0,19,19,0,19,Sicilia,ITG1
2021-01-03,PF/BT,190335.0,HSP11 - P.O. G. F. INGRASSIA,SIC,60-69,8,6,0,0,0,0,14,14,0,14,Sicilia,ITG1
2021-01-03,PF/BT,190337.0,HSP11 - P.O. VILLA DELLE GINESTRE,SIC,20-29,8,6,0,13,0,0,1,14,0,14,Sicilia,ITG1
2021-01-03,PF/BT,190337.0,HSP11 - P.O. VILLA DELLE GINESTRE,SIC,30-39,7,8,0,15,0,0,0,15,0,15,Sicilia,ITG1
2021-01-03,PF/BT,190337.0,HSP11 - P.O. VILLA DELLE GINESTRE,SIC,40-49,8,12,0,16,2,0,2,20,0,20,Sicilia,ITG1
2021-01-03,PF/BT,190337.0,HSP11 - P.O. VILLA DELLE GINESTRE,SIC,50-59,28,37,0,42,13,0,10,65,0,65,Sicilia,ITG1
2021-01-03,PF/BT,190337.0,HSP11 - P.O. VILLA DELLE GINESTRE,SIC,60-69,34,22,0,46,7,0,3,56,0,56,Sicilia,ITG1
2021-01-03,PF/BT,190343.0,HSP11 - P.O. DI MARIA AVOLA,SIC,20-29,0,2,0,2,0,0,0,2,0,2,Sicilia,ITG1
2021-01-03,PF/BT,190343.0,HSP11 - P.O. DI MARIA AVOLA,SIC,30-39,6,6,0,12,0,0,0,12,0,12,Sicilia,ITG1
2021-01-03,PF/BT,190343.0,HSP11 - P.O. DI MARIA AVOLA,SIC,40-49,8,8,0,16,0,0,0,16,0,16,Sicilia,ITG1
2021-01-03,PF/BT,190343.0,HSP11 - P.O. DI MARIA AVOLA,SIC,50-59,16,9,0,25,0,0,0,25,0,25,Sicilia,ITG1
2021-01-03,PF/BT,190343.0,HSP11 - P.O. DI MARIA AVOLA,SIC,60-69,6,2,0,7,1,0,0,8,0,8,Sicilia,ITG1
2021-01-03,PF/BT,190345.0,HSP11 - P.O. UMBERTO I (EX A.O.),SIC,20-29,2,0,0,2,0,0,0,2,0,2,Sicilia,ITG1
2021-01-03,PF/BT,190345.0,HSP11 - P.O. UMBERTO I (EX A.O.),SIC,30-39,8,2,0,10,0,0,0,10,0,10,Sicilia,ITG1
2021-01-03,PF/BT,190345.0,HSP11 - P.O. UMBERTO I (EX A.O.),SIC,40-49,5,3,0,8,0,0,0,8,0,8,Sicilia,ITG1
2021-01-03,PF/BT,190345.0,HSP11 - P.O. UMBERTO I (EX A.O.),SIC,50-59,3,0,0,3,0,0,0,3,0,3,Sicilia,ITG1
2021-01-03,PF/BT,190345.0,HSP11 - P.O. UMBERTO I (EX A.O.),SIC,60-69,1,0,0,1,0,0,0,1,0,1,Sicilia,ITG1
2021-01-03,PF/BT,190346.0,HSP11 - P.O. MUSCATELLO AUGUSTA,SIC,20-29,6,5,0,11,0,0,0,11,0,11,Sicilia,ITG1
2021-01-03,PF/BT,190346.0,HSP11 - P.O. MUSCATELLO AUGUSTA,SIC,30-39,2,2,0,4,0,0,0,4,0,4,Sicilia,ITG1
2021-01-03,PF/BT,190346.0,HSP11 - P.O. MUSCATELLO AUGUSTA,SIC,40-49,4,2,0,6,0,0,0,6,0,6,Sicilia,ITG1
2021-01-03,PF/BT,190346.0,HSP11 - P.O. MUSCATELLO AUGUSTA,SIC,50-59,3,3,0,6,0,0,0,6,0,6,Sicilia,ITG1
2021-01-03,PF/BT,190346.0,HSP11 - P.O. MUSCATELLO AUGUSTA,SIC,60-69,3,0,0,3,0,0,0,3,0,3,Sicilia,ITG1
2021-01-03,PF/BT,190347.0,HSP11 - OSPEDALE GENERALE DI ZONA,SIC,20-29,2,0,0,2,0,0,0,2,0,2,Sicilia,ITG1
2021-01-03,PF/BT,190347.0,HSP11 - OSPEDALE GENERALE DI ZONA,SIC,30-39,5,10,0,15,0,0,0,15,0,15,Sicilia,ITG1
2021-01-03,PF/BT,190347.0,HSP11 - OSPEDALE GENERALE DI ZONA,SIC,40-49,4,8,0,12,0,0,0,12,0,12,Sicilia,ITG1
2021-01-03,PF/BT,190347.0,HSP11 - OSPEDALE GENERALE DI ZONA,SIC,50-59,9,9,0,18,0,0,0,18,0,18,Sicilia,ITG1
2021-01-03,PF/BT,190347.0,HSP11 - OSPEDALE GENERALE DI ZONA,SIC,60-69,5,8,0,13,0,0,0,13,0,13,Sicilia,ITG1
2021-01-03,PF/BT,190349.0,HSP11 - P.O. SAN VITO E SANTO SPIRITO -ALCAMO,SIC,20-29,4,3,0,7,0,0,0,7,0,7,Sicilia,ITG1
2021-01-03,PF/BT,190349.0,HSP11 - P.O. SAN VITO E SANTO SPIRITO -ALCAMO,SIC,30-39,9,8,0,15,2,0,0,17,0,17,Sicilia,ITG1
2021-01-03,PF/BT,190349.0,HSP11 - P.O. SAN VITO E SANTO SPIRITO -ALCAMO,SIC,40-49,10,14,0,14,9,0,1,24,0,24,Sicilia,ITG1
2021-01-03,PF/BT,190349.0,HSP11 - P.O. SAN VITO E SANTO SPIRITO -ALCAMO,SIC,50-59,25,14,0,30,9,0,0,39,0,39,Sicilia,ITG1
2021-01-03,PF/BT,190349.0,HSP11 - P.O. SAN VITO E SANTO SPIRITO -ALCAMO,SIC,60-69,27,9,0,33,2,0,1,36,0,36,Sicilia,ITG1
2021-01-03,PF/BT,190349.0,HSP11 - P.O. SAN VITO E SANTO SPIRITO -ALCAMO,SIC,70-79,1,0,0,1,0,0,0,1,0,1,Sicilia,ITG1
2021-01-03,PF/BT,190351.0,HSP11 - P.O. S. ANTONIO ABATE  - TRAPANI,SIC,20-29,5,1,0,6,0,0,0,6,0,6,Sicilia,ITG1
2021-01-03,PF/BT,190351.0,HSP11 - P.O. S. ANTONIO ABATE  - TRAPANI,SIC,30-39,15,11,0,26,0,0,0,26,0,26,Sicilia,ITG1
2021-01-03,PF/BT,190351.0,HSP11 - P.O. S. ANTONIO ABATE  - TRAPANI,SIC,40-49,14,13,0,27,0,0,0,27,0,27,Sicilia,ITG1
2021-01-03,PF/BT,190351.0,HSP11 - P.O. S. ANTONIO ABATE  - TRAPANI,SIC,50-59,11,22,0,33,0,0,0,33,0,33,Sicilia,ITG1
2021-01-03,PF/BT,190351.0,HSP11 - P.O. S. ANTONIO ABATE  - TRAPANI,SIC,60-69,19,18,0,37,0,0,0,37,0,37,Sicilia,ITG1
2021-01-03,PF/BT,190351.0,HSP11 - P.O. S. ANTONIO ABATE  - TRAPANI,SIC,70-79,0,1,0,1,0,0,0,1,0,1,Sicilia,ITG1
2021-01-03,PF/BT,190352.0,HSP11 - P.O. V.EMANUELE II CASTELVETRANO,SIC,20-29,4,7,0,9,1,0,1,11,0,11,Sicilia,ITG1
2021-01-03,PF/BT,190352.0,HSP11 - P.O. V.EMANUELE II CASTELVETRANO,SIC,30-39,17,9,0,23,2,0,1,26,0,26,Sicilia,ITG1
2021-01-03,PF/BT,190352.0,HSP11 - P.O. V.EMANUELE II CASTELVETRANO,SIC,40-49,26,23,0,46,2,0,1,49,0,49,Sicilia,ITG1
2021-01-03,PF/BT,190352.0,HSP11 - P.O. V.EMANUELE II CASTELVETRANO,SIC,50-59,28,33,0,55,6,0,0,61,0,61,Sicilia,ITG1
2021-01-03,PF/BT,190352.0,HSP11 - P.O. V.EMANUELE II CASTELVETRANO,SIC,60-69,22,20,0,40,1,0,1,42,0,42,Sicilia,ITG1
2021-01-03,PF/BT,190352.0,HSP11 - P.O. V.EMANUELE II CASTELVETRANO,SIC,70-79,4,0,0,3,0,0,1,4,0,4,Sicilia,ITG1
2021-01-03,PF/BT,190352.0,HSP11 - P.O. V.EMANUELE II CASTELVETRANO,SIC,90+,0,1,0,0,0,0,1,1,0,1,Sicilia,ITG1
2021-01-03,PF/BT,190353.0,HSP11 - P.O.PAOLO BORSELLINO - MARSALA,SIC,20-29,6,4,0,10,0,0,0,10,0,10,Sicilia,ITG1
2021-01-03,PF/BT,190353.0,HSP11 - P.O.PAOLO BORSELLINO - MARSALA,SIC,30-39,16,11,0,27,0,0,0,27,0,27,Sicilia,ITG1
2021-01-03,PF/BT,190353.0,HSP11 - P.O.PAOLO BORSELLINO - MARSALA,SIC,40-49,13,14,0,27,0,0,0,27,0,27,Sicilia,ITG1
2021-01-03,PF/BT,190353.0,HSP11 - P.O.PAOLO BORSELLINO - MARSALA,SIC,50-59,27,18,0,45,0,0,0,45,0,45,Sicilia,ITG1
2021-01-03,PF/BT,190353.0,HSP11 - P.O.PAOLO BORSELLINO - MARSALA,SIC,60-69,15,8,0,23,0,0,0,23,0,23,Sicilia,ITG1
2021-01-03,PF/BT,190354.0,HSP11 - P.O.ABELE AJELLO-MAZARA D.VALLO,SIC,20-29,4,4,0,8,0,0,0,8,0,8,Sicilia,ITG1
2021-01-03,PF/BT,190354.0,HSP11 - P.O.ABELE AJELLO-MAZARA D.VALLO,SIC,30-39,4,8,0,12,0,0,0,12,0,12,Sicilia,ITG1
2021-01-03,PF/BT,190354.0,HSP11 - P.O.ABELE AJELLO-MAZARA D.VALLO,SIC,40-49,10,10,0,20,0,0,0,20,0,20,Sicilia,ITG1
2021-01-03,PF/BT,190354.0,HSP11 - P.O.ABELE AJELLO-MAZARA D.VALLO,SIC,50-59,12,14,0,26,0,0,0,26,0,26,Sicilia,ITG1
2021-01-03,PF/BT,190354.0,HSP11 - P.O.ABELE AJELLO-MAZARA D.VALLO,SIC,60-69,9,4,0,13,0,0,0,13,0,13,Sicilia,ITG1
2021-01-03,PF/BT,190921.0,HSP11 - A.O. per lEmergenza Cannizzaro,SIC,16-19,1,0,0,1,0,0,0,1,0,1,Sicilia,ITG1
2021-01-03,PF/BT,190921.0,HSP11 - A.O. per lEmergenza Cannizzaro,SIC,20-29,2,8,0,10,0,0,0,10,0,10,Sicilia,ITG1
2021-01-03,PF/BT,190921.0,HSP11 - A.O. per lEmergenza Cannizzaro,SIC,30-39,13,20,0,33,0,0,0,33,0,33,Sicilia,ITG1
2021-01-03,PF/BT,190921.0,HSP11 - A.O. per lEmergenza Cannizzaro,SIC,40-49,24,25,0,49,0,0,0,49,0,49,Sicilia,ITG1
2021-01-03,PF/BT,190921.0,HSP11 - A.O. per lEmergenza Cannizzaro,SIC,50-59,23,18,0,41,0,0,0,41,0,41,Sicilia,ITG1
2021-01-03,PF/BT,190921.0,HSP11 - A.O. per lEmergenza Cannizzaro,SIC,60-69,19,9,0,28,0,0,0,28,0,28,Sicilia,ITG1
2021-01-03,PF/BT,19092201.0,HSP11 - OSPEDALE GARIBALDI - CENTRO,SIC,20-29,1,3,0,4,0,0,0,4,0,4,Sicilia,ITG1
2021-01-03,PF/BT,19092201.0,HSP11 - OSPEDALE GARIBALDI - CENTRO,SIC,30-39,4,5,0,9,0,0,0,9,0,9,Sicilia,ITG1
2021-01-03,PF/BT,19092201.0,HSP11 - OSPEDALE GARIBALDI - CENTRO,SIC,40-49,8,7,0,15,0,0,0,15,0,15,Sicilia,ITG1
2021-01-03,PF/BT,19092201.0,HSP11 - OSPEDALE GARIBALDI - CENTRO,SIC,50-59,8,9,0,17,0,0,0,17,0,17,Sicilia,ITG1
2021-01-03,PF/BT,19092201.0,HSP11 - OSPEDALE GARIBALDI - CENTRO,SIC,60-69,2,1,0,3,0,0,0,3,0,3,Sicilia,ITG1
2021-01-03,PF/BT,19092204.0,HSP11 - NUOVO OSPEDALE GARIBALDI - NESIMA,SIC,20-29,3,9,0,12,0,0,0,12,0,12,Sicilia,ITG1
2021-01-03,PF/BT,19092204.0,HSP11 - NUOVO OSPEDALE GARIBALDI - NESIMA,SIC,30-39,4,13,0,16,0,0,1,17,0,17,Sicilia,ITG1
2021-01-03,PF/BT,19092204.0,HSP11 - NUOVO OSPEDALE GARIBALDI - NESIMA,SIC,40-49,12,11,0,23,0,0,0,23,0,23,Sicilia,ITG1
2021-01-03,PF/BT,19092204.0,HSP11 - NUOVO OSPEDALE GARIBALDI - NESIMA,SIC,50-59,14,14,0,27,0,0,1,28,0,28,Sicilia,ITG1
2021-01-03,PF/BT,19092204.0,HSP11 - NUOVO OSPEDALE GARIBALDI - NESIMA,SIC,60-69,8,6,0,11,0,0,3,14,0,14,Sicilia,ITG1
2021-01-03,PF/BT,19092204.0,HSP11 - NUOVO OSPEDALE GARIBALDI - NESIMA,SIC,70-79,1,1,0,0,0,0,2,2,0,2,Sicilia,ITG1
2021-01-03,PF/BT,19092301.0,HSP11 - PRESIDIO OSPEDALIERO GASPARE RODOLICO,SIC,20-29,1,4,0,5,0,0,0,5,0,5,Sicilia,ITG1
2021-01-03,PF/BT,19092301.0,HSP11 - PRESIDIO OSPEDALIERO GASPARE RODOLICO,SIC,30-39,12,8,0,20,0,0,0,20,0,20,Sicilia,ITG1
2021-01-03,PF/BT,19092301.0,HSP11 - PRESIDIO OSPEDALIERO GASPARE RODOLICO,SIC,40-49,21,18,0,39,0,0,0,39,0,39,Sicilia,ITG1
2021-01-03,PF/BT,19092301.0,HSP11 - PRESIDIO OSPEDALIERO GASPARE RODOLICO,SIC,50-59,22,15,0,37,0,0,0,37,0,37,Sicilia,ITG1
2021-01-03,PF/BT,19092301.0,HSP11 - PRESIDIO OSPEDALIERO GASPARE RODOLICO,SIC,60-69,7,11,0,18,0,0,0,18,0,18,Sicilia,ITG1
2021-01-03,PF/BT,19092304.0,HSP11 - PRESIDIO OSPEDALIERO S.MARCO,SIC,20-29,10,8,0,18,0,0,0,18,0,18,Sicilia,ITG1
2021-01-03,PF/BT,19092304.0,HSP11 - PRESIDIO OSPEDALIERO S.MARCO,SIC,30-39,17,25,0,42,0,0,0,42,0,42,Sicilia,ITG1
2021-01-03,PF/BT,19092304.0,HSP11 - PRESIDIO OSPEDALIERO S.MARCO,SIC,40-49,8,11,0,19,0,0,0,19,0,19,Sicilia,ITG1
2021-01-03,PF/BT,19092304.0,HSP11 - PRESIDIO OSPEDALIERO S.MARCO,SIC,50-59,11,6,0,17,0,0,0,17,0,17,Sicilia,ITG1
2021-01-03,PF/BT,19092304.0,HSP11 - PRESIDIO OSPEDALIERO S.MARCO,SIC,60-69,9,2,0,11,0,0,0,11,0,11,Sicilia,ITG1
2021-01-03,PF/BT,19092601.0,HSP11 - P.O. Villa Sofia,SIC,20-29,12,25,0,37,0,0,0,37,0,37,Sicilia,ITG1
2021-01-03,PF/BT,19092601.0,HSP11 - P.O. Villa Sofia,SIC,30-39,22,22,0,44,0,0,0,44,0,44,Sicilia,ITG1
2021-01-03,PF/BT,19092601.0,HSP11 - P.O. Villa Sofia,SIC,40-49,27,32,0,59,0,0,0,59,0,59,Sicilia,ITG1
2021-01-03,PF/BT,19092601.0,HSP11 - P.O. Villa Sofia,SIC,50-59,36,37,0,73,0,0,0,73,0,73,Sicilia,ITG1
2021-01-03,PF/BT,19092601.0,HSP11 - P.O. Villa Sofia,SIC,60-69,18,19,0,37,0,0,0,37,0,37,Sicilia,ITG1
2021-01-03,PF/BT,19092601.0,HSP11 - P.O. Villa Sofia,SIC,70-79,1,0,0,1,0,0,0,1,0,1,Sicilia,ITG1
2021-01-03,PF/BT,19092701.0,HSP11 - Ospedale Civico,SIC,20-29,17,23,0,40,0,0,0,40,0,40,Sicilia,ITG1
2021-01-03,PF/BT,19092701.0,HSP11 - Ospedale Civico,SIC,30-39,17,20,0,37,0,0,0,37,0,37,Sicilia,ITG1
2021-01-03,PF/BT,19092701.0,HSP11 - Ospedale Civico,SIC,40-49,22,15,0,37,0,0,0,37,0,37,Sicilia,ITG1
2021-01-03,PF/BT,19092701.0,HSP11 - Ospedale Civico,SIC,50-59,14,11,0,25,0,0,0,25,0,25,Sicilia,ITG1
2021-01-03,PF/BT,19092701.0,HSP11 - Ospedale Civico,SIC,60-69,9,8,0,17,0,0,0,17,0,17,Sicilia,ITG1
2021-01-03,PF/BT,19092702.0,HSP11 - Ospedale dei Bambini G. Di Cristina,SIC,20-29,3,7,0,10,0,0,0,10,0,10,Sicilia,ITG1
2021-01-03,PF/BT,19092702.0,HSP11 - Ospedale dei Bambini G. Di Cristina,SIC,30-39,9,9,0,18,0,0,0,18,0,18,Sicilia,ITG1
2021-01-03,PF/BT,19092702.0,HSP11 - Ospedale dei Bambini G. Di Cristina,SIC,40-49,10,12,0,22,0,0,0,22,0,22,Sicilia,ITG1
2021-01-03,PF/BT,19092702.0,HSP11 - Ospedale dei Bambini G. Di Cristina,SIC,50-59,13,2,0,15,0,0,0,15,0,15,Sicilia,ITG1
2021-01-03,PF/BT,19092702.0,HSP11 - Ospedale dei Bambini G. Di Cristina,SIC,60-69,5,11,0,16,0,0,0,16,0,16,Sicilia,ITG1
2021-01-03,PF/BT,190928.0,HSP11 - AZ.OSP.UNIV.P.GIACCONE,SIC,20-29,44,47,0,91,0,0,0,91,0,91,Sicilia,ITG1
2021-01-03,PF/BT,190928.0,HSP11 - AZ.OSP.UNIV.P.GIACCONE,SIC,30-39,31,39,0,69,1,0,0,70,0,70,Sicilia,ITG1
2021-01-03,PF/BT,190928.0,HSP11 - AZ.OSP.UNIV.P.GIACCONE,SIC,40-49,26,30,0,56,0,0,0,56,0,56,Sicilia,ITG1
2021-01-03,PF/BT,190928.0,HSP11 - AZ.OSP.UNIV.P.GIACCONE,SIC,50-59,44,39,0,79,4,0,0,83,0,83,Sicilia,ITG1
2021-01-03,PF/BT,190928.0,HSP11 - AZ.OSP.UNIV.P.GIACCONE,SIC,60-69,39,7,0,46,0,0,0,46,0,46,Sicilia,ITG1
2021-01-03,PF/BT,190928.0,HSP11 - AZ.OSP.UNIV.P.GIACCONE,SIC,70-79,1,0,0,1,0,0,0,1,0,1,Sicilia,ITG1
2021-01-03,PF/BT,190929.0,STS11 - IRCCS Ismett,SIC,20-29,3,9,0,11,1,0,0,12,0,12,Sicilia,ITG1
2021-01-03,PF/BT,190929.0,STS11 - IRCCS Ismett,SIC,30-39,11,13,0,21,3,0,0,24,0,24,Sicilia,ITG1
2021-01-03,PF/BT,190929.0,STS11 - IRCCS Ismett,SIC,40-49,24,27,0,37,14,0,0,51,0,51,Sicilia,ITG1
2021-01-03,PF/BT,190929.0,STS11 - IRCCS Ismett,SIC,50-59,4,12,0,8,8,0,0,16,0,16,Sicilia,ITG1
2021-01-03,PF/BT,190929.0,STS11 - IRCCS Ismett,SIC,60-69,4,0,0,2,2,0,0,4,0,4,Sicilia,ITG1
2021-01-03,PF/BT,190929.0,STS11 - IRCCS Ismett,SIC,70-79,1,0,0,0,1,0,0,1,0,1,Sicilia,ITG1
2021-01-03,PF/BT,19096001.0,HSP11 - IRCCS Centro Neurolesi,SIC,20-29,2,4,0,6,0,0,0,6,0,6,Sicilia,ITG1
2021-01-03,PF/BT,19096001.0,HSP11 - IRCCS Centro Neurolesi,SIC,30-39,16,12,0,23,3,0,2,28,0,28,Sicilia,ITG1
2021-01-03,PF/BT,19096001.0,HSP11 - IRCCS Centro Neurolesi,SIC,40-49,18,19,0,27,8,0,2,37,0,37,Sicilia,ITG1
2021-01-03,PF/BT,19096001.0,HSP11 - IRCCS Centro Neurolesi,SIC,50-59,19,18,0,34,2,0,1,37,0,37,Sicilia,ITG1
2021-01-03,PF/BT,19096001.0,HSP11 - IRCCS Centro Neurolesi,SIC,60-69,9,3,0,11,1,0,0,12,0,12,Sicilia,ITG1
2021-01-04,PF/BT,190179.0,HSP11 - FOND. IST. S. RAFFAELE - GIGLIO,SIC,16-19,0,1,0,0,1,0,0,1,0,1,Sicilia,ITG1
2021-01-04,PF/BT,190179.0,HSP11 - FOND. IST. S. RAFFAELE - GIGLIO,SIC,20-29,6,7,0,11,2,0,0,13,0,13,Sicilia,ITG1
2021-01-04,PF/BT,190179.0,HSP11 - FOND. IST. S. RAFFAELE - GIGLIO,SIC,30-39,31,24,0,44,11,0,0,55,0,55,Sicilia,ITG1
2021-01-04,PF/BT,190179.0,HSP11 - FOND. IST. S. RAFFAELE - GIGLIO,SIC,40-49,31,44,0,48,27,0,0,75,0,75,Sicilia,ITG1
2021-01-04,PF/BT,190179.0,HSP11 - FOND. IST. S. RAFFAELE - GIGLIO,SIC,50-59,25,16,0,32,9,0,0,41,0,41,Sicilia,ITG1
2021-01-04,PF/BT,190179.0,HSP11 - FOND. IST. S. RAFFAELE - GIGLIO,SIC,60-69,10,8,0,15,3,0,0,18,0,18,Sicilia,ITG1
2021-01-04,PF/BT,190179.0,HSP11 - FOND. IST. S. RAFFAELE - GIGLIO,SIC,70-79,1,0,0,1,0,0,0,1,0,1,Sicilia,ITG1
2021-01-04,PF/BT,190199.0,HSP11 - OSP. BUCCHERI LA FERLA FATEBENEFRATELLI,SIC,20-29,2,3,0,5,0,0,0,5,0,5,Sicilia,ITG1
2021-01-04,PF/BT,190199.0,HSP11 - OSP. BUCCHERI LA FERLA FATEBENEFRATELLI,SIC,30-39,13,17,0,29,1,0,0,30,0,30,Sicilia,ITG1
2021-01-04,PF/BT,190199.0,HSP11 - OSP. BUCCHERI LA FERLA FATEBENEFRATELLI,SIC,40-49,5,16,0,21,0,0,0,21,0,21,Sicilia,ITG1
2021-01-04,PF/BT,190199.0,HSP11 - OSP. BUCCHERI LA FERLA FATEBENEFRATELLI,SIC,50-59,14,27,0,39,2,0,0,41,0,41,Sicilia,ITG1
2021-01-04,PF/BT,190199.0,HSP11 - OSP. BUCCHERI LA FERLA FATEBENEFRATELLI,SIC,60-69,13,13,0,25,1,0,0,26,0,26,Sicilia,ITG1
2021-01-04,PF/BT,190199.0,HSP11 - OSP. BUCCHERI LA FERLA FATEBENEFRATELLI,SIC,70-79,3,0,0,3,0,0,0,3,0,3,Sicilia,ITG1
2021-01-04,PF/BT,1902057.0,STRUTTURE PRIVATE NON CODIFICATE NSIS,SIC,16-19,0,1,0,1,0,0,0,1,0,1,Sicilia,ITG1
2021-01-04,PF/BT,1902057.0,STRUTTURE PRIVATE NON CODIFICATE NSIS,SIC,20-29,25,29,0,54,0,0,0,54,0,54,Sicilia,ITG1
2021-01-04,PF/BT,1902057.0,STRUTTURE PRIVATE NON CODIFICATE NSIS,SIC,30-39,13,19,0,32,0,0,0,32,0,32,Sicilia,ITG1
2021-01-04,PF/BT,1902057.0,STRUTTURE PRIVATE NON CODIFICATE NSIS,SIC,40-49,8,6,0,14,0,0,0,14,0,14,Sicilia,ITG1
2021-01-04,PF/BT,1902057.0,STRUTTURE PRIVATE NON CODIFICATE NSIS,SIC,50-59,8,5,0,13,0,0,0,13,0,13,Sicilia,ITG1
2021-01-04,PF/BT,1902057.0,STRUTTURE PRIVATE NON CODIFICATE NSIS,SIC,60-69,8,2,0,10,0,0,0,10,0,10,Sicilia,ITG1
2021-01-04,PF/BT,1902072.0,AMBULATORI VACCINALI NON CODIFICATI NSIS,SIC,30-39,3,2,0,5,0,0,0,5,0,5,Sicilia,ITG1
2021-01-04,PF/BT,1902072.0,AMBULATORI VACCINALI NON CODIFICATI NSIS,SIC,40-49,4,2,0,6,0,0,0,6,0,6,Sicilia,ITG1
2021-01-04,PF/BT,1902072.0,AMBULATORI VACCINALI NON CODIFICATI NSIS,SIC,50-59,9,7,0,16,0,0,0,16,0,16,Sicilia,ITG1
2021-01-04,PF/BT,1902072.0,AMBULATORI VACCINALI NON CODIFICATI NSIS,SIC,60-69,25,13,0,34,4,0,0,38,0,38,Sicilia,ITG1
2021-01-04,PF/BT,190301.0,RIA11 - A.I.A.S.SEZ.DI AGRIGENTO ONLUS,SIC,20-29,7,9,0,16,0,0,0,16,0,16,Sicilia,ITG1
2021-01-04,PF/BT,190301.0,RIA11 - A.I.A.S.SEZ.DI AGRIGENTO ONLUS,SIC,30-39,19,13,0,32,0,0,0,32,0,32,Sicilia,ITG1
2021-01-04,PF/BT,190301.0,RIA11 - A.I.A.S.SEZ.DI AGRIGENTO ONLUS,SIC,40-49,27,25,0,52,0,0,0,52,0,52,Sicilia,ITG1
2021-01-04,PF/BT,190301.0,RIA11 - A.I.A.S.SEZ.DI AGRIGENTO ONLUS,SIC,50-59,22,22,0,44,0,0,0,44,0,44,Sicilia,ITG1
2021-01-04,PF/BT,190301.0,RIA11 - A.I.A.S.SEZ.DI AGRIGENTO ONLUS,SIC,60-69,13,5,0,18,0,0,0,18,0,18,Sicilia,ITG1
2021-01-04,PF/BT,190302.0,RIA11 - C.DELLA SPERANZA DON ANGELO G.,SIC,20-29,1,5,0,6,0,0,0,6,0,6,Sicilia,ITG1
2021-01-04,PF/BT,190302.0,RIA11 - C.DELLA SPERANZA DON ANGELO G.,SIC,30-39,5,2,0,7,0,0,0,7,0,7,Sicilia,ITG1
2021-01-04,PF/BT,190302.0,RIA11 - C.DELLA SPERANZA DON ANGELO G.,SIC,40-49,4,6,0,8,0,0,2,10,0,10,Sicilia,ITG1
2021-01-04,PF/BT,190302.0,RIA11 - C.DELLA SPERANZA DON ANGELO G.,SIC,50-59,22,10,0,31,0,0,1,32,0,32,Sicilia,ITG1
2021-01-04,PF/BT,190302.0,RIA11 - C.DELLA SPERANZA DON ANGELO G.,SIC,60-69,0,4,0,4,0,0,0,4,0,4,Sicilia,ITG1
2021-01-04,PF/BT,190303.0,RIA11 - COMUNITA` DELLA SPERANZA,SIC,30-39,4,1,0,5,0,0,0,5,0,5,Sicilia,ITG1
2021-01-04,PF/BT,190303.0,RIA11 - COMUNITA` DELLA SPERANZA,SIC,40-49,7,2,0,9,0,0,0,9,0,9,Sicilia,ITG1
2021-01-04,PF/BT,190303.0,RIA11 - COMUNITA` DELLA SPERANZA,SIC,50-59,4,7,0,11,0,0,0,11,0,11,Sicilia,ITG1
2021-01-04,PF/BT,190303.0,RIA11 - COMUNITA` DELLA SPERANZA,SIC,60-69,5,5,0,10,0,0,0,10,0,10,Sicilia,ITG1
2021-01-04,PF/BT,190304.0,HSP11 - P.O.  F.LLI PARLAPIANO - RIBERA,SIC,20-29,2,0,0,2,0,0,0,2,0,2,Sicilia,ITG1
2021-01-04,PF/BT,190304.0,HSP11 - P.O.  F.LLI PARLAPIANO - RIBERA,SIC,30-39,4,0,0,4,0,0,0,4,0,4,Sicilia,ITG1
2021-01-04,PF/BT,190304.0,HSP11 - P.O.  F.LLI PARLAPIANO - RIBERA,SIC,40-49,6,5,0,7,4,0,0,11,0,11,Sicilia,ITG1
2021-01-04,PF/BT,190304.0,HSP11 - P.O.  F.LLI PARLAPIANO - RIBERA,SIC,50-59,11,9,0,13,5,0,2,20,0,20,Sicilia,ITG1
2021-01-04,PF/BT,190304.0,HSP11 - P.O.  F.LLI PARLAPIANO - RIBERA,SIC,60-69,27,8,0,34,0,0,1,35,0,35,Sicilia,ITG1
2021-01-04,PF/BT,190305.0,HSP11 - P.O. GIOVANNI PAOLO II,SIC,20-29,2,5,0,7,0,0,0,7,0,7,Sicilia,ITG1
2021-01-04,PF/BT,190305.0,HSP11 - P.O. GIOVANNI PAOLO II,SIC,30-39,9,13,0,22,0,0,0,22,0,22,Sicilia,ITG1
2021-01-04,PF/BT,190305.0,HSP11 - P.O. GIOVANNI PAOLO II,SIC,40-49,5,10,0,15,0,0,0,15,0,15,Sicilia,ITG1
2021-01-04,PF/BT,190305.0,HSP11 - P.O. GIOVANNI PAOLO II,SIC,50-59,12,12,0,24,0,0,0,24,0,24,Sicilia,ITG1
2021-01-04,PF/BT,190305.0,HSP11 - P.O. GIOVANNI PAOLO II,SIC,60-69,9,6,0,15,0,0,0,15,0,15,Sicilia,ITG1
2021-01-04,PF/BT,190306.0,RIA11 - ASS. CASA FAM.ROSETTA ONILUS,SIC,16-19,1,0,0,0,0,0,1,1,0,1,Sicilia,ITG1
2021-01-04,PF/BT,190306.0,RIA11 - ASS. CASA FAM.ROSETTA ONILUS,SIC,20-29,7,6,0,10,0,0,3,13,0,13,Sicilia,ITG1
2021-01-04,PF/BT,190306.0,RIA11 - ASS. CASA FAM.ROSETTA ONILUS,SIC,30-39,31,22,0,42,10,0,1,53,0,53,Sicilia,ITG1
2021-01-04,PF/BT,190306.0,RIA11 - ASS. CASA FAM.ROSETTA ONILUS,SIC,40-49,30,31,0,49,8,0,4,61,0,61,Sicilia,ITG1
2021-01-04,PF/BT,190306.0,RIA11 - ASS. CASA FAM.ROSETTA ONILUS,SIC,50-59,56,48,0,81,19,0,4,104,0,104,Sicilia,ITG1
2021-01-04,PF/BT,190306.0,RIA11 - ASS. CASA FAM.ROSETTA ONILUS,SIC,60-69,50,21,0,59,11,0,1,71,0,71,Sicilia,ITG1
2021-01-04,PF/BT,190306.0,RIA11 - ASS. CASA FAM.ROSETTA ONILUS,SIC,70-79,6,1,0,6,0,0,1,7,0,7,Sicilia,ITG1
2021-01-04,PF/BT,190306.0,RIA11 - ASS. CASA FAM.ROSETTA ONILUS,SIC,80-89,1,0,0,1,0,0,0,1,0,1,Sicilia,ITG1
2021-01-04,PF/BT,190309.0,HSP11 - P.O. VITTORIO EMANUELE (ex AO),SIC,20-29,6,3,0,9,0,0,0,9,0,9,Sicilia,ITG1
2021-01-04,PF/BT,190309.0,HSP11 - P.O. VITTORIO EMANUELE (ex AO),SIC,30-39,13,8,0,21,0,0,0,21,0,21,Sicilia,ITG1
2021-01-04,PF/BT,190309.0,HSP11 - P.O. VITTORIO EMANUELE (ex AO),SIC,40-49,13,9,0,21,0,0,1,22,0,22,Sicilia,ITG1
2021-01-04,PF/BT,190309.0,HSP11 - P.O. VITTORIO EMANUELE (ex AO),SIC,50-59,37,23,0,56,0,0,4,60,0,60,Sicilia,ITG1
2021-01-04,PF/BT,190309.0,HSP11 - P.O. VITTORIO EMANUELE (ex AO),SIC,60-69,27,11,0,36,0,0,2,38,0,38,Sicilia,ITG1
2021-01-04,PF/BT,190312.0,HSP11 - P.O. S. Marta e S. Venera Acireale,SIC,20-29,5,6,0,8,3,0,0,11,0,11,Sicilia,ITG1
2021-01-04,PF/BT,190312.0,HSP11 - P.O. S. Marta e S. Venera Acireale,SIC,30-39,10,9,0,19,0,0,0,19,0,19,Sicilia,ITG1
2021-01-04,PF/BT,190312.0,HSP11 - P.O. S. Marta e S. Venera Acireale,SIC,40-49,12,13,0,25,0,0,0,25,0,25,Sicilia,ITG1
2021-01-04,PF/BT,190312.0,HSP11 - P.O. S. Marta e S. Venera Acireale,SIC,50-59,24,38,0,62,0,0,0,62,0,62,Sicilia,ITG1
2021-01-04,PF/BT,190312.0,HSP11 - P.O. S. Marta e S. Venera Acireale,SIC,60-69,31,14,0,45,0,0,0,45,0,45,Sicilia,ITG1
2021-01-04,PF/BT,190313.0,RIA11 - IST.RIAB.VILLAG. SAN GIUSEPPE,SIC,20-29,4,9,0,13,0,0,0,13,0,13,Sicilia,ITG1
2021-01-04,PF/BT,190313.0,RIA11 - IST.RIAB.VILLAG. SAN GIUSEPPE,SIC,30-39,4,9,0,13,0,0,0,13,0,13,Sicilia,ITG1
2021-01-04,PF/BT,190313.0,RIA11 - IST.RIAB.VILLAG. SAN GIUSEPPE,SIC,40-49,5,14,0,19,0,0,0,19,0,19,Sicilia,ITG1
2021-01-04,PF/BT,190313.0,RIA11 - IST.RIAB.VILLAG. SAN GIUSEPPE,SIC,50-59,25,37,0,62,0,0,0,62,0,62,Sicilia,ITG1
2021-01-04,PF/BT,190313.0,RIA11 - IST.RIAB.VILLAG. SAN GIUSEPPE,SIC,60-69,27,38,0,65,0,0,0,65,0,65,Sicilia,ITG1
2021-01-04,PF/BT,190313.0,RIA11 - IST.RIAB.VILLAG. SAN GIUSEPPE,SIC,70-79,2,0,0,2,0,0,0,2,0,2,Sicilia,ITG1
2021-01-04,PF/BT,190314.0,RIA11 - ASS.J.F.KENNEDY ACIREALE,SIC,20-29,5,3,0,8,0,0,0,8,0,8,Sicilia,ITG1
2021-01-04,PF/BT,190314.0,RIA11 - ASS.J.F.KENNEDY ACIREALE,SIC,30-39,9,10,0,19,0,0,0,19,0,19,Sicilia,ITG1
2021-01-04,PF/BT,190314.0,RIA11 - ASS.J.F.KENNEDY ACIREALE,SIC,40-49,13,16,0,29,0,0,0,29,0,29,Sicilia,ITG1
2021-01-04,PF/BT,190314.0,RIA11 - ASS.J.F.KENNEDY ACIREALE,SIC,50-59,30,19,0,49,0,0,0,49,0,49,Sicilia,ITG1
2021-01-04,PF/BT,190314.0,RIA11 - ASS.J.F.KENNEDY ACIREALE,SIC,60-69,35,22,0,57,0,0,0,57,0,57,Sicilia,ITG1
2021-01-04,PF/BT,190314.0,RIA11 - ASS.J.F.KENNEDY ACIREALE,SIC,70-79,2,0,0,2,0,0,0,2,0,2,Sicilia,ITG1
2021-01-04,PF/BT,190315.0,RIA11 - AIAS SEZ. ACIREALE,SIC,20-29,5,4,0,9,0,0,0,9,0,9,Sicilia,ITG1
2021-01-04,PF/BT,190315.0,RIA11 - AIAS SEZ. ACIREALE,SIC,30-39,7,9,0,16,0,0,0,16,0,16,Sicilia,ITG1
2021-01-04,PF/BT,190315.0,RIA11 - AIAS SEZ. ACIREALE,SIC,40-49,18,18,0,36,0,0,0,36,0,36,Sicilia,ITG1
2021-01-04,PF/BT,190315.0,RIA11 - AIAS SEZ. ACIREALE,SIC,50-59,28,20,0,48,0,0,0,48,0,48,Sicilia,ITG1
2021-01-04,PF/BT,190315.0,RIA11 - AIAS SEZ. ACIREALE,SIC,60-69,32,14,0,46,0,0,0,46,0,46,Sicilia,ITG1
2021-01-04,PF/BT,190316.0,RIA11 - ASS.J.F.KENNEDY - C.RIAB.ONLUS,SIC,20-29,16,11,0,25,2,0,0,27,0,27,Sicilia,ITG1
2021-01-04,PF/BT,190316.0,RIA11 - ASS.J.F.KENNEDY - C.RIAB.ONLUS,SIC,30-39,10,16,0,26,0,0,0,26,0,26,Sicilia,ITG1
2021-01-04,PF/BT,190316.0,RIA11 - ASS.J.F.KENNEDY - C.RIAB.ONLUS,SIC,40-49,8,15,0,19,4,0,0,23,0,23,Sicilia,ITG1
2021-01-04,PF/BT,190316.0,RIA11 - ASS.J.F.KENNEDY - C.RIAB.ONLUS,SIC,50-59,17,30,0,45,2,0,0,47,0,47,Sicilia,ITG1
2021-01-04,PF/BT,190316.0,RIA11 - ASS.J.F.KENNEDY - C.RIAB.ONLUS,SIC,60-69,50,24,0,66,8,0,0,74,0,74,Sicilia,ITG1
2021-01-04,PF/BT,190317.0,HSP11 - P.O. Gravina e S. Pietro Caltagirone,SIC,16-19,0,1,0,1,0,0,0,1,0,1,Sicilia,ITG1
2021-01-04,PF/BT,190317.0,HSP11 - P.O. Gravina e S. Pietro Caltagirone,SIC,20-29,5,2,0,5,2,0,0,7,0,7,Sicilia,ITG1
2021-01-04,PF/BT,190317.0,HSP11 - P.O. Gravina e S. Pietro Caltagirone,SIC,30-39,9,10,0,18,1,0,0,19,0,19,Sicilia,ITG1
2021-01-04,PF/BT,190317.0,HSP11 - P.O. Gravina e S. Pietro Caltagirone,SIC,40-49,9,9,0,15,3,0,0,18,0,18,Sicilia,ITG1
2021-01-04,PF/BT,190317.0,HSP11 - P.O. Gravina e S. Pietro Caltagirone,SIC,50-59,24,19,0,32,11,0,0,43,0,43,Sicilia,ITG1
2021-01-04,PF/BT,190317.0,HSP11 - P.O. Gravina e S. Pietro Caltagirone,SIC,60-69,23,15,0,35,3,0,0,38,0,38,Sicilia,ITG1
2021-01-04,PF/BT,190318.0,RIA11 - ASS.ISTITUTO REGINA VIRGINUM,SIC,20-29,5,7,0,12,0,0,0,12,0,12,Sicilia,ITG1
2021-01-04,PF/BT,190318.0,RIA11 - ASS.ISTITUTO REGINA VIRGINUM,SIC,30-39,11,8,0,19,0,0,0,19,0,19,Sicilia,ITG1
2021-01-04,PF/BT,190318.0,RIA11 - ASS.ISTITUTO REGINA VIRGINUM,SIC,40-49,22,16,0,37,0,0,1,38,0,38,Sicilia,ITG1
2021-01-04,PF/BT,190318.0,RIA11 - ASS.ISTITUTO REGINA VIRGINUM,SIC,50-59,29,24,0,53,0,0,0,53,0,53,Sicilia,ITG1
2021-01-04,PF/BT,190318.0,RIA11 - ASS.ISTITUTO REGINA VIRGINUM,SIC,60-69,28,9,0,37,0,0,0,37,0,37,Sicilia,ITG1
2021-01-04,PF/BT,190318.0,RIA11 - ASS.ISTITUTO REGINA VIRGINUM,SIC,70-79,2,0,0,2,0,0,0,2,0,2,Sicilia,ITG1
2021-01-04,PF/BT,190319.0,HSP11 - P. O. UMBERTO I,SIC,20-29,1,12,0,13,0,0,0,13,0,13,Sicilia,ITG1
2021-01-04,PF/BT,190319.0,HSP11 - P. O. UMBERTO I,SIC,30-39,11,11,0,22,0,0,0,22,0,22,Sicilia,ITG1
2021-01-04,PF/BT,190319.0,HSP11 - P. O. UMBERTO I,SIC,40-49,42,30,0,71,0,0,1,72,0,72,Sicilia,ITG1
2021-01-04,PF/BT,190319.0,HSP11 - P. O. UMBERTO I,SIC,50-59,52,36,0,88,0,0,0,88,0,88,Sicilia,ITG1
2021-01-04,PF/BT,190319.0,HSP11 - P. O. UMBERTO I,SIC,60-69,31,14,0,45,0,0,0,45,0,45,Sicilia,ITG1
2021-01-04,PF/BT,190326.0,HSP11 - P.O. S. VINCENZO TAORMINA,SIC,30-39,9,8,0,17,0,0,0,17,0,17,Sicilia,ITG1
2021-01-04,PF/BT,190326.0,HSP11 - P.O. S. VINCENZO TAORMINA,SIC,40-49,22,23,0,45,0,0,0,45,0,45,Sicilia,ITG1
2021-01-04,PF/BT,190326.0,HSP11 - P.O. S. VINCENZO TAORMINA,SIC,50-59,29,12,0,41,0,0,0,41,0,41,Sicilia,ITG1
2021-01-04,PF/BT,190326.0,HSP11 - P.O. S. VINCENZO TAORMINA,SIC,60-69,12,5,0,17,0,0,0,17,0,17,Sicilia,ITG1
2021-01-04,PF/BT,190328.0,HSP11 - P.O. BARONE-ROMEO PATTI,SIC,30-39,3,4,0,7,0,0,0,7,0,7,Sicilia,ITG1
2021-01-04,PF/BT,190328.0,HSP11 - P.O. BARONE-ROMEO PATTI,SIC,40-49,4,17,0,21,0,0,0,21,0,21,Sicilia,ITG1
2021-01-04,PF/BT,190328.0,HSP11 - P.O. BARONE-ROMEO PATTI,SIC,50-59,5,9,0,13,0,0,1,14,0,14,Sicilia,ITG1
2021-01-04,PF/BT,190328.0,HSP11 - P.O. BARONE-ROMEO PATTI,SIC,60-69,5,5,0,10,0,0,0,10,0,10,Sicilia,ITG1
2021-01-04,PF/BT,190330.0,HSP11 - P.O. DEI BIANCHI CORLEONE,SIC,20-29,1,2,0,2,1,0,0,3,0,3,Sicilia,ITG1
2021-01-04,PF/BT,190330.0,HSP11 - P.O. DEI BIANCHI CORLEONE,SIC,30-39,4,4,0,3,5,0,0,8,0,8,Sicilia,ITG1
2021-01-04,PF/BT,190330.0,HSP11 - P.O. DEI BIANCHI CORLEONE,SIC,40-49,9,6,0,12,3,0,0,15,0,15,Sicilia,ITG1
2021-01-04,PF/BT,190330.0,HSP11 - P.O. DEI BIANCHI CORLEONE,SIC,50-59,6,17,0,8,15,0,0,23,0,23,Sicilia,ITG1
2021-01-04,PF/BT,190330.0,HSP11 - P.O. DEI BIANCHI CORLEONE,SIC,60-69,8,8,0,12,4,0,0,16,0,16,Sicilia,ITG1
2021-01-04,PF/BT,190330.0,HSP11 - P.O. DEI BIANCHI CORLEONE,SIC,70-79,1,0,0,1,0,0,0,1,0,1,Sicilia,ITG1
2021-01-04,PF/BT,190332.0,HSP11 - P.O. CIVICO PARTINICO,SIC,20-29,9,19,0,26,2,0,0,28,0,28,Sicilia,ITG1
2021-01-04,PF/BT,190332.0,HSP11 - P.O. CIVICO PARTINICO,SIC,30-39,19,18,0,30,7,0,0,37,0,37,Sicilia,ITG1
2021-01-04,PF/BT,190332.0,HSP11 - P.O. CIVICO PARTINICO,SIC,40-49,19,7,0,20,5,0,1,26,0,26,Sicilia,ITG1
2021-01-04,PF/BT,190332.0,HSP11 - P.O. CIVICO PARTINICO,SIC,50-59,10,26,0,20,16,0,0,36,0,36,Sicilia,ITG1
2021-01-04,PF/BT,190332.0,HSP11 - P.O. CIVICO PARTINICO,SIC,60-69,22,18,0,31,8,0,1,40,0,40,Sicilia,ITG1
2021-01-04,PF/BT,190332.0,HSP11 - P.O. CIVICO PARTINICO,SIC,70-79,11,0,0,11,0,0,0,11,0,11,Sicilia,ITG1
2021-01-04,PF/BT,190333.0,HSP11 - P.O. MADONNA DELLALTO - PETR. SOTTANA,SIC,20-29,21,10,0,16,5,0,10,31,0,31,Sicilia,ITG1
2021-01-04,PF/BT,190333.0,HSP11 - P.O. MADONNA DELLALTO - PETR. SOTTANA,SIC,30-39,31,19,0,23,9,0,18,50,0,50,Sicilia,ITG1
2021-01-04,PF/BT,190333.0,HSP11 - P.O. MADONNA DELLALTO - PETR. SOTTANA,SIC,40-49,27,24,0,27,10,0,14,51,0,51,Sicilia,ITG1
2021-01-04,PF/BT,190333.0,HSP11 - P.O. MADONNA DELLALTO - PETR. SOTTANA,SIC,50-59,22,24,0,25,7,0,14,46,0,46,Sicilia,ITG1
2021-01-04,PF/BT,190333.0,HSP11 - P.O. MADONNA DELLALTO - PETR. SOTTANA,SIC,60-69,13,8,0,15,1,0,5,21,0,21,Sicilia,ITG1
2021-01-04,PF/BT,190333.0,HSP11 - P.O. MADONNA DELLALTO - PETR. SOTTANA,SIC,70-79,3,2,0,3,0,0,2,5,0,5,Sicilia,ITG1
2021-01-04,PF/BT,190333.0,HSP11 - P.O. MADONNA DELLALTO - PETR. SOTTANA,SIC,80-89,1,0,0,0,0,0,1,1,0,1,Sicilia,ITG1
2021-01-04,PF/BT,190334.0,HSP11 - P.O. S. CIMINO TERMINI IMERESE,SIC,20-29,8,3,0,11,0,0,0,11,0,11,Sicilia,ITG1
2021-01-04,PF/BT,190334.0,HSP11 - P.O. S. CIMINO TERMINI IMERESE,SIC,30-39,2,7,0,9,0,0,0,9,0,9,Sicilia,ITG1
2021-01-04,PF/BT,190334.0,HSP11 - P.O. S. CIMINO TERMINI IMERESE,SIC,40-49,13,19,0,30,2,0,0,32,0,32,Sicilia,ITG1
2021-01-04,PF/BT,190334.0,HSP11 - P.O. S. CIMINO TERMINI IMERESE,SIC,50-59,13,17,0,29,1,0,0,30,0,30,Sicilia,ITG1
2021-01-04,PF/BT,190334.0,HSP11 - P.O. S. CIMINO TERMINI IMERESE,SIC,60-69,19,6,0,23,2,0,0,25,0,25,Sicilia,ITG1
2021-01-04,PF/BT,190335.0,HSP11 - P.O. G. F. INGRASSIA,SIC,20-29,2,2,0,4,0,0,0,4,0,4,Sicilia,ITG1
2021-01-04,PF/BT,190335.0,HSP11 - P.O. G. F. INGRASSIA,SIC,30-39,10,14,0,24,0,0,0,24,0,24,Sicilia,ITG1
2021-01-04,PF/BT,190335.0,HSP11 - P.O. G. F. INGRASSIA,SIC,40-49,10,14,0,24,0,0,0,24,0,24,Sicilia,ITG1
2021-01-04,PF/BT,190335.0,HSP11 - P.O. G. F. INGRASSIA,SIC,50-59,18,14,0,32,0,0,0,32,0,32,Sicilia,ITG1
2021-01-04,PF/BT,190335.0,HSP11 - P.O. G. F. INGRASSIA,SIC,60-69,18,11,0,29,0,0,0,29,0,29,Sicilia,ITG1
2021-01-04,PF/BT,190335.0,HSP11 - P.O. G. F. INGRASSIA,SIC,70-79,1,0,0,1,0,0,0,1,0,1,Sicilia,ITG1
2021-01-04,PF/BT,190337.0,HSP11 - P.O. VILLA DELLE GINESTRE,SIC,16-19,3,1,0,0,4,0,0,4,0,4,Sicilia,ITG1
2021-01-04,PF/BT,190337.0,HSP11 - P.O. VILLA DELLE GINESTRE,SIC,20-29,5,4,0,8,1,0,0,9,0,9,Sicilia,ITG1
2021-01-04,PF/BT,190337.0,HSP11 - P.O. VILLA DELLE GINESTRE,SIC,30-39,12,21,0,29,4,0,0,33,0,33,Sicilia,ITG1
2021-01-04,PF/BT,190337.0,HSP11 - P.O. VILLA DELLE GINESTRE,SIC,40-49,11,16,0,18,7,0,2,27,0,27,Sicilia,ITG1
2021-01-04,PF/BT,190337.0,HSP11 - P.O. VILLA DELLE GINESTRE,SIC,50-59,27,25,0,33,19,0,0,52,0,52,Sicilia,ITG1
2021-01-04,PF/BT,190337.0,HSP11 - P.O. VILLA DELLE GINESTRE,SIC,60-69,35,23,0,51,6,0,1,58,0,58,Sicilia,ITG1
2021-01-04,PF/BT,190337.0,HSP11 - P.O. VILLA DELLE GINESTRE,SIC,70-79,5,2,0,6,1,0,0,7,0,7,Sicilia,ITG1
2021-01-04,PF/BT,190338.0,HSP11 - OSPEDALE Giovanni Paolo II° M.P. A.,SIC,20-29,10,14,0,12,12,0,0,24,0,24,Sicilia,ITG1
2021-01-04,PF/BT,190338.0,HSP11 - OSPEDALE Giovanni Paolo II° M.P. A.,SIC,30-39,13,12,0,11,14,0,0,25,0,25,Sicilia,ITG1
2021-01-04,PF/BT,190338.0,HSP11 - OSPEDALE Giovanni Paolo II° M.P. A.,SIC,40-49,19,27,0,9,37,0,0,46,0,46,Sicilia,ITG1
2021-01-04,PF/BT,190338.0,HSP11 - OSPEDALE Giovanni Paolo II° M.P. A.,SIC,50-59,12,32,0,9,32,0,3,44,0,44,Sicilia,ITG1
2021-01-04,PF/BT,190338.0,HSP11 - OSPEDALE Giovanni Paolo II° M.P. A.,SIC,60-69,13,9,0,9,13,0,0,22,0,22,Sicilia,ITG1
2021-01-04,PF/BT,190339.0,HSP11 - OSPEDALE REGINA MARGHERITA  COMISO,SIC,20-29,3,11,0,13,0,0,1,14,0,14,Sicilia,ITG1
2021-01-04,PF/BT,190339.0,HSP11 - OSPEDALE REGINA MARGHERITA  COMISO,SIC,30-39,5,8,0,11,0,0,2,13,0,13,Sicilia,ITG1
2021-01-04,PF/BT,190339.0,HSP11 - OSPEDALE REGINA MARGHERITA  COMISO,SIC,40-49,8,9,0,16,0,0,1,17,0,17,Sicilia,ITG1
2021-01-04,PF/BT,190339.0,HSP11 - OSPEDALE REGINA MARGHERITA  COMISO,SIC,50-59,16,18,0,33,1,0,0,34,0,34,Sicilia,ITG1
2021-01-04,PF/BT,190339.0,HSP11 - OSPEDALE REGINA MARGHERITA  COMISO,SIC,60-69,7,8,0,15,0,0,0,15,0,15,Sicilia,ITG1
2021-01-04,PF/BT,190339.0,HSP11 - OSPEDALE REGINA MARGHERITA  COMISO,SIC,70-79,2,0,0,1,0,0,1,2,0,2,Sicilia,ITG1
2021-01-04,PF/BT,190340.0,HSP11 - OSPEDALE MAGGIORE MODICA,SIC,20-29,3,0,0,3,0,0,0,3,0,3,Sicilia,ITG1
2021-01-04,PF/BT,190340.0,HSP11 - OSPEDALE MAGGIORE MODICA,SIC,30-39,8,4,0,12,0,0,0,12,0,12,Sicilia,ITG1
2021-01-04,PF/BT,190340.0,HSP11 - OSPEDALE MAGGIORE MODICA,SIC,40-49,4,4,0,8,0,0,0,8,0,8,Sicilia,ITG1
2021-01-04,PF/BT,190340.0,HSP11 - OSPEDALE MAGGIORE MODICA,SIC,50-59,12,19,0,29,2,0,0,31,0,31,Sicilia,ITG1
2021-01-04,PF/BT,190340.0,HSP11 - OSPEDALE MAGGIORE MODICA,SIC,60-69,10,7,0,17,0,0,0,17,0,17,Sicilia,ITG1
2021-01-04,PF/BT,190341.0,HSP11 - OSPEDALE BUSACCA SCICLI,SIC,20-29,0,2,0,2,0,0,0,2,0,2,Sicilia,ITG1
2021-01-04,PF/BT,190341.0,HSP11 - OSPEDALE BUSACCA SCICLI,SIC,30-39,2,1,0,2,0,0,1,3,0,3,Sicilia,ITG1
2021-01-04,PF/BT,190341.0,HSP11 - OSPEDALE BUSACCA SCICLI,SIC,40-49,2,3,0,3,2,0,0,5,0,5,Sicilia,ITG1
2021-01-04,PF/BT,190341.0,HSP11 - OSPEDALE BUSACCA SCICLI,SIC,50-59,8,6,0,11,2,0,1,14,0,14,Sicilia,ITG1
2021-01-04,PF/BT,190341.0,HSP11 - OSPEDALE BUSACCA SCICLI,SIC,60-69,1,4,0,4,1,0,0,5,0,5,Sicilia,ITG1
2021-01-04,PF/BT,190341.0,HSP11 - OSPEDALE BUSACCA SCICLI,SIC,70-79,1,0,0,0,0,0,1,1,0,1,Sicilia,ITG1
2021-01-04,PF/BT,190342.0,HSP11 - OSPEDALE GUZZARDI VITTORIA,SIC,20-29,3,6,0,9,0,0,0,9,0,9,Sicilia,ITG1
2021-01-04,PF/BT,190342.0,HSP11 - OSPEDALE GUZZARDI VITTORIA,SIC,30-39,8,10,0,18,0,0,0,18,0,18,Sicilia,ITG1
2021-01-04,PF/BT,190342.0,HSP11 - OSPEDALE GUZZARDI VITTORIA,SIC,40-49,11,11,0,18,4,0,0,22,0,22,Sicilia,ITG1
2021-01-04,PF/BT,190342.0,HSP11 - OSPEDALE GUZZARDI VITTORIA,SIC,50-59,16,17,0,29,4,0,0,33,0,33,Sicilia,ITG1
2021-01-04,PF/BT,190342.0,HSP11 - OSPEDALE GUZZARDI VITTORIA,SIC,60-69,5,12,0,16,1,0,0,17,0,17,Sicilia,ITG1
2021-01-04,PF/BT,190343.0,HSP11 - P.O. DI MARIA AVOLA,SIC,20-29,1,2,0,3,0,0,0,3,0,3,Sicilia,ITG1
2021-01-04,PF/BT,190343.0,HSP11 - P.O. DI MARIA AVOLA,SIC,40-49,2,3,0,5,0,0,0,5,0,5,Sicilia,ITG1
2021-01-04,PF/BT,190343.0,HSP11 - P.O. DI MARIA AVOLA,SIC,50-59,5,4,0,9,0,0,0,9,0,9,Sicilia,ITG1
2021-01-04,PF/BT,190343.0,HSP11 - P.O. DI MARIA AVOLA,SIC,60-69,0,1,0,1,0,0,0,1,0,1,Sicilia,ITG1
2021-01-04,PF/BT,190345.0,HSP11 - P.O. UMBERTO I (EX A.O.),SIC,20-29,4,7,0,11,0,0,0,11,0,11,Sicilia,ITG1
2021-01-04,PF/BT,190345.0,HSP11 - P.O. UMBERTO I (EX A.O.),SIC,30-39,9,12,0,21,0,0,0,21,0,21,Sicilia,ITG1
2021-01-04,PF/BT,190345.0,HSP11 - P.O. UMBERTO I (EX A.O.),SIC,40-49,10,11,0,21,0,0,0,21,0,21,Sicilia,ITG1
2021-01-04,PF/BT,190345.0,HSP11 - P.O. UMBERTO I (EX A.O.),SIC,50-59,10,14,0,24,0,0,0,24,0,24,Sicilia,ITG1
2021-01-04,PF/BT,190345.0,HSP11 - P.O. UMBERTO I (EX A.O.),SIC,60-69,6,5,0,11,0,0,0,11,0,11,Sicilia,ITG1
2021-01-04,PF/BT,190346.0,HSP11 - P.O. MUSCATELLO AUGUSTA,SIC,20-29,3,3,0,6,0,0,0,6,0,6,Sicilia,ITG1
2021-01-04,PF/BT,190346.0,HSP11 - P.O. MUSCATELLO AUGUSTA,SIC,30-39,3,8,0,11,0,0,0,11,0,11,Sicilia,ITG1
2021-01-04,PF/BT,190346.0,HSP11 - P.O. MUSCATELLO AUGUSTA,SIC,40-49,2,11,0,13,0,0,0,13,0,13,Sicilia,ITG1
2021-01-04,PF/BT,190346.0,HSP11 - P.O. MUSCATELLO AUGUSTA,SIC,50-59,7,9,0,16,0,0,0,16,0,16,Sicilia,ITG1
2021-01-04,PF/BT,190346.0,HSP11 - P.O. MUSCATELLO AUGUSTA,SIC,60-69,8,3,0,11,0,0,0,11,0,11,Sicilia,ITG1
2021-01-04,PF/BT,190347.0,HSP11 - OSPEDALE GENERALE DI ZONA,SIC,20-29,4,2,0,6,0,0,0,6,0,6,Sicilia,ITG1
2021-01-04,PF/BT,190347.0,HSP11 - OSPEDALE GENERALE DI ZONA,SIC,30-39,8,4,0,12,0,0,0,12,0,12,Sicilia,ITG1
2021-01-04,PF/BT,190347.0,HSP11 - OSPEDALE GENERALE DI ZONA,SIC,40-49,8,11,0,19,0,0,0,19,0,19,Sicilia,ITG1
2021-01-04,PF/BT,190347.0,HSP11 - OSPEDALE GENERALE DI ZONA,SIC,50-59,4,5,0,9,0,0,0,9,0,9,Sicilia,ITG1
2021-01-04,PF/BT,190347.0,HSP11 - OSPEDALE GENERALE DI ZONA,SIC,60-69,8,0,0,8,0,0,0,8,0,8,Sicilia,ITG1
2021-01-04,PF/BT,190349.0,HSP11 - P.O. SAN VITO E SANTO SPIRITO -ALCAMO,SIC,16-19,1,0,0,0,0,0,1,1,0,1,Sicilia,ITG1
2021-01-04,PF/BT,190349.0,HSP11 - P.O. SAN VITO E SANTO SPIRITO -ALCAMO,SIC,20-29,3,2,0,4,1,0,0,5,0,5,Sicilia,ITG1
2021-01-04,PF/BT,190349.0,HSP11 - P.O. SAN VITO E SANTO SPIRITO -ALCAMO,SIC,30-39,8,14,0,14,2,0,6,22,0,22,Sicilia,ITG1
2021-01-04,PF/BT,190349.0,HSP11 - P.O. SAN VITO E SANTO SPIRITO -ALCAMO,SIC,40-49,13,31,0,23,11,0,10,44,0,44,Sicilia,ITG1
2021-01-04,PF/BT,190349.0,HSP11 - P.O. SAN VITO E SANTO SPIRITO -ALCAMO,SIC,50-59,17,22,0,23,8,0,8,39,0,39,Sicilia,ITG1
2021-01-04,PF/BT,190349.0,HSP11 - P.O. SAN VITO E SANTO SPIRITO -ALCAMO,SIC,60-69,32,18,0,35,11,0,4,50,0,50,Sicilia,ITG1
2021-01-04,PF/BT,190349.0,HSP11 - P.O. SAN VITO E SANTO SPIRITO -ALCAMO,SIC,70-79,2,0,0,0,0,0,2,2,0,2,Sicilia,ITG1
2021-01-04,PF/BT,190351.0,HSP11 - P.O. S. ANTONIO ABATE  - TRAPANI,SIC,20-29,4,11,0,15,0,0,0,15,0,15,Sicilia,ITG1
2021-01-04,PF/BT,190351.0,HSP11 - P.O. S. ANTONIO ABATE  - TRAPANI,SIC,30-39,19,16,0,35,0,0,0,35,0,35,Sicilia,ITG1
2021-01-04,PF/BT,190351.0,HSP11 - P.O. S. ANTONIO ABATE  - TRAPANI,SIC,40-49,18,33,0,51,0,0,0,51,0,51,Sicilia,ITG1
2021-01-04,PF/BT,190351.0,HSP11 - P.O. S. ANTONIO ABATE  - TRAPANI,SIC,50-59,24,44,0,68,0,0,0,68,0,68,Sicilia,ITG1
2021-01-04,PF/BT,190351.0,HSP11 - P.O. S. ANTONIO ABATE  - TRAPANI,SIC,60-69,28,23,0,51,0,0,0,51,0,51,Sicilia,ITG1
2021-01-04,PF/BT,190351.0,HSP11 - P.O. S. ANTONIO ABATE  - TRAPANI,SIC,70-79,1,0,0,1,0,0,0,1,0,1,Sicilia,ITG1
2021-01-04,PF/BT,190352.0,HSP11 - P.O. V.EMANUELE II CASTELVETRANO,SIC,20-29,3,5,0,6,0,0,2,8,0,8,Sicilia,ITG1
2021-01-04,PF/BT,190352.0,HSP11 - P.O. V.EMANUELE II CASTELVETRANO,SIC,30-39,10,6,0,16,0,0,0,16,0,16,Sicilia,ITG1
2021-01-04,PF/BT,190352.0,HSP11 - P.O. V.EMANUELE II CASTELVETRANO,SIC,40-49,13,15,0,26,1,0,1,28,0,28,Sicilia,ITG1
2021-01-04,PF/BT,190352.0,HSP11 - P.O. V.EMANUELE II CASTELVETRANO,SIC,50-59,26,33,0,56,2,0,1,59,0,59,Sicilia,ITG1
2021-01-04,PF/BT,190352.0,HSP11 - P.O. V.EMANUELE II CASTELVETRANO,SIC,60-69,21,17,0,35,2,0,1,38,0,38,Sicilia,ITG1
2021-01-04,PF/BT,190352.0,HSP11 - P.O. V.EMANUELE II CASTELVETRANO,SIC,70-79,2,0,0,1,0,0,1,2,0,2,Sicilia,ITG1
2021-01-04,PF/BT,190353.0,HSP11 - P.O.PAOLO BORSELLINO - MARSALA,SIC,20-29,1,5,0,6,0,0,0,6,0,6,Sicilia,ITG1
2021-01-04,PF/BT,190353.0,HSP11 - P.O.PAOLO BORSELLINO - MARSALA,SIC,30-39,13,14,0,27,0,0,0,27,0,27,Sicilia,ITG1
2021-01-04,PF/BT,190353.0,HSP11 - P.O.PAOLO BORSELLINO - MARSALA,SIC,40-49,20,17,0,37,0,0,0,37,0,37,Sicilia,ITG1
2021-01-04,PF/BT,190353.0,HSP11 - P.O.PAOLO BORSELLINO - MARSALA,SIC,50-59,17,28,0,45,0,0,0,45,0,45,Sicilia,ITG1
2021-01-04,PF/BT,190353.0,HSP11 - P.O.PAOLO BORSELLINO - MARSALA,SIC,60-69,16,12,0,28,0,0,0,28,0,28,Sicilia,ITG1
2021-01-04,PF/BT,190354.0,HSP11 - P.O.ABELE AJELLO-MAZARA D.VALLO,SIC,20-29,4,9,0,13,0,0,0,13,0,13,Sicilia,ITG1
2021-01-04,PF/BT,190354.0,HSP11 - P.O.ABELE AJELLO-MAZARA D.VALLO,SIC,30-39,8,11,0,19,0,0,0,19,0,19,Sicilia,ITG1
2021-01-04,PF/BT,190354.0,HSP11 - P.O.ABELE AJELLO-MAZARA D.VALLO,SIC,40-49,19,16,0,35,0,0,0,35,0,35,Sicilia,ITG1
2021-01-04,PF/BT,190354.0,HSP11 - P.O.ABELE AJELLO-MAZARA D.VALLO,SIC,50-59,24,23,0,47,0,0,0,47,0,47,Sicilia,ITG1
2021-01-04,PF/BT,190354.0,HSP11 - P.O.ABELE AJELLO-MAZARA D.VALLO,SIC,60-69,15,6,0,21,0,0,0,21,0,21,Sicilia,ITG1
2021-01-04,PF/BT,190354.0,HSP11 - P.O.ABELE AJELLO-MAZARA D.VALLO,SIC,70-79,1,0,0,1,0,0,0,1,0,1,Sicilia,ITG1
2021-01-04,PF/BT,190355.0,HSP11 - P.O. VITTORIO EMANUELE III - SALEMI,SIC,20-29,1,0,0,1,0,0,0,1,0,1,Sicilia,ITG1
2021-01-04,PF/BT,190355.0,HSP11 - P.O. VITTORIO EMANUELE III - SALEMI,SIC,30-39,3,8,0,10,1,0,0,11,0,11,Sicilia,ITG1
2021-01-04,PF/BT,190355.0,HSP11 - P.O. VITTORIO EMANUELE III - SALEMI,SIC,40-49,2,6,0,7,1,0,0,8,0,8,Sicilia,ITG1
2021-01-04,PF/BT,190355.0,HSP11 - P.O. VITTORIO EMANUELE III - SALEMI,SIC,50-59,16,25,0,36,5,0,0,41,0,41,Sicilia,ITG1
2021-01-04,PF/BT,190355.0,HSP11 - P.O. VITTORIO EMANUELE III - SALEMI,SIC,60-69,15,8,0,19,4,0,0,23,0,23,Sicilia,ITG1
2021-01-04,PF/BT,190921.0,HSP11 - A.O. per lEmergenza Cannizzaro,SIC,20-29,7,12,0,19,0,0,0,19,0,19,Sicilia,ITG1
2021-01-04,PF/BT,190921.0,HSP11 - A.O. per lEmergenza Cannizzaro,SIC,30-39,32,28,0,60,0,0,0,60,0,60,Sicilia,ITG1
2021-01-04,PF/BT,190921.0,HSP11 - A.O. per lEmergenza Cannizzaro,SIC,40-49,45,36,0,81,0,0,0,81,0,81,Sicilia,ITG1
2021-01-04,PF/BT,190921.0,HSP11 - A.O. per lEmergenza Cannizzaro,SIC,50-59,68,59,0,127,0,0,0,127,0,127,Sicilia,ITG1
2021-01-04,PF/BT,190921.0,HSP11 - A.O. per lEmergenza Cannizzaro,SIC,60-69,25,19,0,44,0,0,0,44,0,44,Sicilia,ITG1
2021-01-04,PF/BT,19092201.0,HSP11 - OSPEDALE GARIBALDI - CENTRO,SIC,20-29,13,13,0,25,1,0,0,26,0,26,Sicilia,ITG1
2021-01-04,PF/BT,19092201.0,HSP11 - OSPEDALE GARIBALDI - CENTRO,SIC,30-39,20,16,0,31,5,0,0,36,0,36,Sicilia,ITG1
2021-01-04,PF/BT,19092201.0,HSP11 - OSPEDALE GARIBALDI - CENTRO,SIC,40-49,14,21,0,31,4,0,0,35,0,35,Sicilia,ITG1
2021-01-04,PF/BT,19092201.0,HSP11 - OSPEDALE GARIBALDI - CENTRO,SIC,50-59,30,23,0,44,8,0,1,53,0,53,Sicilia,ITG1
2021-01-04,PF/BT,19092201.0,HSP11 - OSPEDALE GARIBALDI - CENTRO,SIC,60-69,21,11,0,21,11,0,0,32,0,32,Sicilia,ITG1
2021-01-04,PF/BT,19092201.0,HSP11 - OSPEDALE GARIBALDI - CENTRO,SIC,70-79,1,0,0,0,0,0,1,1,0,1,Sicilia,ITG1
2021-01-04,PF/BT,19092204.0,HSP11 - NUOVO OSPEDALE GARIBALDI - NESIMA,SIC,20-29,7,8,0,14,1,0,0,15,0,15,Sicilia,ITG1
2021-01-04,PF/BT,19092204.0,HSP11 - NUOVO OSPEDALE GARIBALDI - NESIMA,SIC,30-39,23,23,0,46,0,0,0,46,0,46,Sicilia,ITG1
2021-01-04,PF/BT,19092204.0,HSP11 - NUOVO OSPEDALE GARIBALDI - NESIMA,SIC,40-49,26,31,0,57,0,0,0,57,0,57,Sicilia,ITG1
2021-01-04,PF/BT,19092204.0,HSP11 - NUOVO OSPEDALE GARIBALDI - NESIMA,SIC,50-59,48,53,0,101,0,0,0,101,0,101,Sicilia,ITG1
2021-01-04,PF/BT,19092204.0,HSP11 - NUOVO OSPEDALE GARIBALDI - NESIMA,SIC,60-69,26,16,0,42,0,0,0,42,0,42,Sicilia,ITG1
2021-01-04,PF/BT,19092204.0,HSP11 - NUOVO OSPEDALE GARIBALDI - NESIMA,SIC,70-79,1,0,0,1,0,0,0,1,0,1,Sicilia,ITG1
2021-01-04,PF/BT,19092301.0,HSP11 - PRESIDIO OSPEDALIERO GASPARE RODOLICO,SIC,20-29,14,20,0,34,0,0,0,34,0,34,Sicilia,ITG1
2021-01-04,PF/BT,19092301.0,HSP11 - PRESIDIO OSPEDALIERO GASPARE RODOLICO,SIC,30-39,33,27,0,60,0,0,0,60,0,60,Sicilia,ITG1
2021-01-04,PF/BT,19092301.0,HSP11 - PRESIDIO OSPEDALIERO GASPARE RODOLICO,SIC,40-49,23,53,1,76,0,0,0,76,0,76,Sicilia,ITG1
2021-01-04,PF/BT,19092301.0,HSP11 - PRESIDIO OSPEDALIERO GASPARE RODOLICO,SIC,50-59,33,36,0,69,0,0,0,69,0,69,Sicilia,ITG1
2021-01-04,PF/BT,19092301.0,HSP11 - PRESIDIO OSPEDALIERO GASPARE RODOLICO,SIC,60-69,33,25,0,58,0,0,0,58,0,58,Sicilia,ITG1
2021-01-04,PF/BT,19092304.0,HSP11 - PRESIDIO OSPEDALIERO S.MARCO,SIC,20-29,2,8,0,10,0,0,0,10,0,10,Sicilia,ITG1
2021-01-04,PF/BT,19092304.0,HSP11 - PRESIDIO OSPEDALIERO S.MARCO,SIC,30-39,31,36,0,67,0,0,0,67,0,67,Sicilia,ITG1
2021-01-04,PF/BT,19092304.0,HSP11 - PRESIDIO OSPEDALIERO S.MARCO,SIC,40-49,21,31,0,52,0,0,0,52,0,52,Sicilia,ITG1
2021-01-04,PF/BT,19092304.0,HSP11 - PRESIDIO OSPEDALIERO S.MARCO,SIC,50-59,20,47,0,67,0,0,0,67,0,67,Sicilia,ITG1
2021-01-04,PF/BT,19092304.0,HSP11 - PRESIDIO OSPEDALIERO S.MARCO,SIC,60-69,14,18,0,32,0,0,0,32,0,32,Sicilia,ITG1
2021-01-04,PF/BT,190924.0,HSP11 - Azienda Ospedaliera Papardo,SIC,20-29,4,4,0,6,0,0,2,8,0,8,Sicilia,ITG1
2021-01-04,PF/BT,190924.0,HSP11 - Azienda Ospedaliera Papardo,SIC,30-39,16,11,0,26,0,0,1,27,0,27,Sicilia,ITG1
2021-01-04,PF/BT,190924.0,HSP11 - Azienda Ospedaliera Papardo,SIC,40-49,28,28,0,54,0,0,2,56,0,56,Sicilia,ITG1
2021-01-04,PF/BT,190924.0,HSP11 - Azienda Ospedaliera Papardo,SIC,50-59,45,49,0,88,0,0,6,94,0,94,Sicilia,ITG1
2021-01-04,PF/BT,190924.0,HSP11 - Azienda Ospedaliera Papardo,SIC,60-69,32,22,0,54,0,0,0,54,0,54,Sicilia,ITG1
2021-01-04,PF/BT,19092501.0,HSP11 - COVID HOSPITAL,SIC,20-29,3,8,0,11,0,0,0,11,0,11,Sicilia,ITG1
2021-01-04,PF/BT,19092501.0,HSP11 - COVID HOSPITAL,SIC,30-39,22,19,0,41,0,0,0,41,0,41,Sicilia,ITG1
2021-01-04,PF/BT,19092501.0,HSP11 - COVID HOSPITAL,SIC,40-49,15,21,0,36,0,0,0,36,0,36,Sicilia,ITG1
2021-01-04,PF/BT,19092501.0,HSP11 - COVID HOSPITAL,SIC,50-59,26,28,0,54,0,0,0,54,0,54,Sicilia,ITG1
2021-01-04,PF/BT,19092501.0,HSP11 - COVID HOSPITAL,SIC,60-69,14,20,0,34,0,0,0,34,0,34,Sicilia,ITG1
2021-01-04,PF/BT,19092601.0,HSP11 - P.O. Villa Sofia,SIC,20-29,4,13,0,17,0,0,0,17,0,17,Sicilia,ITG1
2021-01-04,PF/BT,19092601.0,HSP11 - P.O. Villa Sofia,SIC,30-39,18,24,0,42,0,0,0,42,0,42,Sicilia,ITG1
2021-01-04,PF/BT,19092601.0,HSP11 - P.O. Villa Sofia,SIC,40-49,15,25,0,40,0,0,0,40,0,40,Sicilia,ITG1
2021-01-04,PF/BT,19092601.0,HSP11 - P.O. Villa Sofia,SIC,50-59,27,32,0,59,0,0,0,59,0,59,Sicilia,ITG1
2021-01-04,PF/BT,19092601.0,HSP11 - P.O. Villa Sofia,SIC,60-69,10,13,0,23,0,0,0,23,0,23,Sicilia,ITG1
2021-01-04,PF/BT,19092701.0,HSP11 - Ospedale Civico,SIC,20-29,13,18,0,31,0,0,0,31,0,31,Sicilia,ITG1
2021-01-04,PF/BT,19092701.0,HSP11 - Ospedale Civico,SIC,30-39,13,14,0,27,0,0,0,27,0,27,Sicilia,ITG1
2021-01-04,PF/BT,19092701.0,HSP11 - Ospedale Civico,SIC,40-49,18,24,0,40,2,0,0,42,0,42,Sicilia,ITG1
2021-01-04,PF/BT,19092701.0,HSP11 - Ospedale Civico,SIC,50-59,18,20,0,38,0,0,0,38,0,38,Sicilia,ITG1
2021-01-04,PF/BT,19092701.0,HSP11 - Ospedale Civico,SIC,60-69,14,4,0,17,1,0,0,18,0,18,Sicilia,ITG1
2021-01-04,PF/BT,19092702.0,HSP11 - Ospedale dei Bambini G. Di Cristina,SIC,20-29,6,17,0,23,0,0,0,23,0,23,Sicilia,ITG1
2021-01-04,PF/BT,19092702.0,HSP11 - Ospedale dei Bambini G. Di Cristina,SIC,30-39,10,15,0,25,0,0,0,25,0,25,Sicilia,ITG1
2021-01-04,PF/BT,19092702.0,HSP11 - Ospedale dei Bambini G. Di Cristina,SIC,40-49,6,17,0,23,0,0,0,23,0,23,Sicilia,ITG1
2021-01-04,PF/BT,19092702.0,HSP11 - Ospedale dei Bambini G. Di Cristina,SIC,50-59,6,16,0,22,0,0,0,22,0,22,Sicilia,ITG1
2021-01-04,PF/BT,19092702.0,HSP11 - Ospedale dei Bambini G. Di Cristina,SIC,60-69,7,13,0,20,0,0,0,20,0,20,Sicilia,ITG1
2021-01-04,PF/BT,19092702.0,HSP11 - Ospedale dei Bambini G. Di Cristina,SIC,70-79,0,1,0,1,0,0,0,1,0,1,Sicilia,ITG1
2021-01-04,PF/BT,190928.0,HSP11 - AZ.OSP.UNIV.P.GIACCONE,SIC,20-29,55,65,0,120,0,0,0,120,0,120,Sicilia,ITG1
2021-01-04,PF/BT,190928.0,HSP11 - AZ.OSP.UNIV.P.GIACCONE,SIC,30-39,34,38,0,72,0,0,0,72,0,72,Sicilia,ITG1
2021-01-04,PF/BT,190928.0,HSP11 - AZ.OSP.UNIV.P.GIACCONE,SIC,40-49,18,22,0,40,0,0,0,40,0,40,Sicilia,ITG1
2021-01-04,PF/BT,190928.0,HSP11 - AZ.OSP.UNIV.P.GIACCONE,SIC,50-59,25,27,0,51,1,0,0,52,0,52,Sicilia,ITG1
2021-01-04,PF/BT,190928.0,HSP11 - AZ.OSP.UNIV.P.GIACCONE,SIC,60-69,23,10,0,33,0,0,0,33,0,33,Sicilia,ITG1
2021-01-04,PF/BT,190928.0,HSP11 - AZ.OSP.UNIV.P.GIACCONE,SIC,70-79,0,1,0,1,0,0,0,1,0,1,Sicilia,ITG1
2021-01-04,PF/BT,190929.0,STS11 - IRCCS Ismett,SIC,20-29,10,14,0,15,9,0,0,24,0,24,Sicilia,ITG1
2021-01-04,PF/BT,190929.0,STS11 - IRCCS Ismett,SIC,30-39,23,28,0,47,4,0,0,51,0,51,Sicilia,ITG1
2021-01-04,PF/BT,190929.0,STS11 - IRCCS Ismett,SIC,40-49,34,59,0,61,32,0,0,93,0,93,Sicilia,ITG1
2021-01-04,PF/BT,190929.0,STS11 - IRCCS Ismett,SIC,50-59,16,27,0,33,10,0,0,43,0,43,Sicilia,ITG1
2021-01-04,PF/BT,190929.0,STS11 - IRCCS Ismett,SIC,60-69,5,6,0,8,3,0,0,11,0,11,Sicilia,ITG1
2021-01-04,PF/BT,19096001.0,HSP11 - IRCCS Centro Neurolesi,SIC,20-29,7,6,0,8,0,0,5,13,0,13,Sicilia,ITG1
2021-01-04,PF/BT,19096001.0,HSP11 - IRCCS Centro Neurolesi,SIC,30-39,7,19,0,17,0,0,9,26,0,26,Sicilia,ITG1
2021-01-04,PF/BT,19096001.0,HSP11 - IRCCS Centro Neurolesi,SIC,40-49,11,11,0,9,0,0,13,22,0,22,Sicilia,ITG1
2021-01-04,PF/BT,19096001.0,HSP11 - IRCCS Centro Neurolesi,SIC,50-59,11,15,0,12,0,0,14,26,0,26,Sicilia,ITG1
2021-01-04,PF/BT,19096001.0,HSP11 - IRCCS Centro Neurolesi,SIC,60-69,1,1,0,1,0,0,1,2,0,2,Sicilia,ITG1
2021-01-04,PF/BT,19096001.0,HSP11 - IRCCS Centro Neurolesi,SIC,70-79,1,0,0,1,0,0,0,1,0,1,Sicilia,ITG1
2021-01-04,PF/BT,19096002.0,HSP11 - PRESIDIO OSPEDALIERO PIEMONTE,SIC,20-29,3,1,0,3,0,0,1,4,0,4,Sicilia,ITG1
2021-01-04,PF/BT,19096002.0,HSP11 - PRESIDIO OSPEDALIERO PIEMONTE,SIC,30-39,9,10,0,13,0,0,6,19,0,19,Sicilia,ITG1
2021-01-04,PF/BT,19096002.0,HSP11 - PRESIDIO OSPEDALIERO PIEMONTE,SIC,40-49,15,15,0,23,0,0,7,30,0,30,Sicilia,ITG1
2021-01-04,PF/BT,19096002.0,HSP11 - PRESIDIO OSPEDALIERO PIEMONTE,SIC,50-59,18,21,0,37,0,0,2,39,0,39,Sicilia,ITG1
2021-01-04,PF/BT,19096002.0,HSP11 - PRESIDIO OSPEDALIERO PIEMONTE,SIC,60-69,9,7,0,13,0,0,3,16,0,16,Sicilia,ITG1
2021-01-04,PF/BT,608200.0,STS11 - POLIAMBULATORIO San Giorgio,SIC,20-29,0,1,0,1,0,0,0,1,0,1,Sicilia,ITG1
2021-01-04,PF/BT,608200.0,STS11 - POLIAMBULATORIO San Giorgio,SIC,30-39,7,5,0,12,0,0,0,12,0,12,Sicilia,ITG1
2021-01-04,PF/BT,608200.0,STS11 - POLIAMBULATORIO San Giorgio,SIC,40-49,3,0,0,3,0,0,0,3,0,3,Sicilia,ITG1
2021-01-04,PF/BT,608200.0,STS11 - POLIAMBULATORIO San Giorgio,SIC,50-59,2,4,0,6,0,0,0,6,0,6,Sicilia,ITG1
2021-01-04,PF/BT,608200.0,STS11 - POLIAMBULATORIO San Giorgio,SIC,60-69,10,4,0,14,0,0,0,14,0,14,Sicilia,ITG1
2021-01-04,PF/BT,608400.0,STS11 - POLIAMBULATORIO  San Luigi,SIC,16-19,1,0,0,1,0,0,0,1,0,1,Sicilia,ITG1
2021-01-04,PF/BT,608400.0,STS11 - POLIAMBULATORIO  San Luigi,SIC,20-29,2,0,0,1,0,0,1,2,0,2,Sicilia,ITG1
2021-01-04,PF/BT,608400.0,STS11 - POLIAMBULATORIO  San Luigi,SIC,30-39,1,2,0,3,0,0,0,3,0,3,Sicilia,ITG1
2021-01-04,PF/BT,608400.0,STS11 - POLIAMBULATORIO  San Luigi,SIC,40-49,3,2,0,3,0,0,2,5,0,5,Sicilia,ITG1
2021-01-04,PF/BT,608400.0,STS11 - POLIAMBULATORIO  San Luigi,SIC,50-59,5,6,0,11,0,0,0,11,0,11,Sicilia,ITG1
2021-01-04,PF/BT,608400.0,STS11 - POLIAMBULATORIO  San Luigi,SIC,60-69,12,12,0,24,0,0,0,24,0,24,Sicilia,ITG1
2021-01-04,PF/BT,820800.0,STS11 - RSA BONIFATO,SIC,20-29,1,1,0,2,0,0,0,2,0,2,Sicilia,ITG1
2021-01-04,PF/BT,820800.0,STS11 - RSA BONIFATO,SIC,30-39,3,0,0,3,0,0,0,3,0,3,Sicilia,ITG1
2021-01-04,PF/BT,820800.0,STS11 - RSA BONIFATO,SIC,40-49,1,1,0,2,0,0,0,2,0,2,Sicilia,ITG1
2021-01-04,PF/BT,820800.0,STS11 - RSA BONIFATO,SIC,50-59,2,1,0,2,0,1,0,3,0,3,Sicilia,ITG1
2021-01-04,PF/BT,820800.0,STS11 - RSA BONIFATO,SIC,60-69,1,1,0,2,0,0,0,2,0,2,Sicilia,ITG1
2021-01-04,PF/BT,820800.0,STS11 - RSA BONIFATO,SIC,70-79,1,1,0,1,0,1,0,2,0,2,Sicilia,ITG1
2021-01-04,PF/BT,820800.0,STS11 - RSA BONIFATO,SIC,80-89,0,4,0,0,0,4,0,4,0,4,Sicilia,ITG1
2021-01-05,PF/BT,190179.0,HSP11 - FOND. IST. S. RAFFAELE - GIGLIO,SIC,40-49,2,3,0,3,2,0,0,5,0,5,Sicilia,ITG1
2021-01-05,PF/BT,190179.0,HSP11 - FOND. IST. S. RAFFAELE - GIGLIO,SIC,50-59,2,5,0,7,0,0,0,7,0,7,Sicilia,ITG1
2021-01-05,PF/BT,190179.0,HSP11 - FOND. IST. S. RAFFAELE - GIGLIO,SIC,60-69,3,3,0,6,0,0,0,6,0,6,Sicilia,ITG1
2021-01-05,PF/BT,190199.0,HSP11 - OSP. BUCCHERI LA FERLA FATEBENEFRATELLI,SIC,20-29,3,7,0,8,2,0,0,10,0,10,Sicilia,ITG1
2021-01-05,PF/BT,190199.0,HSP11 - OSP. BUCCHERI LA FERLA FATEBENEFRATELLI,SIC,30-39,10,14,0,16,8,0,0,24,0,24,Sicilia,ITG1
2021-01-05,PF/BT,190199.0,HSP11 - OSP. BUCCHERI LA FERLA FATEBENEFRATELLI,SIC,40-49,10,17,0,18,9,0,0,27,0,27,Sicilia,ITG1
2021-01-05,PF/BT,190199.0,HSP11 - OSP. BUCCHERI LA FERLA FATEBENEFRATELLI,SIC,50-59,19,30,0,36,13,0,0,49,0,49,Sicilia,ITG1
2021-01-05,PF/BT,190199.0,HSP11 - OSP. BUCCHERI LA FERLA FATEBENEFRATELLI,SIC,60-69,11,9,0,9,11,0,0,20,0,20,Sicilia,ITG1
2021-01-05,PF/BT,190199.0,HSP11 - OSP. BUCCHERI LA FERLA FATEBENEFRATELLI,SIC,70-79,1,0,0,0,1,0,0,1,0,1,Sicilia,ITG1
2021-01-05,PF/BT,190199.0,HSP11 - OSP. BUCCHERI LA FERLA FATEBENEFRATELLI,SIC,80-89,1,0,0,0,1,0,0,1,0,1,Sicilia,ITG1
2021-01-05,PF/BT,1902017.0,STRUTTURE PRIVATE NON CODIFICATE NSIS,SIC,20-29,1,4,0,5,0,0,0,5,0,5,Sicilia,ITG1
2021-01-05,PF/BT,1902017.0,STRUTTURE PRIVATE NON CODIFICATE NSIS,SIC,30-39,7,3,0,10,0,0,0,10,0,10,Sicilia,ITG1
2021-01-05,PF/BT,1902017.0,STRUTTURE PRIVATE NON CODIFICATE NSIS,SIC,40-49,1,8,0,9,0,0,0,9,0,9,Sicilia,ITG1
2021-01-05,PF/BT,1902017.0,STRUTTURE PRIVATE NON CODIFICATE NSIS,SIC,50-59,3,9,0,12,0,0,0,12,0,12,Sicilia,ITG1
2021-01-05,PF/BT,1902017.0,STRUTTURE PRIVATE NON CODIFICATE NSIS,SIC,60-69,4,6,0,7,0,3,0,10,0,10,Sicilia,ITG1
2021-01-05,PF/BT,1902017.0,STRUTTURE PRIVATE NON CODIFICATE NSIS,SIC,70-79,8,4,0,1,0,11,0,12,0,12,Sicilia,ITG1
2021-01-05,PF/BT,1902017.0,STRUTTURE PRIVATE NON CODIFICATE NSIS,SIC,80-89,8,22,0,0,0,30,0,30,0,30,Sicilia,ITG1
2021-01-05,PF/BT,1902017.0,STRUTTURE PRIVATE NON CODIFICATE NSIS,SIC,90+,0,10,0,0,0,10,0,10,0,10,Sicilia,ITG1
2021-01-05,PF/BT,1902057.0,STRUTTURE PRIVATE NON CODIFICATE NSIS,SIC,20-29,1,9,0,10,0,0,0,10,0,10,Sicilia,ITG1
2021-01-05,PF/BT,1902057.0,STRUTTURE PRIVATE NON CODIFICATE NSIS,SIC,30-39,5,2,0,7,0,0,0,7,0,7,Sicilia,ITG1
2021-01-05,PF/BT,1902057.0,STRUTTURE PRIVATE NON CODIFICATE NSIS,SIC,40-49,16,8,0,24,0,0,0,24,0,24,Sicilia,ITG1
2021-01-05,PF/BT,1902057.0,STRUTTURE PRIVATE NON CODIFICATE NSIS,SIC,50-59,15,10,0,25,0,0,0,25,0,25,Sicilia,ITG1
2021-01-05,PF/BT,1902057.0,STRUTTURE PRIVATE NON CODIFICATE NSIS,SIC,60-69,21,9,0,30,0,0,0,30,0,30,Sicilia,ITG1
2021-01-05,PF/BT,1902072.0,AMBULATORI VACCINALI NON CODIFICATI NSIS,SIC,20-29,1,1,0,1,1,0,0,2,0,2,Sicilia,ITG1
2021-01-05,PF/BT,1902072.0,AMBULATORI VACCINALI NON CODIFICATI NSIS,SIC,30-39,7,4,0,7,3,0,1,11,0,11,Sicilia,ITG1
2021-01-05,PF/BT,1902072.0,AMBULATORI VACCINALI NON CODIFICATI NSIS,SIC,40-49,4,12,0,13,0,0,3,16,0,16,Sicilia,ITG1
2021-01-05,PF/BT,1902072.0,AMBULATORI VACCINALI NON CODIFICATI NSIS,SIC,50-59,8,12,0,16,2,0,2,20,0,20,Sicilia,ITG1
2021-01-05,PF/BT,1902072.0,AMBULATORI VACCINALI NON CODIFICATI NSIS,SIC,60-69,12,3,0,10,5,0,0,15,0,15,Sicilia,ITG1
2021-01-05,PF/BT,1902072.0,AMBULATORI VACCINALI NON CODIFICATI NSIS,SIC,70-79,1,3,0,0,4,0,0,4,0,4,Sicilia,ITG1
2021-01-05,PF/BT,1902072.0,AMBULATORI VACCINALI NON CODIFICATI NSIS,SIC,80-89,6,7,0,0,12,0,1,13,0,13,Sicilia,ITG1
2021-01-05,PF/BT,1902072.0,AMBULATORI VACCINALI NON CODIFICATI NSIS,SIC,90+,2,2,0,1,3,0,0,4,0,4,Sicilia,ITG1
2021-01-05,PF/BT,190301.0,RIA11 - A.I.A.S.SEZ.DI AGRIGENTO ONLUS,SIC,20-29,13,14,0,27,0,0,0,27,0,27,Sicilia,ITG1
2021-01-05,PF/BT,190301.0,RIA11 - A.I.A.S.SEZ.DI AGRIGENTO ONLUS,SIC,30-39,30,28,0,58,0,0,0,58,0,58,Sicilia,ITG1
2021-01-05,PF/BT,190301.0,RIA11 - A.I.A.S.SEZ.DI AGRIGENTO ONLUS,SIC,40-49,42,41,0,83,0,0,0,83,0,83,Sicilia,ITG1
2021-01-05,PF/BT,190301.0,RIA11 - A.I.A.S.SEZ.DI AGRIGENTO ONLUS,SIC,50-59,42,48,0,90,0,0,0,90,0,90,Sicilia,ITG1
2021-01-05,PF/BT,190301.0,RIA11 - A.I.A.S.SEZ.DI AGRIGENTO ONLUS,SIC,60-69,45,34,0,79,0,0,0,79,0,79,Sicilia,ITG1
2021-01-05,PF/BT,190301.0,RIA11 - A.I.A.S.SEZ.DI AGRIGENTO ONLUS,SIC,70-79,2,0,0,2,0,0,0,2,0,2,Sicilia,ITG1
2021-01-05,PF/BT,190302.0,RIA11 - C.DELLA SPERANZA DON ANGELO G.,SIC,20-29,1,7,0,8,0,0,0,8,0,8,Sicilia,ITG1
2021-01-05,PF/BT,190302.0,RIA11 - C.DELLA SPERANZA DON ANGELO G.,SIC,30-39,11,9,0,20,0,0,0,20,0,20,Sicilia,ITG1
2021-01-05,PF/BT,190302.0,RIA11 - C.DELLA SPERANZA DON ANGELO G.,SIC,40-49,12,14,0,23,0,0,3,26,0,26,Sicilia,ITG1
2021-01-05,PF/BT,190302.0,RIA11 - C.DELLA SPERANZA DON ANGELO G.,SIC,50-59,40,27,0,60,0,0,7,67,0,67,Sicilia,ITG1
2021-01-05,PF/BT,190302.0,RIA11 - C.DELLA SPERANZA DON ANGELO G.,SIC,60-69,36,23,0,59,0,0,0,59,0,59,Sicilia,ITG1
2021-01-05,PF/BT,190303.0,RIA11 - COMUNITA` DELLA SPERANZA,SIC,20-29,0,3,0,3,0,0,0,3,0,3,Sicilia,ITG1
2021-01-05,PF/BT,190303.0,RIA11 - COMUNITA` DELLA SPERANZA,SIC,30-39,5,8,0,13,0,0,0,13,0,13,Sicilia,ITG1
2021-01-05,PF/BT,190303.0,RIA11 - COMUNITA` DELLA SPERANZA,SIC,40-49,6,20,0,25,1,0,0,26,0,26,Sicilia,ITG1
2021-01-05,PF/BT,190303.0,RIA11 - COMUNITA` DELLA SPERANZA,SIC,50-59,24,38,0,58,4,0,0,62,0,62,Sicilia,ITG1
2021-01-05,PF/BT,190303.0,RIA11 - COMUNITA` DELLA SPERANZA,SIC,60-69,42,18,0,58,2,0,0,60,0,60,Sicilia,ITG1
2021-01-05,PF/BT,190303.0,RIA11 - COMUNITA` DELLA SPERANZA,SIC,70-79,4,0,0,4,0,0,0,4,0,4,Sicilia,ITG1
2021-01-05,PF/BT,190304.0,HSP11 - P.O.  F.LLI PARLAPIANO - RIBERA,SIC,20-29,8,6,0,12,2,0,0,14,0,14,Sicilia,ITG1
2021-01-05,PF/BT,190304.0,HSP11 - P.O.  F.LLI PARLAPIANO - RIBERA,SIC,30-39,10,10,0,18,1,0,1,20,0,20,Sicilia,ITG1
2021-01-05,PF/BT,190304.0,HSP11 - P.O.  F.LLI PARLAPIANO - RIBERA,SIC,40-49,14,18,0,22,10,0,0,32,0,32,Sicilia,ITG1
2021-01-05,PF/BT,190304.0,HSP11 - P.O.  F.LLI PARLAPIANO - RIBERA,SIC,50-59,31,21,0,43,7,0,2,52,0,52,Sicilia,ITG1
2021-01-05,PF/BT,190304.0,HSP11 - P.O.  F.LLI PARLAPIANO - RIBERA,SIC,60-69,36,17,0,48,3,0,2,53,0,53,Sicilia,ITG1
2021-01-05,PF/BT,190304.0,HSP11 - P.O.  F.LLI PARLAPIANO - RIBERA,SIC,70-79,6,3,0,9,0,0,0,9,0,9,Sicilia,ITG1
2021-01-05,PF/BT,190304.0,HSP11 - P.O.  F.LLI PARLAPIANO - RIBERA,SIC,80-89,4,1,0,3,0,0,2,5,0,5,Sicilia,ITG1
2021-01-05,PF/BT,190304.0,HSP11 - P.O.  F.LLI PARLAPIANO - RIBERA,SIC,90+,1,0,0,1,0,0,0,1,0,1,Sicilia,ITG1
2021-01-05,PF/BT,190305.0,HSP11 - P.O. GIOVANNI PAOLO II,SIC,20-29,6,5,0,11,0,0,0,11,0,11,Sicilia,ITG1
2021-01-05,PF/BT,190305.0,HSP11 - P.O. GIOVANNI PAOLO II,SIC,30-39,18,14,0,32,0,0,0,32,0,32,Sicilia,ITG1
2021-01-05,PF/BT,190305.0,HSP11 - P.O. GIOVANNI PAOLO II,SIC,40-49,18,26,0,44,0,0,0,44,0,44,Sicilia,ITG1
2021-01-05,PF/BT,190305.0,HSP11 - P.O. GIOVANNI PAOLO II,SIC,50-59,34,38,0,72,0,0,0,72,0,72,Sicilia,ITG1
2021-01-05,PF/BT,190305.0,HSP11 - P.O. GIOVANNI PAOLO II,SIC,60-69,10,14,0,24,0,0,0,24,0,24,Sicilia,ITG1
2021-01-05,PF/BT,190306.0,RIA11 - ASS. CASA FAM.ROSETTA ONILUS,SIC,20-29,10,10,0,18,2,0,0,20,0,20,Sicilia,ITG1
2021-01-05,PF/BT,190306.0,RIA11 - ASS. CASA FAM.ROSETTA ONILUS,SIC,30-39,17,24,0,31,7,0,3,41,0,41,Sicilia,ITG1
2021-01-05,PF/BT,190306.0,RIA11 - ASS. CASA FAM.ROSETTA ONILUS,SIC,40-49,32,29,0,41,18,0,2,61,0,61,Sicilia,ITG1
2021-01-05,PF/BT,190306.0,RIA11 - ASS. CASA FAM.ROSETTA ONILUS,SIC,50-59,65,56,0,78,40,0,3,121,0,121,Sicilia,ITG1
2021-01-05,PF/BT,190306.0,RIA11 - ASS. CASA FAM.ROSETTA ONILUS,SIC,60-69,86,42,0,108,18,0,2,128,0,128,Sicilia,ITG1
2021-01-05,PF/BT,190306.0,RIA11 - ASS. CASA FAM.ROSETTA ONILUS,SIC,70-79,15,0,0,14,1,0,0,15,0,15,Sicilia,ITG1
2021-01-05,PF/BT,190309.0,HSP11 - P.O. VITTORIO EMANUELE (ex AO),SIC,20-29,14,11,0,25,0,0,0,25,0,25,Sicilia,ITG1
2021-01-05,PF/BT,190309.0,HSP11 - P.O. VITTORIO EMANUELE (ex AO),SIC,30-39,12,15,0,26,0,0,1,27,0,27,Sicilia,ITG1
2021-01-05,PF/BT,190309.0,HSP11 - P.O. VITTORIO EMANUELE (ex AO),SIC,40-49,19,19,0,36,0,0,2,38,0,38,Sicilia,ITG1
2021-01-05,PF/BT,190309.0,HSP11 - P.O. VITTORIO EMANUELE (ex AO),SIC,50-59,45,24,0,65,0,0,4,69,0,69,Sicilia,ITG1
2021-01-05,PF/BT,190309.0,HSP11 - P.O. VITTORIO EMANUELE (ex AO),SIC,60-69,38,18,0,55,0,0,1,56,0,56,Sicilia,ITG1
2021-01-05,PF/BT,190309.0,HSP11 - P.O. VITTORIO EMANUELE (ex AO),SIC,70-79,1,0,0,1,0,0,0,1,0,1,Sicilia,ITG1
2021-01-05,PF/BT,190312.0,HSP11 - P.O. S. Marta e S. Venera Acireale,SIC,20-29,14,4,0,18,0,0,0,18,0,18,Sicilia,ITG1
2021-01-05,PF/BT,190312.0,HSP11 - P.O. S. Marta e S. Venera Acireale,SIC,30-39,15,10,0,24,1,0,0,25,0,25,Sicilia,ITG1
2021-01-05,PF/BT,190312.0,HSP11 - P.O. S. Marta e S. Venera Acireale,SIC,40-49,17,24,0,38,3,0,0,41,0,41,Sicilia,ITG1
2021-01-05,PF/BT,190312.0,HSP11 - P.O. S. Marta e S. Venera Acireale,SIC,50-59,27,36,0,63,0,0,0,63,0,63,Sicilia,ITG1
2021-01-05,PF/BT,190312.0,HSP11 - P.O. S. Marta e S. Venera Acireale,SIC,60-69,38,34,0,72,0,0,0,72,0,72,Sicilia,ITG1
2021-01-05,PF/BT,190312.0,HSP11 - P.O. S. Marta e S. Venera Acireale,SIC,70-79,2,0,0,2,0,0,0,2,0,2,Sicilia,ITG1
2021-01-05,PF/BT,190312.0,HSP11 - P.O. S. Marta e S. Venera Acireale,SIC,80-89,1,0,0,1,0,0,0,1,0,1,Sicilia,ITG1
2021-01-05,PF/BT,190313.0,RIA11 - IST.RIAB.VILLAG. SAN GIUSEPPE,SIC,16-19,0,1,0,1,0,0,0,1,0,1,Sicilia,ITG1
2021-01-05,PF/BT,190313.0,RIA11 - IST.RIAB.VILLAG. SAN GIUSEPPE,SIC,20-29,12,9,0,20,1,0,0,21,0,21,Sicilia,ITG1
2021-01-05,PF/BT,190313.0,RIA11 - IST.RIAB.VILLAG. SAN GIUSEPPE,SIC,30-39,10,12,0,22,0,0,0,22,0,22,Sicilia,ITG1
2021-01-05,PF/BT,190313.0,RIA11 - IST.RIAB.VILLAG. SAN GIUSEPPE,SIC,40-49,9,21,0,30,0,0,0,30,0,30,Sicilia,ITG1
2021-01-05,PF/BT,190313.0,RIA11 - IST.RIAB.VILLAG. SAN GIUSEPPE,SIC,50-59,25,31,0,56,0,0,0,56,0,56,Sicilia,ITG1
2021-01-05,PF/BT,190313.0,RIA11 - IST.RIAB.VILLAG. SAN GIUSEPPE,SIC,60-69,54,24,0,78,0,0,0,78,0,78,Sicilia,ITG1
2021-01-05,PF/BT,190313.0,RIA11 - IST.RIAB.VILLAG. SAN GIUSEPPE,SIC,70-79,4,2,0,6,0,0,0,6,0,6,Sicilia,ITG1
2021-01-05,PF/BT,190313.0,RIA11 - IST.RIAB.VILLAG. SAN GIUSEPPE,SIC,80-89,1,0,0,1,0,0,0,1,0,1,Sicilia,ITG1
2021-01-05,PF/BT,190314.0,RIA11 - ASS.J.F.KENNEDY ACIREALE,SIC,16-19,1,1,0,2,0,0,0,2,0,2,Sicilia,ITG1
2021-01-05,PF/BT,190314.0,RIA11 - ASS.J.F.KENNEDY ACIREALE,SIC,20-29,12,3,0,15,0,0,0,15,0,15,Sicilia,ITG1
2021-01-05,PF/BT,190314.0,RIA11 - ASS.J.F.KENNEDY ACIREALE,SIC,30-39,17,22,0,39,0,0,0,39,0,39,Sicilia,ITG1
2021-01-05,PF/BT,190314.0,RIA11 - ASS.J.F.KENNEDY ACIREALE,SIC,40-49,21,27,0,48,0,0,0,48,0,48,Sicilia,ITG1
2021-01-05,PF/BT,190314.0,RIA11 - ASS.J.F.KENNEDY ACIREALE,SIC,50-59,17,17,0,34,0,0,0,34,0,34,Sicilia,ITG1
2021-01-05,PF/BT,190314.0,RIA11 - ASS.J.F.KENNEDY ACIREALE,SIC,60-69,22,14,0,36,0,0,0,36,0,36,Sicilia,ITG1
2021-01-05,PF/BT,190314.0,RIA11 - ASS.J.F.KENNEDY ACIREALE,SIC,70-79,4,0,0,4,0,0,0,4,0,4,Sicilia,ITG1
2021-01-05,PF/BT,190315.0,RIA11 - AIAS SEZ. ACIREALE,SIC,20-29,6,15,0,21,0,0,0,21,0,21,Sicilia,ITG1
2021-01-05,PF/BT,190315.0,RIA11 - AIAS SEZ. ACIREALE,SIC,30-39,14,26,0,40,0,0,0,40,0,40,Sicilia,ITG1
2021-01-05,PF/BT,190315.0,RIA11 - AIAS SEZ. ACIREALE,SIC,40-49,19,17,0,36,0,0,0,36,0,36,Sicilia,ITG1
2021-01-05,PF/BT,190315.0,RIA11 - AIAS SEZ. ACIREALE,SIC,50-59,24,19,0,42,1,0,0,43,0,43,Sicilia,ITG1
2021-01-05,PF/BT,190315.0,RIA11 - AIAS SEZ. ACIREALE,SIC,60-69,23,20,0,43,0,0,0,43,0,43,Sicilia,ITG1
2021-01-05,PF/BT,190315.0,RIA11 - AIAS SEZ. ACIREALE,SIC,70-79,5,4,0,9,0,0,0,9,0,9,Sicilia,ITG1
2021-01-05,PF/BT,190316.0,RIA11 - ASS.J.F.KENNEDY - C.RIAB.ONLUS,SIC,20-29,7,15,0,19,3,0,0,22,0,22,Sicilia,ITG1
2021-01-05,PF/BT,190316.0,RIA11 - ASS.J.F.KENNEDY - C.RIAB.ONLUS,SIC,30-39,25,13,0,28,10,0,0,38,0,38,Sicilia,ITG1
2021-01-05,PF/BT,190316.0,RIA11 - ASS.J.F.KENNEDY - C.RIAB.ONLUS,SIC,40-49,18,19,0,26,11,0,0,37,0,37,Sicilia,ITG1
2021-01-05,PF/BT,190316.0,RIA11 - ASS.J.F.KENNEDY - C.RIAB.ONLUS,SIC,50-59,19,42,0,44,17,0,0,61,0,61,Sicilia,ITG1
2021-01-05,PF/BT,190316.0,RIA11 - ASS.J.F.KENNEDY - C.RIAB.ONLUS,SIC,60-69,43,34,0,62,15,0,0,77,0,77,Sicilia,ITG1
2021-01-05,PF/BT,190316.0,RIA11 - ASS.J.F.KENNEDY - C.RIAB.ONLUS,SIC,70-79,11,2,0,11,2,0,0,13,0,13,Sicilia,ITG1
2021-01-05,PF/BT,190316.0,RIA11 - ASS.J.F.KENNEDY - C.RIAB.ONLUS,SIC,80-89,3,0,0,3,0,0,0,3,0,3,Sicilia,ITG1
2021-01-05,PF/BT,190316.0,RIA11 - ASS.J.F.KENNEDY - C.RIAB.ONLUS,SIC,90+,1,0,0,1,0,0,0,1,0,1,Sicilia,ITG1
2021-01-05,PF/BT,190317.0,HSP11 - P.O. Gravina e S. Pietro Caltagirone,SIC,20-29,10,3,0,8,5,0,0,13,0,13,Sicilia,ITG1
2021-01-05,PF/BT,190317.0,HSP11 - P.O. Gravina e S. Pietro Caltagirone,SIC,30-39,8,11,0,15,4,0,0,19,0,19,Sicilia,ITG1
2021-01-05,PF/BT,190317.0,HSP11 - P.O. Gravina e S. Pietro Caltagirone,SIC,40-49,21,19,0,27,13,0,0,40,0,40,Sicilia,ITG1
2021-01-05,PF/BT,190317.0,HSP11 - P.O. Gravina e S. Pietro Caltagirone,SIC,50-59,33,43,0,56,20,0,0,76,0,76,Sicilia,ITG1
2021-01-05,PF/BT,190317.0,HSP11 - P.O. Gravina e S. Pietro Caltagirone,SIC,60-69,56,32,0,75,13,0,0,88,0,88,Sicilia,ITG1
2021-01-05,PF/BT,190317.0,HSP11 - P.O. Gravina e S. Pietro Caltagirone,SIC,70-79,2,0,0,2,0,0,0,2,0,2,Sicilia,ITG1
2021-01-05,PF/BT,190318.0,RIA11 - ASS.ISTITUTO REGINA VIRGINUM,SIC,16-19,2,1,0,3,0,0,0,3,0,3,Sicilia,ITG1
2021-01-05,PF/BT,190318.0,RIA11 - ASS.ISTITUTO REGINA VIRGINUM,SIC,20-29,13,10,0,20,1,0,2,23,0,23,Sicilia,ITG1
2021-01-05,PF/BT,190318.0,RIA11 - ASS.ISTITUTO REGINA VIRGINUM,SIC,30-39,18,13,0,24,4,0,3,31,0,31,Sicilia,ITG1
2021-01-05,PF/BT,190318.0,RIA11 - ASS.ISTITUTO REGINA VIRGINUM,SIC,40-49,14,24,0,26,11,0,1,38,0,38,Sicilia,ITG1
2021-01-05,PF/BT,190318.0,RIA11 - ASS.ISTITUTO REGINA VIRGINUM,SIC,50-59,26,38,0,49,11,0,4,64,0,64,Sicilia,ITG1
2021-01-05,PF/BT,190318.0,RIA11 - ASS.ISTITUTO REGINA VIRGINUM,SIC,60-69,18,23,0,27,11,0,3,41,0,41,Sicilia,ITG1
2021-01-05,PF/BT,190318.0,RIA11 - ASS.ISTITUTO REGINA VIRGINUM,SIC,70-79,2,0,0,1,1,0,0,2,0,2,Sicilia,ITG1
2021-01-05,PF/BT,190318.0,RIA11 - ASS.ISTITUTO REGINA VIRGINUM,SIC,80-89,1,0,0,1,0,0,0,1,0,1,Sicilia,ITG1
2021-01-05,PF/BT,190319.0,HSP11 - P. O. UMBERTO I,SIC,20-29,7,8,0,14,0,0,1,15,0,15,Sicilia,ITG1
2021-01-05,PF/BT,190319.0,HSP11 - P. O. UMBERTO I,SIC,30-39,15,10,0,22,0,0,3,25,0,25,Sicilia,ITG1
2021-01-05,PF/BT,190319.0,HSP11 - P. O. UMBERTO I,SIC,40-49,35,25,0,59,0,0,1,60,0,60,Sicilia,ITG1
2021-01-05,PF/BT,190319.0,HSP11 - P. O. UMBERTO I,SIC,50-59,41,38,0,78,0,0,1,79,0,79,Sicilia,ITG1
2021-01-05,PF/BT,190319.0,HSP11 - P. O. UMBERTO I,SIC,60-69,24,18,0,42,0,0,0,42,0,42,Sicilia,ITG1
2021-01-05,PF/BT,190319.0,HSP11 - P. O. UMBERTO I,SIC,70-79,1,0,0,1,0,0,0,1,0,1,Sicilia,ITG1
2021-01-05,PF/BT,190321.0,HSP11 - P. O. FERRO-CAPRA-BRANCIFORTE,SIC,20-29,1,0,0,1,0,0,0,1,0,1,Sicilia,ITG1
2021-01-05,PF/BT,190321.0,HSP11 - P. O. FERRO-CAPRA-BRANCIFORTE,SIC,30-39,0,1,0,1,0,0,0,1,0,1,Sicilia,ITG1
2021-01-05,PF/BT,190321.0,HSP11 - P. O. FERRO-CAPRA-BRANCIFORTE,SIC,40-49,4,2,0,6,0,0,0,6,0,6,Sicilia,ITG1
2021-01-05,PF/BT,190321.0,HSP11 - P. O. FERRO-CAPRA-BRANCIFORTE,SIC,50-59,17,7,0,24,0,0,0,24,0,24,Sicilia,ITG1
2021-01-05,PF/BT,190321.0,HSP11 - P. O. FERRO-CAPRA-BRANCIFORTE,SIC,60-69,11,5,0,16,0,0,0,16,0,16,Sicilia,ITG1
2021-01-05,PF/BT,190322.0,HSP11 - P. O. CARLO BASILOTTA,SIC,20-29,2,2,0,4,0,0,0,4,0,4,Sicilia,ITG1
2021-01-05,PF/BT,190322.0,HSP11 - P. O. CARLO BASILOTTA,SIC,30-39,6,7,0,13,0,0,0,13,0,13,Sicilia,ITG1
2021-01-05,PF/BT,190322.0,HSP11 - P. O. CARLO BASILOTTA,SIC,40-49,10,11,0,21,0,0,0,21,0,21,Sicilia,ITG1
2021-01-05,PF/BT,190322.0,HSP11 - P. O. CARLO BASILOTTA,SIC,50-59,15,10,0,25,0,0,0,25,0,25,Sicilia,ITG1
2021-01-05,PF/BT,190322.0,HSP11 - P. O. CARLO BASILOTTA,SIC,60-69,10,5,0,15,0,0,0,15,0,15,Sicilia,ITG1
2021-01-05,PF/BT,190325.0,HSP11 - P.O. G. FOGLIANI MILAZZO,SIC,20-29,0,1,0,1,0,0,0,1,0,1,Sicilia,ITG1
2021-01-05,PF/BT,190325.0,HSP11 - P.O. G. FOGLIANI MILAZZO,SIC,30-39,8,5,0,13,0,0,0,13,0,13,Sicilia,ITG1
2021-01-05,PF/BT,190325.0,HSP11 - P.O. G. FOGLIANI MILAZZO,SIC,40-49,20,25,0,45,0,0,0,45,0,45,Sicilia,ITG1
2021-01-05,PF/BT,190325.0,HSP11 - P.O. G. FOGLIANI MILAZZO,SIC,50-59,36,26,0,62,0,0,0,62,0,62,Sicilia,ITG1
2021-01-05,PF/BT,190325.0,HSP11 - P.O. G. FOGLIANI MILAZZO,SIC,60-69,29,15,0,44,0,0,0,44,0,44,Sicilia,ITG1
2021-01-05,PF/BT,190328.0,HSP11 - P.O. BARONE-ROMEO PATTI,SIC,20-29,1,1,0,2,0,0,0,2,0,2,Sicilia,ITG1
2021-01-05,PF/BT,190328.0,HSP11 - P.O. BARONE-ROMEO PATTI,SIC,30-39,5,10,0,15,0,0,0,15,0,15,Sicilia,ITG1
2021-01-05,PF/BT,190328.0,HSP11 - P.O. BARONE-ROMEO PATTI,SIC,40-49,7,15,0,19,0,0,3,22,0,22,Sicilia,ITG1
2021-01-05,PF/BT,190328.0,HSP11 - P.O. BARONE-ROMEO PATTI,SIC,50-59,10,17,0,22,0,0,5,27,0,27,Sicilia,ITG1
2021-01-05,PF/BT,190328.0,HSP11 - P.O. BARONE-ROMEO PATTI,SIC,60-69,13,11,0,19,0,0,5,24,0,24,Sicilia,ITG1
2021-01-05,PF/BT,190329.0,HSP11 - STABILIMENTO OSPED. S. AGATA MILITELLO,SIC,30-39,5,4,0,9,0,0,0,9,0,9,Sicilia,ITG1
2021-01-05,PF/BT,190329.0,HSP11 - STABILIMENTO OSPED. S. AGATA MILITELLO,SIC,40-49,14,9,0,23,0,0,0,23,0,23,Sicilia,ITG1
2021-01-05,PF/BT,190329.0,HSP11 - STABILIMENTO OSPED. S. AGATA MILITELLO,SIC,50-59,20,12,0,32,0,0,0,32,0,32,Sicilia,ITG1
2021-01-05,PF/BT,190329.0,HSP11 - STABILIMENTO OSPED. S. AGATA MILITELLO,SIC,60-69,18,5,0,23,0,0,0,23,0,23,Sicilia,ITG1
2021-01-05,PF/BT,190329.0,HSP11 - STABILIMENTO OSPED. S. AGATA MILITELLO,SIC,70-79,1,0,0,1,0,0,0,1,0,1,Sicilia,ITG1
2021-01-05,PF/BT,190332.0,HSP11 - P.O. CIVICO PARTINICO,SIC,20-29,2,13,0,13,2,0,0,15,0,15,Sicilia,ITG1
2021-01-05,PF/BT,190332.0,HSP11 - P.O. CIVICO PARTINICO,SIC,30-39,11,19,0,23,7,0,0,30,0,30,Sicilia,ITG1
2021-01-05,PF/BT,190332.0,HSP11 - P.O. CIVICO PARTINICO,SIC,40-49,24,23,0,33,14,0,0,47,0,47,Sicilia,ITG1
2021-01-05,PF/BT,190332.0,HSP11 - P.O. CIVICO PARTINICO,SIC,50-59,22,14,0,24,12,0,0,36,0,36,Sicilia,ITG1
2021-01-05,PF/BT,190332.0,HSP11 - P.O. CIVICO PARTINICO,SIC,60-69,24,10,0,30,4,0,0,34,0,34,Sicilia,ITG1
2021-01-05,PF/BT,190332.0,HSP11 - P.O. CIVICO PARTINICO,SIC,70-79,3,0,0,3,0,0,0,3,0,3,Sicilia,ITG1
2021-01-05,PF/BT,190332.0,HSP11 - P.O. CIVICO PARTINICO,SIC,80-89,1,1,0,1,1,0,0,2,0,2,Sicilia,ITG1
2021-01-05,PF/BT,190333.0,HSP11 - P.O. MADONNA DELLALTO - PETR. SOTTANA,SIC,16-19,7,1,0,0,0,0,8,8,0,8,Sicilia,ITG1
2021-01-05,PF/BT,190333.0,HSP11 - P.O. MADONNA DELLALTO - PETR. SOTTANA,SIC,20-29,10,8,0,8,4,0,6,18,0,18,Sicilia,ITG1
2021-01-05,PF/BT,190333.0,HSP11 - P.O. MADONNA DELLALTO - PETR. SOTTANA,SIC,30-39,10,12,0,16,0,0,6,22,0,22,Sicilia,ITG1
2021-01-05,PF/BT,190333.0,HSP11 - P.O. MADONNA DELLALTO - PETR. SOTTANA,SIC,40-49,9,29,0,27,3,3,5,38,0,38,Sicilia,ITG1
2021-01-05,PF/BT,190333.0,HSP11 - P.O. MADONNA DELLALTO - PETR. SOTTANA,SIC,50-59,21,21,0,19,4,14,5,42,0,42,Sicilia,ITG1
2021-01-05,PF/BT,190333.0,HSP11 - P.O. MADONNA DELLALTO - PETR. SOTTANA,SIC,60-69,2,10,0,6,0,6,0,12,0,12,Sicilia,ITG1
2021-01-05,PF/BT,190333.0,HSP11 - P.O. MADONNA DELLALTO - PETR. SOTTANA,SIC,70-79,6,7,0,0,0,12,1,13,0,13,Sicilia,ITG1
2021-01-05,PF/BT,190333.0,HSP11 - P.O. MADONNA DELLALTO - PETR. SOTTANA,SIC,80-89,12,19,0,0,0,31,0,31,0,31,Sicilia,ITG1
2021-01-05,PF/BT,190333.0,HSP11 - P.O. MADONNA DELLALTO - PETR. SOTTANA,SIC,90+,7,12,0,0,0,19,0,19,0,19,Sicilia,ITG1
2021-01-05,PF/BT,190335.0,HSP11 - P.O. G. F. INGRASSIA,SIC,20-29,1,0,0,1,0,0,0,1,0,1,Sicilia,ITG1
2021-01-05,PF/BT,190335.0,HSP11 - P.O. G. F. INGRASSIA,SIC,30-39,7,4,0,11,0,0,0,11,0,11,Sicilia,ITG1
2021-01-05,PF/BT,190335.0,HSP11 - P.O. G. F. INGRASSIA,SIC,40-49,5,4,0,9,0,0,0,9,0,9,Sicilia,ITG1
2021-01-05,PF/BT,190335.0,HSP11 - P.O. G. F. INGRASSIA,SIC,50-59,6,15,0,21,0,0,0,21,0,21,Sicilia,ITG1
2021-01-05,PF/BT,190335.0,HSP11 - P.O. G. F. INGRASSIA,SIC,60-69,1,12,0,13,0,0,0,13,0,13,Sicilia,ITG1
2021-01-05,PF/BT,190335.0,HSP11 - P.O. G. F. INGRASSIA,SIC,70-79,1,0,0,1,0,0,0,1,0,1,Sicilia,ITG1
2021-01-05,PF/BT,190337.0,HSP11 - P.O. VILLA DELLE GINESTRE,SIC,16-19,1,0,0,0,1,0,0,1,0,1,Sicilia,ITG1
2021-01-05,PF/BT,190337.0,HSP11 - P.O. VILLA DELLE GINESTRE,SIC,20-29,10,17,0,20,5,0,2,27,0,27,Sicilia,ITG1
2021-01-05,PF/BT,190337.0,HSP11 - P.O. VILLA DELLE GINESTRE,SIC,30-39,21,21,0,24,11,0,7,42,0,42,Sicilia,ITG1
2021-01-05,PF/BT,190337.0,HSP11 - P.O. VILLA DELLE GINESTRE,SIC,40-49,44,28,0,32,28,0,12,72,0,72,Sicilia,ITG1
2021-01-05,PF/BT,190337.0,HSP11 - P.O. VILLA DELLE GINESTRE,SIC,50-59,60,57,0,68,27,0,22,117,0,117,Sicilia,ITG1
2021-01-05,PF/BT,190337.0,HSP11 - P.O. VILLA DELLE GINESTRE,SIC,60-69,92,64,0,128,21,0,7,156,0,156,Sicilia,ITG1
2021-01-05,PF/BT,190337.0,HSP11 - P.O. VILLA DELLE GINESTRE,SIC,70-79,4,1,0,5,0,0,0,5,0,5,Sicilia,ITG1
2021-01-05,PF/BT,190338.0,HSP11 - OSPEDALE Giovanni Paolo II° M.P. A.,SIC,20-29,16,13,0,28,1,0,0,29,0,29,Sicilia,ITG1
2021-01-05,PF/BT,190338.0,HSP11 - OSPEDALE Giovanni Paolo II° M.P. A.,SIC,30-39,23,28,0,49,2,0,0,51,0,51,Sicilia,ITG1
2021-01-05,PF/BT,190338.0,HSP11 - OSPEDALE Giovanni Paolo II° M.P. A.,SIC,40-49,22,27,0,43,6,0,0,49,0,49,Sicilia,ITG1
2021-01-05,PF/BT,190338.0,HSP11 - OSPEDALE Giovanni Paolo II° M.P. A.,SIC,50-59,22,39,0,55,6,0,0,61,0,61,Sicilia,ITG1
2021-01-05,PF/BT,190338.0,HSP11 - OSPEDALE Giovanni Paolo II° M.P. A.,SIC,60-69,14,16,0,29,1,0,0,30,0,30,Sicilia,ITG1
2021-01-05,PF/BT,190338.0,HSP11 - OSPEDALE Giovanni Paolo II° M.P. A.,SIC,70-79,2,0,0,2,0,0,0,2,0,2,Sicilia,ITG1
2021-01-05,PF/BT,190340.0,HSP11 - OSPEDALE MAGGIORE MODICA,SIC,20-29,3,1,0,4,0,0,0,4,0,4,Sicilia,ITG1
2021-01-05,PF/BT,190340.0,HSP11 - OSPEDALE MAGGIORE MODICA,SIC,30-39,4,5,0,9,0,0,0,9,0,9,Sicilia,ITG1
2021-01-05,PF/BT,190340.0,HSP11 - OSPEDALE MAGGIORE MODICA,SIC,40-49,10,10,0,20,0,0,0,20,0,20,Sicilia,ITG1
2021-01-05,PF/BT,190340.0,HSP11 - OSPEDALE MAGGIORE MODICA,SIC,50-59,18,12,0,30,0,0,0,30,0,30,Sicilia,ITG1
2021-01-05,PF/BT,190340.0,HSP11 - OSPEDALE MAGGIORE MODICA,SIC,60-69,11,9,0,20,0,0,0,20,0,20,Sicilia,ITG1
2021-01-05,PF/BT,190341.0,HSP11 - OSPEDALE BUSACCA SCICLI,SIC,20-29,12,13,0,23,2,0,0,25,0,25,Sicilia,ITG1
2021-01-05,PF/BT,190341.0,HSP11 - OSPEDALE BUSACCA SCICLI,SIC,30-39,9,3,0,11,1,0,0,12,0,12,Sicilia,ITG1
2021-01-05,PF/BT,190341.0,HSP11 - OSPEDALE BUSACCA SCICLI,SIC,40-49,3,6,0,8,1,0,0,9,0,9,Sicilia,ITG1
2021-01-05,PF/BT,190341.0,HSP11 - OSPEDALE BUSACCA SCICLI,SIC,50-59,6,12,0,13,5,0,0,18,0,18,Sicilia,ITG1
2021-01-05,PF/BT,190341.0,HSP11 - OSPEDALE BUSACCA SCICLI,SIC,60-69,10,7,0,12,5,0,0,17,0,17,Sicilia,ITG1
2021-01-05,PF/BT,190341.0,HSP11 - OSPEDALE BUSACCA SCICLI,SIC,70-79,1,0,0,1,0,0,0,1,0,1,Sicilia,ITG1
2021-01-05,PF/BT,190341.0,HSP11 - OSPEDALE BUSACCA SCICLI,SIC,80-89,1,0,0,0,1,0,0,1,0,1,Sicilia,ITG1
2021-01-05,PF/BT,190342.0,HSP11 - OSPEDALE GUZZARDI VITTORIA,SIC,20-29,1,11,0,12,0,0,0,12,0,12,Sicilia,ITG1
2021-01-05,PF/BT,190342.0,HSP11 - OSPEDALE GUZZARDI VITTORIA,SIC,30-39,11,12,0,22,0,0,1,23,0,23,Sicilia,ITG1
2021-01-05,PF/BT,190342.0,HSP11 - OSPEDALE GUZZARDI VITTORIA,SIC,40-49,13,18,0,31,0,0,0,31,0,31,Sicilia,ITG1
2021-01-05,PF/BT,190342.0,HSP11 - OSPEDALE GUZZARDI VITTORIA,SIC,50-59,23,25,0,48,0,0,0,48,0,48,Sicilia,ITG1
2021-01-05,PF/BT,190342.0,HSP11 - OSPEDALE GUZZARDI VITTORIA,SIC,60-69,8,9,0,17,0,0,0,17,0,17,Sicilia,ITG1
2021-01-05,PF/BT,190342.0,HSP11 - OSPEDALE GUZZARDI VITTORIA,SIC,70-79,0,2,0,2,0,0,0,2,0,2,Sicilia,ITG1
2021-01-05,PF/BT,190343.0,HSP11 - P.O. DI MARIA AVOLA,SIC,20-29,2,2,0,4,0,0,0,4,0,4,Sicilia,ITG1
2021-01-05,PF/BT,190343.0,HSP11 - P.O. DI MARIA AVOLA,SIC,30-39,1,3,0,4,0,0,0,4,0,4,Sicilia,ITG1
2021-01-05,PF/BT,190343.0,HSP11 - P.O. DI MARIA AVOLA,SIC,40-49,12,9,0,21,0,0,0,21,0,21,Sicilia,ITG1
2021-01-05,PF/BT,190343.0,HSP11 - P.O. DI MARIA AVOLA,SIC,50-59,9,8,0,17,0,0,0,17,0,17,Sicilia,ITG1
2021-01-05,PF/BT,190343.0,HSP11 - P.O. DI MARIA AVOLA,SIC,60-69,2,0,0,2,0,0,0,2,0,2,Sicilia,ITG1
2021-01-05,PF/BT,190345.0,HSP11 - P.O. UMBERTO I (EX A.O.),SIC,20-29,3,5,0,8,0,0,0,8,0,8,Sicilia,ITG1
2021-01-05,PF/BT,190345.0,HSP11 - P.O. UMBERTO I (EX A.O.),SIC,30-39,19,23,0,42,0,0,0,42,0,42,Sicilia,ITG1
2021-01-05,PF/BT,190345.0,HSP11 - P.O. UMBERTO I (EX A.O.),SIC,40-49,14,37,0,50,1,0,0,51,0,51,Sicilia,ITG1
2021-01-05,PF/BT,190345.0,HSP11 - P.O. UMBERTO I (EX A.O.),SIC,50-59,23,29,0,51,0,0,1,52,0,52,Sicilia,ITG1
2021-01-05,PF/BT,190345.0,HSP11 - P.O. UMBERTO I (EX A.O.),SIC,60-69,16,11,0,25,2,0,0,27,0,27,Sicilia,ITG1
2021-01-05,PF/BT,190346.0,HSP11 - P.O. MUSCATELLO AUGUSTA,SIC,20-29,1,1,0,2,0,0,0,2,0,2,Sicilia,ITG1
2021-01-05,PF/BT,190346.0,HSP11 - P.O. MUSCATELLO AUGUSTA,SIC,30-39,4,10,0,14,0,0,0,14,0,14,Sicilia,ITG1
2021-01-05,PF/BT,190346.0,HSP11 - P.O. MUSCATELLO AUGUSTA,SIC,40-49,2,14,0,16,0,0,0,16,0,16,Sicilia,ITG1
2021-01-05,PF/BT,190346.0,HSP11 - P.O. MUSCATELLO AUGUSTA,SIC,50-59,4,9,0,13,0,0,0,13,0,13,Sicilia,ITG1
2021-01-05,PF/BT,190346.0,HSP11 - P.O. MUSCATELLO AUGUSTA,SIC,60-69,3,2,0,5,0,0,0,5,0,5,Sicilia,ITG1
2021-01-05,PF/BT,190347.0,HSP11 - OSPEDALE GENERALE DI ZONA,SIC,20-29,0,1,0,1,0,0,0,1,0,1,Sicilia,ITG1
2021-01-05,PF/BT,190347.0,HSP11 - OSPEDALE GENERALE DI ZONA,SIC,30-39,3,5,0,8,0,0,0,8,0,8,Sicilia,ITG1
2021-01-05,PF/BT,190347.0,HSP11 - OSPEDALE GENERALE DI ZONA,SIC,40-49,7,4,0,10,1,0,0,11,0,11,Sicilia,ITG1
2021-01-05,PF/BT,190347.0,HSP11 - OSPEDALE GENERALE DI ZONA,SIC,50-59,15,11,0,25,1,0,0,26,0,26,Sicilia,ITG1
2021-01-05,PF/BT,190347.0,HSP11 - OSPEDALE GENERALE DI ZONA,SIC,60-69,1,1,0,2,0,0,0,2,0,2,Sicilia,ITG1
2021-01-05,PF/BT,190349.0,HSP11 - P.O. SAN VITO E SANTO SPIRITO -ALCAMO,SIC,16-19,1,1,0,1,0,0,1,2,0,2,Sicilia,ITG1
2021-01-05,PF/BT,190349.0,HSP11 - P.O. SAN VITO E SANTO SPIRITO -ALCAMO,SIC,20-29,10,5,0,11,0,0,4,15,0,15,Sicilia,ITG1
2021-01-05,PF/BT,190349.0,HSP11 - P.O. SAN VITO E SANTO SPIRITO -ALCAMO,SIC,30-39,16,16,0,24,3,0,5,32,0,32,Sicilia,ITG1
2021-01-05,PF/BT,190349.0,HSP11 - P.O. SAN VITO E SANTO SPIRITO -ALCAMO,SIC,40-49,14,15,0,17,5,0,7,29,0,29,Sicilia,ITG1
2021-01-05,PF/BT,190349.0,HSP11 - P.O. SAN VITO E SANTO SPIRITO -ALCAMO,SIC,50-59,25,19,0,26,10,0,8,44,0,44,Sicilia,ITG1
2021-01-05,PF/BT,190349.0,HSP11 - P.O. SAN VITO E SANTO SPIRITO -ALCAMO,SIC,60-69,8,12,0,13,4,0,3,20,0,20,Sicilia,ITG1
2021-01-05,PF/BT,190349.0,HSP11 - P.O. SAN VITO E SANTO SPIRITO -ALCAMO,SIC,70-79,2,0,0,1,0,0,1,2,0,2,Sicilia,ITG1
2021-01-05,PF/BT,190351.0,HSP11 - P.O. S. ANTONIO ABATE  - TRAPANI,SIC,20-29,3,8,0,9,2,0,0,11,0,11,Sicilia,ITG1
2021-01-05,PF/BT,190351.0,HSP11 - P.O. S. ANTONIO ABATE  - TRAPANI,SIC,30-39,12,20,0,25,7,0,0,32,0,32,Sicilia,ITG1
2021-01-05,PF/BT,190351.0,HSP11 - P.O. S. ANTONIO ABATE  - TRAPANI,SIC,40-49,24,32,0,33,22,0,1,56,0,56,Sicilia,ITG1
2021-01-05,PF/BT,190351.0,HSP11 - P.O. S. ANTONIO ABATE  - TRAPANI,SIC,50-59,30,43,0,48,24,0,1,73,0,73,Sicilia,ITG1
2021-01-05,PF/BT,190351.0,HSP11 - P.O. S. ANTONIO ABATE  - TRAPANI,SIC,60-69,26,18,0,32,12,0,0,44,0,44,Sicilia,ITG1
2021-01-05,PF/BT,190351.0,HSP11 - P.O. S. ANTONIO ABATE  - TRAPANI,SIC,70-79,2,2,0,4,0,0,0,4,0,4,Sicilia,ITG1
2021-01-05,PF/BT,190352.0,HSP11 - P.O. V.EMANUELE II CASTELVETRANO,SIC,16-19,1,0,0,0,1,0,0,1,0,1,Sicilia,ITG1
2021-01-05,PF/BT,190352.0,HSP11 - P.O. V.EMANUELE II CASTELVETRANO,SIC,20-29,3,4,0,7,0,0,0,7,0,7,Sicilia,ITG1
2021-01-05,PF/BT,190352.0,HSP11 - P.O. V.EMANUELE II CASTELVETRANO,SIC,30-39,7,9,0,16,0,0,0,16,0,16,Sicilia,ITG1
2021-01-05,PF/BT,190352.0,HSP11 - P.O. V.EMANUELE II CASTELVETRANO,SIC,40-49,12,8,0,15,2,0,3,20,0,20,Sicilia,ITG1
2021-01-05,PF/BT,190352.0,HSP11 - P.O. V.EMANUELE II CASTELVETRANO,SIC,50-59,12,31,0,38,2,0,3,43,0,43,Sicilia,ITG1
2021-01-05,PF/BT,190352.0,HSP11 - P.O. V.EMANUELE II CASTELVETRANO,SIC,60-69,13,7,0,19,0,0,1,20,0,20,Sicilia,ITG1
2021-01-05,PF/BT,190352.0,HSP11 - P.O. V.EMANUELE II CASTELVETRANO,SIC,70-79,2,0,0,1,0,0,1,2,0,2,Sicilia,ITG1
2021-01-05,PF/BT,190353.0,HSP11 - P.O.PAOLO BORSELLINO - MARSALA,SIC,20-29,3,5,0,8,0,0,0,8,0,8,Sicilia,ITG1
2021-01-05,PF/BT,190353.0,HSP11 - P.O.PAOLO BORSELLINO - MARSALA,SIC,30-39,12,9,0,21,0,0,0,21,0,21,Sicilia,ITG1
2021-01-05,PF/BT,190353.0,HSP11 - P.O.PAOLO BORSELLINO - MARSALA,SIC,40-49,7,3,0,10,0,0,0,10,0,10,Sicilia,ITG1
2021-01-05,PF/BT,190353.0,HSP11 - P.O.PAOLO BORSELLINO - MARSALA,SIC,50-59,11,18,0,29,0,0,0,29,0,29,Sicilia,ITG1
2021-01-05,PF/BT,190353.0,HSP11 - P.O.PAOLO BORSELLINO - MARSALA,SIC,60-69,33,17,0,50,0,0,0,50,0,50,Sicilia,ITG1
2021-01-05,PF/BT,190353.0,HSP11 - P.O.PAOLO BORSELLINO - MARSALA,SIC,70-79,1,0,0,1,0,0,0,1,0,1,Sicilia,ITG1
2021-01-05,PF/BT,190354.0,HSP11 - P.O.ABELE AJELLO-MAZARA D.VALLO,SIC,16-19,1,0,0,1,0,0,0,1,0,1,Sicilia,ITG1
2021-01-05,PF/BT,190354.0,HSP11 - P.O.ABELE AJELLO-MAZARA D.VALLO,SIC,20-29,7,5,0,12,0,0,0,12,0,12,Sicilia,ITG1
2021-01-05,PF/BT,190354.0,HSP11 - P.O.ABELE AJELLO-MAZARA D.VALLO,SIC,30-39,8,10,0,18,0,0,0,18,0,18,Sicilia,ITG1
2021-01-05,PF/BT,190354.0,HSP11 - P.O.ABELE AJELLO-MAZARA D.VALLO,SIC,40-49,5,12,0,17,0,0,0,17,0,17,Sicilia,ITG1
2021-01-05,PF/BT,190354.0,HSP11 - P.O.ABELE AJELLO-MAZARA D.VALLO,SIC,50-59,12,16,0,28,0,0,0,28,0,28,Sicilia,ITG1
2021-01-05,PF/BT,190354.0,HSP11 - P.O.ABELE AJELLO-MAZARA D.VALLO,SIC,60-69,19,17,0,36,0,0,0,36,0,36,Sicilia,ITG1
2021-01-05,PF/BT,190354.0,HSP11 - P.O.ABELE AJELLO-MAZARA D.VALLO,SIC,70-79,0,2,0,2,0,0,0,2,0,2,Sicilia,ITG1
2021-01-05,PF/BT,190355.0,HSP11 - P.O. VITTORIO EMANUELE III - SALEMI,SIC,20-29,2,2,0,4,0,0,0,4,0,4,Sicilia,ITG1
2021-01-05,PF/BT,190355.0,HSP11 - P.O. VITTORIO EMANUELE III - SALEMI,SIC,30-39,2,7,0,9,0,0,0,9,0,9,Sicilia,ITG1
2021-01-05,PF/BT,190355.0,HSP11 - P.O. VITTORIO EMANUELE III - SALEMI,SIC,40-49,8,9,0,17,0,0,0,17,0,17,Sicilia,ITG1
2021-01-05,PF/BT,190355.0,HSP11 - P.O. VITTORIO EMANUELE III - SALEMI,SIC,50-59,14,20,0,34,0,0,0,34,0,34,Sicilia,ITG1
2021-01-05,PF/BT,190355.0,HSP11 - P.O. VITTORIO EMANUELE III - SALEMI,SIC,60-69,16,11,0,27,0,0,0,27,0,27,Sicilia,ITG1
2021-01-05,PF/BT,190355.0,HSP11 - P.O. VITTORIO EMANUELE III - SALEMI,SIC,70-79,1,1,0,2,0,0,0,2,0,2,Sicilia,ITG1
2021-01-05,PF/BT,190355.0,HSP11 - P.O. VITTORIO EMANUELE III - SALEMI,SIC,80-89,1,0,0,1,0,0,0,1,0,1,Sicilia,ITG1
2021-01-05,PF/BT,190512.0,HSP11 - CASA DI CURA MADONNA DEL ROSARIO,SIC,20-29,4,6,0,10,0,0,0,10,0,10,Sicilia,ITG1
2021-01-05,PF/BT,190512.0,HSP11 - CASA DI CURA MADONNA DEL ROSARIO,SIC,30-39,4,1,0,5,0,0,0,5,0,5,Sicilia,ITG1
2021-01-05,PF/BT,190512.0,HSP11 - CASA DI CURA MADONNA DEL ROSARIO,SIC,40-49,2,3,0,4,1,0,0,5,0,5,Sicilia,ITG1
2021-01-05,PF/BT,190512.0,HSP11 - CASA DI CURA MADONNA DEL ROSARIO,SIC,50-59,2,1,0,2,1,0,0,3,0,3,Sicilia,ITG1
2021-01-05,PF/BT,190512.0,HSP11 - CASA DI CURA MADONNA DEL ROSARIO,SIC,60-69,1,0,0,1,0,0,0,1,0,1,Sicilia,ITG1
2021-01-05,PF/BT,190554.0,HSP11 - ISTITUTO ONCOLOGICO DEL MEDITERRANEO SPA,SIC,20-29,10,13,0,23,0,0,0,23,0,23,Sicilia,ITG1
2021-01-05,PF/BT,190554.0,HSP11 - ISTITUTO ONCOLOGICO DEL MEDITERRANEO SPA,SIC,30-39,14,9,0,22,0,0,1,23,0,23,Sicilia,ITG1
2021-01-05,PF/BT,190554.0,HSP11 - ISTITUTO ONCOLOGICO DEL MEDITERRANEO SPA,SIC,40-49,11,17,0,25,3,0,0,28,0,28,Sicilia,ITG1
2021-01-05,PF/BT,190554.0,HSP11 - ISTITUTO ONCOLOGICO DEL MEDITERRANEO SPA,SIC,50-59,4,3,0,6,1,0,0,7,0,7,Sicilia,ITG1
2021-01-05,PF/BT,190554.0,HSP11 - ISTITUTO ONCOLOGICO DEL MEDITERRANEO SPA,SIC,60-69,7,3,0,9,1,0,0,10,0,10,Sicilia,ITG1
2021-01-05,PF/BT,190554.0,HSP11 - ISTITUTO ONCOLOGICO DEL MEDITERRANEO SPA,SIC,70-79,5,0,0,4,0,0,1,5,0,5,Sicilia,ITG1
2021-01-05,PF/BT,190712.0,HSP11 - CASA DI CURA MUSUMECI GECAS SRL,SIC,20-29,7,7,0,13,0,0,1,14,0,14,Sicilia,ITG1
2021-01-05,PF/BT,190712.0,HSP11 - CASA DI CURA MUSUMECI GECAS SRL,SIC,30-39,8,9,0,9,2,0,6,17,0,17,Sicilia,ITG1
2021-01-05,PF/BT,190712.0,HSP11 - CASA DI CURA MUSUMECI GECAS SRL,SIC,40-49,11,15,0,14,5,0,7,26,0,26,Sicilia,ITG1
2021-01-05,PF/BT,190712.0,HSP11 - CASA DI CURA MUSUMECI GECAS SRL,SIC,50-59,17,16,0,18,6,0,9,33,0,33,Sicilia,ITG1
2021-01-05,PF/BT,190712.0,HSP11 - CASA DI CURA MUSUMECI GECAS SRL,SIC,60-69,11,11,0,12,2,0,8,22,0,22,Sicilia,ITG1
2021-01-05,PF/BT,190712.0,HSP11 - CASA DI CURA MUSUMECI GECAS SRL,SIC,70-79,7,1,0,7,0,0,1,8,0,8,Sicilia,ITG1
2021-01-05,PF/BT,190716.0,HSP11 - CASA DI CURA CAPPELLANI GIOMI S.P.A.,SIC,20-29,0,2,0,2,0,0,0,2,0,2,Sicilia,ITG1
2021-01-05,PF/BT,190716.0,HSP11 - CASA DI CURA CAPPELLANI GIOMI S.P.A.,SIC,30-39,5,1,0,6,0,0,0,6,0,6,Sicilia,ITG1
2021-01-05,PF/BT,190716.0,HSP11 - CASA DI CURA CAPPELLANI GIOMI S.P.A.,SIC,40-49,6,3,0,9,0,0,0,9,0,9,Sicilia,ITG1
2021-01-05,PF/BT,190716.0,HSP11 - CASA DI CURA CAPPELLANI GIOMI S.P.A.,SIC,50-59,2,4,0,6,0,0,0,6,0,6,Sicilia,ITG1
2021-01-05,PF/BT,190716.0,HSP11 - CASA DI CURA CAPPELLANI GIOMI S.P.A.,SIC,60-69,5,1,0,6,0,0,0,6,0,6,Sicilia,ITG1
2021-01-05,PF/BT,190716.0,HSP11 - CASA DI CURA CAPPELLANI GIOMI S.P.A.,SIC,70-79,3,0,0,3,0,0,0,3,0,3,Sicilia,ITG1
2021-01-05,PF/BT,190726.0,HSP11 - ISTITUTO CLINICO VIDIMURA srl,SIC,20-29,4,4,0,8,0,0,0,8,0,8,Sicilia,ITG1
2021-01-05,PF/BT,190726.0,HSP11 - ISTITUTO CLINICO VIDIMURA srl,SIC,30-39,2,1,0,2,1,0,0,3,0,3,Sicilia,ITG1
2021-01-05,PF/BT,190726.0,HSP11 - ISTITUTO CLINICO VIDIMURA srl,SIC,40-49,1,6,0,3,4,0,0,7,0,7,Sicilia,ITG1
2021-01-05,PF/BT,190726.0,HSP11 - ISTITUTO CLINICO VIDIMURA srl,SIC,50-59,7,7,0,10,4,0,0,14,0,14,Sicilia,ITG1
2021-01-05,PF/BT,190726.0,HSP11 - ISTITUTO CLINICO VIDIMURA srl,SIC,60-69,5,1,0,6,0,0,0,6,0,6,Sicilia,ITG1
2021-01-05,PF/BT,190726.0,HSP11 - ISTITUTO CLINICO VIDIMURA srl,SIC,70-79,1,0,0,1,0,0,0,1,0,1,Sicilia,ITG1
2021-01-05,PF/BT,190921.0,HSP11 - A.O. per lEmergenza Cannizzaro,SIC,20-29,6,8,0,14,0,0,0,14,0,14,Sicilia,ITG1
2021-01-05,PF/BT,190921.0,HSP11 - A.O. per lEmergenza Cannizzaro,SIC,30-39,33,27,0,60,0,0,0,60,0,60,Sicilia,ITG1
2021-01-05,PF/BT,190921.0,HSP11 - A.O. per lEmergenza Cannizzaro,SIC,40-49,46,57,0,102,1,0,0,103,0,103,Sicilia,ITG1
2021-01-05,PF/BT,190921.0,HSP11 - A.O. per lEmergenza Cannizzaro,SIC,50-59,75,64,0,137,2,0,0,139,0,139,Sicilia,ITG1
2021-01-05,PF/BT,190921.0,HSP11 - A.O. per lEmergenza Cannizzaro,SIC,60-69,34,22,0,53,3,0,0,56,0,56,Sicilia,ITG1
2021-01-05,PF/BT,19092201.0,HSP11 - OSPEDALE GARIBALDI - CENTRO,SIC,20-29,2,14,0,16,0,0,0,16,0,16,Sicilia,ITG1
2021-01-05,PF/BT,19092201.0,HSP11 - OSPEDALE GARIBALDI - CENTRO,SIC,30-39,21,19,0,38,2,0,0,40,0,40,Sicilia,ITG1
2021-01-05,PF/BT,19092201.0,HSP11 - OSPEDALE GARIBALDI - CENTRO,SIC,40-49,18,28,0,36,9,0,1,46,0,46,Sicilia,ITG1
2021-01-05,PF/BT,19092201.0,HSP11 - OSPEDALE GARIBALDI - CENTRO,SIC,50-59,36,47,0,69,14,0,0,83,0,83,Sicilia,ITG1
2021-01-05,PF/BT,19092201.0,HSP11 - OSPEDALE GARIBALDI - CENTRO,SIC,60-69,25,16,0,33,8,0,0,41,0,41,Sicilia,ITG1
2021-01-05,PF/BT,19092201.0,HSP11 - OSPEDALE GARIBALDI - CENTRO,SIC,70-79,1,0,0,1,0,0,0,1,0,1,Sicilia,ITG1
2021-01-05,PF/BT,19092204.0,HSP11 - NUOVO OSPEDALE GARIBALDI - NESIMA,SIC,20-29,4,12,0,16,0,0,0,16,0,16,Sicilia,ITG1
2021-01-05,PF/BT,19092204.0,HSP11 - NUOVO OSPEDALE GARIBALDI - NESIMA,SIC,30-39,15,22,0,36,1,0,0,37,0,37,Sicilia,ITG1
2021-01-05,PF/BT,19092204.0,HSP11 - NUOVO OSPEDALE GARIBALDI - NESIMA,SIC,40-49,30,46,0,73,1,0,2,76,0,76,Sicilia,ITG1
2021-01-05,PF/BT,19092204.0,HSP11 - NUOVO OSPEDALE GARIBALDI - NESIMA,SIC,50-59,44,41,0,78,5,0,2,85,0,85,Sicilia,ITG1
2021-01-05,PF/BT,19092204.0,HSP11 - NUOVO OSPEDALE GARIBALDI - NESIMA,SIC,60-69,25,14,0,37,2,0,0,39,0,39,Sicilia,ITG1
2021-01-05,PF/BT,19092301.0,HSP11 - PRESIDIO OSPEDALIERO GASPARE RODOLICO,SIC,20-29,20,18,0,38,0,0,0,38,0,38,Sicilia,ITG1
2021-01-05,PF/BT,19092301.0,HSP11 - PRESIDIO OSPEDALIERO GASPARE RODOLICO,SIC,30-39,38,32,0,70,0,0,0,70,0,70,Sicilia,ITG1
2021-01-05,PF/BT,19092301.0,HSP11 - PRESIDIO OSPEDALIERO GASPARE RODOLICO,SIC,40-49,23,37,0,60,0,0,0,60,0,60,Sicilia,ITG1
2021-01-05,PF/BT,19092301.0,HSP11 - PRESIDIO OSPEDALIERO GASPARE RODOLICO,SIC,50-59,29,55,0,84,0,0,0,84,0,84,Sicilia,ITG1
2021-01-05,PF/BT,19092301.0,HSP11 - PRESIDIO OSPEDALIERO GASPARE RODOLICO,SIC,60-69,27,19,0,46,0,0,0,46,0,46,Sicilia,ITG1
2021-01-05,PF/BT,19092304.0,HSP11 - PRESIDIO OSPEDALIERO S.MARCO,SIC,16-19,4,18,0,19,3,0,0,22,0,22,Sicilia,ITG1
2021-01-05,PF/BT,19092304.0,HSP11 - PRESIDIO OSPEDALIERO S.MARCO,SIC,20-29,44,105,0,141,8,0,0,149,0,149,Sicilia,ITG1
2021-01-05,PF/BT,19092304.0,HSP11 - PRESIDIO OSPEDALIERO S.MARCO,SIC,30-39,20,28,0,47,1,0,0,48,0,48,Sicilia,ITG1
2021-01-05,PF/BT,19092304.0,HSP11 - PRESIDIO OSPEDALIERO S.MARCO,SIC,40-49,9,19,0,26,2,0,0,28,0,28,Sicilia,ITG1
2021-01-05,PF/BT,19092304.0,HSP11 - PRESIDIO OSPEDALIERO S.MARCO,SIC,50-59,13,17,0,30,0,0,0,30,0,30,Sicilia,ITG1
2021-01-05,PF/BT,19092304.0,HSP11 - PRESIDIO OSPEDALIERO S.MARCO,SIC,60-69,16,18,0,34,0,0,0,34,0,34,Sicilia,ITG1
2021-01-05,PF/BT,190924.0,HSP11 - Azienda Ospedaliera Papardo,SIC,20-29,7,7,0,5,0,0,9,14,0,14,Sicilia,ITG1
2021-01-05,PF/BT,190924.0,HSP11 - Azienda Ospedaliera Papardo,SIC,30-39,23,23,0,31,0,0,15,46,0,46,Sicilia,ITG1
2021-01-05,PF/BT,190924.0,HSP11 - Azienda Ospedaliera Papardo,SIC,40-49,30,50,0,64,0,0,16,80,0,80,Sicilia,ITG1
2021-01-05,PF/BT,190924.0,HSP11 - Azienda Ospedaliera Papardo,SIC,50-59,47,55,0,82,0,0,20,102,0,102,Sicilia,ITG1
2021-01-05,PF/BT,190924.0,HSP11 - Azienda Ospedaliera Papardo,SIC,60-69,47,29,0,72,0,0,4,76,0,76,Sicilia,ITG1
2021-01-05,PF/BT,19092501.0,HSP11 - COVID HOSPITAL,SIC,20-29,6,18,0,24,0,0,0,24,0,24,Sicilia,ITG1
2021-01-05,PF/BT,19092501.0,HSP11 - COVID HOSPITAL,SIC,30-39,37,31,0,68,0,0,0,68,0,68,Sicilia,ITG1
2021-01-05,PF/BT,19092501.0,HSP11 - COVID HOSPITAL,SIC,40-49,27,36,0,63,0,0,0,63,0,63,Sicilia,ITG1
2021-01-05,PF/BT,19092501.0,HSP11 - COVID HOSPITAL,SIC,50-59,42,49,0,91,0,0,0,91,0,91,Sicilia,ITG1
2021-01-05,PF/BT,19092501.0,HSP11 - COVID HOSPITAL,SIC,60-69,13,17,0,30,0,0,0,30,0,30,Sicilia,ITG1
2021-01-05,PF/BT,19092601.0,HSP11 - P.O. Villa Sofia,SIC,20-29,3,11,0,14,0,0,0,14,0,14,Sicilia,ITG1
2021-01-05,PF/BT,19092601.0,HSP11 - P.O. Villa Sofia,SIC,30-39,10,20,0,30,0,0,0,30,0,30,Sicilia,ITG1
2021-01-05,PF/BT,19092601.0,HSP11 - P.O. Villa Sofia,SIC,40-49,18,24,0,42,0,0,0,42,0,42,Sicilia,ITG1
2021-01-05,PF/BT,19092601.0,HSP11 - P.O. Villa Sofia,SIC,50-59,30,24,0,54,0,0,0,54,0,54,Sicilia,ITG1
2021-01-05,PF/BT,19092601.0,HSP11 - P.O. Villa Sofia,SIC,60-69,23,17,0,40,0,0,0,40,0,40,Sicilia,ITG1
2021-01-05,PF/BT,19092701.0,HSP11 - Ospedale Civico,SIC,20-29,4,15,0,18,1,0,0,19,0,19,Sicilia,ITG1
2021-01-05,PF/BT,19092701.0,HSP11 - Ospedale Civico,SIC,30-39,22,16,0,38,0,0,0,38,0,38,Sicilia,ITG1
2021-01-05,PF/BT,19092701.0,HSP11 - Ospedale Civico,SIC,40-49,15,13,0,27,1,0,0,28,0,28,Sicilia,ITG1
2021-01-05,PF/BT,19092701.0,HSP11 - Ospedale Civico,SIC,50-59,46,31,0,73,4,0,0,77,0,77,Sicilia,ITG1
2021-01-05,PF/BT,19092701.0,HSP11 - Ospedale Civico,SIC,60-69,14,19,0,32,1,0,0,33,0,33,Sicilia,ITG1
2021-01-05,PF/BT,19092702.0,HSP11 - Ospedale dei Bambini G. Di Cristina,SIC,20-29,5,8,0,13,0,0,0,13,0,13,Sicilia,ITG1
2021-01-05,PF/BT,19092702.0,HSP11 - Ospedale dei Bambini G. Di Cristina,SIC,30-39,2,19,0,21,0,0,0,21,0,21,Sicilia,ITG1
2021-01-05,PF/BT,19092702.0,HSP11 - Ospedale dei Bambini G. Di Cristina,SIC,40-49,7,12,0,19,0,0,0,19,0,19,Sicilia,ITG1
2021-01-05,PF/BT,19092702.0,HSP11 - Ospedale dei Bambini G. Di Cristina,SIC,50-59,12,37,0,49,0,0,0,49,0,49,Sicilia,ITG1
2021-01-05,PF/BT,19092702.0,HSP11 - Ospedale dei Bambini G. Di Cristina,SIC,60-69,14,12,0,26,0,0,0,26,0,26,Sicilia,ITG1
2021-01-05,PF/BT,190928.0,HSP11 - AZ.OSP.UNIV.P.GIACCONE,SIC,20-29,41,51,0,91,1,0,0,92,0,92,Sicilia,ITG1
2021-01-05,PF/BT,190928.0,HSP11 - AZ.OSP.UNIV.P.GIACCONE,SIC,30-39,39,44,0,80,3,0,0,83,0,83,Sicilia,ITG1
2021-01-05,PF/BT,190928.0,HSP11 - AZ.OSP.UNIV.P.GIACCONE,SIC,40-49,24,29,0,50,2,0,1,53,0,53,Sicilia,ITG1
2021-01-05,PF/BT,190928.0,HSP11 - AZ.OSP.UNIV.P.GIACCONE,SIC,50-59,39,26,0,60,4,0,1,65,0,65,Sicilia,ITG1
2021-01-05,PF/BT,190928.0,HSP11 - AZ.OSP.UNIV.P.GIACCONE,SIC,60-69,23,6,0,28,1,0,0,29,0,29,Sicilia,ITG1
2021-01-05,PF/BT,190928.0,HSP11 - AZ.OSP.UNIV.P.GIACCONE,SIC,70-79,2,2,0,3,0,0,1,4,0,4,Sicilia,ITG1
2021-01-05,PF/BT,190928.0,HSP11 - AZ.OSP.UNIV.P.GIACCONE,SIC,80-89,1,0,0,1,0,0,0,1,0,1,Sicilia,ITG1
2021-01-05,PF/BT,190928.0,HSP11 - AZ.OSP.UNIV.P.GIACCONE,SIC,90+,1,0,0,0,0,0,1,1,0,1,Sicilia,ITG1
2021-01-05,PF/BT,190929.0,STS11 - IRCCS Ismett,SIC,20-29,6,8,0,10,4,0,0,14,0,14,Sicilia,ITG1
2021-01-05,PF/BT,190929.0,STS11 - IRCCS Ismett,SIC,30-39,6,12,0,13,5,0,0,18,0,18,Sicilia,ITG1
2021-01-05,PF/BT,190929.0,STS11 - IRCCS Ismett,SIC,40-49,21,35,0,29,27,0,0,56,0,56,Sicilia,ITG1
2021-01-05,PF/BT,190929.0,STS11 - IRCCS Ismett,SIC,50-59,19,25,0,13,31,0,0,44,0,44,Sicilia,ITG1
2021-01-05,PF/BT,190929.0,STS11 - IRCCS Ismett,SIC,60-69,3,2,0,1,4,0,0,5,0,5,Sicilia,ITG1
2021-01-05,PF/BT,190929.0,STS11 - IRCCS Ismett,SIC,70-79,1,0,0,0,1,0,0,1,0,1,Sicilia,ITG1
2021-01-05,PF/BT,190950.0,HSP11 - ASSOCIAZIONE OASI MARIA SS,SIC,20-29,0,1,0,1,0,0,0,1,0,1,Sicilia,ITG1
2021-01-05,PF/BT,190950.0,HSP11 - ASSOCIAZIONE OASI MARIA SS,SIC,30-39,5,2,0,6,0,0,1,7,0,7,Sicilia,ITG1
2021-01-05,PF/BT,190950.0,HSP11 - ASSOCIAZIONE OASI MARIA SS,SIC,40-49,6,5,0,9,0,0,2,11,0,11,Sicilia,ITG1
2021-01-05,PF/BT,190950.0,HSP11 - ASSOCIAZIONE OASI MARIA SS,SIC,50-59,9,14,0,21,0,0,2,23,0,23,Sicilia,ITG1
2021-01-05,PF/BT,190950.0,HSP11 - ASSOCIAZIONE OASI MARIA SS,SIC,60-69,2,6,0,7,0,0,1,8,0,8,Sicilia,ITG1
2021-01-05,PF/BT,190950.0,HSP11 - ASSOCIAZIONE OASI MARIA SS,SIC,70-79,0,1,0,0,0,0,1,1,0,1,Sicilia,ITG1
2021-01-05,PF/BT,19096001.0,HSP11 - IRCCS Centro Neurolesi,SIC,20-29,4,4,0,8,0,0,0,8,0,8,Sicilia,ITG1
2021-01-05,PF/BT,19096001.0,HSP11 - IRCCS Centro Neurolesi,SIC,30-39,10,19,0,29,0,0,0,29,0,29,Sicilia,ITG1
2021-01-05,PF/BT,19096001.0,HSP11 - IRCCS Centro Neurolesi,SIC,40-49,7,16,0,23,0,0,0,23,0,23,Sicilia,ITG1
2021-01-05,PF/BT,19096001.0,HSP11 - IRCCS Centro Neurolesi,SIC,50-59,7,15,0,21,0,0,1,22,0,22,Sicilia,ITG1
2021-01-05,PF/BT,19096001.0,HSP11 - IRCCS Centro Neurolesi,SIC,60-69,0,1,0,1,0,0,0,1,0,1,Sicilia,ITG1
2021-01-05,PF/BT,19096002.0,HSP11 - PRESIDIO OSPEDALIERO PIEMONTE,SIC,20-29,0,3,0,2,0,0,1,3,0,3,Sicilia,ITG1
2021-01-05,PF/BT,19096002.0,HSP11 - PRESIDIO OSPEDALIERO PIEMONTE,SIC,30-39,7,12,0,13,0,0,6,19,0,19,Sicilia,ITG1
2021-01-05,PF/BT,19096002.0,HSP11 - PRESIDIO OSPEDALIERO PIEMONTE,SIC,40-49,17,21,0,28,0,0,10,38,0,38,Sicilia,ITG1
2021-01-05,PF/BT,19096002.0,HSP11 - PRESIDIO OSPEDALIERO PIEMONTE,SIC,50-59,12,25,0,31,0,0,6,37,0,37,Sicilia,ITG1
2021-01-05,PF/BT,19096002.0,HSP11 - PRESIDIO OSPEDALIERO PIEMONTE,SIC,60-69,17,12,0,25,0,0,4,29,0,29,Sicilia,ITG1
2021-01-05,PF/BT,606000.0,STS11 - R. S. A. LEONFORTE,SIC,20-29,2,1,0,3,0,0,0,3,0,3,Sicilia,ITG1
2021-01-05,PF/BT,606000.0,STS11 - R. S. A. LEONFORTE,SIC,30-39,7,0,0,7,0,0,0,7,0,7,Sicilia,ITG1
2021-01-05,PF/BT,606000.0,STS11 - R. S. A. LEONFORTE,SIC,40-49,2,4,0,6,0,0,0,6,0,6,Sicilia,ITG1
2021-01-05,PF/BT,606000.0,STS11 - R. S. A. LEONFORTE,SIC,50-59,5,7,0,12,0,0,0,12,0,12,Sicilia,ITG1
2021-01-05,PF/BT,606000.0,STS11 - R. S. A. LEONFORTE,SIC,60-69,4,1,0,3,0,2,0,5,0,5,Sicilia,ITG1
2021-01-05,PF/BT,606000.0,STS11 - R. S. A. LEONFORTE,SIC,70-79,3,3,0,1,0,5,0,6,0,6,Sicilia,ITG1
2021-01-05,PF/BT,606000.0,STS11 - R. S. A. LEONFORTE,SIC,80-89,2,11,0,0,0,13,0,13,0,13,Sicilia,ITG1
2021-01-05,PF/BT,606000.0,STS11 - R. S. A. LEONFORTE,SIC,90+,0,1,0,0,0,1,0,1,0,1,Sicilia,ITG1
2021-01-05,PF/BT,607500.0,STS11 - R. S. A. Villa Maria - SALUSTRA s.r.l.,SIC,20-29,1,2,0,3,0,0,0,3,0,3,Sicilia,ITG1
2021-01-05,PF/BT,607500.0,STS11 - R. S. A. Villa Maria - SALUSTRA s.r.l.,SIC,30-39,2,5,0,7,0,0,0,7,0,7,Sicilia,ITG1
2021-01-05,PF/BT,607500.0,STS11 - R. S. A. Villa Maria - SALUSTRA s.r.l.,SIC,40-49,2,5,0,7,0,0,0,7,0,7,Sicilia,ITG1
2021-01-05,PF/BT,607500.0,STS11 - R. S. A. Villa Maria - SALUSTRA s.r.l.,SIC,50-59,4,5,0,8,0,1,0,9,0,9,Sicilia,ITG1
2021-01-05,PF/BT,607500.0,STS11 - R. S. A. Villa Maria - SALUSTRA s.r.l.,SIC,60-69,1,5,0,6,0,0,0,6,0,6,Sicilia,ITG1
2021-01-05,PF/BT,607500.0,STS11 - R. S. A. Villa Maria - SALUSTRA s.r.l.,SIC,70-79,3,0,0,1,0,2,0,3,0,3,Sicilia,ITG1
2021-01-05,PF/BT,607500.0,STS11 - R. S. A. Villa Maria - SALUSTRA s.r.l.,SIC,80-89,1,6,0,0,0,7,0,7,0,7,Sicilia,ITG1
2021-01-05,PF/BT,608200.0,STS11 - POLIAMBULATORIO San Giorgio,SIC,20-29,7,6,0,13,0,0,0,13,0,13,Sicilia,ITG1
2021-01-05,PF/BT,608200.0,STS11 - POLIAMBULATORIO San Giorgio,SIC,30-39,1,2,0,3,0,0,0,3,0,3,Sicilia,ITG1
2021-01-05,PF/BT,608200.0,STS11 - POLIAMBULATORIO San Giorgio,SIC,40-49,1,2,0,3,0,0,0,3,0,3,Sicilia,ITG1
2021-01-05,PF/BT,608200.0,STS11 - POLIAMBULATORIO San Giorgio,SIC,50-59,1,5,0,6,0,0,0,6,0,6,Sicilia,ITG1
2021-01-05,PF/BT,608200.0,STS11 - POLIAMBULATORIO San Giorgio,SIC,60-69,2,8,0,10,0,0,0,10,0,10,Sicilia,ITG1
2021-01-05,PF/BT,608200.0,STS11 - POLIAMBULATORIO San Giorgio,SIC,70-79,0,1,0,1,0,0,0,1,0,1,Sicilia,ITG1
2021-01-05,PF/BT,820800.0,STS11 - RSA BONIFATO,SIC,30-39,0,2,0,1,0,0,1,2,0,2,Sicilia,ITG1
2021-01-05,PF/BT,820800.0,STS11 - RSA BONIFATO,SIC,40-49,0,2,0,1,0,0,1,2,0,2,Sicilia,ITG1
2021-01-05,PF/BT,829100.0,STS11 - OPUS RESIDENTIAL S.R.L.,SIC,20-29,6,4,0,9,0,1,0,10,0,10,Sicilia,ITG1
2021-01-05,PF/BT,829100.0,STS11 - OPUS RESIDENTIAL S.R.L.,SIC,30-39,7,3,0,8,0,2,0,10,0,10,Sicilia,ITG1
2021-01-05,PF/BT,829100.0,STS11 - OPUS RESIDENTIAL S.R.L.,SIC,40-49,8,3,0,11,0,0,0,11,0,11,Sicilia,ITG1
2021-01-05,PF/BT,829100.0,STS11 - OPUS RESIDENTIAL S.R.L.,SIC,50-59,1,7,0,7,0,1,0,8,0,8,Sicilia,ITG1
2021-01-05,PF/BT,829100.0,STS11 - OPUS RESIDENTIAL S.R.L.,SIC,60-69,3,2,0,2,0,3,0,5,0,5,Sicilia,ITG1
2021-01-05,PF/BT,829100.0,STS11 - OPUS RESIDENTIAL S.R.L.,SIC,70-79,3,6,0,0,0,9,0,9,0,9,Sicilia,ITG1
2021-01-05,PF/BT,829100.0,STS11 - OPUS RESIDENTIAL S.R.L.,SIC,80-89,1,12,0,0,0,13,0,13,0,13,Sicilia,ITG1
2021-01-05,PF/BT,829100.0,STS11 - OPUS RESIDENTIAL S.R.L.,SIC,90+,0,5,0,0,0,5,0,5,0,5,Sicilia,ITG1
2021-01-05,PF/BT,831700.0,STS11 - RSA IL TULIPANO,SIC,20-29,2,2,0,4,0,0,0,4,0,4,Sicilia,ITG1
2021-01-05,PF/BT,831700.0,STS11 - RSA IL TULIPANO,SIC,30-39,1,1,0,2,0,0,0,2,0,2,Sicilia,ITG1
2021-01-05,PF/BT,831700.0,STS11 - RSA IL TULIPANO,SIC,40-49,3,6,0,9,0,0,0,9,0,9,Sicilia,ITG1
2021-01-05,PF/BT,831700.0,STS11 - RSA IL TULIPANO,SIC,50-59,0,3,0,3,0,0,0,3,0,3,Sicilia,ITG1
2021-01-05,PF/BT,831700.0,STS11 - RSA IL TULIPANO,SIC,60-69,1,1,0,2,0,0,0,2,0,2,Sicilia,ITG1
2021-01-05,PF/BT,831700.0,STS11 - RSA IL TULIPANO,SIC,70-79,0,1,0,0,0,1,0,1,0,1,Sicilia,ITG1
2021-01-05,PF/BT,831700.0,STS11 - RSA IL TULIPANO,SIC,80-89,1,2,0,0,0,3,0,3,0,3,Sicilia,ITG1
2021-01-05,PF/BT,831700.0,STS11 - RSA IL TULIPANO,SIC,90+,0,1,0,0,0,1,0,1,0,1,Sicilia,ITG1
2021-01-06,PF/BT,1902037.0,STRUTTURE PRIVATE NON CODIFICATE NSIS,SIC,20-29,2,3,0,2,3,0,0,5,0,5,Sicilia,ITG1
2021-01-06,PF/BT,1902037.0,STRUTTURE PRIVATE NON CODIFICATE NSIS,SIC,30-39,6,3,0,6,3,0,0,9,0,9,Sicilia,ITG1
2021-01-06,PF/BT,1902037.0,STRUTTURE PRIVATE NON CODIFICATE NSIS,SIC,40-49,5,6,0,6,1,0,4,11,0,11,Sicilia,ITG1
2021-01-06,PF/BT,1902037.0,STRUTTURE PRIVATE NON CODIFICATE NSIS,SIC,50-59,9,6,0,6,2,0,7,15,0,15,Sicilia,ITG1
2021-01-06,PF/BT,1902037.0,STRUTTURE PRIVATE NON CODIFICATE NSIS,SIC,60-69,2,6,0,2,1,0,5,8,0,8,Sicilia,ITG1
2021-01-06,PF/BT,1902037.0,STRUTTURE PRIVATE NON CODIFICATE NSIS,SIC,70-79,1,1,0,1,0,0,1,2,0,2,Sicilia,ITG1
2021-01-06,PF/BT,1902037.0,STRUTTURE PRIVATE NON CODIFICATE NSIS,SIC,80-89,1,2,0,1,0,0,2,3,0,3,Sicilia,ITG1
2021-01-06,PF/BT,1902057.0,STRUTTURE PRIVATE NON CODIFICATE NSIS,SIC,16-19,1,0,0,0,0,0,1,1,0,1,Sicilia,ITG1
2021-01-06,PF/BT,1902057.0,STRUTTURE PRIVATE NON CODIFICATE NSIS,SIC,20-29,6,4,0,9,0,0,1,10,0,10,Sicilia,ITG1
2021-01-06,PF/BT,1902057.0,STRUTTURE PRIVATE NON CODIFICATE NSIS,SIC,30-39,5,4,0,8,1,0,0,9,0,9,Sicilia,ITG1
2021-01-06,PF/BT,1902057.0,STRUTTURE PRIVATE NON CODIFICATE NSIS,SIC,40-49,15,19,0,32,2,0,0,34,0,34,Sicilia,ITG1
2021-01-06,PF/BT,1902057.0,STRUTTURE PRIVATE NON CODIFICATE NSIS,SIC,50-59,21,21,0,38,1,0,3,42,0,42,Sicilia,ITG1
2021-01-06,PF/BT,1902057.0,STRUTTURE PRIVATE NON CODIFICATE NSIS,SIC,60-69,35,16,0,51,0,0,0,51,0,51,Sicilia,ITG1
2021-01-06,PF/BT,1902057.0,STRUTTURE PRIVATE NON CODIFICATE NSIS,SIC,70-79,1,0,0,0,0,0,1,1,0,1,Sicilia,ITG1
2021-01-06,PF/BT,1902072.0,AMBULATORI VACCINALI NON CODIFICATI NSIS,SIC,20-29,5,11,0,11,0,0,5,16,0,16,Sicilia,ITG1
2021-01-06,PF/BT,1902072.0,AMBULATORI VACCINALI NON CODIFICATI NSIS,SIC,30-39,15,29,0,22,1,0,21,44,0,44,Sicilia,ITG1
2021-01-06,PF/BT,1902072.0,AMBULATORI VACCINALI NON CODIFICATI NSIS,SIC,40-49,11,24,0,20,2,0,13,35,0,35,Sicilia,ITG1
2021-01-06,PF/BT,1902072.0,AMBULATORI VACCINALI NON CODIFICATI NSIS,SIC,50-59,31,33,0,41,4,0,19,64,0,64,Sicilia,ITG1
2021-01-06,PF/BT,1902072.0,AMBULATORI VACCINALI NON CODIFICATI NSIS,SIC,60-69,108,47,0,135,5,0,15,155,0,155,Sicilia,ITG1
2021-01-06,PF/BT,1902072.0,AMBULATORI VACCINALI NON CODIFICATI NSIS,SIC,70-79,11,2,0,10,0,0,3,13,0,13,Sicilia,ITG1
2021-01-06,PF/BT,1902072.0,AMBULATORI VACCINALI NON CODIFICATI NSIS,SIC,80-89,2,1,0,3,0,0,0,3,0,3,Sicilia,ITG1
2021-01-06,PF/BT,190301.0,RIA11 - A.I.A.S.SEZ.DI AGRIGENTO ONLUS,SIC,20-29,21,15,0,28,0,0,8,36,0,36,Sicilia,ITG1
2021-01-06,PF/BT,190301.0,RIA11 - A.I.A.S.SEZ.DI AGRIGENTO ONLUS,SIC,30-39,32,27,0,57,0,0,2,59,0,59,Sicilia,ITG1
2021-01-06,PF/BT,190301.0,RIA11 - A.I.A.S.SEZ.DI AGRIGENTO ONLUS,SIC,40-49,35,22,0,55,1,0,1,57,0,57,Sicilia,ITG1
2021-01-06,PF/BT,190301.0,RIA11 - A.I.A.S.SEZ.DI AGRIGENTO ONLUS,SIC,50-59,47,39,0,80,0,0,6,86,0,86,Sicilia,ITG1
2021-01-06,PF/BT,190301.0,RIA11 - A.I.A.S.SEZ.DI AGRIGENTO ONLUS,SIC,60-69,73,28,0,100,0,0,1,101,0,101,Sicilia,ITG1
2021-01-06,PF/BT,190301.0,RIA11 - A.I.A.S.SEZ.DI AGRIGENTO ONLUS,SIC,70-79,8,1,0,9,0,0,0,9,0,9,Sicilia,ITG1
2021-01-06,PF/BT,190302.0,RIA11 - C.DELLA SPERANZA DON ANGELO G.,SIC,20-29,0,1,0,1,0,0,0,1,0,1,Sicilia,ITG1
2021-01-06,PF/BT,190302.0,RIA11 - C.DELLA SPERANZA DON ANGELO G.,SIC,30-39,4,3,0,7,0,0,0,7,0,7,Sicilia,ITG1
2021-01-06,PF/BT,190302.0,RIA11 - C.DELLA SPERANZA DON ANGELO G.,SIC,40-49,4,5,0,9,0,0,0,9,0,9,Sicilia,ITG1
2021-01-06,PF/BT,190302.0,RIA11 - C.DELLA SPERANZA DON ANGELO G.,SIC,50-59,23,11,0,32,0,0,2,34,0,34,Sicilia,ITG1
2021-01-06,PF/BT,190302.0,RIA11 - C.DELLA SPERANZA DON ANGELO G.,SIC,60-69,32,16,0,48,0,0,0,48,0,48,Sicilia,ITG1
2021-01-06,PF/BT,190302.0,RIA11 - C.DELLA SPERANZA DON ANGELO G.,SIC,70-79,2,0,0,2,0,0,0,2,0,2,Sicilia,ITG1
2021-01-06,PF/BT,190302.0,RIA11 - C.DELLA SPERANZA DON ANGELO G.,SIC,80-89,0,1,0,0,0,0,1,1,0,1,Sicilia,ITG1
2021-01-06,PF/BT,190303.0,RIA11 - COMUNITA` DELLA SPERANZA,SIC,20-29,1,0,0,1,0,0,0,1,0,1,Sicilia,ITG1
2021-01-06,PF/BT,190303.0,RIA11 - COMUNITA` DELLA SPERANZA,SIC,30-39,0,2,0,2,0,0,0,2,0,2,Sicilia,ITG1
2021-01-06,PF/BT,190303.0,RIA11 - COMUNITA` DELLA SPERANZA,SIC,40-49,1,4,0,3,2,0,0,5,0,5,Sicilia,ITG1
2021-01-06,PF/BT,190303.0,RIA11 - COMUNITA` DELLA SPERANZA,SIC,50-59,2,7,0,7,2,0,0,9,0,9,Sicilia,ITG1
2021-01-06,PF/BT,190303.0,RIA11 - COMUNITA` DELLA SPERANZA,SIC,60-69,7,0,0,5,2,0,0,7,0,7,Sicilia,ITG1
2021-01-06,PF/BT,190305.0,HSP11 - P.O. GIOVANNI PAOLO II,SIC,20-29,3,4,0,7,0,0,0,7,0,7,Sicilia,ITG1
2021-01-06,PF/BT,190305.0,HSP11 - P.O. GIOVANNI PAOLO II,SIC,30-39,8,5,0,13,0,0,0,13,0,13,Sicilia,ITG1
2021-01-06,PF/BT,190305.0,HSP11 - P.O. GIOVANNI PAOLO II,SIC,40-49,9,12,0,19,2,0,0,21,0,21,Sicilia,ITG1
2021-01-06,PF/BT,190305.0,HSP11 - P.O. GIOVANNI PAOLO II,SIC,50-59,19,23,0,35,7,0,0,42,0,42,Sicilia,ITG1
2021-01-06,PF/BT,190305.0,HSP11 - P.O. GIOVANNI PAOLO II,SIC,60-69,23,18,0,40,1,0,0,41,0,41,Sicilia,ITG1
2021-01-06,PF/BT,190306.0,RIA11 - ASS. CASA FAM.ROSETTA ONILUS,SIC,16-19,1,0,0,1,0,0,0,1,0,1,Sicilia,ITG1
2021-01-06,PF/BT,190306.0,RIA11 - ASS. CASA FAM.ROSETTA ONILUS,SIC,20-29,16,15,0,28,3,0,0,31,0,31,Sicilia,ITG1
2021-01-06,PF/BT,190306.0,RIA11 - ASS. CASA FAM.ROSETTA ONILUS,SIC,30-39,25,25,0,48,0,0,2,50,0,50,Sicilia,ITG1
2021-01-06,PF/BT,190306.0,RIA11 - ASS. CASA FAM.ROSETTA ONILUS,SIC,40-49,40,23,0,51,10,0,2,63,0,63,Sicilia,ITG1
2021-01-06,PF/BT,190306.0,RIA11 - ASS. CASA FAM.ROSETTA ONILUS,SIC,50-59,45,56,0,72,28,0,1,101,0,101,Sicilia,ITG1
2021-01-06,PF/BT,190306.0,RIA11 - ASS. CASA FAM.ROSETTA ONILUS,SIC,60-69,46,27,0,60,11,0,2,73,0,73,Sicilia,ITG1
2021-01-06,PF/BT,190306.0,RIA11 - ASS. CASA FAM.ROSETTA ONILUS,SIC,70-79,14,1,0,15,0,0,0,15,0,15,Sicilia,ITG1
2021-01-06,PF/BT,190306.0,RIA11 - ASS. CASA FAM.ROSETTA ONILUS,SIC,80-89,1,0,0,1,0,0,0,1,0,1,Sicilia,ITG1
2021-01-06,PF/BT,190309.0,HSP11 - P.O. VITTORIO EMANUELE (ex AO),SIC,20-29,3,7,0,9,0,0,1,10,0,10,Sicilia,ITG1
2021-01-06,PF/BT,190309.0,HSP11 - P.O. VITTORIO EMANUELE (ex AO),SIC,30-39,4,5,0,8,0,0,1,9,0,9,Sicilia,ITG1
2021-01-06,PF/BT,190309.0,HSP11 - P.O. VITTORIO EMANUELE (ex AO),SIC,40-49,14,4,0,16,0,0,2,18,0,18,Sicilia,ITG1
2021-01-06,PF/BT,190309.0,HSP11 - P.O. VITTORIO EMANUELE (ex AO),SIC,50-59,24,12,0,35,0,0,1,36,0,36,Sicilia,ITG1
2021-01-06,PF/BT,190309.0,HSP11 - P.O. VITTORIO EMANUELE (ex AO),SIC,60-69,24,10,0,31,0,0,3,34,0,34,Sicilia,ITG1
2021-01-06,PF/BT,190312.0,HSP11 - P.O. S. Marta e S. Venera Acireale,SIC,16-19,1,0,0,0,1,0,0,1,0,1,Sicilia,ITG1
2021-01-06,PF/BT,190312.0,HSP11 - P.O. S. Marta e S. Venera Acireale,SIC,20-29,1,1,0,2,0,0,0,2,0,2,Sicilia,ITG1
2021-01-06,PF/BT,190312.0,HSP11 - P.O. S. Marta e S. Venera Acireale,SIC,30-39,10,11,0,16,5,0,0,21,0,21,Sicilia,ITG1
2021-01-06,PF/BT,190312.0,HSP11 - P.O. S. Marta e S. Venera Acireale,SIC,40-49,13,16,0,27,2,0,0,29,0,29,Sicilia,ITG1
2021-01-06,PF/BT,190312.0,HSP11 - P.O. S. Marta e S. Venera Acireale,SIC,50-59,15,17,0,32,0,0,0,32,0,32,Sicilia,ITG1
2021-01-06,PF/BT,190312.0,HSP11 - P.O. S. Marta e S. Venera Acireale,SIC,60-69,31,21,0,49,3,0,0,52,0,52,Sicilia,ITG1
2021-01-06,PF/BT,190312.0,HSP11 - P.O. S. Marta e S. Venera Acireale,SIC,70-79,6,0,0,6,0,0,0,6,0,6,Sicilia,ITG1
2021-01-06,PF/BT,190312.0,HSP11 - P.O. S. Marta e S. Venera Acireale,SIC,90+,0,1,0,1,0,0,0,1,0,1,Sicilia,ITG1
2021-01-06,PF/BT,190313.0,RIA11 - IST.RIAB.VILLAG. SAN GIUSEPPE,SIC,20-29,6,7,0,10,0,0,3,13,0,13,Sicilia,ITG1
2021-01-06,PF/BT,190313.0,RIA11 - IST.RIAB.VILLAG. SAN GIUSEPPE,SIC,30-39,10,10,0,16,1,0,3,20,0,20,Sicilia,ITG1
2021-01-06,PF/BT,190313.0,RIA11 - IST.RIAB.VILLAG. SAN GIUSEPPE,SIC,40-49,9,13,0,22,0,0,0,22,0,22,Sicilia,ITG1
2021-01-06,PF/BT,190313.0,RIA11 - IST.RIAB.VILLAG. SAN GIUSEPPE,SIC,50-59,19,21,0,35,0,0,5,40,0,40,Sicilia,ITG1
2021-01-06,PF/BT,190313.0,RIA11 - IST.RIAB.VILLAG. SAN GIUSEPPE,SIC,60-69,36,15,0,49,1,0,1,51,0,51,Sicilia,ITG1
2021-01-06,PF/BT,190313.0,RIA11 - IST.RIAB.VILLAG. SAN GIUSEPPE,SIC,70-79,3,0,0,3,0,0,0,3,0,3,Sicilia,ITG1
2021-01-06,PF/BT,190313.0,RIA11 - IST.RIAB.VILLAG. SAN GIUSEPPE,SIC,80-89,0,1,0,1,0,0,0,1,0,1,Sicilia,ITG1
2021-01-06,PF/BT,190314.0,RIA11 - ASS.J.F.KENNEDY ACIREALE,SIC,16-19,1,2,0,3,0,0,0,3,0,3,Sicilia,ITG1
2021-01-06,PF/BT,190314.0,RIA11 - ASS.J.F.KENNEDY ACIREALE,SIC,20-29,6,7,0,13,0,0,0,13,0,13,Sicilia,ITG1
2021-01-06,PF/BT,190314.0,RIA11 - ASS.J.F.KENNEDY ACIREALE,SIC,30-39,10,26,0,36,0,0,0,36,0,36,Sicilia,ITG1
2021-01-06,PF/BT,190314.0,RIA11 - ASS.J.F.KENNEDY ACIREALE,SIC,40-49,17,17,0,34,0,0,0,34,0,34,Sicilia,ITG1
2021-01-06,PF/BT,190314.0,RIA11 - ASS.J.F.KENNEDY ACIREALE,SIC,50-59,18,18,0,36,0,0,0,36,0,36,Sicilia,ITG1
2021-01-06,PF/BT,190314.0,RIA11 - ASS.J.F.KENNEDY ACIREALE,SIC,60-69,15,10,0,25,0,0,0,25,0,25,Sicilia,ITG1
2021-01-06,PF/BT,190314.0,RIA11 - ASS.J.F.KENNEDY ACIREALE,SIC,70-79,2,1,0,3,0,0,0,3,0,3,Sicilia,ITG1
2021-01-06,PF/BT,190315.0,RIA11 - AIAS SEZ. ACIREALE,SIC,16-19,1,2,0,3,0,0,0,3,0,3,Sicilia,ITG1
2021-01-06,PF/BT,190315.0,RIA11 - AIAS SEZ. ACIREALE,SIC,20-29,6,17,0,23,0,0,0,23,0,23,Sicilia,ITG1
2021-01-06,PF/BT,190315.0,RIA11 - AIAS SEZ. ACIREALE,SIC,30-39,8,13,0,21,0,0,0,21,0,21,Sicilia,ITG1
2021-01-06,PF/BT,190315.0,RIA11 - AIAS SEZ. ACIREALE,SIC,40-49,13,21,0,34,0,0,0,34,0,34,Sicilia,ITG1
2021-01-06,PF/BT,190315.0,RIA11 - AIAS SEZ. ACIREALE,SIC,50-59,9,17,0,26,0,0,0,26,0,26,Sicilia,ITG1
2021-01-06,PF/BT,190315.0,RIA11 - AIAS SEZ. ACIREALE,SIC,60-69,14,13,0,27,0,0,0,27,0,27,Sicilia,ITG1
2021-01-06,PF/BT,190315.0,RIA11 - AIAS SEZ. ACIREALE,SIC,70-79,4,0,0,4,0,0,0,4,0,4,Sicilia,ITG1
2021-01-06,PF/BT,190316.0,RIA11 - ASS.J.F.KENNEDY - C.RIAB.ONLUS,SIC,16-19,0,1,0,0,1,0,0,1,0,1,Sicilia,ITG1
2021-01-06,PF/BT,190316.0,RIA11 - ASS.J.F.KENNEDY - C.RIAB.ONLUS,SIC,20-29,8,15,0,18,5,0,0,23,0,23,Sicilia,ITG1
2021-01-06,PF/BT,190316.0,RIA11 - ASS.J.F.KENNEDY - C.RIAB.ONLUS,SIC,30-39,14,10,0,21,3,0,0,24,0,24,Sicilia,ITG1
2021-01-06,PF/BT,190316.0,RIA11 - ASS.J.F.KENNEDY - C.RIAB.ONLUS,SIC,40-49,11,13,0,16,8,0,0,24,0,24,Sicilia,ITG1
2021-01-06,PF/BT,190316.0,RIA11 - ASS.J.F.KENNEDY - C.RIAB.ONLUS,SIC,50-59,6,11,0,10,7,0,0,17,0,17,Sicilia,ITG1
2021-01-06,PF/BT,190316.0,RIA11 - ASS.J.F.KENNEDY - C.RIAB.ONLUS,SIC,60-69,26,7,0,31,2,0,0,33,0,33,Sicilia,ITG1
2021-01-06,PF/BT,190316.0,RIA11 - ASS.J.F.KENNEDY - C.RIAB.ONLUS,SIC,70-79,7,0,0,7,0,0,0,7,0,7,Sicilia,ITG1
2021-01-06,PF/BT,190316.0,RIA11 - ASS.J.F.KENNEDY - C.RIAB.ONLUS,SIC,80-89,3,0,0,3,0,0,0,3,0,3,Sicilia,ITG1
2021-01-06,PF/BT,190317.0,HSP11 - P.O. Gravina e S. Pietro Caltagirone,SIC,20-29,3,2,0,4,1,0,0,5,0,5,Sicilia,ITG1
2021-01-06,PF/BT,190317.0,HSP11 - P.O. Gravina e S. Pietro Caltagirone,SIC,30-39,8,15,0,15,8,0,0,23,0,23,Sicilia,ITG1
2021-01-06,PF/BT,190317.0,HSP11 - P.O. Gravina e S. Pietro Caltagirone,SIC,40-49,8,8,0,11,5,0,0,16,0,16,Sicilia,ITG1
2021-01-06,PF/BT,190317.0,HSP11 - P.O. Gravina e S. Pietro Caltagirone,SIC,50-59,12,14,0,19,7,0,0,26,0,26,Sicilia,ITG1
2021-01-06,PF/BT,190317.0,HSP11 - P.O. Gravina e S. Pietro Caltagirone,SIC,60-69,13,5,0,17,1,0,0,18,0,18,Sicilia,ITG1
2021-01-06,PF/BT,190317.0,HSP11 - P.O. Gravina e S. Pietro Caltagirone,SIC,70-79,2,0,0,2,0,0,0,2,0,2,Sicilia,ITG1
2021-01-06,PF/BT,190318.0,RIA11 - ASS.ISTITUTO REGINA VIRGINUM,SIC,20-29,5,3,0,7,0,0,1,8,0,8,Sicilia,ITG1
2021-01-06,PF/BT,190318.0,RIA11 - ASS.ISTITUTO REGINA VIRGINUM,SIC,30-39,12,3,0,12,1,0,2,15,0,15,Sicilia,ITG1
2021-01-06,PF/BT,190318.0,RIA11 - ASS.ISTITUTO REGINA VIRGINUM,SIC,40-49,3,12,0,11,0,0,4,15,0,15,Sicilia,ITG1
2021-01-06,PF/BT,190318.0,RIA11 - ASS.ISTITUTO REGINA VIRGINUM,SIC,50-59,3,2,0,3,1,0,1,5,0,5,Sicilia,ITG1
2021-01-06,PF/BT,190318.0,RIA11 - ASS.ISTITUTO REGINA VIRGINUM,SIC,60-69,9,2,0,11,0,0,0,11,0,11,Sicilia,ITG1
2021-01-06,PF/BT,190319.0,HSP11 - P. O. UMBERTO I,SIC,20-29,4,2,0,6,0,0,0,6,0,6,Sicilia,ITG1
2021-01-06,PF/BT,190319.0,HSP11 - P. O. UMBERTO I,SIC,30-39,2,5,0,7,0,0,0,7,0,7,Sicilia,ITG1
2021-01-06,PF/BT,190319.0,HSP11 - P. O. UMBERTO I,SIC,40-49,15,12,0,25,0,0,2,27,0,27,Sicilia,ITG1
2021-01-06,PF/BT,190319.0,HSP11 - P. O. UMBERTO I,SIC,50-59,10,11,0,21,0,0,0,21,0,21,Sicilia,ITG1
2021-01-06,PF/BT,190319.0,HSP11 - P. O. UMBERTO I,SIC,60-69,26,13,0,38,1,0,0,39,0,39,Sicilia,ITG1
2021-01-06,PF/BT,190319.0,HSP11 - P. O. UMBERTO I,SIC,70-79,1,1,0,2,0,0,0,2,0,2,Sicilia,ITG1
2021-01-06,PF/BT,190322.0,HSP11 - P. O. CARLO BASILOTTA,SIC,20-29,0,1,0,1,0,0,0,1,0,1,Sicilia,ITG1
2021-01-06,PF/BT,190322.0,HSP11 - P. O. CARLO BASILOTTA,SIC,30-39,3,2,0,4,0,0,1,5,0,5,Sicilia,ITG1
2021-01-06,PF/BT,190322.0,HSP11 - P. O. CARLO BASILOTTA,SIC,40-49,6,3,0,9,0,0,0,9,0,9,Sicilia,ITG1
2021-01-06,PF/BT,190322.0,HSP11 - P. O. CARLO BASILOTTA,SIC,50-59,18,22,0,34,5,0,1,40,0,40,Sicilia,ITG1
2021-01-06,PF/BT,190322.0,HSP11 - P. O. CARLO BASILOTTA,SIC,60-69,14,9,0,17,6,0,0,23,0,23,Sicilia,ITG1
2021-01-06,PF/BT,190328.0,HSP11 - P.O. BARONE-ROMEO PATTI,SIC,20-29,0,1,0,1,0,0,0,1,0,1,Sicilia,ITG1
2021-01-06,PF/BT,190328.0,HSP11 - P.O. BARONE-ROMEO PATTI,SIC,30-39,13,14,0,27,0,0,0,27,0,27,Sicilia,ITG1
2021-01-06,PF/BT,190328.0,HSP11 - P.O. BARONE-ROMEO PATTI,SIC,40-49,12,27,0,39,0,0,0,39,0,39,Sicilia,ITG1
2021-01-06,PF/BT,190328.0,HSP11 - P.O. BARONE-ROMEO PATTI,SIC,50-59,23,43,0,61,4,0,1,66,0,66,Sicilia,ITG1
2021-01-06,PF/BT,190328.0,HSP11 - P.O. BARONE-ROMEO PATTI,SIC,60-69,20,16,0,32,3,0,1,36,0,36,Sicilia,ITG1
2021-01-06,PF/BT,190328.0,HSP11 - P.O. BARONE-ROMEO PATTI,SIC,70-79,1,0,0,0,0,0,1,1,0,1,Sicilia,ITG1
2021-01-06,PF/BT,190337.0,HSP11 - P.O. VILLA DELLE GINESTRE,SIC,20-29,5,7,0,12,0,0,0,12,0,12,Sicilia,ITG1
2021-01-06,PF/BT,190337.0,HSP11 - P.O. VILLA DELLE GINESTRE,SIC,30-39,16,11,0,21,4,0,2,27,0,27,Sicilia,ITG1
2021-01-06,PF/BT,190337.0,HSP11 - P.O. VILLA DELLE GINESTRE,SIC,40-49,32,17,0,27,21,0,1,49,0,49,Sicilia,ITG1
2021-01-06,PF/BT,190337.0,HSP11 - P.O. VILLA DELLE GINESTRE,SIC,50-59,45,50,0,63,32,0,0,95,0,95,Sicilia,ITG1
2021-01-06,PF/BT,190337.0,HSP11 - P.O. VILLA DELLE GINESTRE,SIC,60-69,72,31,0,100,3,0,0,103,0,103,Sicilia,ITG1
2021-01-06,PF/BT,190337.0,HSP11 - P.O. VILLA DELLE GINESTRE,SIC,70-79,16,4,0,20,0,0,0,20,0,20,Sicilia,ITG1
2021-01-06,PF/BT,190338.0,HSP11 - OSPEDALE Giovanni Paolo II° M.P. A.,SIC,20-29,6,14,0,18,1,0,1,20,0,20,Sicilia,ITG1
2021-01-06,PF/BT,190338.0,HSP11 - OSPEDALE Giovanni Paolo II° M.P. A.,SIC,30-39,13,29,0,37,4,0,1,42,0,42,Sicilia,ITG1
2021-01-06,PF/BT,190338.0,HSP11 - OSPEDALE Giovanni Paolo II° M.P. A.,SIC,40-49,29,37,0,61,5,0,0,66,0,66,Sicilia,ITG1
2021-01-06,PF/BT,190338.0,HSP11 - OSPEDALE Giovanni Paolo II° M.P. A.,SIC,50-59,35,47,0,78,4,0,0,82,0,82,Sicilia,ITG1
2021-01-06,PF/BT,190338.0,HSP11 - OSPEDALE Giovanni Paolo II° M.P. A.,SIC,60-69,39,19,0,54,3,0,1,58,0,58,Sicilia,ITG1
2021-01-06,PF/BT,190338.0,HSP11 - OSPEDALE Giovanni Paolo II° M.P. A.,SIC,70-79,1,0,0,1,0,0,0,1,0,1,Sicilia,ITG1
2021-01-06,PF/BT,190339.0,HSP11 - OSPEDALE REGINA MARGHERITA  COMISO,SIC,20-29,3,10,0,13,0,0,0,13,0,13,Sicilia,ITG1
2021-01-06,PF/BT,190339.0,HSP11 - OSPEDALE REGINA MARGHERITA  COMISO,SIC,30-39,13,4,0,14,0,0,3,17,0,17,Sicilia,ITG1
2021-01-06,PF/BT,190339.0,HSP11 - OSPEDALE REGINA MARGHERITA  COMISO,SIC,40-49,4,0,0,4,0,0,0,4,0,4,Sicilia,ITG1
2021-01-06,PF/BT,190339.0,HSP11 - OSPEDALE REGINA MARGHERITA  COMISO,SIC,50-59,3,7,0,8,1,0,1,10,0,10,Sicilia,ITG1
2021-01-06,PF/BT,190339.0,HSP11 - OSPEDALE REGINA MARGHERITA  COMISO,SIC,60-69,2,1,0,3,0,0,0,3,0,3,Sicilia,ITG1
2021-01-06,PF/BT,190340.0,HSP11 - OSPEDALE MAGGIORE MODICA,SIC,20-29,4,1,0,5,0,0,0,5,0,5,Sicilia,ITG1
2021-01-06,PF/BT,190340.0,HSP11 - OSPEDALE MAGGIORE MODICA,SIC,30-39,4,9,0,11,2,0,0,13,0,13,Sicilia,ITG1
2021-01-06,PF/BT,190340.0,HSP11 - OSPEDALE MAGGIORE MODICA,SIC,40-49,10,9,0,16,3,0,0,19,0,19,Sicilia,ITG1
2021-01-06,PF/BT,190340.0,HSP11 - OSPEDALE MAGGIORE MODICA,SIC,50-59,11,11,0,20,2,0,0,22,0,22,Sicilia,ITG1
2021-01-06,PF/BT,190340.0,HSP11 - OSPEDALE MAGGIORE MODICA,SIC,60-69,12,10,0,17,5,0,0,22,0,22,Sicilia,ITG1
2021-01-06,PF/BT,190341.0,HSP11 - OSPEDALE BUSACCA SCICLI,SIC,20-29,5,5,0,2,6,0,2,10,0,10,Sicilia,ITG1
2021-01-06,PF/BT,190341.0,HSP11 - OSPEDALE BUSACCA SCICLI,SIC,30-39,4,10,0,4,9,0,1,14,0,14,Sicilia,ITG1
2021-01-06,PF/BT,190341.0,HSP11 - OSPEDALE BUSACCA SCICLI,SIC,40-49,4,8,0,2,8,0,2,12,0,12,Sicilia,ITG1
2021-01-06,PF/BT,190341.0,HSP11 - OSPEDALE BUSACCA SCICLI,SIC,50-59,10,15,0,8,12,0,5,25,0,25,Sicilia,ITG1
2021-01-06,PF/BT,190341.0,HSP11 - OSPEDALE BUSACCA SCICLI,SIC,60-69,21,26,0,11,27,0,9,47,0,47,Sicilia,ITG1
2021-01-06,PF/BT,190341.0,HSP11 - OSPEDALE BUSACCA SCICLI,SIC,70-79,28,14,0,7,21,0,14,42,0,42,Sicilia,ITG1
2021-01-06,PF/BT,190341.0,HSP11 - OSPEDALE BUSACCA SCICLI,SIC,80-89,3,1,0,0,1,0,3,4,0,4,Sicilia,ITG1
2021-01-06,PF/BT,190342.0,HSP11 - OSPEDALE GUZZARDI VITTORIA,SIC,20-29,1,4,0,4,1,0,0,5,0,5,Sicilia,ITG1
2021-01-06,PF/BT,190342.0,HSP11 - OSPEDALE GUZZARDI VITTORIA,SIC,30-39,3,3,0,6,0,0,0,6,0,6,Sicilia,ITG1
2021-01-06,PF/BT,190342.0,HSP11 - OSPEDALE GUZZARDI VITTORIA,SIC,40-49,5,13,0,17,1,0,0,18,0,18,Sicilia,ITG1
2021-01-06,PF/BT,190342.0,HSP11 - OSPEDALE GUZZARDI VITTORIA,SIC,50-59,14,21,0,34,1,0,0,35,0,35,Sicilia,ITG1
2021-01-06,PF/BT,190342.0,HSP11 - OSPEDALE GUZZARDI VITTORIA,SIC,60-69,6,7,0,13,0,0,0,13,0,13,Sicilia,ITG1
2021-01-06,PF/BT,190343.0,HSP11 - P.O. DI MARIA AVOLA,SIC,20-29,1,1,0,2,0,0,0,2,0,2,Sicilia,ITG1
2021-01-06,PF/BT,190343.0,HSP11 - P.O. DI MARIA AVOLA,SIC,30-39,4,2,0,6,0,0,0,6,0,6,Sicilia,ITG1
2021-01-06,PF/BT,190343.0,HSP11 - P.O. DI MARIA AVOLA,SIC,40-49,14,11,0,25,0,0,0,25,0,25,Sicilia,ITG1
2021-01-06,PF/BT,190343.0,HSP11 - P.O. DI MARIA AVOLA,SIC,50-59,14,10,0,24,0,0,0,24,0,24,Sicilia,ITG1
2021-01-06,PF/BT,190343.0,HSP11 - P.O. DI MARIA AVOLA,SIC,60-69,10,4,0,14,0,0,0,14,0,14,Sicilia,ITG1
2021-01-06,PF/BT,190343.0,HSP11 - P.O. DI MARIA AVOLA,SIC,70-79,1,0,0,1,0,0,0,1,0,1,Sicilia,ITG1
2021-01-06,PF/BT,190345.0,HSP11 - P.O. UMBERTO I (EX A.O.),SIC,20-29,0,1,0,1,0,0,0,1,0,1,Sicilia,ITG1
2021-01-06,PF/BT,190345.0,HSP11 - P.O. UMBERTO I (EX A.O.),SIC,30-39,4,3,0,7,0,0,0,7,0,7,Sicilia,ITG1
2021-01-06,PF/BT,190345.0,HSP11 - P.O. UMBERTO I (EX A.O.),SIC,40-49,4,5,0,9,0,0,0,9,0,9,Sicilia,ITG1
2021-01-06,PF/BT,190345.0,HSP11 - P.O. UMBERTO I (EX A.O.),SIC,50-59,13,10,0,23,0,0,0,23,0,23,Sicilia,ITG1
2021-01-06,PF/BT,190345.0,HSP11 - P.O. UMBERTO I (EX A.O.),SIC,60-69,6,2,0,8,0,0,0,8,0,8,Sicilia,ITG1
2021-01-06,PF/BT,190346.0,HSP11 - P.O. MUSCATELLO AUGUSTA,SIC,20-29,0,1,0,1,0,0,0,1,0,1,Sicilia,ITG1
2021-01-06,PF/BT,190346.0,HSP11 - P.O. MUSCATELLO AUGUSTA,SIC,30-39,4,0,0,4,0,0,0,4,0,4,Sicilia,ITG1
2021-01-06,PF/BT,190346.0,HSP11 - P.O. MUSCATELLO AUGUSTA,SIC,40-49,3,5,0,8,0,0,0,8,0,8,Sicilia,ITG1
2021-01-06,PF/BT,190346.0,HSP11 - P.O. MUSCATELLO AUGUSTA,SIC,50-59,0,10,0,10,0,0,0,10,0,10,Sicilia,ITG1
2021-01-06,PF/BT,190346.0,HSP11 - P.O. MUSCATELLO AUGUSTA,SIC,60-69,1,0,0,1,0,0,0,1,0,1,Sicilia,ITG1
2021-01-06,PF/BT,190349.0,HSP11 - P.O. SAN VITO E SANTO SPIRITO -ALCAMO,SIC,20-29,5,6,0,5,0,0,6,11,0,11,Sicilia,ITG1
2021-01-06,PF/BT,190349.0,HSP11 - P.O. SAN VITO E SANTO SPIRITO -ALCAMO,SIC,30-39,7,10,0,12,2,0,3,17,0,17,Sicilia,ITG1
2021-01-06,PF/BT,190349.0,HSP11 - P.O. SAN VITO E SANTO SPIRITO -ALCAMO,SIC,40-49,7,13,0,13,0,0,7,20,0,20,Sicilia,ITG1
2021-01-06,PF/BT,190349.0,HSP11 - P.O. SAN VITO E SANTO SPIRITO -ALCAMO,SIC,50-59,10,4,0,8,0,0,6,14,0,14,Sicilia,ITG1
2021-01-06,PF/BT,190349.0,HSP11 - P.O. SAN VITO E SANTO SPIRITO -ALCAMO,SIC,60-69,8,6,0,10,0,0,4,14,0,14,Sicilia,ITG1
2021-01-06,PF/BT,190349.0,HSP11 - P.O. SAN VITO E SANTO SPIRITO -ALCAMO,SIC,70-79,2,0,0,2,0,0,0,2,0,2,Sicilia,ITG1
2021-01-06,PF/BT,190349.0,HSP11 - P.O. SAN VITO E SANTO SPIRITO -ALCAMO,SIC,80-89,1,1,0,0,0,0,2,2,0,2,Sicilia,ITG1
2021-01-06,PF/BT,190351.0,HSP11 - P.O. S. ANTONIO ABATE  - TRAPANI,SIC,20-29,5,9,0,14,0,0,0,14,0,14,Sicilia,ITG1
2021-01-06,PF/BT,190351.0,HSP11 - P.O. S. ANTONIO ABATE  - TRAPANI,SIC,30-39,12,9,0,18,3,0,0,21,0,21,Sicilia,ITG1
2021-01-06,PF/BT,190351.0,HSP11 - P.O. S. ANTONIO ABATE  - TRAPANI,SIC,40-49,18,17,0,35,0,0,0,35,0,35,Sicilia,ITG1
2021-01-06,PF/BT,190351.0,HSP11 - P.O. S. ANTONIO ABATE  - TRAPANI,SIC,50-59,21,15,0,32,4,0,0,36,0,36,Sicilia,ITG1
2021-01-06,PF/BT,190351.0,HSP11 - P.O. S. ANTONIO ABATE  - TRAPANI,SIC,60-69,25,11,0,35,1,0,0,36,0,36,Sicilia,ITG1
2021-01-06,PF/BT,190351.0,HSP11 - P.O. S. ANTONIO ABATE  - TRAPANI,SIC,70-79,5,0,0,5,0,0,0,5,0,5,Sicilia,ITG1
2021-01-06,PF/BT,190352.0,HSP11 - P.O. V.EMANUELE II CASTELVETRANO,SIC,16-19,1,0,0,0,0,0,1,1,0,1,Sicilia,ITG1
2021-01-06,PF/BT,190352.0,HSP11 - P.O. V.EMANUELE II CASTELVETRANO,SIC,20-29,1,13,0,9,1,0,4,14,0,14,Sicilia,ITG1
2021-01-06,PF/BT,190352.0,HSP11 - P.O. V.EMANUELE II CASTELVETRANO,SIC,30-39,4,2,0,5,0,0,1,6,0,6,Sicilia,ITG1
2021-01-06,PF/BT,190352.0,HSP11 - P.O. V.EMANUELE II CASTELVETRANO,SIC,40-49,9,14,0,9,4,0,10,23,0,23,Sicilia,ITG1
2021-01-06,PF/BT,190352.0,HSP11 - P.O. V.EMANUELE II CASTELVETRANO,SIC,50-59,9,12,0,12,5,0,4,21,0,21,Sicilia,ITG1
2021-01-06,PF/BT,190352.0,HSP11 - P.O. V.EMANUELE II CASTELVETRANO,SIC,60-69,10,7,0,15,1,0,1,17,0,17,Sicilia,ITG1
2021-01-06,PF/BT,190352.0,HSP11 - P.O. V.EMANUELE II CASTELVETRANO,SIC,70-79,1,1,0,0,0,0,2,2,0,2,Sicilia,ITG1
2021-01-06,PF/BT,190353.0,HSP11 - P.O.PAOLO BORSELLINO - MARSALA,SIC,20-29,8,6,0,14,0,0,0,14,0,14,Sicilia,ITG1
2021-01-06,PF/BT,190353.0,HSP11 - P.O.PAOLO BORSELLINO - MARSALA,SIC,30-39,8,7,0,15,0,0,0,15,0,15,Sicilia,ITG1
2021-01-06,PF/BT,190353.0,HSP11 - P.O.PAOLO BORSELLINO - MARSALA,SIC,40-49,5,10,0,15,0,0,0,15,0,15,Sicilia,ITG1
2021-01-06,PF/BT,190353.0,HSP11 - P.O.PAOLO BORSELLINO - MARSALA,SIC,50-59,16,17,0,33,0,0,0,33,0,33,Sicilia,ITG1
2021-01-06,PF/BT,190353.0,HSP11 - P.O.PAOLO BORSELLINO - MARSALA,SIC,60-69,36,15,0,51,0,0,0,51,0,51,Sicilia,ITG1
2021-01-06,PF/BT,190353.0,HSP11 - P.O.PAOLO BORSELLINO - MARSALA,SIC,70-79,3,1,0,4,0,0,0,4,0,4,Sicilia,ITG1
2021-01-06,PF/BT,190353.0,HSP11 - P.O.PAOLO BORSELLINO - MARSALA,SIC,80-89,1,0,0,1,0,0,0,1,0,1,Sicilia,ITG1
2021-01-06,PF/BT,190354.0,HSP11 - P.O.ABELE AJELLO-MAZARA D.VALLO,SIC,16-19,2,1,0,3,0,0,0,3,0,3,Sicilia,ITG1
2021-01-06,PF/BT,190354.0,HSP11 - P.O.ABELE AJELLO-MAZARA D.VALLO,SIC,20-29,8,7,0,15,0,0,0,15,0,15,Sicilia,ITG1
2021-01-06,PF/BT,190354.0,HSP11 - P.O.ABELE AJELLO-MAZARA D.VALLO,SIC,30-39,5,3,0,8,0,0,0,8,0,8,Sicilia,ITG1
2021-01-06,PF/BT,190354.0,HSP11 - P.O.ABELE AJELLO-MAZARA D.VALLO,SIC,40-49,11,9,0,20,0,0,0,20,0,20,Sicilia,ITG1
2021-01-06,PF/BT,190354.0,HSP11 - P.O.ABELE AJELLO-MAZARA D.VALLO,SIC,50-59,10,14,0,24,0,0,0,24,0,24,Sicilia,ITG1
2021-01-06,PF/BT,190354.0,HSP11 - P.O.ABELE AJELLO-MAZARA D.VALLO,SIC,60-69,22,7,0,29,0,0,0,29,0,29,Sicilia,ITG1
2021-01-06,PF/BT,190354.0,HSP11 - P.O.ABELE AJELLO-MAZARA D.VALLO,SIC,70-79,3,0,0,3,0,0,0,3,0,3,Sicilia,ITG1
2021-01-06,PF/BT,190716.0,HSP11 - CASA DI CURA CAPPELLANI GIOMI S.P.A.,SIC,20-29,1,0,0,1,0,0,0,1,0,1,Sicilia,ITG1
2021-01-06,PF/BT,190716.0,HSP11 - CASA DI CURA CAPPELLANI GIOMI S.P.A.,SIC,30-39,2,0,0,2,0,0,0,2,0,2,Sicilia,ITG1
2021-01-06,PF/BT,190716.0,HSP11 - CASA DI CURA CAPPELLANI GIOMI S.P.A.,SIC,50-59,1,2,0,3,0,0,0,3,0,3,Sicilia,ITG1
2021-01-06,PF/BT,190724.0,HSP11 - ISCAS MORGAGNI NORD SRL,SIC,20-29,3,0,0,3,0,0,0,3,0,3,Sicilia,ITG1
2021-01-06,PF/BT,190724.0,HSP11 - ISCAS MORGAGNI NORD SRL,SIC,30-39,2,3,0,5,0,0,0,5,0,5,Sicilia,ITG1
2021-01-06,PF/BT,190724.0,HSP11 - ISCAS MORGAGNI NORD SRL,SIC,40-49,0,2,0,2,0,0,0,2,0,2,Sicilia,ITG1
2021-01-06,PF/BT,190724.0,HSP11 - ISCAS MORGAGNI NORD SRL,SIC,50-59,1,0,0,1,0,0,0,1,0,1,Sicilia,ITG1
2021-01-06,PF/BT,190724.0,HSP11 - ISCAS MORGAGNI NORD SRL,SIC,60-69,1,0,0,1,0,0,0,1,0,1,Sicilia,ITG1
2021-01-06,PF/BT,190726.0,HSP11 - ISTITUTO CLINICO VIDIMURA srl,SIC,20-29,2,7,0,8,1,0,0,9,0,9,Sicilia,ITG1
2021-01-06,PF/BT,190726.0,HSP11 - ISTITUTO CLINICO VIDIMURA srl,SIC,30-39,1,4,0,4,1,0,0,5,0,5,Sicilia,ITG1
2021-01-06,PF/BT,190726.0,HSP11 - ISTITUTO CLINICO VIDIMURA srl,SIC,40-49,2,3,0,4,1,0,0,5,0,5,Sicilia,ITG1
2021-01-06,PF/BT,190726.0,HSP11 - ISTITUTO CLINICO VIDIMURA srl,SIC,50-59,2,4,0,3,3,0,0,6,0,6,Sicilia,ITG1
2021-01-06,PF/BT,190726.0,HSP11 - ISTITUTO CLINICO VIDIMURA srl,SIC,60-69,8,2,0,7,3,0,0,10,0,10,Sicilia,ITG1
2021-01-06,PF/BT,190726.0,HSP11 - ISTITUTO CLINICO VIDIMURA srl,SIC,70-79,1,0,0,1,0,0,0,1,0,1,Sicilia,ITG1
2021-01-06,PF/BT,190921.0,HSP11 - A.O. per lEmergenza Cannizzaro,SIC,20-29,2,3,0,5,0,0,0,5,0,5,Sicilia,ITG1
2021-01-06,PF/BT,190921.0,HSP11 - A.O. per lEmergenza Cannizzaro,SIC,30-39,10,10,0,20,0,0,0,20,0,20,Sicilia,ITG1
2021-01-06,PF/BT,190921.0,HSP11 - A.O. per lEmergenza Cannizzaro,SIC,40-49,21,14,0,34,1,0,0,35,0,35,Sicilia,ITG1
2021-01-06,PF/BT,190921.0,HSP11 - A.O. per lEmergenza Cannizzaro,SIC,50-59,16,16,0,32,0,0,0,32,0,32,Sicilia,ITG1
2021-01-06,PF/BT,190921.0,HSP11 - A.O. per lEmergenza Cannizzaro,SIC,60-69,5,5,0,10,0,0,0,10,0,10,Sicilia,ITG1
2021-01-06,PF/BT,19092201.0,HSP11 - OSPEDALE GARIBALDI - CENTRO,SIC,20-29,4,9,0,13,0,0,0,13,0,13,Sicilia,ITG1
2021-01-06,PF/BT,19092201.0,HSP11 - OSPEDALE GARIBALDI - CENTRO,SIC,30-39,7,6,0,13,0,0,0,13,0,13,Sicilia,ITG1
2021-01-06,PF/BT,19092201.0,HSP11 - OSPEDALE GARIBALDI - CENTRO,SIC,40-49,13,11,0,23,1,0,0,24,0,24,Sicilia,ITG1
2021-01-06,PF/BT,19092201.0,HSP11 - OSPEDALE GARIBALDI - CENTRO,SIC,50-59,9,8,0,17,0,0,0,17,0,17,Sicilia,ITG1
2021-01-06,PF/BT,19092201.0,HSP11 - OSPEDALE GARIBALDI - CENTRO,SIC,60-69,3,5,0,8,0,0,0,8,0,8,Sicilia,ITG1
2021-01-06,PF/BT,19092204.0,HSP11 - NUOVO OSPEDALE GARIBALDI - NESIMA,SIC,20-29,1,4,0,5,0,0,0,5,0,5,Sicilia,ITG1
2021-01-06,PF/BT,19092204.0,HSP11 - NUOVO OSPEDALE GARIBALDI - NESIMA,SIC,30-39,9,12,0,21,0,0,0,21,0,21,Sicilia,ITG1
2021-01-06,PF/BT,19092204.0,HSP11 - NUOVO OSPEDALE GARIBALDI - NESIMA,SIC,40-49,10,16,0,25,0,0,1,26,0,26,Sicilia,ITG1
2021-01-06,PF/BT,19092204.0,HSP11 - NUOVO OSPEDALE GARIBALDI - NESIMA,SIC,50-59,14,33,0,47,0,0,0,47,0,47,Sicilia,ITG1
2021-01-06,PF/BT,19092204.0,HSP11 - NUOVO OSPEDALE GARIBALDI - NESIMA,SIC,60-69,14,9,0,23,0,0,0,23,0,23,Sicilia,ITG1
2021-01-06,PF/BT,19092204.0,HSP11 - NUOVO OSPEDALE GARIBALDI - NESIMA,SIC,70-79,1,2,0,1,0,0,2,3,0,3,Sicilia,ITG1
2021-01-06,PF/BT,19092204.0,HSP11 - NUOVO OSPEDALE GARIBALDI - NESIMA,SIC,80-89,1,0,0,0,0,0,1,1,0,1,Sicilia,ITG1
2021-01-06,PF/BT,19092204.0,HSP11 - NUOVO OSPEDALE GARIBALDI - NESIMA,SIC,90+,1,0,0,0,0,0,1,1,0,1,Sicilia,ITG1
2021-01-06,PF/BT,19092301.0,HSP11 - PRESIDIO OSPEDALIERO GASPARE RODOLICO,SIC,20-29,15,14,0,29,0,0,0,29,0,29,Sicilia,ITG1
2021-01-06,PF/BT,19092301.0,HSP11 - PRESIDIO OSPEDALIERO GASPARE RODOLICO,SIC,30-39,24,35,0,59,0,0,0,59,0,59,Sicilia,ITG1
2021-01-06,PF/BT,19092301.0,HSP11 - PRESIDIO OSPEDALIERO GASPARE RODOLICO,SIC,40-49,27,19,0,46,0,0,0,46,0,46,Sicilia,ITG1
2021-01-06,PF/BT,19092301.0,HSP11 - PRESIDIO OSPEDALIERO GASPARE RODOLICO,SIC,50-59,36,36,0,72,0,0,0,72,0,72,Sicilia,ITG1
2021-01-06,PF/BT,19092301.0,HSP11 - PRESIDIO OSPEDALIERO GASPARE RODOLICO,SIC,60-69,25,23,0,48,0,0,0,48,0,48,Sicilia,ITG1
2021-01-06,PF/BT,19092301.0,HSP11 - PRESIDIO OSPEDALIERO GASPARE RODOLICO,SIC,70-79,2,0,0,2,0,0,0,2,0,2,Sicilia,ITG1
2021-01-06,PF/BT,19092304.0,HSP11 - PRESIDIO OSPEDALIERO S.MARCO,SIC,16-19,1,5,0,6,0,0,0,6,0,6,Sicilia,ITG1
2021-01-06,PF/BT,19092304.0,HSP11 - PRESIDIO OSPEDALIERO S.MARCO,SIC,20-29,29,31,0,53,7,0,0,60,0,60,Sicilia,ITG1
2021-01-06,PF/BT,19092304.0,HSP11 - PRESIDIO OSPEDALIERO S.MARCO,SIC,30-39,15,9,0,21,3,0,0,24,0,24,Sicilia,ITG1
2021-01-06,PF/BT,19092304.0,HSP11 - PRESIDIO OSPEDALIERO S.MARCO,SIC,40-49,9,12,0,20,1,0,0,21,0,21,Sicilia,ITG1
2021-01-06,PF/BT,19092304.0,HSP11 - PRESIDIO OSPEDALIERO S.MARCO,SIC,50-59,13,11,0,21,3,0,0,24,0,24,Sicilia,ITG1
2021-01-06,PF/BT,19092304.0,HSP11 - PRESIDIO OSPEDALIERO S.MARCO,SIC,60-69,7,8,0,15,0,0,0,15,0,15,Sicilia,ITG1
2021-01-06,PF/BT,190924.0,HSP11 - Azienda Ospedaliera Papardo,SIC,20-29,2,1,0,1,0,0,2,3,0,3,Sicilia,ITG1
2021-01-06,PF/BT,190924.0,HSP11 - Azienda Ospedaliera Papardo,SIC,30-39,6,5,0,8,0,0,3,11,0,11,Sicilia,ITG1
2021-01-06,PF/BT,190924.0,HSP11 - Azienda Ospedaliera Papardo,SIC,40-49,8,9,0,14,0,0,3,17,0,17,Sicilia,ITG1
2021-01-06,PF/BT,190924.0,HSP11 - Azienda Ospedaliera Papardo,SIC,50-59,13,15,0,26,0,0,2,28,0,28,Sicilia,ITG1
2021-01-06,PF/BT,190924.0,HSP11 - Azienda Ospedaliera Papardo,SIC,60-69,8,5,0,13,0,0,0,13,0,13,Sicilia,ITG1
2021-01-06,PF/BT,19092501.0,HSP11 - COVID HOSPITAL,SIC,20-29,14,12,0,26,0,0,0,26,0,26,Sicilia,ITG1
2021-01-06,PF/BT,19092501.0,HSP11 - COVID HOSPITAL,SIC,30-39,26,25,0,51,0,0,0,51,0,51,Sicilia,ITG1
2021-01-06,PF/BT,19092501.0,HSP11 - COVID HOSPITAL,SIC,40-49,26,33,0,59,0,0,0,59,0,59,Sicilia,ITG1
2021-01-06,PF/BT,19092501.0,HSP11 - COVID HOSPITAL,SIC,50-59,42,45,0,87,0,0,0,87,0,87,Sicilia,ITG1
2021-01-06,PF/BT,19092501.0,HSP11 - COVID HOSPITAL,SIC,60-69,25,14,0,39,0,0,0,39,0,39,Sicilia,ITG1
2021-01-06,PF/BT,19092601.0,HSP11 - P.O. Villa Sofia,SIC,20-29,3,2,0,5,0,0,0,5,0,5,Sicilia,ITG1
2021-01-06,PF/BT,19092601.0,HSP11 - P.O. Villa Sofia,SIC,30-39,9,10,0,19,0,0,0,19,0,19,Sicilia,ITG1
2021-01-06,PF/BT,19092601.0,HSP11 - P.O. Villa Sofia,SIC,40-49,8,15,0,23,0,0,0,23,0,23,Sicilia,ITG1
2021-01-06,PF/BT,19092601.0,HSP11 - P.O. Villa Sofia,SIC,50-59,15,14,0,29,0,0,0,29,0,29,Sicilia,ITG1
2021-01-06,PF/BT,19092601.0,HSP11 - P.O. Villa Sofia,SIC,60-69,6,8,0,14,0,0,0,14,0,14,Sicilia,ITG1
2021-01-06,PF/BT,19092701.0,HSP11 - Ospedale Civico,SIC,20-29,5,10,0,15,0,0,0,15,0,15,Sicilia,ITG1
2021-01-06,PF/BT,19092701.0,HSP11 - Ospedale Civico,SIC,30-39,17,19,0,35,1,0,0,36,0,36,Sicilia,ITG1
2021-01-06,PF/BT,19092701.0,HSP11 - Ospedale Civico,SIC,40-49,23,25,0,48,0,0,0,48,0,48,Sicilia,ITG1
2021-01-06,PF/BT,19092701.0,HSP11 - Ospedale Civico,SIC,50-59,45,39,0,84,0,0,0,84,0,84,Sicilia,ITG1
2021-01-06,PF/BT,19092701.0,HSP11 - Ospedale Civico,SIC,60-69,17,10,0,26,1,0,0,27,0,27,Sicilia,ITG1
2021-01-06,PF/BT,19092702.0,HSP11 - Ospedale dei Bambini G. Di Cristina,SIC,20-29,2,9,0,11,0,0,0,11,0,11,Sicilia,ITG1
2021-01-06,PF/BT,19092702.0,HSP11 - Ospedale dei Bambini G. Di Cristina,SIC,30-39,6,8,0,14,0,0,0,14,0,14,Sicilia,ITG1
2021-01-06,PF/BT,19092702.0,HSP11 - Ospedale dei Bambini G. Di Cristina,SIC,40-49,12,10,0,22,0,0,0,22,0,22,Sicilia,ITG1
2021-01-06,PF/BT,19092702.0,HSP11 - Ospedale dei Bambini G. Di Cristina,SIC,50-59,22,21,0,43,0,0,0,43,0,43,Sicilia,ITG1
2021-01-06,PF/BT,19092702.0,HSP11 - Ospedale dei Bambini G. Di Cristina,SIC,60-69,15,10,0,25,0,0,0,25,0,25,Sicilia,ITG1
2021-01-06,PF/BT,190928.0,HSP11 - AZ.OSP.UNIV.P.GIACCONE,SIC,20-29,15,20,0,33,2,0,0,35,0,35,Sicilia,ITG1
2021-01-06,PF/BT,190928.0,HSP11 - AZ.OSP.UNIV.P.GIACCONE,SIC,30-39,21,21,0,40,2,0,0,42,0,42,Sicilia,ITG1
2021-01-06,PF/BT,190928.0,HSP11 - AZ.OSP.UNIV.P.GIACCONE,SIC,40-49,16,14,0,26,4,0,0,30,0,30,Sicilia,ITG1
2021-01-06,PF/BT,190928.0,HSP11 - AZ.OSP.UNIV.P.GIACCONE,SIC,50-59,29,30,0,52,6,0,1,59,0,59,Sicilia,ITG1
2021-01-06,PF/BT,190928.0,HSP11 - AZ.OSP.UNIV.P.GIACCONE,SIC,60-69,19,8,0,24,3,0,0,27,0,27,Sicilia,ITG1
2021-01-06,PF/BT,190928.0,HSP11 - AZ.OSP.UNIV.P.GIACCONE,SIC,70-79,5,1,0,5,1,0,0,6,0,6,Sicilia,ITG1
2021-01-06,PF/BT,190928.0,HSP11 - AZ.OSP.UNIV.P.GIACCONE,SIC,80-89,0,1,0,1,0,0,0,1,0,1,Sicilia,ITG1
2021-01-06,PF/BT,19096002.0,HSP11 - PRESIDIO OSPEDALIERO PIEMONTE,SIC,20-29,1,2,0,2,0,0,1,3,0,3,Sicilia,ITG1
2021-01-06,PF/BT,19096002.0,HSP11 - PRESIDIO OSPEDALIERO PIEMONTE,SIC,30-39,9,11,0,17,0,0,3,20,0,20,Sicilia,ITG1
2021-01-06,PF/BT,19096002.0,HSP11 - PRESIDIO OSPEDALIERO PIEMONTE,SIC,40-49,4,6,0,9,0,0,1,10,0,10,Sicilia,ITG1
2021-01-06,PF/BT,19096002.0,HSP11 - PRESIDIO OSPEDALIERO PIEMONTE,SIC,50-59,7,10,0,15,0,0,2,17,0,17,Sicilia,ITG1
2021-01-06,PF/BT,19096002.0,HSP11 - PRESIDIO OSPEDALIERO PIEMONTE,SIC,60-69,12,4,0,16,0,0,0,16,0,16,Sicilia,ITG1
2021-01-06,PF/BT,608200.0,STS11 - POLIAMBULATORIO San Giorgio,SIC,20-29,5,8,0,11,2,0,0,13,0,13,Sicilia,ITG1
2021-01-06,PF/BT,608200.0,STS11 - POLIAMBULATORIO San Giorgio,SIC,30-39,5,8,0,13,0,0,0,13,0,13,Sicilia,ITG1
2021-01-06,PF/BT,608200.0,STS11 - POLIAMBULATORIO San Giorgio,SIC,40-49,9,8,0,17,0,0,0,17,0,17,Sicilia,ITG1
2021-01-06,PF/BT,608200.0,STS11 - POLIAMBULATORIO San Giorgio,SIC,50-59,15,11,0,26,0,0,0,26,0,26,Sicilia,ITG1
2021-01-06,PF/BT,608200.0,STS11 - POLIAMBULATORIO San Giorgio,SIC,60-69,31,21,0,52,0,0,0,52,0,52,Sicilia,ITG1
2021-01-06,PF/BT,608200.0,STS11 - POLIAMBULATORIO San Giorgio,SIC,70-79,3,0,0,3,0,0,0,3,0,3,Sicilia,ITG1
2021-01-06,PF/BT,608400.0,STS11 - POLIAMBULATORIO  San Luigi,SIC,20-29,0,1,0,1,0,0,0,1,0,1,Sicilia,ITG1
2021-01-06,PF/BT,608400.0,STS11 - POLIAMBULATORIO  San Luigi,SIC,30-39,2,3,0,5,0,0,0,5,0,5,Sicilia,ITG1
2021-01-06,PF/BT,608400.0,STS11 - POLIAMBULATORIO  San Luigi,SIC,40-49,3,8,0,11,0,0,0,11,0,11,Sicilia,ITG1
2021-01-06,PF/BT,608400.0,STS11 - POLIAMBULATORIO  San Luigi,SIC,50-59,2,12,0,14,0,0,0,14,0,14,Sicilia,ITG1
2021-01-06,PF/BT,608400.0,STS11 - POLIAMBULATORIO  San Luigi,SIC,60-69,16,12,0,27,0,0,1,28,0,28,Sicilia,ITG1
2021-01-06,PF/BT,608400.0,STS11 - POLIAMBULATORIO  San Luigi,SIC,70-79,1,0,0,0,0,0,1,1,0,1,Sicilia,ITG1
2021-01-06,PF/BT,800901.0,STS11 - CTA VILLA SALVADOR,SIC,20-29,4,1,0,2,0,0,3,5,0,5,Sicilia,ITG1
2021-01-06,PF/BT,800901.0,STS11 - CTA VILLA SALVADOR,SIC,30-39,5,5,0,8,0,0,2,10,0,10,Sicilia,ITG1
2021-01-06,PF/BT,800901.0,STS11 - CTA VILLA SALVADOR,SIC,40-49,6,9,0,10,0,0,5,15,0,15,Sicilia,ITG1
2021-01-06,PF/BT,800901.0,STS11 - CTA VILLA SALVADOR,SIC,50-59,11,8,0,13,0,0,6,19,0,19,Sicilia,ITG1
2021-01-06,PF/BT,800901.0,STS11 - CTA VILLA SALVADOR,SIC,60-69,11,5,0,7,0,0,9,16,0,16,Sicilia,ITG1
2021-01-06,PF/BT,800901.0,STS11 - CTA VILLA SALVADOR,SIC,70-79,4,0,0,0,0,0,4,4,0,4,Sicilia,ITG1
2021-01-06,PF/BT,800901.0,STS11 - CTA VILLA SALVADOR,SIC,80-89,1,2,0,0,0,0,3,3,0,3,Sicilia,ITG1
2021-01-06,PF/BT,826800.0,STS11 - RSA RESIDENZA SERENA srl,SIC,20-29,1,3,0,4,0,0,0,4,0,4,Sicilia,ITG1
2021-01-06,PF/BT,826800.0,STS11 - RSA RESIDENZA SERENA srl,SIC,30-39,2,4,0,6,0,0,0,6,0,6,Sicilia,ITG1
2021-01-06,PF/BT,826800.0,STS11 - RSA RESIDENZA SERENA srl,SIC,40-49,5,3,0,8,0,0,0,8,0,8,Sicilia,ITG1
2021-01-06,PF/BT,826800.0,STS11 - RSA RESIDENZA SERENA srl,SIC,50-59,1,3,0,4,0,0,0,4,0,4,Sicilia,ITG1
2021-01-06,PF/BT,826800.0,STS11 - RSA RESIDENZA SERENA srl,SIC,60-69,2,0,0,2,0,0,0,2,0,2,Sicilia,ITG1
2021-01-06,PF/BT,827100.0,STS11 - RSA KORUS srl,SIC,20-29,2,2,0,4,0,0,0,4,0,4,Sicilia,ITG1
2021-01-06,PF/BT,827100.0,STS11 - RSA KORUS srl,SIC,30-39,5,1,0,6,0,0,0,6,0,6,Sicilia,ITG1
2021-01-06,PF/BT,827100.0,STS11 - RSA KORUS srl,SIC,40-49,1,3,0,4,0,0,0,4,0,4,Sicilia,ITG1
2021-01-06,PF/BT,827100.0,STS11 - RSA KORUS srl,SIC,50-59,2,2,0,4,0,0,0,4,0,4,Sicilia,ITG1
2021-01-06,PF/BT,827100.0,STS11 - RSA KORUS srl,SIC,60-69,4,1,0,4,0,1,0,5,0,5,Sicilia,ITG1
2021-01-06,PF/BT,827100.0,STS11 - RSA KORUS srl,SIC,80-89,0,1,0,0,0,1,0,1,0,1,Sicilia,ITG1
2021-01-07,PF/BT,190179.0,HSP11 - FOND. IST. S. RAFFAELE - GIGLIO,SIC,20-29,1,0,0,0,1,0,0,1,0,1,Sicilia,ITG1
2021-01-07,PF/BT,190179.0,HSP11 - FOND. IST. S. RAFFAELE - GIGLIO,SIC,30-39,11,0,0,9,2,0,0,11,0,11,Sicilia,ITG1
2021-01-07,PF/BT,190179.0,HSP11 - FOND. IST. S. RAFFAELE - GIGLIO,SIC,40-49,7,9,0,10,6,0,0,16,0,16,Sicilia,ITG1
2021-01-07,PF/BT,190179.0,HSP11 - FOND. IST. S. RAFFAELE - GIGLIO,SIC,50-59,8,16,0,17,7,0,0,24,0,24,Sicilia,ITG1
2021-01-07,PF/BT,190179.0,HSP11 - FOND. IST. S. RAFFAELE - GIGLIO,SIC,60-69,7,7,0,10,4,0,0,14,0,14,Sicilia,ITG1
2021-01-07,PF/BT,190199.0,HSP11 - OSP. BUCCHERI LA FERLA FATEBENEFRATELLI,SIC,20-29,2,4,0,5,1,0,0,6,0,6,Sicilia,ITG1
2021-01-07,PF/BT,190199.0,HSP11 - OSP. BUCCHERI LA FERLA FATEBENEFRATELLI,SIC,30-39,15,6,0,11,10,0,0,21,0,21,Sicilia,ITG1
2021-01-07,PF/BT,190199.0,HSP11 - OSP. BUCCHERI LA FERLA FATEBENEFRATELLI,SIC,40-49,24,12,0,18,18,0,0,36,0,36,Sicilia,ITG1
2021-01-07,PF/BT,190199.0,HSP11 - OSP. BUCCHERI LA FERLA FATEBENEFRATELLI,SIC,50-59,12,17,0,19,10,0,0,29,0,29,Sicilia,ITG1
2021-01-07,PF/BT,190199.0,HSP11 - OSP. BUCCHERI LA FERLA FATEBENEFRATELLI,SIC,60-69,3,8,0,8,3,0,0,11,0,11,Sicilia,ITG1
2021-01-07,PF/BT,190199.0,HSP11 - OSP. BUCCHERI LA FERLA FATEBENEFRATELLI,SIC,70-79,4,0,0,1,3,0,0,4,0,4,Sicilia,ITG1
2021-01-07,PF/BT,190199.0,HSP11 - OSP. BUCCHERI LA FERLA FATEBENEFRATELLI,SIC,80-89,1,0,0,0,1,0,0,1,0,1,Sicilia,ITG1
2021-01-07,PF/BT,1902017.0,STRUTTURE PRIVATE NON CODIFICATE NSIS,SIC,20-29,3,12,0,9,4,1,1,15,0,15,Sicilia,ITG1
2021-01-07,PF/BT,1902017.0,STRUTTURE PRIVATE NON CODIFICATE NSIS,SIC,30-39,3,10,0,11,2,0,0,13,0,13,Sicilia,ITG1
2021-01-07,PF/BT,1902017.0,STRUTTURE PRIVATE NON CODIFICATE NSIS,SIC,40-49,5,16,0,17,3,1,0,21,0,21,Sicilia,ITG1
2021-01-07,PF/BT,1902017.0,STRUTTURE PRIVATE NON CODIFICATE NSIS,SIC,50-59,7,18,0,17,3,3,2,25,0,25,Sicilia,ITG1
2021-01-07,PF/BT,1902017.0,STRUTTURE PRIVATE NON CODIFICATE NSIS,SIC,60-69,10,13,0,13,3,7,0,23,0,23,Sicilia,ITG1
2021-01-07,PF/BT,1902017.0,STRUTTURE PRIVATE NON CODIFICATE NSIS,SIC,70-79,7,18,0,2,0,23,0,25,0,25,Sicilia,ITG1
2021-01-07,PF/BT,1902017.0,STRUTTURE PRIVATE NON CODIFICATE NSIS,SIC,80-89,14,39,0,0,0,53,0,53,0,53,Sicilia,ITG1
2021-01-07,PF/BT,1902017.0,STRUTTURE PRIVATE NON CODIFICATE NSIS,SIC,90+,0,22,0,1,0,21,0,22,0,22,Sicilia,ITG1
2021-01-07,PF/BT,1902037.0,STRUTTURE PRIVATE NON CODIFICATE NSIS,SIC,20-29,5,7,0,12,0,0,0,12,0,12,Sicilia,ITG1
2021-01-07,PF/BT,1902037.0,STRUTTURE PRIVATE NON CODIFICATE NSIS,SIC,30-39,10,4,0,14,0,0,0,14,0,14,Sicilia,ITG1
2021-01-07,PF/BT,1902037.0,STRUTTURE PRIVATE NON CODIFICATE NSIS,SIC,40-49,13,11,0,22,1,1,0,24,0,24,Sicilia,ITG1
2021-01-07,PF/BT,1902037.0,STRUTTURE PRIVATE NON CODIFICATE NSIS,SIC,50-59,14,24,0,30,5,3,0,38,0,38,Sicilia,ITG1
2021-01-07,PF/BT,1902037.0,STRUTTURE PRIVATE NON CODIFICATE NSIS,SIC,60-69,9,5,0,12,0,1,1,14,0,14,Sicilia,ITG1
2021-01-07,PF/BT,1902037.0,STRUTTURE PRIVATE NON CODIFICATE NSIS,SIC,70-79,2,0,0,1,1,0,0,2,0,2,Sicilia,ITG1
2021-01-07,PF/BT,1902037.0,STRUTTURE PRIVATE NON CODIFICATE NSIS,SIC,80-89,0,1,0,0,0,1,0,1,0,1,Sicilia,ITG1
2021-01-07,PF/BT,1902047.0,STRUTTURE PRIVATE NON CODIFICATE NSIS,SIC,20-29,5,1,0,6,0,0,0,6,0,6,Sicilia,ITG1
2021-01-07,PF/BT,1902047.0,STRUTTURE PRIVATE NON CODIFICATE NSIS,SIC,30-39,3,5,0,8,0,0,0,8,0,8,Sicilia,ITG1
2021-01-07,PF/BT,1902047.0,STRUTTURE PRIVATE NON CODIFICATE NSIS,SIC,40-49,2,15,0,17,0,0,0,17,0,17,Sicilia,ITG1
2021-01-07,PF/BT,1902047.0,STRUTTURE PRIVATE NON CODIFICATE NSIS,SIC,50-59,2,15,0,15,0,2,0,17,0,17,Sicilia,ITG1
2021-01-07,PF/BT,1902047.0,STRUTTURE PRIVATE NON CODIFICATE NSIS,SIC,60-69,6,1,0,2,0,5,0,7,0,7,Sicilia,ITG1
2021-01-07,PF/BT,1902047.0,STRUTTURE PRIVATE NON CODIFICATE NSIS,SIC,70-79,5,9,0,0,0,14,0,14,0,14,Sicilia,ITG1
2021-01-07,PF/BT,1902047.0,STRUTTURE PRIVATE NON CODIFICATE NSIS,SIC,80-89,10,21,0,0,0,31,0,31,0,31,Sicilia,ITG1
2021-01-07,PF/BT,1902047.0,STRUTTURE PRIVATE NON CODIFICATE NSIS,SIC,90+,6,20,0,1,0,25,0,26,0,26,Sicilia,ITG1
2021-01-07,PF/BT,1902057.0,STRUTTURE PRIVATE NON CODIFICATE NSIS,SIC,20-29,2,0,0,2,0,0,0,2,0,2,Sicilia,ITG1
2021-01-07,PF/BT,1902057.0,STRUTTURE PRIVATE NON CODIFICATE NSIS,SIC,30-39,4,6,0,10,0,0,0,10,0,10,Sicilia,ITG1
2021-01-07,PF/BT,1902057.0,STRUTTURE PRIVATE NON CODIFICATE NSIS,SIC,40-49,6,15,0,18,1,0,2,21,0,21,Sicilia,ITG1
2021-01-07,PF/BT,1902057.0,STRUTTURE PRIVATE NON CODIFICATE NSIS,SIC,50-59,16,33,0,43,2,1,3,49,0,49,Sicilia,ITG1
2021-01-07,PF/BT,1902057.0,STRUTTURE PRIVATE NON CODIFICATE NSIS,SIC,60-69,25,20,0,40,0,2,3,45,0,45,Sicilia,ITG1
2021-01-07,PF/BT,1902057.0,STRUTTURE PRIVATE NON CODIFICATE NSIS,SIC,70-79,0,2,0,0,0,2,0,2,0,2,Sicilia,ITG1
2021-01-07,PF/BT,1902057.0,STRUTTURE PRIVATE NON CODIFICATE NSIS,SIC,80-89,1,6,0,0,0,7,0,7,0,7,Sicilia,ITG1
2021-01-07,PF/BT,1902057.0,STRUTTURE PRIVATE NON CODIFICATE NSIS,SIC,90+,1,1,0,0,0,2,0,2,0,2,Sicilia,ITG1
2021-01-07,PF/BT,1902072.0,AMBULATORI VACCINALI NON CODIFICATI NSIS,SIC,20-29,0,1,0,1,0,0,0,1,0,1,Sicilia,ITG1
2021-01-07,PF/BT,1902072.0,AMBULATORI VACCINALI NON CODIFICATI NSIS,SIC,30-39,0,6,0,5,1,0,0,6,0,6,Sicilia,ITG1
2021-01-07,PF/BT,1902072.0,AMBULATORI VACCINALI NON CODIFICATI NSIS,SIC,40-49,0,2,0,2,0,0,0,2,0,2,Sicilia,ITG1
2021-01-07,PF/BT,1902072.0,AMBULATORI VACCINALI NON CODIFICATI NSIS,SIC,50-59,4,4,0,6,1,0,1,8,0,8,Sicilia,ITG1
2021-01-07,PF/BT,1902072.0,AMBULATORI VACCINALI NON CODIFICATI NSIS,SIC,60-69,6,3,0,9,0,0,0,9,0,9,Sicilia,ITG1
2021-01-07,PF/BT,1902072.0,AMBULATORI VACCINALI NON CODIFICATI NSIS,SIC,70-79,2,0,0,2,0,0,0,2,0,2,Sicilia,ITG1
2021-01-07,PF/BT,1902077.0,STRUTTURE PRIVATE NON CODIFICATE NSIS,SIC,20-29,2,8,0,10,0,0,0,10,0,10,Sicilia,ITG1
2021-01-07,PF/BT,1902077.0,STRUTTURE PRIVATE NON CODIFICATE NSIS,SIC,30-39,0,13,0,13,0,0,0,13,0,13,Sicilia,ITG1
2021-01-07,PF/BT,1902077.0,STRUTTURE PRIVATE NON CODIFICATE NSIS,SIC,40-49,3,11,0,14,0,0,0,14,0,14,Sicilia,ITG1
2021-01-07,PF/BT,1902077.0,STRUTTURE PRIVATE NON CODIFICATE NSIS,SIC,50-59,5,19,0,24,0,0,0,24,0,24,Sicilia,ITG1
2021-01-07,PF/BT,1902077.0,STRUTTURE PRIVATE NON CODIFICATE NSIS,SIC,60-69,0,9,0,9,0,0,0,9,0,9,Sicilia,ITG1
2021-01-07,PF/BT,1902077.0,STRUTTURE PRIVATE NON CODIFICATE NSIS,SIC,70-79,2,1,0,3,0,0,0,3,0,3,Sicilia,ITG1
2021-01-07,PF/BT,190301.0,RIA11 - A.I.A.S.SEZ.DI AGRIGENTO ONLUS,SIC,20-29,13,8,0,15,0,0,6,21,0,21,Sicilia,ITG1
2021-01-07,PF/BT,190301.0,RIA11 - A.I.A.S.SEZ.DI AGRIGENTO ONLUS,SIC,30-39,10,16,0,25,0,0,1,26,0,26,Sicilia,ITG1
2021-01-07,PF/BT,190301.0,RIA11 - A.I.A.S.SEZ.DI AGRIGENTO ONLUS,SIC,40-49,39,20,0,52,1,0,6,59,0,59,Sicilia,ITG1
2021-01-07,PF/BT,190301.0,RIA11 - A.I.A.S.SEZ.DI AGRIGENTO ONLUS,SIC,50-59,45,34,0,67,1,0,11,79,0,79,Sicilia,ITG1
2021-01-07,PF/BT,190301.0,RIA11 - A.I.A.S.SEZ.DI AGRIGENTO ONLUS,SIC,60-69,34,28,0,56,0,0,6,62,0,62,Sicilia,ITG1
2021-01-07,PF/BT,190301.0,RIA11 - A.I.A.S.SEZ.DI AGRIGENTO ONLUS,SIC,70-79,2,0,0,2,0,0,0,2,0,2,Sicilia,ITG1
2021-01-07,PF/BT,190302.0,RIA11 - C.DELLA SPERANZA DON ANGELO G.,SIC,16-19,1,0,0,1,0,0,0,1,0,1,Sicilia,ITG1
2021-01-07,PF/BT,190302.0,RIA11 - C.DELLA SPERANZA DON ANGELO G.,SIC,20-29,3,2,0,5,0,0,0,5,0,5,Sicilia,ITG1
2021-01-07,PF/BT,190302.0,RIA11 - C.DELLA SPERANZA DON ANGELO G.,SIC,30-39,2,4,0,6,0,0,0,6,0,6,Sicilia,ITG1
2021-01-07,PF/BT,190302.0,RIA11 - C.DELLA SPERANZA DON ANGELO G.,SIC,40-49,2,6,0,8,0,0,0,8,0,8,Sicilia,ITG1
2021-01-07,PF/BT,190302.0,RIA11 - C.DELLA SPERANZA DON ANGELO G.,SIC,50-59,7,12,0,19,0,0,0,19,0,19,Sicilia,ITG1
2021-01-07,PF/BT,190302.0,RIA11 - C.DELLA SPERANZA DON ANGELO G.,SIC,60-69,10,10,0,20,0,0,0,20,0,20,Sicilia,ITG1
2021-01-07,PF/BT,190303.0,RIA11 - COMUNITA` DELLA SPERANZA,SIC,16-19,0,1,0,1,0,0,0,1,0,1,Sicilia,ITG1
2021-01-07,PF/BT,190303.0,RIA11 - COMUNITA` DELLA SPERANZA,SIC,20-29,2,2,0,2,2,0,0,4,0,4,Sicilia,ITG1
2021-01-07,PF/BT,190303.0,RIA11 - COMUNITA` DELLA SPERANZA,SIC,30-39,8,4,0,7,5,0,0,12,0,12,Sicilia,ITG1
2021-01-07,PF/BT,190303.0,RIA11 - COMUNITA` DELLA SPERANZA,SIC,40-49,5,15,0,12,8,0,0,20,0,20,Sicilia,ITG1
2021-01-07,PF/BT,190303.0,RIA11 - COMUNITA` DELLA SPERANZA,SIC,50-59,8,18,0,14,12,0,0,26,0,26,Sicilia,ITG1
2021-01-07,PF/BT,190303.0,RIA11 - COMUNITA` DELLA SPERANZA,SIC,60-69,12,9,0,18,3,0,0,21,0,21,Sicilia,ITG1
2021-01-07,PF/BT,190304.0,HSP11 - P.O.  F.LLI PARLAPIANO - RIBERA,SIC,20-29,3,17,0,12,6,0,2,20,0,20,Sicilia,ITG1
2021-01-07,PF/BT,190304.0,HSP11 - P.O.  F.LLI PARLAPIANO - RIBERA,SIC,30-39,12,17,0,17,12,0,0,29,0,29,Sicilia,ITG1
2021-01-07,PF/BT,190304.0,HSP11 - P.O.  F.LLI PARLAPIANO - RIBERA,SIC,40-49,12,29,0,21,19,0,1,41,0,41,Sicilia,ITG1
2021-01-07,PF/BT,190304.0,HSP11 - P.O.  F.LLI PARLAPIANO - RIBERA,SIC,50-59,21,26,0,30,16,0,1,47,0,47,Sicilia,ITG1
2021-01-07,PF/BT,190304.0,HSP11 - P.O.  F.LLI PARLAPIANO - RIBERA,SIC,60-69,19,11,0,18,10,0,2,30,0,30,Sicilia,ITG1
2021-01-07,PF/BT,190304.0,HSP11 - P.O.  F.LLI PARLAPIANO - RIBERA,SIC,70-79,6,1,0,7,0,0,0,7,0,7,Sicilia,ITG1
2021-01-07,PF/BT,190305.0,HSP11 - P.O. GIOVANNI PAOLO II,SIC,20-29,2,6,0,5,3,0,0,8,0,8,Sicilia,ITG1
2021-01-07,PF/BT,190305.0,HSP11 - P.O. GIOVANNI PAOLO II,SIC,30-39,4,13,0,12,5,0,0,17,0,17,Sicilia,ITG1
2021-01-07,PF/BT,190305.0,HSP11 - P.O. GIOVANNI PAOLO II,SIC,40-49,11,16,0,15,12,0,0,27,0,27,Sicilia,ITG1
2021-01-07,PF/BT,190305.0,HSP11 - P.O. GIOVANNI PAOLO II,SIC,50-59,23,28,0,28,23,0,0,51,0,51,Sicilia,ITG1
2021-01-07,PF/BT,190305.0,HSP11 - P.O. GIOVANNI PAOLO II,SIC,60-69,42,26,0,49,19,0,0,68,0,68,Sicilia,ITG1
2021-01-07,PF/BT,190305.0,HSP11 - P.O. GIOVANNI PAOLO II,SIC,70-79,2,0,0,2,0,0,0,2,0,2,Sicilia,ITG1
2021-01-07,PF/BT,190306.0,RIA11 - ASS. CASA FAM.ROSETTA ONILUS,SIC,16-19,1,0,0,1,0,0,0,1,0,1,Sicilia,ITG1
2021-01-07,PF/BT,190306.0,RIA11 - ASS. CASA FAM.ROSETTA ONILUS,SIC,20-29,5,2,0,2,1,0,4,7,0,7,Sicilia,ITG1
2021-01-07,PF/BT,190306.0,RIA11 - ASS. CASA FAM.ROSETTA ONILUS,SIC,30-39,5,4,0,4,4,0,1,9,0,9,Sicilia,ITG1
2021-01-07,PF/BT,190306.0,RIA11 - ASS. CASA FAM.ROSETTA ONILUS,SIC,40-49,11,9,0,15,5,0,0,20,0,20,Sicilia,ITG1
2021-01-07,PF/BT,190306.0,RIA11 - ASS. CASA FAM.ROSETTA ONILUS,SIC,50-59,28,27,0,30,20,0,5,55,0,55,Sicilia,ITG1
2021-01-07,PF/BT,190306.0,RIA11 - ASS. CASA FAM.ROSETTA ONILUS,SIC,60-69,18,7,0,18,4,0,3,25,0,25,Sicilia,ITG1
2021-01-07,PF/BT,190309.0,HSP11 - P.O. VITTORIO EMANUELE (ex AO),SIC,20-29,3,0,0,3,0,0,0,3,0,3,Sicilia,ITG1
2021-01-07,PF/BT,190309.0,HSP11 - P.O. VITTORIO EMANUELE (ex AO),SIC,30-39,2,3,0,5,0,0,0,5,0,5,Sicilia,ITG1
2021-01-07,PF/BT,190309.0,HSP11 - P.O. VITTORIO EMANUELE (ex AO),SIC,40-49,3,2,0,3,0,0,2,5,0,5,Sicilia,ITG1
2021-01-07,PF/BT,190309.0,HSP11 - P.O. VITTORIO EMANUELE (ex AO),SIC,50-59,7,4,0,8,0,0,3,11,0,11,Sicilia,ITG1
2021-01-07,PF/BT,190309.0,HSP11 - P.O. VITTORIO EMANUELE (ex AO),SIC,60-69,8,4,0,11,0,0,1,12,0,12,Sicilia,ITG1
2021-01-07,PF/BT,190312.0,HSP11 - P.O. S. Marta e S. Venera Acireale,SIC,20-29,3,2,0,3,2,0,0,5,0,5,Sicilia,ITG1
2021-01-07,PF/BT,190312.0,HSP11 - P.O. S. Marta e S. Venera Acireale,SIC,30-39,10,7,0,11,6,0,0,17,0,17,Sicilia,ITG1
2021-01-07,PF/BT,190312.0,HSP11 - P.O. S. Marta e S. Venera Acireale,SIC,40-49,12,17,0,22,7,0,0,29,0,29,Sicilia,ITG1
2021-01-07,PF/BT,190312.0,HSP11 - P.O. S. Marta e S. Venera Acireale,SIC,50-59,20,32,0,42,10,0,0,52,0,52,Sicilia,ITG1
2021-01-07,PF/BT,190312.0,HSP11 - P.O. S. Marta e S. Venera Acireale,SIC,60-69,15,21,0,33,3,0,0,36,0,36,Sicilia,ITG1
2021-01-07,PF/BT,190312.0,HSP11 - P.O. S. Marta e S. Venera Acireale,SIC,70-79,3,1,0,4,0,0,0,4,0,4,Sicilia,ITG1
2021-01-07,PF/BT,190312.0,HSP11 - P.O. S. Marta e S. Venera Acireale,SIC,80-89,1,0,0,1,0,0,0,1,0,1,Sicilia,ITG1
2021-01-07,PF/BT,190313.0,RIA11 - IST.RIAB.VILLAG. SAN GIUSEPPE,SIC,20-29,4,5,0,9,0,0,0,9,0,9,Sicilia,ITG1
2021-01-07,PF/BT,190313.0,RIA11 - IST.RIAB.VILLAG. SAN GIUSEPPE,SIC,30-39,0,7,0,7,0,0,0,7,0,7,Sicilia,ITG1
2021-01-07,PF/BT,190313.0,RIA11 - IST.RIAB.VILLAG. SAN GIUSEPPE,SIC,40-49,10,10,0,18,0,0,2,20,0,20,Sicilia,ITG1
2021-01-07,PF/BT,190313.0,RIA11 - IST.RIAB.VILLAG. SAN GIUSEPPE,SIC,50-59,7,20,0,23,1,0,3,27,0,27,Sicilia,ITG1
2021-01-07,PF/BT,190313.0,RIA11 - IST.RIAB.VILLAG. SAN GIUSEPPE,SIC,60-69,25,23,0,42,1,0,5,48,0,48,Sicilia,ITG1
2021-01-07,PF/BT,190313.0,RIA11 - IST.RIAB.VILLAG. SAN GIUSEPPE,SIC,70-79,1,2,0,2,0,0,1,3,0,3,Sicilia,ITG1
2021-01-07,PF/BT,190314.0,RIA11 - ASS.J.F.KENNEDY ACIREALE,SIC,20-29,13,12,0,25,0,0,0,25,0,25,Sicilia,ITG1
2021-01-07,PF/BT,190314.0,RIA11 - ASS.J.F.KENNEDY ACIREALE,SIC,30-39,13,12,0,25,0,0,0,25,0,25,Sicilia,ITG1
2021-01-07,PF/BT,190314.0,RIA11 - ASS.J.F.KENNEDY ACIREALE,SIC,40-49,11,10,0,21,0,0,0,21,0,21,Sicilia,ITG1
2021-01-07,PF/BT,190314.0,RIA11 - ASS.J.F.KENNEDY ACIREALE,SIC,50-59,7,13,0,20,0,0,0,20,0,20,Sicilia,ITG1
2021-01-07,PF/BT,190314.0,RIA11 - ASS.J.F.KENNEDY ACIREALE,SIC,60-69,9,11,0,20,0,0,0,20,0,20,Sicilia,ITG1
2021-01-07,PF/BT,190314.0,RIA11 - ASS.J.F.KENNEDY ACIREALE,SIC,70-79,3,0,0,3,0,0,0,3,0,3,Sicilia,ITG1
2021-01-07,PF/BT,190315.0,RIA11 - AIAS SEZ. ACIREALE,SIC,20-29,4,2,0,6,0,0,0,6,0,6,Sicilia,ITG1
2021-01-07,PF/BT,190315.0,RIA11 - AIAS SEZ. ACIREALE,SIC,30-39,8,5,0,13,0,0,0,13,0,13,Sicilia,ITG1
2021-01-07,PF/BT,190315.0,RIA11 - AIAS SEZ. ACIREALE,SIC,40-49,6,10,0,16,0,0,0,16,0,16,Sicilia,ITG1
2021-01-07,PF/BT,190315.0,RIA11 - AIAS SEZ. ACIREALE,SIC,50-59,2,9,0,11,0,0,0,11,0,11,Sicilia,ITG1
2021-01-07,PF/BT,190315.0,RIA11 - AIAS SEZ. ACIREALE,SIC,60-69,8,5,0,13,0,0,0,13,0,13,Sicilia,ITG1
2021-01-07,PF/BT,190315.0,RIA11 - AIAS SEZ. ACIREALE,SIC,80-89,0,1,0,1,0,0,0,1,0,1,Sicilia,ITG1
2021-01-07,PF/BT,190316.0,RIA11 - ASS.J.F.KENNEDY - C.RIAB.ONLUS,SIC,16-19,0,1,0,0,1,0,0,1,0,1,Sicilia,ITG1
2021-01-07,PF/BT,190316.0,RIA11 - ASS.J.F.KENNEDY - C.RIAB.ONLUS,SIC,20-29,4,14,0,14,4,0,0,18,0,18,Sicilia,ITG1
2021-01-07,PF/BT,190316.0,RIA11 - ASS.J.F.KENNEDY - C.RIAB.ONLUS,SIC,30-39,3,24,0,21,6,0,0,27,0,27,Sicilia,ITG1
2021-01-07,PF/BT,190316.0,RIA11 - ASS.J.F.KENNEDY - C.RIAB.ONLUS,SIC,40-49,5,14,0,16,3,0,0,19,0,19,Sicilia,ITG1
2021-01-07,PF/BT,190316.0,RIA11 - ASS.J.F.KENNEDY - C.RIAB.ONLUS,SIC,50-59,8,16,0,18,6,0,0,24,0,24,Sicilia,ITG1
2021-01-07,PF/BT,190316.0,RIA11 - ASS.J.F.KENNEDY - C.RIAB.ONLUS,SIC,60-69,19,12,0,24,7,0,0,31,0,31,Sicilia,ITG1
2021-01-07,PF/BT,190316.0,RIA11 - ASS.J.F.KENNEDY - C.RIAB.ONLUS,SIC,70-79,4,0,0,3,1,0,0,4,0,4,Sicilia,ITG1
2021-01-07,PF/BT,190316.0,RIA11 - ASS.J.F.KENNEDY - C.RIAB.ONLUS,SIC,80-89,0,1,0,1,0,0,0,1,0,1,Sicilia,ITG1
2021-01-07,PF/BT,190317.0,HSP11 - P.O. Gravina e S. Pietro Caltagirone,SIC,20-29,4,3,0,6,1,0,0,7,0,7,Sicilia,ITG1
2021-01-07,PF/BT,190317.0,HSP11 - P.O. Gravina e S. Pietro Caltagirone,SIC,30-39,6,10,0,10,6,0,0,16,0,16,Sicilia,ITG1
2021-01-07,PF/BT,190317.0,HSP11 - P.O. Gravina e S. Pietro Caltagirone,SIC,40-49,5,13,0,12,6,0,0,18,0,18,Sicilia,ITG1
2021-01-07,PF/BT,190317.0,HSP11 - P.O. Gravina e S. Pietro Caltagirone,SIC,50-59,12,22,0,23,11,0,0,34,0,34,Sicilia,ITG1
2021-01-07,PF/BT,190317.0,HSP11 - P.O. Gravina e S. Pietro Caltagirone,SIC,60-69,8,17,0,15,10,0,0,25,0,25,Sicilia,ITG1
2021-01-07,PF/BT,190317.0,HSP11 - P.O. Gravina e S. Pietro Caltagirone,SIC,70-79,1,0,0,1,0,0,0,1,0,1,Sicilia,ITG1
2021-01-07,PF/BT,190318.0,RIA11 - ASS.ISTITUTO REGINA VIRGINUM,SIC,30-39,2,8,0,8,2,0,0,10,0,10,Sicilia,ITG1
2021-01-07,PF/BT,190318.0,RIA11 - ASS.ISTITUTO REGINA VIRGINUM,SIC,40-49,3,8,0,7,4,0,0,11,0,11,Sicilia,ITG1
2021-01-07,PF/BT,190318.0,RIA11 - ASS.ISTITUTO REGINA VIRGINUM,SIC,50-59,4,7,0,11,0,0,0,11,0,11,Sicilia,ITG1
2021-01-07,PF/BT,190318.0,RIA11 - ASS.ISTITUTO REGINA VIRGINUM,SIC,60-69,5,4,0,9,0,0,0,9,0,9,Sicilia,ITG1
2021-01-07,PF/BT,190318.0,RIA11 - ASS.ISTITUTO REGINA VIRGINUM,SIC,70-79,1,0,0,1,0,0,0,1,0,1,Sicilia,ITG1
2021-01-07,PF/BT,190319.0,HSP11 - P. O. UMBERTO I,SIC,20-29,1,3,0,2,1,0,1,4,0,4,Sicilia,ITG1
2021-01-07,PF/BT,190319.0,HSP11 - P. O. UMBERTO I,SIC,30-39,14,2,0,10,3,0,3,16,0,16,Sicilia,ITG1
2021-01-07,PF/BT,190319.0,HSP11 - P. O. UMBERTO I,SIC,40-49,11,10,0,12,1,0,8,21,0,21,Sicilia,ITG1
2021-01-07,PF/BT,190319.0,HSP11 - P. O. UMBERTO I,SIC,50-59,27,23,0,32,4,0,14,50,0,50,Sicilia,ITG1
2021-01-07,PF/BT,190319.0,HSP11 - P. O. UMBERTO I,SIC,60-69,18,11,0,23,2,0,4,29,0,29,Sicilia,ITG1
2021-01-07,PF/BT,190326.0,HSP11 - P.O. S. VINCENZO TAORMINA,SIC,20-29,2,3,0,5,0,0,0,5,0,5,Sicilia,ITG1
2021-01-07,PF/BT,190326.0,HSP11 - P.O. S. VINCENZO TAORMINA,SIC,30-39,11,11,0,22,0,0,0,22,0,22,Sicilia,ITG1
2021-01-07,PF/BT,190326.0,HSP11 - P.O. S. VINCENZO TAORMINA,SIC,40-49,16,27,0,42,1,0,0,43,0,43,Sicilia,ITG1
2021-01-07,PF/BT,190326.0,HSP11 - P.O. S. VINCENZO TAORMINA,SIC,50-59,24,51,0,74,1,0,0,75,0,75,Sicilia,ITG1
2021-01-07,PF/BT,190326.0,HSP11 - P.O. S. VINCENZO TAORMINA,SIC,60-69,12,11,0,21,2,0,0,23,0,23,Sicilia,ITG1
2021-01-07,PF/BT,190328.0,HSP11 - P.O. BARONE-ROMEO PATTI,SIC,20-29,3,2,0,2,3,0,0,5,0,5,Sicilia,ITG1
2021-01-07,PF/BT,190328.0,HSP11 - P.O. BARONE-ROMEO PATTI,SIC,30-39,4,4,0,6,2,0,0,8,0,8,Sicilia,ITG1
2021-01-07,PF/BT,190328.0,HSP11 - P.O. BARONE-ROMEO PATTI,SIC,40-49,10,11,0,14,7,0,0,21,0,21,Sicilia,ITG1
2021-01-07,PF/BT,190328.0,HSP11 - P.O. BARONE-ROMEO PATTI,SIC,50-59,18,31,0,42,6,0,1,49,0,49,Sicilia,ITG1
2021-01-07,PF/BT,190328.0,HSP11 - P.O. BARONE-ROMEO PATTI,SIC,60-69,13,12,0,19,6,0,0,25,0,25,Sicilia,ITG1
2021-01-07,PF/BT,190329.0,HSP11 - STABILIMENTO OSPED. S. AGATA MILITELLO,SIC,20-29,1,5,0,6,0,0,0,6,0,6,Sicilia,ITG1
2021-01-07,PF/BT,190329.0,HSP11 - STABILIMENTO OSPED. S. AGATA MILITELLO,SIC,30-39,3,4,0,7,0,0,0,7,0,7,Sicilia,ITG1
2021-01-07,PF/BT,190329.0,HSP11 - STABILIMENTO OSPED. S. AGATA MILITELLO,SIC,40-49,8,16,0,24,0,0,0,24,0,24,Sicilia,ITG1
2021-01-07,PF/BT,190329.0,HSP11 - STABILIMENTO OSPED. S. AGATA MILITELLO,SIC,50-59,23,27,0,50,0,0,0,50,0,50,Sicilia,ITG1
2021-01-07,PF/BT,190329.0,HSP11 - STABILIMENTO OSPED. S. AGATA MILITELLO,SIC,60-69,22,16,0,38,0,0,0,38,0,38,Sicilia,ITG1
2021-01-07,PF/BT,190330.0,HSP11 - P.O. DEI BIANCHI CORLEONE,SIC,20-29,2,3,0,4,1,0,0,5,0,5,Sicilia,ITG1
2021-01-07,PF/BT,190330.0,HSP11 - P.O. DEI BIANCHI CORLEONE,SIC,30-39,6,6,0,10,2,0,0,12,0,12,Sicilia,ITG1
2021-01-07,PF/BT,190330.0,HSP11 - P.O. DEI BIANCHI CORLEONE,SIC,40-49,10,8,0,15,3,0,0,18,0,18,Sicilia,ITG1
2021-01-07,PF/BT,190330.0,HSP11 - P.O. DEI BIANCHI CORLEONE,SIC,50-59,14,22,0,25,11,0,0,36,0,36,Sicilia,ITG1
2021-01-07,PF/BT,190330.0,HSP11 - P.O. DEI BIANCHI CORLEONE,SIC,60-69,14,11,0,17,8,0,0,25,0,25,Sicilia,ITG1
2021-01-07,PF/BT,190332.0,HSP11 - P.O. CIVICO PARTINICO,SIC,20-29,3,6,0,7,2,0,0,9,0,9,Sicilia,ITG1
2021-01-07,PF/BT,190332.0,HSP11 - P.O. CIVICO PARTINICO,SIC,30-39,9,12,0,16,5,0,0,21,0,21,Sicilia,ITG1
2021-01-07,PF/BT,190332.0,HSP11 - P.O. CIVICO PARTINICO,SIC,40-49,20,14,0,23,11,0,0,34,0,34,Sicilia,ITG1
2021-01-07,PF/BT,190332.0,HSP11 - P.O. CIVICO PARTINICO,SIC,50-59,20,14,0,20,14,0,0,34,0,34,Sicilia,ITG1
2021-01-07,PF/BT,190332.0,HSP11 - P.O. CIVICO PARTINICO,SIC,60-69,13,13,0,19,7,0,0,26,0,26,Sicilia,ITG1
2021-01-07,PF/BT,190332.0,HSP11 - P.O. CIVICO PARTINICO,SIC,70-79,5,0,0,3,2,0,0,5,0,5,Sicilia,ITG1
2021-01-07,PF/BT,190332.0,HSP11 - P.O. CIVICO PARTINICO,SIC,80-89,1,2,0,0,3,0,0,3,0,3,Sicilia,ITG1
2021-01-07,PF/BT,190333.0,HSP11 - P.O. MADONNA DELLALTO - PETR. SOTTANA,SIC,16-19,1,0,0,0,1,0,0,1,0,1,Sicilia,ITG1
2021-01-07,PF/BT,190333.0,HSP11 - P.O. MADONNA DELLALTO - PETR. SOTTANA,SIC,20-29,7,6,0,5,7,0,1,13,0,13,Sicilia,ITG1
2021-01-07,PF/BT,190333.0,HSP11 - P.O. MADONNA DELLALTO - PETR. SOTTANA,SIC,30-39,9,4,0,1,9,0,3,13,0,13,Sicilia,ITG1
2021-01-07,PF/BT,190333.0,HSP11 - P.O. MADONNA DELLALTO - PETR. SOTTANA,SIC,40-49,2,6,0,1,6,0,1,8,0,8,Sicilia,ITG1
2021-01-07,PF/BT,190333.0,HSP11 - P.O. MADONNA DELLALTO - PETR. SOTTANA,SIC,50-59,5,4,0,5,3,0,1,9,0,9,Sicilia,ITG1
2021-01-07,PF/BT,190333.0,HSP11 - P.O. MADONNA DELLALTO - PETR. SOTTANA,SIC,60-69,6,3,0,3,3,0,3,9,0,9,Sicilia,ITG1
2021-01-07,PF/BT,190333.0,HSP11 - P.O. MADONNA DELLALTO - PETR. SOTTANA,SIC,70-79,1,0,0,0,0,0,1,1,0,1,Sicilia,ITG1
2021-01-07,PF/BT,190334.0,HSP11 - P.O. S. CIMINO TERMINI IMERESE,SIC,20-29,3,2,0,5,0,0,0,5,0,5,Sicilia,ITG1
2021-01-07,PF/BT,190334.0,HSP11 - P.O. S. CIMINO TERMINI IMERESE,SIC,30-39,4,4,0,8,0,0,0,8,0,8,Sicilia,ITG1
2021-01-07,PF/BT,190334.0,HSP11 - P.O. S. CIMINO TERMINI IMERESE,SIC,40-49,7,8,0,15,0,0,0,15,0,15,Sicilia,ITG1
2021-01-07,PF/BT,190334.0,HSP11 - P.O. S. CIMINO TERMINI IMERESE,SIC,50-59,24,29,0,53,0,0,0,53,0,53,Sicilia,ITG1
2021-01-07,PF/BT,190334.0,HSP11 - P.O. S. CIMINO TERMINI IMERESE,SIC,60-69,33,32,0,65,0,0,0,65,0,65,Sicilia,ITG1
2021-01-07,PF/BT,190334.0,HSP11 - P.O. S. CIMINO TERMINI IMERESE,SIC,70-79,3,0,0,3,0,0,0,3,0,3,Sicilia,ITG1
2021-01-07,PF/BT,190335.0,HSP11 - P.O. G. F. INGRASSIA,SIC,30-39,7,4,0,11,0,0,0,11,0,11,Sicilia,ITG1
2021-01-07,PF/BT,190335.0,HSP11 - P.O. G. F. INGRASSIA,SIC,40-49,3,5,0,8,0,0,0,8,0,8,Sicilia,ITG1
2021-01-07,PF/BT,190335.0,HSP11 - P.O. G. F. INGRASSIA,SIC,50-59,4,4,0,8,0,0,0,8,0,8,Sicilia,ITG1
2021-01-07,PF/BT,190335.0,HSP11 - P.O. G. F. INGRASSIA,SIC,60-69,5,2,0,7,0,0,0,7,0,7,Sicilia,ITG1
2021-01-07,PF/BT,190337.0,HSP11 - P.O. VILLA DELLE GINESTRE,SIC,16-19,0,1,0,0,0,0,1,1,0,1,Sicilia,ITG1
2021-01-07,PF/BT,190337.0,HSP11 - P.O. VILLA DELLE GINESTRE,SIC,20-29,8,7,0,12,2,0,1,15,0,15,Sicilia,ITG1
2021-01-07,PF/BT,190337.0,HSP11 - P.O. VILLA DELLE GINESTRE,SIC,30-39,17,14,0,23,7,0,1,31,0,31,Sicilia,ITG1
2021-01-07,PF/BT,190337.0,HSP11 - P.O. VILLA DELLE GINESTRE,SIC,40-49,29,26,0,35,18,0,2,55,0,55,Sicilia,ITG1
2021-01-07,PF/BT,190337.0,HSP11 - P.O. VILLA DELLE GINESTRE,SIC,50-59,51,24,0,44,23,0,8,75,0,75,Sicilia,ITG1
2021-01-07,PF/BT,190337.0,HSP11 - P.O. VILLA DELLE GINESTRE,SIC,60-69,54,27,0,60,20,0,1,81,0,81,Sicilia,ITG1
2021-01-07,PF/BT,190337.0,HSP11 - P.O. VILLA DELLE GINESTRE,SIC,70-79,15,3,0,16,1,0,1,18,0,18,Sicilia,ITG1
2021-01-07,PF/BT,190337.0,HSP11 - P.O. VILLA DELLE GINESTRE,SIC,80-89,2,0,0,2,0,0,0,2,0,2,Sicilia,ITG1
2021-01-07,PF/BT,190338.0,HSP11 - OSPEDALE Giovanni Paolo II° M.P. A.,SIC,20-29,10,13,0,22,1,0,0,23,0,23,Sicilia,ITG1
2021-01-07,PF/BT,190338.0,HSP11 - OSPEDALE Giovanni Paolo II° M.P. A.,SIC,30-39,13,19,0,32,0,0,0,32,0,32,Sicilia,ITG1
2021-01-07,PF/BT,190338.0,HSP11 - OSPEDALE Giovanni Paolo II° M.P. A.,SIC,40-49,21,30,0,43,7,0,1,51,0,51,Sicilia,ITG1
2021-01-07,PF/BT,190338.0,HSP11 - OSPEDALE Giovanni Paolo II° M.P. A.,SIC,50-59,26,34,0,57,3,0,0,60,0,60,Sicilia,ITG1
2021-01-07,PF/BT,190338.0,HSP11 - OSPEDALE Giovanni Paolo II° M.P. A.,SIC,60-69,11,20,0,29,2,0,0,31,0,31,Sicilia,ITG1
2021-01-07,PF/BT,190338.0,HSP11 - OSPEDALE Giovanni Paolo II° M.P. A.,SIC,70-79,1,0,0,1,0,0,0,1,0,1,Sicilia,ITG1
2021-01-07,PF/BT,190339.0,HSP11 - OSPEDALE REGINA MARGHERITA  COMISO,SIC,30-39,1,1,0,2,0,0,0,2,0,2,Sicilia,ITG1
2021-01-07,PF/BT,190339.0,HSP11 - OSPEDALE REGINA MARGHERITA  COMISO,SIC,40-49,2,3,0,5,0,0,0,5,0,5,Sicilia,ITG1
2021-01-07,PF/BT,190339.0,HSP11 - OSPEDALE REGINA MARGHERITA  COMISO,SIC,50-59,2,5,0,7,0,0,0,7,0,7,Sicilia,ITG1
2021-01-07,PF/BT,190339.0,HSP11 - OSPEDALE REGINA MARGHERITA  COMISO,SIC,60-69,1,2,0,3,0,0,0,3,0,3,Sicilia,ITG1
2021-01-07,PF/BT,190340.0,HSP11 - OSPEDALE MAGGIORE MODICA,SIC,20-29,2,7,0,9,0,0,0,9,0,9,Sicilia,ITG1
2021-01-07,PF/BT,190340.0,HSP11 - OSPEDALE MAGGIORE MODICA,SIC,30-39,1,7,0,8,0,0,0,8,0,8,Sicilia,ITG1
2021-01-07,PF/BT,190340.0,HSP11 - OSPEDALE MAGGIORE MODICA,SIC,40-49,4,12,0,13,3,0,0,16,0,16,Sicilia,ITG1
2021-01-07,PF/BT,190340.0,HSP11 - OSPEDALE MAGGIORE MODICA,SIC,50-59,14,24,0,36,2,0,0,38,0,38,Sicilia,ITG1
2021-01-07,PF/BT,190340.0,HSP11 - OSPEDALE MAGGIORE MODICA,SIC,60-69,12,11,0,22,1,0,0,23,0,23,Sicilia,ITG1
2021-01-07,PF/BT,190341.0,HSP11 - OSPEDALE BUSACCA SCICLI,SIC,16-19,0,1,0,1,0,0,0,1,0,1,Sicilia,ITG1
2021-01-07,PF/BT,190341.0,HSP11 - OSPEDALE BUSACCA SCICLI,SIC,20-29,2,7,0,7,2,0,0,9,0,9,Sicilia,ITG1
2021-01-07,PF/BT,190341.0,HSP11 - OSPEDALE BUSACCA SCICLI,SIC,30-39,5,9,0,14,0,0,0,14,0,14,Sicilia,ITG1
2021-01-07,PF/BT,190341.0,HSP11 - OSPEDALE BUSACCA SCICLI,SIC,40-49,10,8,0,17,1,0,0,18,0,18,Sicilia,ITG1
2021-01-07,PF/BT,190341.0,HSP11 - OSPEDALE BUSACCA SCICLI,SIC,50-59,4,12,0,14,1,1,0,16,0,16,Sicilia,ITG1
2021-01-07,PF/BT,190341.0,HSP11 - OSPEDALE BUSACCA SCICLI,SIC,60-69,5,7,0,10,1,1,0,12,0,12,Sicilia,ITG1
2021-01-07,PF/BT,190341.0,HSP11 - OSPEDALE BUSACCA SCICLI,SIC,70-79,1,1,0,0,0,2,0,2,0,2,Sicilia,ITG1
2021-01-07,PF/BT,190341.0,HSP11 - OSPEDALE BUSACCA SCICLI,SIC,80-89,0,2,0,0,0,2,0,2,0,2,Sicilia,ITG1
2021-01-07,PF/BT,190342.0,HSP11 - OSPEDALE GUZZARDI VITTORIA,SIC,20-29,4,5,0,9,0,0,0,9,0,9,Sicilia,ITG1
2021-01-07,PF/BT,190342.0,HSP11 - OSPEDALE GUZZARDI VITTORIA,SIC,30-39,2,9,0,11,0,0,0,11,0,11,Sicilia,ITG1
2021-01-07,PF/BT,190342.0,HSP11 - OSPEDALE GUZZARDI VITTORIA,SIC,40-49,14,10,0,23,1,0,0,24,0,24,Sicilia,ITG1
2021-01-07,PF/BT,190342.0,HSP11 - OSPEDALE GUZZARDI VITTORIA,SIC,50-59,11,14,0,25,0,0,0,25,0,25,Sicilia,ITG1
2021-01-07,PF/BT,190342.0,HSP11 - OSPEDALE GUZZARDI VITTORIA,SIC,60-69,5,8,0,13,0,0,0,13,0,13,Sicilia,ITG1
2021-01-07,PF/BT,190343.0,HSP11 - P.O. DI MARIA AVOLA,SIC,20-29,0,2,0,2,0,0,0,2,0,2,Sicilia,ITG1
2021-01-07,PF/BT,190343.0,HSP11 - P.O. DI MARIA AVOLA,SIC,30-39,3,3,0,6,0,0,0,6,0,6,Sicilia,ITG1
2021-01-07,PF/BT,190343.0,HSP11 - P.O. DI MARIA AVOLA,SIC,40-49,6,7,0,13,0,0,0,13,0,13,Sicilia,ITG1
2021-01-07,PF/BT,190343.0,HSP11 - P.O. DI MARIA AVOLA,SIC,50-59,7,19,0,26,0,0,0,26,0,26,Sicilia,ITG1
2021-01-07,PF/BT,190343.0,HSP11 - P.O. DI MARIA AVOLA,SIC,60-69,19,12,0,31,0,0,0,31,0,31,Sicilia,ITG1
2021-01-07,PF/BT,190345.0,HSP11 - P.O. UMBERTO I (EX A.O.),SIC,20-29,3,1,0,4,0,0,0,4,0,4,Sicilia,ITG1
2021-01-07,PF/BT,190345.0,HSP11 - P.O. UMBERTO I (EX A.O.),SIC,30-39,9,10,0,19,0,0,0,19,0,19,Sicilia,ITG1
2021-01-07,PF/BT,190345.0,HSP11 - P.O. UMBERTO I (EX A.O.),SIC,40-49,17,11,0,27,1,0,0,28,0,28,Sicilia,ITG1
2021-01-07,PF/BT,190345.0,HSP11 - P.O. UMBERTO I (EX A.O.),SIC,50-59,19,23,0,41,1,0,0,42,0,42,Sicilia,ITG1
2021-01-07,PF/BT,190345.0,HSP11 - P.O. UMBERTO I (EX A.O.),SIC,60-69,23,15,0,38,0,0,0,38,0,38,Sicilia,ITG1
2021-01-07,PF/BT,190345.0,HSP11 - P.O. UMBERTO I (EX A.O.),SIC,80-89,1,0,0,1,0,0,0,1,0,1,Sicilia,ITG1
2021-01-07,PF/BT,190346.0,HSP11 - P.O. MUSCATELLO AUGUSTA,SIC,20-29,0,1,0,1,0,0,0,1,0,1,Sicilia,ITG1
2021-01-07,PF/BT,190346.0,HSP11 - P.O. MUSCATELLO AUGUSTA,SIC,30-39,2,6,0,8,0,0,0,8,0,8,Sicilia,ITG1
2021-01-07,PF/BT,190346.0,HSP11 - P.O. MUSCATELLO AUGUSTA,SIC,40-49,3,5,0,8,0,0,0,8,0,8,Sicilia,ITG1
2021-01-07,PF/BT,190346.0,HSP11 - P.O. MUSCATELLO AUGUSTA,SIC,50-59,5,11,0,16,0,0,0,16,0,16,Sicilia,ITG1
2021-01-07,PF/BT,190346.0,HSP11 - P.O. MUSCATELLO AUGUSTA,SIC,60-69,9,6,0,15,0,0,0,15,0,15,Sicilia,ITG1
2021-01-07,PF/BT,190347.0,HSP11 - OSPEDALE GENERALE DI ZONA,SIC,20-29,0,5,0,1,4,0,0,5,0,5,Sicilia,ITG1
2021-01-07,PF/BT,190347.0,HSP11 - OSPEDALE GENERALE DI ZONA,SIC,30-39,10,13,0,20,3,0,0,23,0,23,Sicilia,ITG1
2021-01-07,PF/BT,190347.0,HSP11 - OSPEDALE GENERALE DI ZONA,SIC,40-49,16,24,0,32,8,0,0,40,0,40,Sicilia,ITG1
2021-01-07,PF/BT,190347.0,HSP11 - OSPEDALE GENERALE DI ZONA,SIC,50-59,13,16,0,26,3,0,0,29,0,29,Sicilia,ITG1
2021-01-07,PF/BT,190347.0,HSP11 - OSPEDALE GENERALE DI ZONA,SIC,60-69,9,14,0,20,3,0,0,23,0,23,Sicilia,ITG1
2021-01-07,PF/BT,190349.0,HSP11 - P.O. SAN VITO E SANTO SPIRITO -ALCAMO,SIC,20-29,5,5,0,8,2,0,0,10,0,10,Sicilia,ITG1
2021-01-07,PF/BT,190349.0,HSP11 - P.O. SAN VITO E SANTO SPIRITO -ALCAMO,SIC,30-39,7,12,0,15,3,0,1,19,0,19,Sicilia,ITG1
2021-01-07,PF/BT,190349.0,HSP11 - P.O. SAN VITO E SANTO SPIRITO -ALCAMO,SIC,40-49,6,18,0,19,1,0,4,24,0,24,Sicilia,ITG1
2021-01-07,PF/BT,190349.0,HSP11 - P.O. SAN VITO E SANTO SPIRITO -ALCAMO,SIC,50-59,11,20,0,24,7,0,0,31,0,31,Sicilia,ITG1
2021-01-07,PF/BT,190349.0,HSP11 - P.O. SAN VITO E SANTO SPIRITO -ALCAMO,SIC,60-69,14,7,0,17,3,0,1,21,0,21,Sicilia,ITG1
2021-01-07,PF/BT,190349.0,HSP11 - P.O. SAN VITO E SANTO SPIRITO -ALCAMO,SIC,70-79,3,0,0,3,0,0,0,3,0,3,Sicilia,ITG1
2021-01-07,PF/BT,190351.0,HSP11 - P.O. S. ANTONIO ABATE  - TRAPANI,SIC,20-29,11,14,0,24,1,0,0,25,0,25,Sicilia,ITG1
2021-01-07,PF/BT,190351.0,HSP11 - P.O. S. ANTONIO ABATE  - TRAPANI,SIC,30-39,17,22,0,38,1,0,0,39,0,39,Sicilia,ITG1
2021-01-07,PF/BT,190351.0,HSP11 - P.O. S. ANTONIO ABATE  - TRAPANI,SIC,40-49,21,37,0,55,3,0,0,58,0,58,Sicilia,ITG1
2021-01-07,PF/BT,190351.0,HSP11 - P.O. S. ANTONIO ABATE  - TRAPANI,SIC,50-59,29,34,0,59,4,0,0,63,0,63,Sicilia,ITG1
2021-01-07,PF/BT,190351.0,HSP11 - P.O. S. ANTONIO ABATE  - TRAPANI,SIC,60-69,28,24,0,44,8,0,0,52,0,52,Sicilia,ITG1
2021-01-07,PF/BT,190351.0,HSP11 - P.O. S. ANTONIO ABATE  - TRAPANI,SIC,70-79,6,0,0,6,0,0,0,6,0,6,Sicilia,ITG1
2021-01-07,PF/BT,190351.0,RIA11 - C.S.R. - CENTRO DI COMISO,SIC,20-29,1,1,0,2,0,0,0,2,0,2,Sicilia,ITG1
2021-01-07,PF/BT,190351.0,RIA11 - C.S.R. - CENTRO DI COMISO,SIC,30-39,0,2,0,2,0,0,0,2,0,2,Sicilia,ITG1
2021-01-07,PF/BT,190351.0,RIA11 - C.S.R. - CENTRO DI COMISO,SIC,40-49,0,5,0,5,0,0,0,5,0,5,Sicilia,ITG1
2021-01-07,PF/BT,190351.0,RIA11 - C.S.R. - CENTRO DI COMISO,SIC,50-59,2,5,0,7,0,0,0,7,0,7,Sicilia,ITG1
2021-01-07,PF/BT,190351.0,RIA11 - C.S.R. - CENTRO DI COMISO,SIC,60-69,0,2,0,2,0,0,0,2,0,2,Sicilia,ITG1
2021-01-07,PF/BT,190352.0,HSP11 - P.O. V.EMANUELE II CASTELVETRANO,SIC,20-29,7,9,0,14,1,0,1,16,0,16,Sicilia,ITG1
2021-01-07,PF/BT,190352.0,HSP11 - P.O. V.EMANUELE II CASTELVETRANO,SIC,30-39,6,11,0,12,3,0,2,17,0,17,Sicilia,ITG1
2021-01-07,PF/BT,190352.0,HSP11 - P.O. V.EMANUELE II CASTELVETRANO,SIC,40-49,11,16,0,16,8,0,3,27,0,27,Sicilia,ITG1
2021-01-07,PF/BT,190352.0,HSP11 - P.O. V.EMANUELE II CASTELVETRANO,SIC,50-59,15,16,0,22,8,0,1,31,0,31,Sicilia,ITG1
2021-01-07,PF/BT,190352.0,HSP11 - P.O. V.EMANUELE II CASTELVETRANO,SIC,60-69,11,9,0,16,2,0,2,20,0,20,Sicilia,ITG1
2021-01-07,PF/BT,190352.0,HSP11 - P.O. V.EMANUELE II CASTELVETRANO,SIC,70-79,2,0,0,1,1,0,0,2,0,2,Sicilia,ITG1
2021-01-07,PF/BT,190352.0,HSP11 - P.O. V.EMANUELE II CASTELVETRANO,SIC,80-89,1,0,0,0,1,0,0,1,0,1,Sicilia,ITG1
2021-01-07,PF/BT,190353.0,HSP11 - P.O.PAOLO BORSELLINO - MARSALA,SIC,20-29,3,13,0,16,0,0,0,16,0,16,Sicilia,ITG1
2021-01-07,PF/BT,190353.0,HSP11 - P.O.PAOLO BORSELLINO - MARSALA,SIC,30-39,9,11,0,20,0,0,0,20,0,20,Sicilia,ITG1
2021-01-07,PF/BT,190353.0,HSP11 - P.O.PAOLO BORSELLINO - MARSALA,SIC,40-49,9,11,0,20,0,0,0,20,0,20,Sicilia,ITG1
2021-01-07,PF/BT,190353.0,HSP11 - P.O.PAOLO BORSELLINO - MARSALA,SIC,50-59,18,20,0,38,0,0,0,38,0,38,Sicilia,ITG1
2021-01-07,PF/BT,190353.0,HSP11 - P.O.PAOLO BORSELLINO - MARSALA,SIC,60-69,17,13,0,30,0,0,0,30,0,30,Sicilia,ITG1
2021-01-07,PF/BT,190353.0,HSP11 - P.O.PAOLO BORSELLINO - MARSALA,SIC,70-79,2,0,0,2,0,0,0,2,0,2,Sicilia,ITG1
2021-01-07,PF/BT,190354.0,HSP11 - P.O.ABELE AJELLO-MAZARA D.VALLO,SIC,16-19,1,0,0,1,0,0,0,1,0,1,Sicilia,ITG1
2021-01-07,PF/BT,190354.0,HSP11 - P.O.ABELE AJELLO-MAZARA D.VALLO,SIC,20-29,1,6,0,6,1,0,0,7,0,7,Sicilia,ITG1
2021-01-07,PF/BT,190354.0,HSP11 - P.O.ABELE AJELLO-MAZARA D.VALLO,SIC,30-39,11,9,0,20,0,0,0,20,0,20,Sicilia,ITG1
2021-01-07,PF/BT,190354.0,HSP11 - P.O.ABELE AJELLO-MAZARA D.VALLO,SIC,40-49,10,20,0,28,2,0,0,30,0,30,Sicilia,ITG1
2021-01-07,PF/BT,190354.0,HSP11 - P.O.ABELE AJELLO-MAZARA D.VALLO,SIC,50-59,10,28,0,34,4,0,0,38,0,38,Sicilia,ITG1
2021-01-07,PF/BT,190354.0,HSP11 - P.O.ABELE AJELLO-MAZARA D.VALLO,SIC,60-69,16,8,0,24,0,0,0,24,0,24,Sicilia,ITG1
2021-01-07,PF/BT,190355.0,HSP11 - P.O. VITTORIO EMANUELE III - SALEMI,SIC,16-19,1,0,0,1,0,0,0,1,0,1,Sicilia,ITG1
2021-01-07,PF/BT,190355.0,HSP11 - P.O. VITTORIO EMANUELE III - SALEMI,SIC,20-29,4,4,0,8,0,0,0,8,0,8,Sicilia,ITG1
2021-01-07,PF/BT,190355.0,HSP11 - P.O. VITTORIO EMANUELE III - SALEMI,SIC,30-39,4,10,0,14,0,0,0,14,0,14,Sicilia,ITG1
2021-01-07,PF/BT,190355.0,HSP11 - P.O. VITTORIO EMANUELE III - SALEMI,SIC,40-49,9,20,0,29,0,0,0,29,0,29,Sicilia,ITG1
2021-01-07,PF/BT,190355.0,HSP11 - P.O. VITTORIO EMANUELE III - SALEMI,SIC,50-59,16,15,0,31,0,0,0,31,0,31,Sicilia,ITG1
2021-01-07,PF/BT,190355.0,HSP11 - P.O. VITTORIO EMANUELE III - SALEMI,SIC,60-69,8,4,0,12,0,0,0,12,0,12,Sicilia,ITG1
2021-01-07,PF/BT,190355.0,HSP11 - P.O. VITTORIO EMANUELE III - SALEMI,SIC,70-79,1,0,0,1,0,0,0,1,0,1,Sicilia,ITG1
2021-01-07,PF/BT,190511.0,HSP11 - CASA DI CURA DI STEFANO VELONA S.R.L.,SIC,20-29,0,3,0,3,0,0,0,3,0,3,Sicilia,ITG1
2021-01-07,PF/BT,190511.0,HSP11 - CASA DI CURA DI STEFANO VELONA S.R.L.,SIC,30-39,2,1,0,1,2,0,0,3,0,3,Sicilia,ITG1
2021-01-07,PF/BT,190511.0,HSP11 - CASA DI CURA DI STEFANO VELONA S.R.L.,SIC,40-49,2,5,0,1,6,0,0,7,0,7,Sicilia,ITG1
2021-01-07,PF/BT,190511.0,HSP11 - CASA DI CURA DI STEFANO VELONA S.R.L.,SIC,50-59,3,3,0,4,1,0,1,6,0,6,Sicilia,ITG1
2021-01-07,PF/BT,190511.0,HSP11 - CASA DI CURA DI STEFANO VELONA S.R.L.,SIC,60-69,4,0,0,4,0,0,0,4,0,4,Sicilia,ITG1
2021-01-07,PF/BT,190511.0,HSP11 - CASA DI CURA DI STEFANO VELONA S.R.L.,SIC,70-79,1,0,0,1,0,0,0,1,0,1,Sicilia,ITG1
2021-01-07,PF/BT,190512.0,HSP11 - CASA DI CURA MADONNA DEL ROSARIO,SIC,20-29,1,0,0,1,0,0,0,1,0,1,Sicilia,ITG1
2021-01-07,PF/BT,190512.0,HSP11 - CASA DI CURA MADONNA DEL ROSARIO,SIC,30-39,1,1,0,2,0,0,0,2,0,2,Sicilia,ITG1
2021-01-07,PF/BT,190512.0,HSP11 - CASA DI CURA MADONNA DEL ROSARIO,SIC,40-49,1,3,0,2,2,0,0,4,0,4,Sicilia,ITG1
2021-01-07,PF/BT,190512.0,HSP11 - CASA DI CURA MADONNA DEL ROSARIO,SIC,50-59,2,1,0,2,1,0,0,3,0,3,Sicilia,ITG1
2021-01-07,PF/BT,190512.0,HSP11 - CASA DI CURA MADONNA DEL ROSARIO,SIC,60-69,1,1,0,2,0,0,0,2,0,2,Sicilia,ITG1
2021-01-07,PF/BT,190513.0,HSP11 - CASA DI CURA G.B. MORGAGNI S.R.L.,SIC,20-29,17,31,0,40,6,0,2,48,0,48,Sicilia,ITG1
2021-01-07,PF/BT,190513.0,HSP11 - CASA DI CURA G.B. MORGAGNI S.R.L.,SIC,30-39,12,17,0,21,6,0,2,29,0,29,Sicilia,ITG1
2021-01-07,PF/BT,190513.0,HSP11 - CASA DI CURA G.B. MORGAGNI S.R.L.,SIC,40-49,10,21,0,22,8,0,1,31,0,31,Sicilia,ITG1
2021-01-07,PF/BT,190513.0,HSP11 - CASA DI CURA G.B. MORGAGNI S.R.L.,SIC,50-59,17,18,0,24,7,0,4,35,0,35,Sicilia,ITG1
2021-01-07,PF/BT,190513.0,HSP11 - CASA DI CURA G.B. MORGAGNI S.R.L.,SIC,60-69,15,6,0,16,3,0,2,21,0,21,Sicilia,ITG1
2021-01-07,PF/BT,190513.0,HSP11 - CASA DI CURA G.B. MORGAGNI S.R.L.,SIC,70-79,6,0,0,5,0,0,1,6,0,6,Sicilia,ITG1
2021-01-07,PF/BT,190513.0,HSP11 - CASA DI CURA G.B. MORGAGNI S.R.L.,SIC,80-89,1,0,0,1,0,0,0,1,0,1,Sicilia,ITG1
2021-01-07,PF/BT,190519.0,HSP11 - HUMANITAS ISTITUTO CLINICO CATANESE,SIC,20-29,8,10,0,17,1,0,0,18,0,18,Sicilia,ITG1
2021-01-07,PF/BT,190519.0,HSP11 - HUMANITAS ISTITUTO CLINICO CATANESE,SIC,30-39,20,22,0,36,6,0,0,42,0,42,Sicilia,ITG1
2021-01-07,PF/BT,190519.0,HSP11 - HUMANITAS ISTITUTO CLINICO CATANESE,SIC,40-49,17,15,0,26,6,0,0,32,0,32,Sicilia,ITG1
2021-01-07,PF/BT,190519.0,HSP11 - HUMANITAS ISTITUTO CLINICO CATANESE,SIC,50-59,13,10,0,18,5,0,0,23,0,23,Sicilia,ITG1
2021-01-07,PF/BT,190519.0,HSP11 - HUMANITAS ISTITUTO CLINICO CATANESE,SIC,60-69,9,3,0,11,1,0,0,12,0,12,Sicilia,ITG1
2021-01-07,PF/BT,190519.0,HSP11 - HUMANITAS ISTITUTO CLINICO CATANESE,SIC,70-79,1,0,0,1,0,0,0,1,0,1,Sicilia,ITG1
2021-01-07,PF/BT,190521.0,HSP11 - CASA DI CURA CARMIDE,SIC,20-29,15,9,0,22,2,0,0,24,0,24,Sicilia,ITG1
2021-01-07,PF/BT,190521.0,HSP11 - CASA DI CURA CARMIDE,SIC,30-39,13,16,0,26,3,0,0,29,0,29,Sicilia,ITG1
2021-01-07,PF/BT,190521.0,HSP11 - CASA DI CURA CARMIDE,SIC,40-49,17,23,0,34,6,0,0,40,0,40,Sicilia,ITG1
2021-01-07,PF/BT,190521.0,HSP11 - CASA DI CURA CARMIDE,SIC,50-59,14,18,0,27,5,0,0,32,0,32,Sicilia,ITG1
2021-01-07,PF/BT,190521.0,HSP11 - CASA DI CURA CARMIDE,SIC,60-69,2,8,0,8,2,0,0,10,0,10,Sicilia,ITG1
2021-01-07,PF/BT,190521.0,HSP11 - CASA DI CURA CARMIDE,SIC,70-79,1,0,0,0,1,0,0,1,0,1,Sicilia,ITG1
2021-01-07,PF/BT,190521.0,HSP11 - CASA DI CURA CARMIDE,SIC,80-89,1,0,0,1,0,0,0,1,0,1,Sicilia,ITG1
2021-01-07,PF/BT,190525.0,HSP11 - CASA DI CURA S.CAMILLO,SIC,20-29,2,4,0,5,0,0,1,6,0,6,Sicilia,ITG1
2021-01-07,PF/BT,190525.0,HSP11 - CASA DI CURA S.CAMILLO,SIC,30-39,3,1,0,4,0,0,0,4,0,4,Sicilia,ITG1
2021-01-07,PF/BT,190525.0,HSP11 - CASA DI CURA S.CAMILLO,SIC,40-49,6,4,0,5,0,0,5,10,0,10,Sicilia,ITG1
2021-01-07,PF/BT,190525.0,HSP11 - CASA DI CURA S.CAMILLO,SIC,50-59,5,4,0,3,0,0,6,9,0,9,Sicilia,ITG1
2021-01-07,PF/BT,190525.0,HSP11 - CASA DI CURA S.CAMILLO,SIC,60-69,3,4,0,3,0,0,4,7,0,7,Sicilia,ITG1
2021-01-07,PF/BT,190528.0,HSP11 - CASA DI CURA VILLA SALUS S.A.S.,SIC,20-29,2,4,0,5,1,0,0,6,0,6,Sicilia,ITG1
2021-01-07,PF/BT,190528.0,HSP11 - CASA DI CURA VILLA SALUS S.A.S.,SIC,30-39,5,8,0,13,0,0,0,13,0,13,Sicilia,ITG1
2021-01-07,PF/BT,190528.0,HSP11 - CASA DI CURA VILLA SALUS S.A.S.,SIC,40-49,7,10,0,16,1,0,0,17,0,17,Sicilia,ITG1
2021-01-07,PF/BT,190528.0,HSP11 - CASA DI CURA VILLA SALUS S.A.S.,SIC,50-59,4,9,0,13,0,0,0,13,0,13,Sicilia,ITG1
2021-01-07,PF/BT,190528.0,HSP11 - CASA DI CURA VILLA SALUS S.A.S.,SIC,60-69,4,4,0,8,0,0,0,8,0,8,Sicilia,ITG1
2021-01-07,PF/BT,190528.0,HSP11 - CASA DI CURA VILLA SALUS S.A.S.,SIC,70-79,3,0,0,3,0,0,0,3,0,3,Sicilia,ITG1
2021-01-07,PF/BT,190530.0,HSP11 - C.O.T. S.P.A. (CURE ORTOPED. TRAUM.),SIC,20-29,3,6,0,8,1,0,0,9,0,9,Sicilia,ITG1
2021-01-07,PF/BT,190530.0,HSP11 - C.O.T. S.P.A. (CURE ORTOPED. TRAUM.),SIC,30-39,10,5,0,14,1,0,0,15,0,15,Sicilia,ITG1
2021-01-07,PF/BT,190530.0,HSP11 - C.O.T. S.P.A. (CURE ORTOPED. TRAUM.),SIC,40-49,6,2,0,6,2,0,0,8,0,8,Sicilia,ITG1
2021-01-07,PF/BT,190530.0,HSP11 - C.O.T. S.P.A. (CURE ORTOPED. TRAUM.),SIC,50-59,6,3,0,7,2,0,0,9,0,9,Sicilia,ITG1
2021-01-07,PF/BT,190530.0,HSP11 - C.O.T. S.P.A. (CURE ORTOPED. TRAUM.),SIC,60-69,4,1,0,5,0,0,0,5,0,5,Sicilia,ITG1
2021-01-07,PF/BT,190530.0,HSP11 - C.O.T. S.P.A. (CURE ORTOPED. TRAUM.),SIC,70-79,1,1,0,2,0,0,0,2,0,2,Sicilia,ITG1
2021-01-07,PF/BT,190531.0,HSP11 - CASA DI CURA VILLA IGEA SRL,SIC,20-29,1,0,0,1,0,0,0,1,0,1,Sicilia,ITG1
2021-01-07,PF/BT,190531.0,HSP11 - CASA DI CURA VILLA IGEA SRL,SIC,30-39,2,3,0,4,1,0,0,5,0,5,Sicilia,ITG1
2021-01-07,PF/BT,190531.0,HSP11 - CASA DI CURA VILLA IGEA SRL,SIC,40-49,6,5,0,7,0,0,4,11,0,11,Sicilia,ITG1
2021-01-07,PF/BT,190531.0,HSP11 - CASA DI CURA VILLA IGEA SRL,SIC,50-59,4,6,0,8,1,0,1,10,0,10,Sicilia,ITG1
2021-01-07,PF/BT,190531.0,HSP11 - CASA DI CURA VILLA IGEA SRL,SIC,60-69,3,1,0,4,0,0,0,4,0,4,Sicilia,ITG1
2021-01-07,PF/BT,190531.0,HSP11 - CASA DI CURA VILLA IGEA SRL,SIC,70-79,1,1,0,1,0,0,1,2,0,2,Sicilia,ITG1
2021-01-07,PF/BT,190552.0,HSP11 - CASA DI CURA CLINICA DEL MEDITERRANEO,SIC,20-29,2,6,0,5,3,0,0,8,0,8,Sicilia,ITG1
2021-01-07,PF/BT,190552.0,HSP11 - CASA DI CURA CLINICA DEL MEDITERRANEO,SIC,30-39,4,6,0,7,3,0,0,10,0,10,Sicilia,ITG1
2021-01-07,PF/BT,190552.0,HSP11 - CASA DI CURA CLINICA DEL MEDITERRANEO,SIC,40-49,10,14,0,18,5,0,1,24,0,24,Sicilia,ITG1
2021-01-07,PF/BT,190552.0,HSP11 - CASA DI CURA CLINICA DEL MEDITERRANEO,SIC,50-59,2,10,0,6,4,0,2,12,0,12,Sicilia,ITG1
2021-01-07,PF/BT,190552.0,HSP11 - CASA DI CURA CLINICA DEL MEDITERRANEO,SIC,60-69,8,4,0,11,1,0,0,12,0,12,Sicilia,ITG1
2021-01-07,PF/BT,190554.0,HSP11 - ISTITUTO ONCOLOGICO DEL MEDITERRANEO SPA,SIC,20-29,2,5,0,6,1,0,0,7,0,7,Sicilia,ITG1
2021-01-07,PF/BT,190554.0,HSP11 - ISTITUTO ONCOLOGICO DEL MEDITERRANEO SPA,SIC,30-39,2,11,0,12,1,0,0,13,0,13,Sicilia,ITG1
2021-01-07,PF/BT,190554.0,HSP11 - ISTITUTO ONCOLOGICO DEL MEDITERRANEO SPA,SIC,40-49,10,7,0,13,0,0,4,17,0,17,Sicilia,ITG1
2021-01-07,PF/BT,190554.0,HSP11 - ISTITUTO ONCOLOGICO DEL MEDITERRANEO SPA,SIC,50-59,3,7,0,6,3,0,1,10,0,10,Sicilia,ITG1
2021-01-07,PF/BT,190554.0,HSP11 - ISTITUTO ONCOLOGICO DEL MEDITERRANEO SPA,SIC,60-69,4,1,0,2,1,0,2,5,0,5,Sicilia,ITG1
2021-01-07,PF/BT,190554.0,HSP11 - ISTITUTO ONCOLOGICO DEL MEDITERRANEO SPA,SIC,70-79,6,0,0,6,0,0,0,6,0,6,Sicilia,ITG1
2021-01-07,PF/BT,190554.0,HSP11 - ISTITUTO ONCOLOGICO DEL MEDITERRANEO SPA,SIC,80-89,2,0,0,2,0,0,0,2,0,2,Sicilia,ITG1
2021-01-07,PF/BT,190712.0,HSP11 - CASA DI CURA MUSUMECI GECAS SRL,SIC,30-39,2,0,0,0,0,0,2,2,0,2,Sicilia,ITG1
2021-01-07,PF/BT,190712.0,HSP11 - CASA DI CURA MUSUMECI GECAS SRL,SIC,50-59,0,1,0,0,1,0,0,1,0,1,Sicilia,ITG1
2021-01-07,PF/BT,190712.0,HSP11 - CASA DI CURA MUSUMECI GECAS SRL,SIC,60-69,0,1,0,0,1,0,0,1,0,1,Sicilia,ITG1
2021-01-07,PF/BT,190716.0,HSP11 - CASA DI CURA CAPPELLANI GIOMI S.P.A.,SIC,20-29,2,4,0,6,0,0,0,6,0,6,Sicilia,ITG1
2021-01-07,PF/BT,190716.0,HSP11 - CASA DI CURA CAPPELLANI GIOMI S.P.A.,SIC,30-39,4,2,0,6,0,0,0,6,0,6,Sicilia,ITG1
2021-01-07,PF/BT,190716.0,HSP11 - CASA DI CURA CAPPELLANI GIOMI S.P.A.,SIC,40-49,2,10,0,12,0,0,0,12,0,12,Sicilia,ITG1
2021-01-07,PF/BT,190716.0,HSP11 - CASA DI CURA CAPPELLANI GIOMI S.P.A.,SIC,50-59,0,8,0,8,0,0,0,8,0,8,Sicilia,ITG1
2021-01-07,PF/BT,190716.0,HSP11 - CASA DI CURA CAPPELLANI GIOMI S.P.A.,SIC,60-69,6,2,0,8,0,0,0,8,0,8,Sicilia,ITG1
2021-01-07,PF/BT,190724.0,HSP11 - ISCAS MORGAGNI NORD SRL,SIC,20-29,2,8,0,9,1,0,0,10,0,10,Sicilia,ITG1
2021-01-07,PF/BT,190724.0,HSP11 - ISCAS MORGAGNI NORD SRL,SIC,30-39,10,3,0,13,0,0,0,13,0,13,Sicilia,ITG1
2021-01-07,PF/BT,190724.0,HSP11 - ISCAS MORGAGNI NORD SRL,SIC,40-49,6,7,0,13,0,0,0,13,0,13,Sicilia,ITG1
2021-01-07,PF/BT,190724.0,HSP11 - ISCAS MORGAGNI NORD SRL,SIC,50-59,8,4,0,11,1,0,0,12,0,12,Sicilia,ITG1
2021-01-07,PF/BT,190724.0,HSP11 - ISCAS MORGAGNI NORD SRL,SIC,60-69,11,1,0,12,0,0,0,12,0,12,Sicilia,ITG1
2021-01-07,PF/BT,190726.0,HSP11 - ISTITUTO CLINICO VIDIMURA srl,SIC,20-29,0,3,0,2,1,0,0,3,0,3,Sicilia,ITG1
2021-01-07,PF/BT,190726.0,HSP11 - ISTITUTO CLINICO VIDIMURA srl,SIC,30-39,1,0,0,1,0,0,0,1,0,1,Sicilia,ITG1
2021-01-07,PF/BT,190726.0,HSP11 - ISTITUTO CLINICO VIDIMURA srl,SIC,40-49,1,0,0,0,1,0,0,1,0,1,Sicilia,ITG1
2021-01-07,PF/BT,190726.0,HSP11 - ISTITUTO CLINICO VIDIMURA srl,SIC,70-79,1,0,0,1,0,0,0,1,0,1,Sicilia,ITG1
2021-01-07,PF/BT,190921.0,HSP11 - A.O. per lEmergenza Cannizzaro,SIC,20-29,2,5,0,7,0,0,0,7,0,7,Sicilia,ITG1
2021-01-07,PF/BT,190921.0,HSP11 - A.O. per lEmergenza Cannizzaro,SIC,30-39,21,14,0,34,1,0,0,35,0,35,Sicilia,ITG1
2021-01-07,PF/BT,190921.0,HSP11 - A.O. per lEmergenza Cannizzaro,SIC,40-49,19,28,0,46,1,0,0,47,0,47,Sicilia,ITG1
2021-01-07,PF/BT,190921.0,HSP11 - A.O. per lEmergenza Cannizzaro,SIC,50-59,31,35,0,60,6,0,0,66,0,66,Sicilia,ITG1
2021-01-07,PF/BT,190921.0,HSP11 - A.O. per lEmergenza Cannizzaro,SIC,60-69,16,15,0,28,3,0,0,31,0,31,Sicilia,ITG1
2021-01-07,PF/BT,19092201.0,HSP11 - OSPEDALE GARIBALDI - CENTRO,SIC,20-29,1,5,0,6,0,0,0,6,0,6,Sicilia,ITG1
2021-01-07,PF/BT,19092201.0,HSP11 - OSPEDALE GARIBALDI - CENTRO,SIC,30-39,5,6,0,9,2,0,0,11,0,11,Sicilia,ITG1
2021-01-07,PF/BT,19092201.0,HSP11 - OSPEDALE GARIBALDI - CENTRO,SIC,40-49,4,6,0,7,3,0,0,10,0,10,Sicilia,ITG1
2021-01-07,PF/BT,19092201.0,HSP11 - OSPEDALE GARIBALDI - CENTRO,SIC,50-59,6,9,0,15,0,0,0,15,0,15,Sicilia,ITG1
2021-01-07,PF/BT,19092201.0,HSP11 - OSPEDALE GARIBALDI - CENTRO,SIC,60-69,6,5,0,4,7,0,0,11,0,11,Sicilia,ITG1
2021-01-07,PF/BT,19092204.0,HSP11 - NUOVO OSPEDALE GARIBALDI - NESIMA,SIC,20-29,2,12,0,13,0,0,1,14,0,14,Sicilia,ITG1
2021-01-07,PF/BT,19092204.0,HSP11 - NUOVO OSPEDALE GARIBALDI - NESIMA,SIC,30-39,5,22,0,25,1,0,1,27,0,27,Sicilia,ITG1
2021-01-07,PF/BT,19092204.0,HSP11 - NUOVO OSPEDALE GARIBALDI - NESIMA,SIC,40-49,16,19,0,32,2,0,1,35,0,35,Sicilia,ITG1
2021-01-07,PF/BT,19092204.0,HSP11 - NUOVO OSPEDALE GARIBALDI - NESIMA,SIC,50-59,28,40,0,62,3,0,3,68,0,68,Sicilia,ITG1
2021-01-07,PF/BT,19092204.0,HSP11 - NUOVO OSPEDALE GARIBALDI - NESIMA,SIC,60-69,10,18,0,25,1,0,2,28,0,28,Sicilia,ITG1
2021-01-07,PF/BT,19092204.0,HSP11 - NUOVO OSPEDALE GARIBALDI - NESIMA,SIC,90+,1,0,0,0,0,0,1,1,0,1,Sicilia,ITG1
2021-01-07,PF/BT,19092301.0,HSP11 - PRESIDIO OSPEDALIERO GASPARE RODOLICO,SIC,20-29,6,7,0,13,0,0,0,13,0,13,Sicilia,ITG1
2021-01-07,PF/BT,19092301.0,HSP11 - PRESIDIO OSPEDALIERO GASPARE RODOLICO,SIC,30-39,18,26,0,44,0,0,0,44,0,44,Sicilia,ITG1
2021-01-07,PF/BT,19092301.0,HSP11 - PRESIDIO OSPEDALIERO GASPARE RODOLICO,SIC,40-49,23,38,0,61,0,0,0,61,0,61,Sicilia,ITG1
2021-01-07,PF/BT,19092301.0,HSP11 - PRESIDIO OSPEDALIERO GASPARE RODOLICO,SIC,50-59,41,59,0,100,0,0,0,100,0,100,Sicilia,ITG1
2021-01-07,PF/BT,19092301.0,HSP11 - PRESIDIO OSPEDALIERO GASPARE RODOLICO,SIC,60-69,36,26,0,62,0,0,0,62,0,62,Sicilia,ITG1
2021-01-07,PF/BT,19092304.0,HSP11 - PRESIDIO OSPEDALIERO S.MARCO,SIC,16-19,1,0,0,1,0,0,0,1,0,1,Sicilia,ITG1
2021-01-07,PF/BT,19092304.0,HSP11 - PRESIDIO OSPEDALIERO S.MARCO,SIC,20-29,58,70,0,127,1,0,0,128,0,128,Sicilia,ITG1
2021-01-07,PF/BT,19092304.0,HSP11 - PRESIDIO OSPEDALIERO S.MARCO,SIC,30-39,33,65,0,96,2,0,0,98,0,98,Sicilia,ITG1
2021-01-07,PF/BT,19092304.0,HSP11 - PRESIDIO OSPEDALIERO S.MARCO,SIC,40-49,9,9,0,17,1,0,0,18,0,18,Sicilia,ITG1
2021-01-07,PF/BT,19092304.0,HSP11 - PRESIDIO OSPEDALIERO S.MARCO,SIC,50-59,11,20,0,31,0,0,0,31,0,31,Sicilia,ITG1
2021-01-07,PF/BT,19092304.0,HSP11 - PRESIDIO OSPEDALIERO S.MARCO,SIC,60-69,15,9,0,24,0,0,0,24,0,24,Sicilia,ITG1
2021-01-07,PF/BT,190924.0,HSP11 - Azienda Ospedaliera Papardo,SIC,20-29,5,2,0,4,0,0,3,7,0,7,Sicilia,ITG1
2021-01-07,PF/BT,190924.0,HSP11 - Azienda Ospedaliera Papardo,SIC,30-39,14,9,0,16,0,0,7,23,0,23,Sicilia,ITG1
2021-01-07,PF/BT,190924.0,HSP11 - Azienda Ospedaliera Papardo,SIC,40-49,9,19,0,23,0,0,5,28,0,28,Sicilia,ITG1
2021-01-07,PF/BT,190924.0,HSP11 - Azienda Ospedaliera Papardo,SIC,50-59,23,22,0,34,0,0,11,45,0,45,Sicilia,ITG1
2021-01-07,PF/BT,190924.0,HSP11 - Azienda Ospedaliera Papardo,SIC,60-69,22,13,0,29,0,0,6,35,0,35,Sicilia,ITG1
2021-01-07,PF/BT,19092501.0,HSP11 - COVID HOSPITAL,SIC,20-29,10,20,0,30,0,0,0,30,0,30,Sicilia,ITG1
2021-01-07,PF/BT,19092501.0,HSP11 - COVID HOSPITAL,SIC,30-39,23,29,0,52,0,0,0,52,0,52,Sicilia,ITG1
2021-01-07,PF/BT,19092501.0,HSP11 - COVID HOSPITAL,SIC,40-49,28,55,0,83,0,0,0,83,0,83,Sicilia,ITG1
2021-01-07,PF/BT,19092501.0,HSP11 - COVID HOSPITAL,SIC,50-59,43,43,0,86,0,0,0,86,0,86,Sicilia,ITG1
2021-01-07,PF/BT,19092501.0,HSP11 - COVID HOSPITAL,SIC,60-69,30,22,0,52,0,0,0,52,0,52,Sicilia,ITG1
2021-01-07,PF/BT,19092501.0,HSP11 - COVID HOSPITAL,SIC,70-79,2,1,0,3,0,0,0,3,0,3,Sicilia,ITG1
2021-01-07,PF/BT,19092601.0,HSP11 - P.O. Villa Sofia,SIC,20-29,7,21,0,28,0,0,0,28,0,28,Sicilia,ITG1
2021-01-07,PF/BT,19092601.0,HSP11 - P.O. Villa Sofia,SIC,30-39,16,25,0,41,0,0,0,41,0,41,Sicilia,ITG1
2021-01-07,PF/BT,19092601.0,HSP11 - P.O. Villa Sofia,SIC,40-49,23,36,0,59,0,0,0,59,0,59,Sicilia,ITG1
2021-01-07,PF/BT,19092601.0,HSP11 - P.O. Villa Sofia,SIC,50-59,41,38,0,79,0,0,0,79,0,79,Sicilia,ITG1
2021-01-07,PF/BT,19092601.0,HSP11 - P.O. Villa Sofia,SIC,60-69,13,23,0,36,0,0,0,36,0,36,Sicilia,ITG1
2021-01-07,PF/BT,19092601.0,HSP11 - P.O. Villa Sofia,SIC,70-79,1,0,0,1,0,0,0,1,0,1,Sicilia,ITG1
2021-01-07,PF/BT,19092701.0,HSP11 - Ospedale Civico,SIC,20-29,5,11,0,16,0,0,0,16,0,16,Sicilia,ITG1
2021-01-07,PF/BT,19092701.0,HSP11 - Ospedale Civico,SIC,30-39,19,9,0,28,0,0,0,28,0,28,Sicilia,ITG1
2021-01-07,PF/BT,19092701.0,HSP11 - Ospedale Civico,SIC,40-49,15,17,0,32,0,0,0,32,0,32,Sicilia,ITG1
2021-01-07,PF/BT,19092701.0,HSP11 - Ospedale Civico,SIC,50-59,48,37,0,85,0,0,0,85,0,85,Sicilia,ITG1
2021-01-07,PF/BT,19092701.0,HSP11 - Ospedale Civico,SIC,60-69,42,13,0,53,2,0,0,55,0,55,Sicilia,ITG1
2021-01-07,PF/BT,19092702.0,HSP11 - Ospedale dei Bambini G. Di Cristina,SIC,20-29,3,3,0,6,0,0,0,6,0,6,Sicilia,ITG1
2021-01-07,PF/BT,19092702.0,HSP11 - Ospedale dei Bambini G. Di Cristina,SIC,30-39,11,26,0,37,0,0,0,37,0,37,Sicilia,ITG1
2021-01-07,PF/BT,19092702.0,HSP11 - Ospedale dei Bambini G. Di Cristina,SIC,40-49,9,14,0,23,0,0,0,23,0,23,Sicilia,ITG1
2021-01-07,PF/BT,19092702.0,HSP11 - Ospedale dei Bambini G. Di Cristina,SIC,50-59,9,27,0,36,0,0,0,36,0,36,Sicilia,ITG1
2021-01-07,PF/BT,19092702.0,HSP11 - Ospedale dei Bambini G. Di Cristina,SIC,60-69,5,7,0,12,0,0,0,12,0,12,Sicilia,ITG1
2021-01-07,PF/BT,190928.0,HSP11 - AZ.OSP.UNIV.P.GIACCONE,SIC,20-29,19,43,0,62,0,0,0,62,0,62,Sicilia,ITG1
2021-01-07,PF/BT,190928.0,HSP11 - AZ.OSP.UNIV.P.GIACCONE,SIC,30-39,23,36,0,59,0,0,0,59,0,59,Sicilia,ITG1
2021-01-07,PF/BT,190928.0,HSP11 - AZ.OSP.UNIV.P.GIACCONE,SIC,40-49,23,18,0,40,1,0,0,41,0,41,Sicilia,ITG1
2021-01-07,PF/BT,190928.0,HSP11 - AZ.OSP.UNIV.P.GIACCONE,SIC,50-59,46,30,0,74,2,0,0,76,0,76,Sicilia,ITG1
2021-01-07,PF/BT,190928.0,HSP11 - AZ.OSP.UNIV.P.GIACCONE,SIC,60-69,27,27,0,49,1,0,4,54,0,54,Sicilia,ITG1
2021-01-07,PF/BT,190928.0,HSP11 - AZ.OSP.UNIV.P.GIACCONE,SIC,70-79,5,1,0,6,0,0,0,6,0,6,Sicilia,ITG1
2021-01-07,PF/BT,190928.0,HSP11 - AZ.OSP.UNIV.P.GIACCONE,SIC,80-89,1,0,0,1,0,0,0,1,0,1,Sicilia,ITG1
2021-01-07,PF/BT,190929.0,STS11 - IRCCS Ismett,SIC,20-29,1,5,0,3,3,0,0,6,0,6,Sicilia,ITG1
2021-01-07,PF/BT,190929.0,STS11 - IRCCS Ismett,SIC,30-39,9,5,0,3,11,0,0,14,0,14,Sicilia,ITG1
2021-01-07,PF/BT,190929.0,STS11 - IRCCS Ismett,SIC,40-49,22,25,0,15,32,0,0,47,0,47,Sicilia,ITG1
2021-01-07,PF/BT,190929.0,STS11 - IRCCS Ismett,SIC,50-59,9,14,0,8,15,0,0,23,0,23,Sicilia,ITG1
2021-01-07,PF/BT,190950.0,HSP11 - ASSOCIAZIONE OASI MARIA SS,SIC,20-29,4,0,0,4,0,0,0,4,0,4,Sicilia,ITG1
2021-01-07,PF/BT,190950.0,HSP11 - ASSOCIAZIONE OASI MARIA SS,SIC,30-39,9,12,0,19,0,0,2,21,0,21,Sicilia,ITG1
2021-01-07,PF/BT,190950.0,HSP11 - ASSOCIAZIONE OASI MARIA SS,SIC,40-49,6,27,0,31,0,0,2,33,0,33,Sicilia,ITG1
2021-01-07,PF/BT,190950.0,HSP11 - ASSOCIAZIONE OASI MARIA SS,SIC,50-59,15,24,0,38,0,0,1,39,0,39,Sicilia,ITG1
2021-01-07,PF/BT,190950.0,HSP11 - ASSOCIAZIONE OASI MARIA SS,SIC,60-69,6,3,0,9,0,0,0,9,0,9,Sicilia,ITG1
2021-01-07,PF/BT,190950.0,HSP11 - ASSOCIAZIONE OASI MARIA SS,SIC,80-89,0,1,0,0,0,0,1,1,0,1,Sicilia,ITG1
2021-01-07,PF/BT,19096001.0,HSP11 - IRCCS Centro Neurolesi,SIC,20-29,2,4,0,6,0,0,0,6,0,6,Sicilia,ITG1
2021-01-07,PF/BT,19096001.0,HSP11 - IRCCS Centro Neurolesi,SIC,30-39,4,6,0,10,0,0,0,10,0,10,Sicilia,ITG1
2021-01-07,PF/BT,19096001.0,HSP11 - IRCCS Centro Neurolesi,SIC,40-49,5,3,0,8,0,0,0,8,0,8,Sicilia,ITG1
2021-01-07,PF/BT,19096001.0,HSP11 - IRCCS Centro Neurolesi,SIC,50-59,14,10,0,24,0,0,0,24,0,24,Sicilia,ITG1
2021-01-07,PF/BT,19096001.0,HSP11 - IRCCS Centro Neurolesi,SIC,60-69,41,16,0,57,0,0,0,57,0,57,Sicilia,ITG1
2021-01-07,PF/BT,19096001.0,HSP11 - IRCCS Centro Neurolesi,SIC,70-79,3,0,0,3,0,0,0,3,0,3,Sicilia,ITG1
2021-01-07,PF/BT,19096002.0,HSP11 - PRESIDIO OSPEDALIERO PIEMONTE,SIC,20-29,3,1,0,2,0,0,2,4,0,4,Sicilia,ITG1
2021-01-07,PF/BT,19096002.0,HSP11 - PRESIDIO OSPEDALIERO PIEMONTE,SIC,30-39,2,3,0,4,0,0,1,5,0,5,Sicilia,ITG1
2021-01-07,PF/BT,19096002.0,HSP11 - PRESIDIO OSPEDALIERO PIEMONTE,SIC,40-49,9,8,0,12,0,0,5,17,0,17,Sicilia,ITG1
2021-01-07,PF/BT,19096002.0,HSP11 - PRESIDIO OSPEDALIERO PIEMONTE,SIC,50-59,11,7,0,12,0,0,6,18,0,18,Sicilia,ITG1
2021-01-07,PF/BT,19096002.0,HSP11 - PRESIDIO OSPEDALIERO PIEMONTE,SIC,60-69,29,14,0,42,0,0,1,43,0,43,Sicilia,ITG1
2021-01-07,PF/BT,19096002.0,HSP11 - PRESIDIO OSPEDALIERO PIEMONTE,SIC,70-79,3,0,0,3,0,0,0,3,0,3,Sicilia,ITG1
2021-01-07,PF/BT,417800.0,STS11 - REM RADIOTERAPIA Catania s.r.l.,SIC,20-29,1,0,0,1,0,0,0,1,0,1,Sicilia,ITG1
2021-01-07,PF/BT,417800.0,STS11 - REM RADIOTERAPIA Catania s.r.l.,SIC,30-39,0,1,0,0,0,0,1,1,0,1,Sicilia,ITG1
2021-01-07,PF/BT,417800.0,STS11 - REM RADIOTERAPIA Catania s.r.l.,SIC,40-49,1,1,0,1,0,0,1,2,0,2,Sicilia,ITG1
2021-01-07,PF/BT,417800.0,STS11 - REM RADIOTERAPIA Catania s.r.l.,SIC,50-59,0,2,0,0,0,0,2,2,0,2,Sicilia,ITG1
2021-01-07,PF/BT,417800.0,STS11 - REM RADIOTERAPIA Catania s.r.l.,SIC,60-69,1,0,0,1,0,0,0,1,0,1,Sicilia,ITG1
2021-01-07,PF/BT,417800.0,STS11 - REM RADIOTERAPIA Catania s.r.l.,SIC,80-89,1,0,0,1,0,0,0,1,0,1,Sicilia,ITG1
2021-01-07,PF/BT,608200.0,STS11 - POLIAMBULATORIO San Giorgio,SIC,20-29,0,1,0,1,0,0,0,1,0,1,Sicilia,ITG1
2021-01-07,PF/BT,608200.0,STS11 - POLIAMBULATORIO San Giorgio,SIC,30-39,1,3,1,4,0,0,0,4,0,4,Sicilia,ITG1
2021-01-07,PF/BT,608200.0,STS11 - POLIAMBULATORIO San Giorgio,SIC,40-49,2,11,0,13,0,0,0,13,0,13,Sicilia,ITG1
2021-01-07,PF/BT,608200.0,STS11 - POLIAMBULATORIO San Giorgio,SIC,50-59,15,10,0,25,0,0,0,25,0,25,Sicilia,ITG1
2021-01-07,PF/BT,608200.0,STS11 - POLIAMBULATORIO San Giorgio,SIC,60-69,35,13,0,48,0,0,0,48,0,48,Sicilia,ITG1
2021-01-07,PF/BT,608200.0,STS11 - POLIAMBULATORIO San Giorgio,SIC,70-79,2,1,0,3,0,0,0,3,0,3,Sicilia,ITG1
2021-01-07,PF/BT,608400.0,STS11 - POLIAMBULATORIO  San Luigi,SIC,20-29,0,1,0,1,0,0,0,1,0,1,Sicilia,ITG1
2021-01-07,PF/BT,608400.0,STS11 - POLIAMBULATORIO  San Luigi,SIC,30-39,3,6,0,9,0,0,0,9,0,9,Sicilia,ITG1
2021-01-07,PF/BT,608400.0,STS11 - POLIAMBULATORIO  San Luigi,SIC,40-49,4,8,0,12,0,0,0,12,0,12,Sicilia,ITG1
2021-01-07,PF/BT,608400.0,STS11 - POLIAMBULATORIO  San Luigi,SIC,50-59,7,9,0,16,0,0,0,16,0,16,Sicilia,ITG1
2021-01-07,PF/BT,608400.0,STS11 - POLIAMBULATORIO  San Luigi,SIC,60-69,19,20,0,39,0,0,0,39,0,39,Sicilia,ITG1
2021-01-07,PF/BT,608400.0,STS11 - POLIAMBULATORIO  San Luigi,SIC,70-79,1,0,0,1,0,0,0,1,0,1,Sicilia,ITG1
2021-01-07,PF/BT,808000.0,STS11 - CTA HELIOS,SIC,20-29,4,3,0,5,1,0,1,7,0,7,Sicilia,ITG1
2021-01-07,PF/BT,808000.0,STS11 - CTA HELIOS,SIC,30-39,6,1,0,2,0,0,5,7,0,7,Sicilia,ITG1
2021-01-07,PF/BT,808000.0,STS11 - CTA HELIOS,SIC,40-49,10,8,0,9,0,0,9,18,0,18,Sicilia,ITG1
2021-01-07,PF/BT,808000.0,STS11 - CTA HELIOS,SIC,50-59,6,3,0,3,0,0,6,9,0,9,Sicilia,ITG1
2021-01-07,PF/BT,808000.0,STS11 - CTA HELIOS,SIC,60-69,8,3,0,5,0,0,6,11,0,11,Sicilia,ITG1
2021-01-07,PF/BT,808000.0,STS11 - CTA HELIOS,SIC,70-79,2,0,0,1,0,0,1,2,0,2,Sicilia,ITG1
2021-01-07,PF/BT,830400.0,STS11 - RSA VILLA GAIA SRL,SIC,20-29,1,0,0,1,0,0,0,1,0,1,Sicilia,ITG1
2021-01-07,PF/BT,830400.0,STS11 - RSA VILLA GAIA SRL,SIC,30-39,2,4,0,6,0,0,0,6,0,6,Sicilia,ITG1
2021-01-07,PF/BT,830400.0,STS11 - RSA VILLA GAIA SRL,SIC,40-49,2,3,0,5,0,0,0,5,0,5,Sicilia,ITG1
2021-01-07,PF/BT,830400.0,STS11 - RSA VILLA GAIA SRL,SIC,50-59,4,3,0,7,0,0,0,7,0,7,Sicilia,ITG1
2021-01-07,PF/BT,830400.0,STS11 - RSA VILLA GAIA SRL,SIC,60-69,1,2,0,3,0,0,0,3,0,3,Sicilia,ITG1
2021-01-08,PF/BT,190179.0,HSP11 - FOND. IST. S. RAFFAELE - GIGLIO,SIC,20-29,3,1,0,2,2,0,0,4,0,4,Sicilia,ITG1
2021-01-08,PF/BT,190179.0,HSP11 - FOND. IST. S. RAFFAELE - GIGLIO,SIC,30-39,1,6,0,3,4,0,0,7,0,7,Sicilia,ITG1
2021-01-08,PF/BT,190179.0,HSP11 - FOND. IST. S. RAFFAELE - GIGLIO,SIC,40-49,4,8,0,6,6,0,0,12,0,12,Sicilia,ITG1
2021-01-08,PF/BT,190179.0,HSP11 - FOND. IST. S. RAFFAELE - GIGLIO,SIC,50-59,9,11,0,18,2,0,0,20,0,20,Sicilia,ITG1
2021-01-08,PF/BT,190179.0,HSP11 - FOND. IST. S. RAFFAELE - GIGLIO,SIC,60-69,14,7,0,21,0,0,0,21,0,21,Sicilia,ITG1
2021-01-08,PF/BT,190199.0,HSP11 - OSP. BUCCHERI LA FERLA FATEBENEFRATELLI,SIC,20-29,7,4,0,8,3,0,0,11,0,11,Sicilia,ITG1
2021-01-08,PF/BT,190199.0,HSP11 - OSP. BUCCHERI LA FERLA FATEBENEFRATELLI,SIC,30-39,12,6,0,16,2,0,0,18,0,18,Sicilia,ITG1
2021-01-08,PF/BT,190199.0,HSP11 - OSP. BUCCHERI LA FERLA FATEBENEFRATELLI,SIC,40-49,15,15,0,21,9,0,0,30,0,30,Sicilia,ITG1
2021-01-08,PF/BT,190199.0,HSP11 - OSP. BUCCHERI LA FERLA FATEBENEFRATELLI,SIC,50-59,16,14,0,20,10,0,0,30,0,30,Sicilia,ITG1
2021-01-08,PF/BT,190199.0,HSP11 - OSP. BUCCHERI LA FERLA FATEBENEFRATELLI,SIC,60-69,6,5,0,6,5,0,0,11,0,11,Sicilia,ITG1
2021-01-08,PF/BT,190199.0,HSP11 - OSP. BUCCHERI LA FERLA FATEBENEFRATELLI,SIC,70-79,1,1,0,1,1,0,0,2,0,2,Sicilia,ITG1
2021-01-08,PF/BT,1902017.0,STRUTTURE PRIVATE NON CODIFICATE NSIS,SIC,20-29,0,3,0,0,3,0,0,3,0,3,Sicilia,ITG1
2021-01-08,PF/BT,1902017.0,STRUTTURE PRIVATE NON CODIFICATE NSIS,SIC,40-49,0,2,0,1,1,0,0,2,0,2,Sicilia,ITG1
2021-01-08,PF/BT,1902017.0,STRUTTURE PRIVATE NON CODIFICATE NSIS,SIC,50-59,2,4,0,1,4,1,0,6,0,6,Sicilia,ITG1
2021-01-08,PF/BT,1902017.0,STRUTTURE PRIVATE NON CODIFICATE NSIS,SIC,60-69,1,0,0,0,0,1,0,1,0,1,Sicilia,ITG1
2021-01-08,PF/BT,1902017.0,STRUTTURE PRIVATE NON CODIFICATE NSIS,SIC,70-79,0,1,0,0,0,1,0,1,0,1,Sicilia,ITG1
2021-01-08,PF/BT,1902017.0,STRUTTURE PRIVATE NON CODIFICATE NSIS,SIC,80-89,0,6,0,0,0,6,0,6,0,6,Sicilia,ITG1
2021-01-08,PF/BT,1902017.0,STRUTTURE PRIVATE NON CODIFICATE NSIS,SIC,90+,4,6,0,0,0,10,0,10,0,10,Sicilia,ITG1
2021-01-08,PF/BT,1902057.0,STRUTTURE PRIVATE NON CODIFICATE NSIS,SIC,20-29,2,2,0,2,2,0,0,4,0,4,Sicilia,ITG1
2021-01-08,PF/BT,1902057.0,STRUTTURE PRIVATE NON CODIFICATE NSIS,SIC,30-39,1,8,0,9,0,0,0,9,0,9,Sicilia,ITG1
2021-01-08,PF/BT,1902057.0,STRUTTURE PRIVATE NON CODIFICATE NSIS,SIC,40-49,8,21,0,27,2,0,0,29,0,29,Sicilia,ITG1
2021-01-08,PF/BT,1902057.0,STRUTTURE PRIVATE NON CODIFICATE NSIS,SIC,50-59,7,21,0,27,1,0,0,28,0,28,Sicilia,ITG1
2021-01-08,PF/BT,1902057.0,STRUTTURE PRIVATE NON CODIFICATE NSIS,SIC,60-69,19,17,0,36,0,0,0,36,0,36,Sicilia,ITG1
2021-01-08,PF/BT,1902057.0,STRUTTURE PRIVATE NON CODIFICATE NSIS,SIC,70-79,1,2,0,0,0,3,0,3,0,3,Sicilia,ITG1
2021-01-08,PF/BT,1902057.0,STRUTTURE PRIVATE NON CODIFICATE NSIS,SIC,80-89,0,2,0,0,0,2,0,2,0,2,Sicilia,ITG1
2021-01-08,PF/BT,1902057.0,STRUTTURE PRIVATE NON CODIFICATE NSIS,SIC,90+,0,6,0,0,0,6,0,6,0,6,Sicilia,ITG1
2021-01-08,PF/BT,1902072.0,AMBULATORI VACCINALI NON CODIFICATI NSIS,SIC,16-19,0,1,0,1,0,0,0,1,0,1,Sicilia,ITG1
2021-01-08,PF/BT,1902072.0,AMBULATORI VACCINALI NON CODIFICATI NSIS,SIC,20-29,11,16,0,11,2,0,14,27,0,27,Sicilia,ITG1
2021-01-08,PF/BT,1902072.0,AMBULATORI VACCINALI NON CODIFICATI NSIS,SIC,30-39,16,25,0,20,3,0,18,41,0,41,Sicilia,ITG1
2021-01-08,PF/BT,1902072.0,AMBULATORI VACCINALI NON CODIFICATI NSIS,SIC,40-49,25,41,0,33,5,0,28,66,0,66,Sicilia,ITG1
2021-01-08,PF/BT,1902072.0,AMBULATORI VACCINALI NON CODIFICATI NSIS,SIC,50-59,40,47,0,42,21,0,24,87,0,87,Sicilia,ITG1
2021-01-08,PF/BT,1902072.0,AMBULATORI VACCINALI NON CODIFICATI NSIS,SIC,60-69,42,39,0,56,11,0,14,81,0,81,Sicilia,ITG1
2021-01-08,PF/BT,1902072.0,AMBULATORI VACCINALI NON CODIFICATI NSIS,SIC,70-79,30,11,0,20,2,0,19,41,0,41,Sicilia,ITG1
2021-01-08,PF/BT,1902072.0,AMBULATORI VACCINALI NON CODIFICATI NSIS,SIC,80-89,5,8,0,0,0,1,12,13,0,13,Sicilia,ITG1
2021-01-08,PF/BT,1902072.0,AMBULATORI VACCINALI NON CODIFICATI NSIS,SIC,90+,1,0,0,0,0,0,1,1,0,1,Sicilia,ITG1
2021-01-08,PF/BT,1902077.0,STRUTTURE PRIVATE NON CODIFICATE NSIS,SIC,16-19,0,1,0,1,0,0,0,1,0,1,Sicilia,ITG1
2021-01-08,PF/BT,1902077.0,STRUTTURE PRIVATE NON CODIFICATE NSIS,SIC,20-29,0,2,0,2,0,0,0,2,0,2,Sicilia,ITG1
2021-01-08,PF/BT,1902077.0,STRUTTURE PRIVATE NON CODIFICATE NSIS,SIC,30-39,1,6,0,7,0,0,0,7,0,7,Sicilia,ITG1
2021-01-08,PF/BT,1902077.0,STRUTTURE PRIVATE NON CODIFICATE NSIS,SIC,40-49,3,7,0,10,0,0,0,10,0,10,Sicilia,ITG1
2021-01-08,PF/BT,1902077.0,STRUTTURE PRIVATE NON CODIFICATE NSIS,SIC,50-59,1,10,0,8,0,2,1,11,0,11,Sicilia,ITG1
2021-01-08,PF/BT,1902077.0,STRUTTURE PRIVATE NON CODIFICATE NSIS,SIC,60-69,3,8,0,6,0,4,1,11,0,11,Sicilia,ITG1
2021-01-08,PF/BT,1902077.0,STRUTTURE PRIVATE NON CODIFICATE NSIS,SIC,70-79,5,9,0,2,0,12,0,14,0,14,Sicilia,ITG1
2021-01-08,PF/BT,1902077.0,STRUTTURE PRIVATE NON CODIFICATE NSIS,SIC,80-89,9,31,0,1,0,38,1,40,0,40,Sicilia,ITG1
2021-01-08,PF/BT,1902077.0,STRUTTURE PRIVATE NON CODIFICATE NSIS,SIC,90+,9,16,0,0,0,25,0,25,0,25,Sicilia,ITG1
2021-01-08,PF/BT,190301.0,RIA11 - A.I.A.S.SEZ.DI AGRIGENTO ONLUS,SIC,20-29,10,13,0,17,1,0,5,23,0,23,Sicilia,ITG1
2021-01-08,PF/BT,190301.0,RIA11 - A.I.A.S.SEZ.DI AGRIGENTO ONLUS,SIC,30-39,17,22,0,32,5,0,2,39,0,39,Sicilia,ITG1
2021-01-08,PF/BT,190301.0,RIA11 - A.I.A.S.SEZ.DI AGRIGENTO ONLUS,SIC,40-49,43,44,0,58,9,0,20,87,0,87,Sicilia,ITG1
2021-01-08,PF/BT,190301.0,RIA11 - A.I.A.S.SEZ.DI AGRIGENTO ONLUS,SIC,50-59,49,51,0,76,9,0,15,100,0,100,Sicilia,ITG1
2021-01-08,PF/BT,190301.0,RIA11 - A.I.A.S.SEZ.DI AGRIGENTO ONLUS,SIC,60-69,28,19,0,37,4,0,6,47,0,47,Sicilia,ITG1
2021-01-08,PF/BT,190301.0,RIA11 - A.I.A.S.SEZ.DI AGRIGENTO ONLUS,SIC,70-79,9,1,0,10,0,0,0,10,0,10,Sicilia,ITG1
2021-01-08,PF/BT,190302.0,RIA11 - C.DELLA SPERANZA DON ANGELO G.,SIC,20-29,10,2,0,9,0,0,3,12,0,12,Sicilia,ITG1
2021-01-08,PF/BT,190302.0,RIA11 - C.DELLA SPERANZA DON ANGELO G.,SIC,30-39,14,7,0,13,0,0,8,21,0,21,Sicilia,ITG1
2021-01-08,PF/BT,190302.0,RIA11 - C.DELLA SPERANZA DON ANGELO G.,SIC,40-49,21,10,0,20,0,0,11,31,0,31,Sicilia,ITG1
2021-01-08,PF/BT,190302.0,RIA11 - C.DELLA SPERANZA DON ANGELO G.,SIC,50-59,26,20,0,31,0,0,15,46,0,46,Sicilia,ITG1
2021-01-08,PF/BT,190302.0,RIA11 - C.DELLA SPERANZA DON ANGELO G.,SIC,60-69,10,6,0,16,0,0,0,16,0,16,Sicilia,ITG1
2021-01-08,PF/BT,190303.0,RIA11 - COMUNITA` DELLA SPERANZA,SIC,20-29,4,6,0,5,5,0,0,10,0,10,Sicilia,ITG1
2021-01-08,PF/BT,190303.0,RIA11 - COMUNITA` DELLA SPERANZA,SIC,30-39,7,14,0,11,7,0,3,21,0,21,Sicilia,ITG1
2021-01-08,PF/BT,190303.0,RIA11 - COMUNITA` DELLA SPERANZA,SIC,40-49,4,19,0,5,9,0,9,23,0,23,Sicilia,ITG1
2021-01-08,PF/BT,190303.0,RIA11 - COMUNITA` DELLA SPERANZA,SIC,50-59,12,27,0,16,16,0,7,39,0,39,Sicilia,ITG1
2021-01-08,PF/BT,190303.0,RIA11 - COMUNITA` DELLA SPERANZA,SIC,60-69,7,5,0,8,2,0,2,12,0,12,Sicilia,ITG1
2021-01-08,PF/BT,190303.0,RIA11 - COMUNITA` DELLA SPERANZA,SIC,70-79,4,1,0,1,0,0,4,5,0,5,Sicilia,ITG1
2021-01-08,PF/BT,190303.0,RIA11 - COMUNITA` DELLA SPERANZA,SIC,80-89,2,2,0,2,0,0,2,4,0,4,Sicilia,ITG1
2021-01-08,PF/BT,190304.0,HSP11 - P.O.  F.LLI PARLAPIANO - RIBERA,SIC,20-29,6,5,0,10,1,0,0,11,0,11,Sicilia,ITG1
2021-01-08,PF/BT,190304.0,HSP11 - P.O.  F.LLI PARLAPIANO - RIBERA,SIC,30-39,5,12,0,17,0,0,0,17,0,17,Sicilia,ITG1
2021-01-08,PF/BT,190304.0,HSP11 - P.O.  F.LLI PARLAPIANO - RIBERA,SIC,40-49,4,14,0,13,5,0,0,18,0,18,Sicilia,ITG1
2021-01-08,PF/BT,190304.0,HSP11 - P.O.  F.LLI PARLAPIANO - RIBERA,SIC,50-59,15,19,0,17,17,0,0,34,0,34,Sicilia,ITG1
2021-01-08,PF/BT,190304.0,HSP11 - P.O.  F.LLI PARLAPIANO - RIBERA,SIC,60-69,15,8,0,14,9,0,0,23,0,23,Sicilia,ITG1
2021-01-08,PF/BT,190304.0,HSP11 - P.O.  F.LLI PARLAPIANO - RIBERA,SIC,70-79,5,0,0,5,0,0,0,5,0,5,Sicilia,ITG1
2021-01-08,PF/BT,190305.0,HSP11 - P.O. GIOVANNI PAOLO II,SIC,20-29,1,7,0,8,0,0,0,8,0,8,Sicilia,ITG1
2021-01-08,PF/BT,190305.0,HSP11 - P.O. GIOVANNI PAOLO II,SIC,30-39,11,16,0,19,8,0,0,27,0,27,Sicilia,ITG1
2021-01-08,PF/BT,190305.0,HSP11 - P.O. GIOVANNI PAOLO II,SIC,40-49,8,15,0,22,1,0,0,23,0,23,Sicilia,ITG1
2021-01-08,PF/BT,190305.0,HSP11 - P.O. GIOVANNI PAOLO II,SIC,50-59,15,25,0,33,7,0,0,40,0,40,Sicilia,ITG1
2021-01-08,PF/BT,190305.0,HSP11 - P.O. GIOVANNI PAOLO II,SIC,60-69,27,27,0,38,16,0,0,54,0,54,Sicilia,ITG1
2021-01-08,PF/BT,190305.0,HSP11 - P.O. GIOVANNI PAOLO II,SIC,70-79,4,1,0,5,0,0,0,5,0,5,Sicilia,ITG1
2021-01-08,PF/BT,190306.0,PO S.ELIA,SIC,16-19,1,0,0,1,0,0,0,1,0,1,Sicilia,ITG1
2021-01-08,PF/BT,190306.0,PO S.ELIA,SIC,20-29,9,8,0,12,3,0,2,17,0,17,Sicilia,ITG1
2021-01-08,PF/BT,190306.0,PO S.ELIA,SIC,30-39,17,20,0,28,8,0,1,37,0,37,Sicilia,ITG1
2021-01-08,PF/BT,190306.0,PO S.ELIA,SIC,40-49,23,27,0,37,12,0,1,50,0,50,Sicilia,ITG1
2021-01-08,PF/BT,190306.0,PO S.ELIA,SIC,50-59,47,50,0,50,45,0,2,97,0,97,Sicilia,ITG1
2021-01-08,PF/BT,190306.0,PO S.ELIA,SIC,60-69,32,25,0,35,20,0,2,57,0,57,Sicilia,ITG1
2021-01-08,PF/BT,190306.0,PO S.ELIA,SIC,70-79,0,2,0,2,0,0,0,2,0,2,Sicilia,ITG1
2021-01-08,PF/BT,190306.0,PO S.ELIA,SIC,80-89,2,1,0,3,0,0,0,3,0,3,Sicilia,ITG1
2021-01-08,PF/BT,190306.0,RIA11 - ASS. CASA FAM.ROSETTA ONILUS,SIC,16-19,2,0,0,2,0,0,0,2,0,2,Sicilia,ITG1
2021-01-08,PF/BT,190306.0,RIA11 - ASS. CASA FAM.ROSETTA ONILUS,SIC,20-29,13,12,0,19,4,0,2,25,0,25,Sicilia,ITG1
2021-01-08,PF/BT,190306.0,RIA11 - ASS. CASA FAM.ROSETTA ONILUS,SIC,30-39,17,18,0,27,7,0,1,35,0,35,Sicilia,ITG1
2021-01-08,PF/BT,190306.0,RIA11 - ASS. CASA FAM.ROSETTA ONILUS,SIC,40-49,17,25,0,32,10,0,0,42,0,42,Sicilia,ITG1
2021-01-08,PF/BT,190306.0,RIA11 - ASS. CASA FAM.ROSETTA ONILUS,SIC,50-59,40,51,0,48,41,0,2,91,0,91,Sicilia,ITG1
2021-01-08,PF/BT,190306.0,RIA11 - ASS. CASA FAM.ROSETTA ONILUS,SIC,60-69,30,27,0,38,19,0,0,57,0,57,Sicilia,ITG1
2021-01-08,PF/BT,190306.0,RIA11 - ASS. CASA FAM.ROSETTA ONILUS,SIC,70-79,1,2,0,3,0,0,0,3,0,3,Sicilia,ITG1
2021-01-08,PF/BT,190306.0,RIA11 - ASS. CASA FAM.ROSETTA ONILUS,SIC,80-89,2,1,0,3,0,0,0,3,0,3,Sicilia,ITG1
2021-01-08,PF/BT,190309.0,HSP11 - P.O. VITTORIO EMANUELE (ex AO),SIC,20-29,3,3,0,6,0,0,0,6,0,6,Sicilia,ITG1
2021-01-08,PF/BT,190309.0,HSP11 - P.O. VITTORIO EMANUELE (ex AO),SIC,30-39,4,7,0,8,0,0,3,11,0,11,Sicilia,ITG1
2021-01-08,PF/BT,190309.0,HSP11 - P.O. VITTORIO EMANUELE (ex AO),SIC,40-49,4,12,0,15,0,0,1,16,0,16,Sicilia,ITG1
2021-01-08,PF/BT,190309.0,HSP11 - P.O. VITTORIO EMANUELE (ex AO),SIC,50-59,14,7,0,15,0,0,6,21,0,21,Sicilia,ITG1
2021-01-08,PF/BT,190309.0,HSP11 - P.O. VITTORIO EMANUELE (ex AO),SIC,60-69,10,7,0,11,0,0,6,17,0,17,Sicilia,ITG1
2021-01-08,PF/BT,190312.0,HSP11 - P.O. S. Marta e S. Venera Acireale,SIC,20-29,4,3,0,7,0,0,0,7,0,7,Sicilia,ITG1
2021-01-08,PF/BT,190312.0,HSP11 - P.O. S. Marta e S. Venera Acireale,SIC,30-39,5,10,0,15,0,0,0,15,0,15,Sicilia,ITG1
2021-01-08,PF/BT,190312.0,HSP11 - P.O. S. Marta e S. Venera Acireale,SIC,40-49,9,18,0,24,3,0,0,27,0,27,Sicilia,ITG1
2021-01-08,PF/BT,190312.0,HSP11 - P.O. S. Marta e S. Venera Acireale,SIC,50-59,13,21,0,29,5,0,0,34,0,34,Sicilia,ITG1
2021-01-08,PF/BT,190312.0,HSP11 - P.O. S. Marta e S. Venera Acireale,SIC,60-69,18,14,0,31,1,0,0,32,0,32,Sicilia,ITG1
2021-01-08,PF/BT,190312.0,HSP11 - P.O. S. Marta e S. Venera Acireale,SIC,70-79,5,0,0,5,0,0,0,5,0,5,Sicilia,ITG1
2021-01-08,PF/BT,190313.0,RIA11 - IST.RIAB.VILLAG. SAN GIUSEPPE,SIC,20-29,7,1,0,6,0,0,2,8,0,8,Sicilia,ITG1
2021-01-08,PF/BT,190313.0,RIA11 - IST.RIAB.VILLAG. SAN GIUSEPPE,SIC,30-39,4,9,0,5,0,0,8,13,0,13,Sicilia,ITG1
2021-01-08,PF/BT,190313.0,RIA11 - IST.RIAB.VILLAG. SAN GIUSEPPE,SIC,40-49,8,12,0,13,0,0,7,20,0,20,Sicilia,ITG1
2021-01-08,PF/BT,190313.0,RIA11 - IST.RIAB.VILLAG. SAN GIUSEPPE,SIC,50-59,11,16,0,11,0,0,16,27,0,27,Sicilia,ITG1
2021-01-08,PF/BT,190313.0,RIA11 - IST.RIAB.VILLAG. SAN GIUSEPPE,SIC,60-69,14,6,0,17,0,0,3,20,0,20,Sicilia,ITG1
2021-01-08,PF/BT,190313.0,RIA11 - IST.RIAB.VILLAG. SAN GIUSEPPE,SIC,70-79,6,2,0,6,0,0,2,8,0,8,Sicilia,ITG1
2021-01-08,PF/BT,190314.0,RIA11 - ASS.J.F.KENNEDY ACIREALE,SIC,16-19,1,0,0,1,0,0,0,1,0,1,Sicilia,ITG1
2021-01-08,PF/BT,190314.0,RIA11 - ASS.J.F.KENNEDY ACIREALE,SIC,20-29,3,5,0,8,0,0,0,8,0,8,Sicilia,ITG1
2021-01-08,PF/BT,190314.0,RIA11 - ASS.J.F.KENNEDY ACIREALE,SIC,30-39,7,6,0,13,0,0,0,13,0,13,Sicilia,ITG1
2021-01-08,PF/BT,190314.0,RIA11 - ASS.J.F.KENNEDY ACIREALE,SIC,40-49,6,9,0,15,0,0,0,15,0,15,Sicilia,ITG1
2021-01-08,PF/BT,190314.0,RIA11 - ASS.J.F.KENNEDY ACIREALE,SIC,50-59,8,8,0,16,0,0,0,16,0,16,Sicilia,ITG1
2021-01-08,PF/BT,190314.0,RIA11 - ASS.J.F.KENNEDY ACIREALE,SIC,60-69,4,5,0,9,0,0,0,9,0,9,Sicilia,ITG1
2021-01-08,PF/BT,190314.0,RIA11 - ASS.J.F.KENNEDY ACIREALE,SIC,70-79,3,1,0,4,0,0,0,4,0,4,Sicilia,ITG1
2021-01-08,PF/BT,190315.0,RIA11 - AIAS SEZ. ACIREALE,SIC,20-29,1,0,0,1,0,0,0,1,0,1,Sicilia,ITG1
2021-01-08,PF/BT,190315.0,RIA11 - AIAS SEZ. ACIREALE,SIC,30-39,0,1,0,1,0,0,0,1,0,1,Sicilia,ITG1
2021-01-08,PF/BT,190315.0,RIA11 - AIAS SEZ. ACIREALE,SIC,40-49,2,2,0,4,0,0,0,4,0,4,Sicilia,ITG1
2021-01-08,PF/BT,190315.0,RIA11 - AIAS SEZ. ACIREALE,SIC,50-59,0,1,0,1,0,0,0,1,0,1,Sicilia,ITG1
2021-01-08,PF/BT,190315.0,RIA11 - AIAS SEZ. ACIREALE,SIC,60-69,4,0,0,4,0,0,0,4,0,4,Sicilia,ITG1
2021-01-08,PF/BT,190316.0,RIA11 - ASS.J.F.KENNEDY - C.RIAB.ONLUS,SIC,16-19,0,1,0,1,0,0,0,1,0,1,Sicilia,ITG1
2021-01-08,PF/BT,190316.0,RIA11 - ASS.J.F.KENNEDY - C.RIAB.ONLUS,SIC,20-29,5,2,0,7,0,0,0,7,0,7,Sicilia,ITG1
2021-01-08,PF/BT,190316.0,RIA11 - ASS.J.F.KENNEDY - C.RIAB.ONLUS,SIC,30-39,2,10,0,11,1,0,0,12,0,12,Sicilia,ITG1
2021-01-08,PF/BT,190316.0,RIA11 - ASS.J.F.KENNEDY - C.RIAB.ONLUS,SIC,40-49,3,8,0,9,2,0,0,11,0,11,Sicilia,ITG1
2021-01-08,PF/BT,190316.0,RIA11 - ASS.J.F.KENNEDY - C.RIAB.ONLUS,SIC,50-59,4,18,0,18,4,0,0,22,0,22,Sicilia,ITG1
2021-01-08,PF/BT,190316.0,RIA11 - ASS.J.F.KENNEDY - C.RIAB.ONLUS,SIC,60-69,2,9,0,9,2,0,0,11,0,11,Sicilia,ITG1
2021-01-08,PF/BT,190316.0,RIA11 - ASS.J.F.KENNEDY - C.RIAB.ONLUS,SIC,70-79,0,2,0,2,0,0,0,2,0,2,Sicilia,ITG1
2021-01-08,PF/BT,190317.0,HSP11 - P.O. Gravina e S. Pietro Caltagirone,SIC,16-19,1,0,0,0,1,0,0,1,0,1,Sicilia,ITG1
2021-01-08,PF/BT,190317.0,HSP11 - P.O. Gravina e S. Pietro Caltagirone,SIC,20-29,6,5,0,4,7,0,0,11,0,11,Sicilia,ITG1
2021-01-08,PF/BT,190317.0,HSP11 - P.O. Gravina e S. Pietro Caltagirone,SIC,30-39,5,6,0,6,5,0,0,11,0,11,Sicilia,ITG1
2021-01-08,PF/BT,190317.0,HSP11 - P.O. Gravina e S. Pietro Caltagirone,SIC,40-49,9,18,0,16,11,0,0,27,0,27,Sicilia,ITG1
2021-01-08,PF/BT,190317.0,HSP11 - P.O. Gravina e S. Pietro Caltagirone,SIC,50-59,12,18,0,16,14,0,0,30,0,30,Sicilia,ITG1
2021-01-08,PF/BT,190317.0,HSP11 - P.O. Gravina e S. Pietro Caltagirone,SIC,60-69,7,9,0,10,6,0,0,16,0,16,Sicilia,ITG1
2021-01-08,PF/BT,190318.0,RIA11 - ASS.ISTITUTO REGINA VIRGINUM,SIC,16-19,1,2,0,3,0,0,0,3,0,3,Sicilia,ITG1
2021-01-08,PF/BT,190318.0,RIA11 - ASS.ISTITUTO REGINA VIRGINUM,SIC,20-29,3,6,0,9,0,0,0,9,0,9,Sicilia,ITG1
2021-01-08,PF/BT,190318.0,RIA11 - ASS.ISTITUTO REGINA VIRGINUM,SIC,30-39,3,9,0,10,1,0,1,12,0,12,Sicilia,ITG1
2021-01-08,PF/BT,190318.0,RIA11 - ASS.ISTITUTO REGINA VIRGINUM,SIC,40-49,7,7,0,13,0,0,1,14,0,14,Sicilia,ITG1
2021-01-08,PF/BT,190318.0,RIA11 - ASS.ISTITUTO REGINA VIRGINUM,SIC,50-59,12,12,0,21,0,0,3,24,0,24,Sicilia,ITG1
2021-01-08,PF/BT,190318.0,RIA11 - ASS.ISTITUTO REGINA VIRGINUM,SIC,60-69,15,4,0,19,0,0,0,19,0,19,Sicilia,ITG1
2021-01-08,PF/BT,190318.0,RIA11 - ASS.ISTITUTO REGINA VIRGINUM,SIC,70-79,2,0,0,1,1,0,0,2,0,2,Sicilia,ITG1
2021-01-08,PF/BT,190319.0,HSP11 - P. O. UMBERTO I,SIC,20-29,4,8,0,12,0,0,0,12,0,12,Sicilia,ITG1
2021-01-08,PF/BT,190319.0,HSP11 - P. O. UMBERTO I,SIC,30-39,9,15,0,20,0,0,4,24,0,24,Sicilia,ITG1
2021-01-08,PF/BT,190319.0,HSP11 - P. O. UMBERTO I,SIC,40-49,19,20,0,32,0,0,7,39,0,39,Sicilia,ITG1
2021-01-08,PF/BT,190319.0,HSP11 - P. O. UMBERTO I,SIC,50-59,22,23,0,41,0,0,4,45,0,45,Sicilia,ITG1
2021-01-08,PF/BT,190319.0,HSP11 - P. O. UMBERTO I,SIC,60-69,18,17,0,33,0,0,2,35,0,35,Sicilia,ITG1
2021-01-08,PF/BT,190319.0,HSP11 - P. O. UMBERTO I,SIC,70-79,1,0,0,1,0,0,0,1,0,1,Sicilia,ITG1
2021-01-08,PF/BT,190320.0,HSP11 - P. O. M. CHIELLO,SIC,20-29,0,1,0,1,0,0,0,1,0,1,Sicilia,ITG1
2021-01-08,PF/BT,190320.0,HSP11 - P. O. M. CHIELLO,SIC,30-39,0,3,0,3,0,0,0,3,0,3,Sicilia,ITG1
2021-01-08,PF/BT,190320.0,HSP11 - P. O. M. CHIELLO,SIC,40-49,5,10,0,15,0,0,0,15,0,15,Sicilia,ITG1
2021-01-08,PF/BT,190320.0,HSP11 - P. O. M. CHIELLO,SIC,50-59,20,26,0,46,0,0,0,46,0,46,Sicilia,ITG1
2021-01-08,PF/BT,190320.0,HSP11 - P. O. M. CHIELLO,SIC,60-69,16,15,0,31,0,0,0,31,0,31,Sicilia,ITG1
2021-01-08,PF/BT,190322.0,HSP11 - P. O. CARLO BASILOTTA,SIC,20-29,1,3,0,4,0,0,0,4,0,4,Sicilia,ITG1
2021-01-08,PF/BT,190322.0,HSP11 - P. O. CARLO BASILOTTA,SIC,30-39,2,1,0,2,1,0,0,3,0,3,Sicilia,ITG1
2021-01-08,PF/BT,190322.0,HSP11 - P. O. CARLO BASILOTTA,SIC,40-49,11,8,0,15,2,0,2,19,0,19,Sicilia,ITG1
2021-01-08,PF/BT,190322.0,HSP11 - P. O. CARLO BASILOTTA,SIC,50-59,14,12,0,23,0,0,3,26,0,26,Sicilia,ITG1
2021-01-08,PF/BT,190322.0,HSP11 - P. O. CARLO BASILOTTA,SIC,60-69,18,8,0,24,2,0,0,26,0,26,Sicilia,ITG1
2021-01-08,PF/BT,190323.0,HSP11 - P.O. NUOVO CUTRONI ZODDA BARCELLONA,SIC,20-29,0,1,0,1,0,0,0,1,0,1,Sicilia,ITG1
2021-01-08,PF/BT,190323.0,HSP11 - P.O. NUOVO CUTRONI ZODDA BARCELLONA,SIC,30-39,1,2,0,3,0,0,0,3,0,3,Sicilia,ITG1
2021-01-08,PF/BT,190323.0,HSP11 - P.O. NUOVO CUTRONI ZODDA BARCELLONA,SIC,40-49,8,7,0,15,0,0,0,15,0,15,Sicilia,ITG1
2021-01-08,PF/BT,190323.0,HSP11 - P.O. NUOVO CUTRONI ZODDA BARCELLONA,SIC,50-59,10,12,0,22,0,0,0,22,0,22,Sicilia,ITG1
2021-01-08,PF/BT,190323.0,HSP11 - P.O. NUOVO CUTRONI ZODDA BARCELLONA,SIC,60-69,7,13,0,20,0,0,0,20,0,20,Sicilia,ITG1
2021-01-08,PF/BT,190323.0,HSP11 - P.O. NUOVO CUTRONI ZODDA BARCELLONA,SIC,70-79,1,0,0,1,0,0,0,1,0,1,Sicilia,ITG1
2021-01-08,PF/BT,190325.0,HSP11 - P.O. G. FOGLIANI MILAZZO,SIC,20-29,1,0,0,1,0,0,0,1,0,1,Sicilia,ITG1
2021-01-08,PF/BT,190325.0,HSP11 - P.O. G. FOGLIANI MILAZZO,SIC,30-39,6,9,0,15,0,0,0,15,0,15,Sicilia,ITG1
2021-01-08,PF/BT,190325.0,HSP11 - P.O. G. FOGLIANI MILAZZO,SIC,40-49,5,18,0,23,0,0,0,23,0,23,Sicilia,ITG1
2021-01-08,PF/BT,190325.0,HSP11 - P.O. G. FOGLIANI MILAZZO,SIC,50-59,8,35,0,43,0,0,0,43,0,43,Sicilia,ITG1
2021-01-08,PF/BT,190325.0,HSP11 - P.O. G. FOGLIANI MILAZZO,SIC,60-69,11,20,0,30,1,0,0,31,0,31,Sicilia,ITG1
2021-01-08,PF/BT,190326.0,HSP11 - P.O. S. VINCENZO TAORMINA,SIC,30-39,0,2,0,2,0,0,0,2,0,2,Sicilia,ITG1
2021-01-08,PF/BT,190326.0,HSP11 - P.O. S. VINCENZO TAORMINA,SIC,40-49,0,2,0,1,1,0,0,2,0,2,Sicilia,ITG1
2021-01-08,PF/BT,190326.0,HSP11 - P.O. S. VINCENZO TAORMINA,SIC,50-59,2,4,0,6,0,0,0,6,0,6,Sicilia,ITG1
2021-01-08,PF/BT,190326.0,HSP11 - P.O. S. VINCENZO TAORMINA,SIC,60-69,1,1,0,1,1,0,0,2,0,2,Sicilia,ITG1
2021-01-08,PF/BT,190328.0,HSP11 - P.O. BARONE-ROMEO PATTI,SIC,30-39,5,0,0,5,0,0,0,5,0,5,Sicilia,ITG1
2021-01-08,PF/BT,190328.0,HSP11 - P.O. BARONE-ROMEO PATTI,SIC,40-49,5,5,0,10,0,0,0,10,0,10,Sicilia,ITG1
2021-01-08,PF/BT,190328.0,HSP11 - P.O. BARONE-ROMEO PATTI,SIC,50-59,6,7,0,9,4,0,0,13,0,13,Sicilia,ITG1
2021-01-08,PF/BT,190328.0,HSP11 - P.O. BARONE-ROMEO PATTI,SIC,60-69,5,6,0,8,2,0,1,11,0,11,Sicilia,ITG1
2021-01-08,PF/BT,190328.0,HSP11 - P.O. BARONE-ROMEO PATTI,SIC,70-79,3,0,0,2,1,0,0,3,0,3,Sicilia,ITG1
2021-01-08,PF/BT,190329.0,HSP11 - STABILIMENTO OSPED. S. AGATA MILITELLO,SIC,20-29,1,0,0,0,0,0,1,1,0,1,Sicilia,ITG1
2021-01-08,PF/BT,190329.0,HSP11 - STABILIMENTO OSPED. S. AGATA MILITELLO,SIC,30-39,1,6,0,6,0,0,1,7,0,7,Sicilia,ITG1
2021-01-08,PF/BT,190329.0,HSP11 - STABILIMENTO OSPED. S. AGATA MILITELLO,SIC,40-49,4,10,0,9,0,0,5,14,0,14,Sicilia,ITG1
2021-01-08,PF/BT,190329.0,HSP11 - STABILIMENTO OSPED. S. AGATA MILITELLO,SIC,50-59,17,11,0,28,0,0,0,28,0,28,Sicilia,ITG1
2021-01-08,PF/BT,190329.0,HSP11 - STABILIMENTO OSPED. S. AGATA MILITELLO,SIC,60-69,18,10,0,26,0,0,2,28,0,28,Sicilia,ITG1
2021-01-08,PF/BT,190329.0,HSP11 - STABILIMENTO OSPED. S. AGATA MILITELLO,SIC,70-79,2,0,0,2,0,0,0,2,0,2,Sicilia,ITG1
2021-01-08,PF/BT,190330.0,HSP11 - P.O. DEI BIANCHI CORLEONE,SIC,20-29,3,3,0,4,1,0,1,6,0,6,Sicilia,ITG1
2021-01-08,PF/BT,190330.0,HSP11 - P.O. DEI BIANCHI CORLEONE,SIC,30-39,1,4,0,4,1,0,0,5,0,5,Sicilia,ITG1
2021-01-08,PF/BT,190330.0,HSP11 - P.O. DEI BIANCHI CORLEONE,SIC,40-49,10,9,0,13,5,0,1,19,0,19,Sicilia,ITG1
2021-01-08,PF/BT,190330.0,HSP11 - P.O. DEI BIANCHI CORLEONE,SIC,50-59,17,20,0,26,11,0,0,37,0,37,Sicilia,ITG1
2021-01-08,PF/BT,190330.0,HSP11 - P.O. DEI BIANCHI CORLEONE,SIC,60-69,18,3,0,20,1,0,0,21,0,21,Sicilia,ITG1
2021-01-08,PF/BT,190330.0,HSP11 - P.O. DEI BIANCHI CORLEONE,SIC,70-79,2,0,0,1,0,0,1,2,0,2,Sicilia,ITG1
2021-01-08,PF/BT,190332.0,HSP11 - P.O. CIVICO PARTINICO,SIC,16-19,1,0,0,0,1,0,0,1,0,1,Sicilia,ITG1
2021-01-08,PF/BT,190332.0,HSP11 - P.O. CIVICO PARTINICO,SIC,20-29,3,6,0,5,4,0,0,9,0,9,Sicilia,ITG1
2021-01-08,PF/BT,190332.0,HSP11 - P.O. CIVICO PARTINICO,SIC,30-39,1,1,0,1,1,0,0,2,0,2,Sicilia,ITG1
2021-01-08,PF/BT,190332.0,HSP11 - P.O. CIVICO PARTINICO,SIC,40-49,8,7,0,10,5,0,0,15,0,15,Sicilia,ITG1
2021-01-08,PF/BT,190332.0,HSP11 - P.O. CIVICO PARTINICO,SIC,50-59,5,7,0,8,4,0,0,12,0,12,Sicilia,ITG1
2021-01-08,PF/BT,190332.0,HSP11 - P.O. CIVICO PARTINICO,SIC,60-69,5,3,0,6,2,0,0,8,0,8,Sicilia,ITG1
2021-01-08,PF/BT,190332.0,HSP11 - P.O. CIVICO PARTINICO,SIC,70-79,1,0,0,1,0,0,0,1,0,1,Sicilia,ITG1
2021-01-08,PF/BT,190333.0,HSP11 - P.O. MADONNA DELLALTO - PETR. SOTTANA,SIC,16-19,0,1,0,0,0,0,1,1,0,1,Sicilia,ITG1
2021-01-08,PF/BT,190333.0,HSP11 - P.O. MADONNA DELLALTO - PETR. SOTTANA,SIC,20-29,2,5,0,3,0,0,4,7,0,7,Sicilia,ITG1
2021-01-08,PF/BT,190333.0,HSP11 - P.O. MADONNA DELLALTO - PETR. SOTTANA,SIC,30-39,7,8,0,7,3,0,5,15,0,15,Sicilia,ITG1
2021-01-08,PF/BT,190333.0,HSP11 - P.O. MADONNA DELLALTO - PETR. SOTTANA,SIC,40-49,6,9,0,9,3,1,2,15,0,15,Sicilia,ITG1
2021-01-08,PF/BT,190333.0,HSP11 - P.O. MADONNA DELLALTO - PETR. SOTTANA,SIC,50-59,5,16,0,14,1,3,3,21,0,21,Sicilia,ITG1
2021-01-08,PF/BT,190333.0,HSP11 - P.O. MADONNA DELLALTO - PETR. SOTTANA,SIC,60-69,7,7,0,3,1,8,2,14,0,14,Sicilia,ITG1
2021-01-08,PF/BT,190333.0,HSP11 - P.O. MADONNA DELLALTO - PETR. SOTTANA,SIC,70-79,7,9,0,0,0,14,2,16,0,16,Sicilia,ITG1
2021-01-08,PF/BT,190333.0,HSP11 - P.O. MADONNA DELLALTO - PETR. SOTTANA,SIC,80-89,10,23,0,0,0,31,2,33,0,33,Sicilia,ITG1
2021-01-08,PF/BT,190333.0,HSP11 - P.O. MADONNA DELLALTO - PETR. SOTTANA,SIC,90+,7,7,0,0,0,13,1,14,0,14,Sicilia,ITG1
2021-01-08,PF/BT,190334.0,HSP11 - P.O. S. CIMINO TERMINI IMERESE,SIC,20-29,5,9,0,14,0,0,0,14,0,14,Sicilia,ITG1
2021-01-08,PF/BT,190334.0,HSP11 - P.O. S. CIMINO TERMINI IMERESE,SIC,30-39,11,17,0,28,0,0,0,28,0,28,Sicilia,ITG1
2021-01-08,PF/BT,190334.0,HSP11 - P.O. S. CIMINO TERMINI IMERESE,SIC,40-49,13,35,0,48,0,0,0,48,0,48,Sicilia,ITG1
2021-01-08,PF/BT,190334.0,HSP11 - P.O. S. CIMINO TERMINI IMERESE,SIC,50-59,10,22,0,31,1,0,0,32,0,32,Sicilia,ITG1
2021-01-08,PF/BT,190334.0,HSP11 - P.O. S. CIMINO TERMINI IMERESE,SIC,60-69,17,20,0,37,0,0,0,37,0,37,Sicilia,ITG1
2021-01-08,PF/BT,190334.0,HSP11 - P.O. S. CIMINO TERMINI IMERESE,SIC,70-79,2,0,0,2,0,0,0,2,0,2,Sicilia,ITG1
2021-01-08,PF/BT,190334.0,HSP11 - P.O. S. CIMINO TERMINI IMERESE,SIC,80-89,1,0,0,1,0,0,0,1,0,1,Sicilia,ITG1
2021-01-08,PF/BT,190335.0,G.F.Ingrassia,SIC,20-29,0,1,0,1,0,0,0,1,0,1,Sicilia,ITG1
2021-01-08,PF/BT,190335.0,G.F.Ingrassia,SIC,30-39,3,4,0,7,0,0,0,7,0,7,Sicilia,ITG1
2021-01-08,PF/BT,190335.0,G.F.Ingrassia,SIC,40-49,2,7,0,9,0,0,0,9,0,9,Sicilia,ITG1
2021-01-08,PF/BT,190335.0,G.F.Ingrassia,SIC,50-59,1,5,0,6,0,0,0,6,0,6,Sicilia,ITG1
2021-01-08,PF/BT,190335.0,G.F.Ingrassia,SIC,60-69,5,7,0,12,0,0,0,12,0,12,Sicilia,ITG1
2021-01-08,PF/BT,190335.0,G.F.Ingrassia,SIC,70-79,7,0,0,7,0,0,0,7,0,7,Sicilia,ITG1
2021-01-08,PF/BT,190337.0,HSP11 - P.O. VILLA DELLE GINESTRE,SIC,20-29,11,9,0,13,3,0,4,20,0,20,Sicilia,ITG1
2021-01-08,PF/BT,190337.0,HSP11 - P.O. VILLA DELLE GINESTRE,SIC,30-39,20,20,0,29,9,0,2,40,0,40,Sicilia,ITG1
2021-01-08,PF/BT,190337.0,HSP11 - P.O. VILLA DELLE GINESTRE,SIC,40-49,27,22,0,25,18,0,6,49,0,49,Sicilia,ITG1
2021-01-08,PF/BT,190337.0,HSP11 - P.O. VILLA DELLE GINESTRE,SIC,50-59,34,32,0,33,28,0,5,66,0,66,Sicilia,ITG1
2021-01-08,PF/BT,190337.0,HSP11 - P.O. VILLA DELLE GINESTRE,SIC,60-69,63,30,0,77,14,0,2,93,0,93,Sicilia,ITG1
2021-01-08,PF/BT,190337.0,HSP11 - P.O. VILLA DELLE GINESTRE,SIC,70-79,9,2,0,11,0,0,0,11,0,11,Sicilia,ITG1
2021-01-08,PF/BT,190337.0,HSP11 - P.O. VILLA DELLE GINESTRE,SIC,80-89,2,0,0,2,0,0,0,2,0,2,Sicilia,ITG1
2021-01-08,PF/BT,190338.0,HSP11 - OSPEDALE Giovanni Paolo II° M.P. A.,SIC,20-29,5,13,0,17,1,0,0,18,0,18,Sicilia,ITG1
2021-01-08,PF/BT,190338.0,HSP11 - OSPEDALE Giovanni Paolo II° M.P. A.,SIC,30-39,16,20,0,34,2,0,0,36,0,36,Sicilia,ITG1
2021-01-08,PF/BT,190338.0,HSP11 - OSPEDALE Giovanni Paolo II° M.P. A.,SIC,40-49,16,31,0,45,2,0,0,47,0,47,Sicilia,ITG1
2021-01-08,PF/BT,190338.0,HSP11 - OSPEDALE Giovanni Paolo II° M.P. A.,SIC,50-59,21,36,0,50,7,0,0,57,0,57,Sicilia,ITG1
2021-01-08,PF/BT,190338.0,HSP11 - OSPEDALE Giovanni Paolo II° M.P. A.,SIC,60-69,13,19,0,31,1,0,0,32,0,32,Sicilia,ITG1
2021-01-08,PF/BT,190338.0,HSP11 - OSPEDALE Giovanni Paolo II° M.P. A.,SIC,70-79,2,0,0,2,0,0,0,2,0,2,Sicilia,ITG1
2021-01-08,PF/BT,190340.0,HSP11 - OSPEDALE MAGGIORE MODICA,SIC,20-29,1,6,0,7,0,0,0,7,0,7,Sicilia,ITG1
2021-01-08,PF/BT,190340.0,HSP11 - OSPEDALE MAGGIORE MODICA,SIC,30-39,5,2,0,7,0,0,0,7,0,7,Sicilia,ITG1
2021-01-08,PF/BT,190340.0,HSP11 - OSPEDALE MAGGIORE MODICA,SIC,40-49,3,11,0,12,2,0,0,14,0,14,Sicilia,ITG1
2021-01-08,PF/BT,190340.0,HSP11 - OSPEDALE MAGGIORE MODICA,SIC,50-59,10,23,0,27,6,0,0,33,0,33,Sicilia,ITG1
2021-01-08,PF/BT,190340.0,HSP11 - OSPEDALE MAGGIORE MODICA,SIC,60-69,11,6,0,14,3,0,0,17,0,17,Sicilia,ITG1
2021-01-08,PF/BT,190341.0,HSP11 - OSPEDALE BUSACCA SCICLI,SIC,80-89,1,1,0,0,0,2,0,2,0,2,Sicilia,ITG1
2021-01-08,PF/BT,190342.0,HSP11 - OSPEDALE GUZZARDI VITTORIA,SIC,20-29,4,4,0,8,0,0,0,8,0,8,Sicilia,ITG1
2021-01-08,PF/BT,190342.0,HSP11 - OSPEDALE GUZZARDI VITTORIA,SIC,30-39,3,5,0,8,0,0,0,8,0,8,Sicilia,ITG1
2021-01-08,PF/BT,190342.0,HSP11 - OSPEDALE GUZZARDI VITTORIA,SIC,40-49,11,9,0,19,1,0,0,20,0,20,Sicilia,ITG1
2021-01-08,PF/BT,190342.0,HSP11 - OSPEDALE GUZZARDI VITTORIA,SIC,50-59,9,10,0,18,1,0,0,19,0,19,Sicilia,ITG1
2021-01-08,PF/BT,190342.0,HSP11 - OSPEDALE GUZZARDI VITTORIA,SIC,60-69,6,3,0,9,0,0,0,9,0,9,Sicilia,ITG1
2021-01-08,PF/BT,190343.0,HSP11 - P.O. DI MARIA AVOLA,SIC,30-39,5,1,0,6,0,0,0,6,0,6,Sicilia,ITG1
2021-01-08,PF/BT,190343.0,HSP11 - P.O. DI MARIA AVOLA,SIC,40-49,7,9,0,14,0,0,2,16,0,16,Sicilia,ITG1
2021-01-08,PF/BT,190343.0,HSP11 - P.O. DI MARIA AVOLA,SIC,50-59,18,9,0,26,0,0,1,27,0,27,Sicilia,ITG1
2021-01-08,PF/BT,190343.0,HSP11 - P.O. DI MARIA AVOLA,SIC,60-69,7,4,0,10,0,0,1,11,0,11,Sicilia,ITG1
2021-01-08,PF/BT,190345.0,HSP11 - P.O. UMBERTO I (EX A.O.),SIC,20-29,4,6,0,10,0,0,0,10,0,10,Sicilia,ITG1
2021-01-08,PF/BT,190345.0,HSP11 - P.O. UMBERTO I (EX A.O.),SIC,30-39,11,18,0,28,1,0,0,29,0,29,Sicilia,ITG1
2021-01-08,PF/BT,190345.0,HSP11 - P.O. UMBERTO I (EX A.O.),SIC,40-49,14,31,0,41,4,0,0,45,0,45,Sicilia,ITG1
2021-01-08,PF/BT,190345.0,HSP11 - P.O. UMBERTO I (EX A.O.),SIC,50-59,24,39,0,58,5,0,0,63,0,63,Sicilia,ITG1
2021-01-08,PF/BT,190345.0,HSP11 - P.O. UMBERTO I (EX A.O.),SIC,60-69,13,12,0,24,1,0,0,25,0,25,Sicilia,ITG1
2021-01-08,PF/BT,190346.0,HSP11 - P.O. MUSCATELLO AUGUSTA,SIC,20-29,1,1,0,2,0,0,0,2,0,2,Sicilia,ITG1
2021-01-08,PF/BT,190346.0,HSP11 - P.O. MUSCATELLO AUGUSTA,SIC,30-39,2,7,0,9,0,0,0,9,0,9,Sicilia,ITG1
2021-01-08,PF/BT,190346.0,HSP11 - P.O. MUSCATELLO AUGUSTA,SIC,40-49,2,16,0,18,0,0,0,18,0,18,Sicilia,ITG1
2021-01-08,PF/BT,190346.0,HSP11 - P.O. MUSCATELLO AUGUSTA,SIC,50-59,15,16,0,31,0,0,0,31,0,31,Sicilia,ITG1
2021-01-08,PF/BT,190346.0,HSP11 - P.O. MUSCATELLO AUGUSTA,SIC,60-69,10,19,0,29,0,0,0,29,0,29,Sicilia,ITG1
2021-01-08,PF/BT,190346.0,HSP11 - P.O. MUSCATELLO AUGUSTA,SIC,70-79,1,0,0,1,0,0,0,1,0,1,Sicilia,ITG1
2021-01-08,PF/BT,190347.0,HSP11 - OSPEDALE GENERALE DI ZONA,SIC,20-29,0,4,0,0,4,0,0,4,0,4,Sicilia,ITG1
2021-01-08,PF/BT,190347.0,HSP11 - OSPEDALE GENERALE DI ZONA,SIC,30-39,5,9,0,11,3,0,0,14,0,14,Sicilia,ITG1
2021-01-08,PF/BT,190347.0,HSP11 - OSPEDALE GENERALE DI ZONA,SIC,40-49,11,23,0,25,9,0,0,34,0,34,Sicilia,ITG1
2021-01-08,PF/BT,190347.0,HSP11 - OSPEDALE GENERALE DI ZONA,SIC,50-59,26,33,0,52,7,0,0,59,0,59,Sicilia,ITG1
2021-01-08,PF/BT,190347.0,HSP11 - OSPEDALE GENERALE DI ZONA,SIC,60-69,19,14,0,31,2,0,0,33,0,33,Sicilia,ITG1
2021-01-08,PF/BT,190349.0,HSP11 - P.O. SAN VITO E SANTO SPIRITO -ALCAMO,SIC,30-39,2,0,0,2,0,0,0,2,0,2,Sicilia,ITG1
2021-01-08,PF/BT,190349.0,HSP11 - P.O. SAN VITO E SANTO SPIRITO -ALCAMO,SIC,40-49,2,4,0,3,2,0,1,6,0,6,Sicilia,ITG1
2021-01-08,PF/BT,190349.0,HSP11 - P.O. SAN VITO E SANTO SPIRITO -ALCAMO,SIC,50-59,0,7,0,5,0,0,2,7,0,7,Sicilia,ITG1
2021-01-08,PF/BT,190349.0,HSP11 - P.O. SAN VITO E SANTO SPIRITO -ALCAMO,SIC,60-69,2,6,0,5,3,0,0,8,0,8,Sicilia,ITG1
2021-01-08,PF/BT,190351.0,HSP11 - P.O. S. ANTONIO ABATE  - TRAPANI,SIC,20-29,4,5,0,9,0,0,0,9,0,9,Sicilia,ITG1
2021-01-08,PF/BT,190351.0,HSP11 - P.O. S. ANTONIO ABATE  - TRAPANI,SIC,30-39,7,9,0,16,0,0,0,16,0,16,Sicilia,ITG1
2021-01-08,PF/BT,190351.0,HSP11 - P.O. S. ANTONIO ABATE  - TRAPANI,SIC,40-49,12,8,0,17,3,0,0,20,0,20,Sicilia,ITG1
2021-01-08,PF/BT,190351.0,HSP11 - P.O. S. ANTONIO ABATE  - TRAPANI,SIC,50-59,8,15,0,19,4,0,0,23,0,23,Sicilia,ITG1
2021-01-08,PF/BT,190351.0,HSP11 - P.O. S. ANTONIO ABATE  - TRAPANI,SIC,60-69,13,7,0,20,0,0,0,20,0,20,Sicilia,ITG1
2021-01-08,PF/BT,190351.0,HSP11 - P.O. S. ANTONIO ABATE  - TRAPANI,SIC,70-79,2,0,0,2,0,0,0,2,0,2,Sicilia,ITG1
2021-01-08,PF/BT,190352.0,HSP11 - P.O. V.EMANUELE II CASTELVETRANO,SIC,20-29,1,2,0,3,0,0,0,3,0,3,Sicilia,ITG1
2021-01-08,PF/BT,190352.0,HSP11 - P.O. V.EMANUELE II CASTELVETRANO,SIC,30-39,5,2,0,3,4,0,0,7,0,7,Sicilia,ITG1
2021-01-08,PF/BT,190352.0,HSP11 - P.O. V.EMANUELE II CASTELVETRANO,SIC,40-49,10,10,0,11,7,0,2,20,0,20,Sicilia,ITG1
2021-01-08,PF/BT,190352.0,HSP11 - P.O. V.EMANUELE II CASTELVETRANO,SIC,50-59,6,5,0,8,1,0,2,11,0,11,Sicilia,ITG1
2021-01-08,PF/BT,190352.0,HSP11 - P.O. V.EMANUELE II CASTELVETRANO,SIC,60-69,6,4,0,6,2,0,2,10,0,10,Sicilia,ITG1
2021-01-08,PF/BT,190352.0,HSP11 - P.O. V.EMANUELE II CASTELVETRANO,SIC,70-79,2,1,0,3,0,0,0,3,0,3,Sicilia,ITG1
2021-01-08,PF/BT,190353.0,HSP11 - P.O.PAOLO BORSELLINO - MARSALA,SIC,16-19,0,1,0,1,0,0,0,1,0,1,Sicilia,ITG1
2021-01-08,PF/BT,190353.0,HSP11 - P.O.PAOLO BORSELLINO - MARSALA,SIC,20-29,4,5,0,9,0,0,0,9,0,9,Sicilia,ITG1
2021-01-08,PF/BT,190353.0,HSP11 - P.O.PAOLO BORSELLINO - MARSALA,SIC,30-39,2,7,0,9,0,0,0,9,0,9,Sicilia,ITG1
2021-01-08,PF/BT,190353.0,HSP11 - P.O.PAOLO BORSELLINO - MARSALA,SIC,40-49,6,22,0,28,0,0,0,28,0,28,Sicilia,ITG1
2021-01-08,PF/BT,190353.0,HSP11 - P.O.PAOLO BORSELLINO - MARSALA,SIC,50-59,13,11,0,24,0,0,0,24,0,24,Sicilia,ITG1
2021-01-08,PF/BT,190353.0,HSP11 - P.O.PAOLO BORSELLINO - MARSALA,SIC,60-69,7,4,0,11,0,0,0,11,0,11,Sicilia,ITG1
2021-01-08,PF/BT,190353.0,HSP11 - P.O.PAOLO BORSELLINO - MARSALA,SIC,80-89,1,0,0,1,0,0,0,1,0,1,Sicilia,ITG1
2021-01-08,PF/BT,190354.0,HSP11 - P.O.ABELE AJELLO-MAZARA D.VALLO,SIC,20-29,6,4,0,10,0,0,0,10,0,10,Sicilia,ITG1
2021-01-08,PF/BT,190354.0,HSP11 - P.O.ABELE AJELLO-MAZARA D.VALLO,SIC,30-39,4,8,0,12,0,0,0,12,0,12,Sicilia,ITG1
2021-01-08,PF/BT,190354.0,HSP11 - P.O.ABELE AJELLO-MAZARA D.VALLO,SIC,40-49,9,18,0,26,0,0,1,27,0,27,Sicilia,ITG1
2021-01-08,PF/BT,190354.0,HSP11 - P.O.ABELE AJELLO-MAZARA D.VALLO,SIC,50-59,7,23,0,27,2,0,1,30,0,30,Sicilia,ITG1
2021-01-08,PF/BT,190354.0,HSP11 - P.O.ABELE AJELLO-MAZARA D.VALLO,SIC,60-69,5,11,0,14,2,0,0,16,0,16,Sicilia,ITG1
2021-01-08,PF/BT,190354.0,HSP11 - P.O.ABELE AJELLO-MAZARA D.VALLO,SIC,70-79,2,0,0,2,0,0,0,2,0,2,Sicilia,ITG1
2021-01-08,PF/BT,190355.0,HSP11 - P.O. VITTORIO EMANUELE III - SALEMI,SIC,20-29,3,2,0,5,0,0,0,5,0,5,Sicilia,ITG1
2021-01-08,PF/BT,190355.0,HSP11 - P.O. VITTORIO EMANUELE III - SALEMI,SIC,30-39,1,5,0,6,0,0,0,6,0,6,Sicilia,ITG1
2021-01-08,PF/BT,190355.0,HSP11 - P.O. VITTORIO EMANUELE III - SALEMI,SIC,40-49,4,8,0,12,0,0,0,12,0,12,Sicilia,ITG1
2021-01-08,PF/BT,190355.0,HSP11 - P.O. VITTORIO EMANUELE III - SALEMI,SIC,50-59,8,10,0,18,0,0,0,18,0,18,Sicilia,ITG1
2021-01-08,PF/BT,190355.0,HSP11 - P.O. VITTORIO EMANUELE III - SALEMI,SIC,60-69,3,2,0,5,0,0,0,5,0,5,Sicilia,ITG1
2021-01-08,PF/BT,190355.0,HSP11 - P.O. VITTORIO EMANUELE III - SALEMI,SIC,70-79,2,0,0,2,0,0,0,2,0,2,Sicilia,ITG1
2021-01-08,PF/BT,190506.0,HSP11 - SO.GE.SA.SPA.C.DI.C.S.BARBARA,SIC,20-29,6,5,0,11,0,0,0,11,0,11,Sicilia,ITG1
2021-01-08,PF/BT,190506.0,HSP11 - SO.GE.SA.SPA.C.DI.C.S.BARBARA,SIC,30-39,4,6,0,10,0,0,0,10,0,10,Sicilia,ITG1
2021-01-08,PF/BT,190506.0,HSP11 - SO.GE.SA.SPA.C.DI.C.S.BARBARA,SIC,40-49,4,7,0,10,0,0,1,11,0,11,Sicilia,ITG1
2021-01-08,PF/BT,190506.0,HSP11 - SO.GE.SA.SPA.C.DI.C.S.BARBARA,SIC,50-59,6,7,0,12,0,1,0,13,0,13,Sicilia,ITG1
2021-01-08,PF/BT,190506.0,HSP11 - SO.GE.SA.SPA.C.DI.C.S.BARBARA,SIC,60-69,4,1,0,1,2,2,0,5,0,5,Sicilia,ITG1
2021-01-08,PF/BT,190506.0,HSP11 - SO.GE.SA.SPA.C.DI.C.S.BARBARA,SIC,70-79,0,2,0,0,0,2,0,2,0,2,Sicilia,ITG1
2021-01-08,PF/BT,190506.0,HSP11 - SO.GE.SA.SPA.C.DI.C.S.BARBARA,SIC,80-89,0,3,0,0,0,3,0,3,0,3,Sicilia,ITG1
2021-01-08,PF/BT,190506.0,HSP11 - SO.GE.SA.SPA.C.DI.C.S.BARBARA,SIC,90+,1,4,0,0,0,5,0,5,0,5,Sicilia,ITG1
2021-01-08,PF/BT,190511.0,HSP11 - CASA DI CURA DI STEFANO VELONA S.R.L.,SIC,20-29,1,3,0,3,0,0,1,4,0,4,Sicilia,ITG1
2021-01-08,PF/BT,190511.0,HSP11 - CASA DI CURA DI STEFANO VELONA S.R.L.,SIC,30-39,4,2,0,4,2,0,0,6,0,6,Sicilia,ITG1
2021-01-08,PF/BT,190511.0,HSP11 - CASA DI CURA DI STEFANO VELONA S.R.L.,SIC,40-49,2,3,0,3,1,0,1,5,0,5,Sicilia,ITG1
2021-01-08,PF/BT,190511.0,HSP11 - CASA DI CURA DI STEFANO VELONA S.R.L.,SIC,50-59,6,5,0,8,1,0,2,11,0,11,Sicilia,ITG1
2021-01-08,PF/BT,190511.0,HSP11 - CASA DI CURA DI STEFANO VELONA S.R.L.,SIC,60-69,2,1,0,3,0,0,0,3,0,3,Sicilia,ITG1
2021-01-08,PF/BT,190511.0,HSP11 - CASA DI CURA DI STEFANO VELONA S.R.L.,SIC,70-79,1,0,0,1,0,0,0,1,0,1,Sicilia,ITG1
2021-01-08,PF/BT,190513.0,HSP11 - CASA DI CURA G.B. MORGAGNI S.R.L.,SIC,20-29,8,17,0,19,4,0,2,25,0,25,Sicilia,ITG1
2021-01-08,PF/BT,190513.0,HSP11 - CASA DI CURA G.B. MORGAGNI S.R.L.,SIC,30-39,10,9,0,10,4,0,5,19,0,19,Sicilia,ITG1
2021-01-08,PF/BT,190513.0,HSP11 - CASA DI CURA G.B. MORGAGNI S.R.L.,SIC,40-49,13,15,0,12,10,0,6,28,0,28,Sicilia,ITG1
2021-01-08,PF/BT,190513.0,HSP11 - CASA DI CURA G.B. MORGAGNI S.R.L.,SIC,50-59,17,20,0,21,5,0,11,37,0,37,Sicilia,ITG1
2021-01-08,PF/BT,190513.0,HSP11 - CASA DI CURA G.B. MORGAGNI S.R.L.,SIC,60-69,10,10,0,11,5,0,4,20,0,20,Sicilia,ITG1
2021-01-08,PF/BT,190513.0,HSP11 - CASA DI CURA G.B. MORGAGNI S.R.L.,SIC,70-79,7,0,0,7,0,0,0,7,0,7,Sicilia,ITG1
2021-01-08,PF/BT,190519.0,HSP11 - HUMANITAS ISTITUTO CLINICO CATANESE,SIC,20-29,9,21,0,26,4,0,0,30,0,30,Sicilia,ITG1
2021-01-08,PF/BT,190519.0,HSP11 - HUMANITAS ISTITUTO CLINICO CATANESE,SIC,30-39,28,37,0,50,15,0,0,65,0,65,Sicilia,ITG1
2021-01-08,PF/BT,190519.0,HSP11 - HUMANITAS ISTITUTO CLINICO CATANESE,SIC,40-49,18,13,0,22,9,0,0,31,0,31,Sicilia,ITG1
2021-01-08,PF/BT,190519.0,HSP11 - HUMANITAS ISTITUTO CLINICO CATANESE,SIC,50-59,3,13,0,11,5,0,0,16,0,16,Sicilia,ITG1
2021-01-08,PF/BT,190519.0,HSP11 - HUMANITAS ISTITUTO CLINICO CATANESE,SIC,60-69,9,2,0,10,1,0,0,11,0,11,Sicilia,ITG1
2021-01-08,PF/BT,190519.0,HSP11 - HUMANITAS ISTITUTO CLINICO CATANESE,SIC,70-79,3,0,0,3,0,0,0,3,0,3,Sicilia,ITG1
2021-01-08,PF/BT,190520.0,HSP11 - CASA CURA CENTRO CATANESE MED. E CH.,SIC,20-29,2,6,0,7,1,0,0,8,0,8,Sicilia,ITG1
2021-01-08,PF/BT,190520.0,HSP11 - CASA CURA CENTRO CATANESE MED. E CH.,SIC,30-39,3,6,0,9,0,0,0,9,0,9,Sicilia,ITG1
2021-01-08,PF/BT,190520.0,HSP11 - CASA CURA CENTRO CATANESE MED. E CH.,SIC,40-49,3,5,0,6,2,0,0,8,0,8,Sicilia,ITG1
2021-01-08,PF/BT,190520.0,HSP11 - CASA CURA CENTRO CATANESE MED. E CH.,SIC,50-59,7,8,0,13,2,0,0,15,0,15,Sicilia,ITG1
2021-01-08,PF/BT,190520.0,HSP11 - CASA CURA CENTRO CATANESE MED. E CH.,SIC,60-69,7,0,0,6,1,0,0,7,0,7,Sicilia,ITG1
2021-01-08,PF/BT,190520.0,HSP11 - CASA CURA CENTRO CATANESE MED. E CH.,SIC,70-79,1,0,0,1,0,0,0,1,0,1,Sicilia,ITG1
2021-01-08,PF/BT,190525.0,HSP11 - CASA DI CURA S.CAMILLO,SIC,20-29,6,1,0,6,0,0,1,7,0,7,Sicilia,ITG1
2021-01-08,PF/BT,190525.0,HSP11 - CASA DI CURA S.CAMILLO,SIC,30-39,3,3,0,5,0,0,1,6,0,6,Sicilia,ITG1
2021-01-08,PF/BT,190525.0,HSP11 - CASA DI CURA S.CAMILLO,SIC,40-49,5,3,0,3,0,0,5,8,0,8,Sicilia,ITG1
2021-01-08,PF/BT,190525.0,HSP11 - CASA DI CURA S.CAMILLO,SIC,50-59,4,4,0,5,1,0,2,8,0,8,Sicilia,ITG1
2021-01-08,PF/BT,190525.0,HSP11 - CASA DI CURA S.CAMILLO,SIC,60-69,4,4,0,5,0,0,3,8,0,8,Sicilia,ITG1
2021-01-08,PF/BT,190525.0,HSP11 - CASA DI CURA S.CAMILLO,SIC,70-79,4,0,0,2,0,0,2,4,0,4,Sicilia,ITG1
2021-01-08,PF/BT,190525.0,HSP11 - CASA DI CURA S.CAMILLO,SIC,80-89,1,0,0,1,0,0,0,1,0,1,Sicilia,ITG1
2021-01-08,PF/BT,190528.0,HSP11 - CASA DI CURA VILLA SALUS S.A.S.,SIC,20-29,4,4,0,7,1,0,0,8,0,8,Sicilia,ITG1
2021-01-08,PF/BT,190528.0,HSP11 - CASA DI CURA VILLA SALUS S.A.S.,SIC,30-39,9,6,0,10,5,0,0,15,0,15,Sicilia,ITG1
2021-01-08,PF/BT,190528.0,HSP11 - CASA DI CURA VILLA SALUS S.A.S.,SIC,40-49,9,12,0,13,8,0,0,21,0,21,Sicilia,ITG1
2021-01-08,PF/BT,190528.0,HSP11 - CASA DI CURA VILLA SALUS S.A.S.,SIC,50-59,11,7,0,10,8,0,0,18,0,18,Sicilia,ITG1
2021-01-08,PF/BT,190528.0,HSP11 - CASA DI CURA VILLA SALUS S.A.S.,SIC,60-69,7,6,0,7,6,0,0,13,0,13,Sicilia,ITG1
2021-01-08,PF/BT,190528.0,HSP11 - CASA DI CURA VILLA SALUS S.A.S.,SIC,70-79,2,0,0,0,2,0,0,2,0,2,Sicilia,ITG1
2021-01-08,PF/BT,190528.0,HSP11 - CASA DI CURA VILLA SALUS S.A.S.,SIC,80-89,0,1,0,0,1,0,0,1,0,1,Sicilia,ITG1
2021-01-08,PF/BT,190530.0,HSP11 - C.O.T. S.P.A. (CURE ORTOPED. TRAUM.),SIC,20-29,5,6,0,10,1,0,0,11,0,11,Sicilia,ITG1
2021-01-08,PF/BT,190530.0,HSP11 - C.O.T. S.P.A. (CURE ORTOPED. TRAUM.),SIC,30-39,12,11,0,21,2,0,0,23,0,23,Sicilia,ITG1
2021-01-08,PF/BT,190530.0,HSP11 - C.O.T. S.P.A. (CURE ORTOPED. TRAUM.),SIC,40-49,13,11,0,17,7,0,0,24,0,24,Sicilia,ITG1
2021-01-08,PF/BT,190530.0,HSP11 - C.O.T. S.P.A. (CURE ORTOPED. TRAUM.),SIC,50-59,11,4,0,7,8,0,0,15,0,15,Sicilia,ITG1
2021-01-08,PF/BT,190530.0,HSP11 - C.O.T. S.P.A. (CURE ORTOPED. TRAUM.),SIC,60-69,3,1,0,3,1,0,0,4,0,4,Sicilia,ITG1
2021-01-08,PF/BT,190530.0,HSP11 - C.O.T. S.P.A. (CURE ORTOPED. TRAUM.),SIC,70-79,1,0,0,1,0,0,0,1,0,1,Sicilia,ITG1
2021-01-08,PF/BT,190552.0,HSP11 - CASA DI CURA CLINICA DEL MEDITERRANEO,SIC,20-29,6,2,0,8,0,0,0,8,0,8,Sicilia,ITG1
2021-01-08,PF/BT,190552.0,HSP11 - CASA DI CURA CLINICA DEL MEDITERRANEO,SIC,30-39,9,5,0,12,0,0,2,14,0,14,Sicilia,ITG1
2021-01-08,PF/BT,190552.0,HSP11 - CASA DI CURA CLINICA DEL MEDITERRANEO,SIC,40-49,8,13,0,15,3,0,3,21,0,21,Sicilia,ITG1
2021-01-08,PF/BT,190552.0,HSP11 - CASA DI CURA CLINICA DEL MEDITERRANEO,SIC,50-59,6,4,0,6,2,0,2,10,0,10,Sicilia,ITG1
2021-01-08,PF/BT,190552.0,HSP11 - CASA DI CURA CLINICA DEL MEDITERRANEO,SIC,60-69,8,2,0,9,0,0,1,10,0,10,Sicilia,ITG1
2021-01-08,PF/BT,190552.0,HSP11 - CASA DI CURA CLINICA DEL MEDITERRANEO,SIC,70-79,3,0,0,3,0,0,0,3,0,3,Sicilia,ITG1
2021-01-08,PF/BT,190554.0,HSP11 - ISTITUTO ONCOLOGICO DEL MEDITERRANEO SPA,SIC,20-29,1,6,0,7,0,0,0,7,0,7,Sicilia,ITG1
2021-01-08,PF/BT,190554.0,HSP11 - ISTITUTO ONCOLOGICO DEL MEDITERRANEO SPA,SIC,30-39,6,6,0,6,4,0,2,12,0,12,Sicilia,ITG1
2021-01-08,PF/BT,190554.0,HSP11 - ISTITUTO ONCOLOGICO DEL MEDITERRANEO SPA,SIC,40-49,2,3,0,3,1,0,1,5,0,5,Sicilia,ITG1
2021-01-08,PF/BT,190554.0,HSP11 - ISTITUTO ONCOLOGICO DEL MEDITERRANEO SPA,SIC,50-59,3,2,0,4,1,0,0,5,0,5,Sicilia,ITG1
2021-01-08,PF/BT,190554.0,HSP11 - ISTITUTO ONCOLOGICO DEL MEDITERRANEO SPA,SIC,60-69,2,1,0,2,0,0,1,3,0,3,Sicilia,ITG1
2021-01-08,PF/BT,190554.0,HSP11 - ISTITUTO ONCOLOGICO DEL MEDITERRANEO SPA,SIC,70-79,1,2,0,2,0,0,1,3,0,3,Sicilia,ITG1
2021-01-08,PF/BT,190554.0,HSP11 - ISTITUTO ONCOLOGICO DEL MEDITERRANEO SPA,SIC,80-89,1,0,0,0,0,0,1,1,0,1,Sicilia,ITG1
2021-01-08,PF/BT,190710.0,HSP11 - CASA DI CURA PROF.E.FALCIDIA SrL,SIC,20-29,0,5,0,5,0,0,0,5,0,5,Sicilia,ITG1
2021-01-08,PF/BT,190710.0,HSP11 - CASA DI CURA PROF.E.FALCIDIA SrL,SIC,30-39,0,1,0,1,0,0,0,1,0,1,Sicilia,ITG1
2021-01-08,PF/BT,190710.0,HSP11 - CASA DI CURA PROF.E.FALCIDIA SrL,SIC,40-49,0,3,0,3,0,0,0,3,0,3,Sicilia,ITG1
2021-01-08,PF/BT,190710.0,HSP11 - CASA DI CURA PROF.E.FALCIDIA SrL,SIC,50-59,3,2,0,5,0,0,0,5,0,5,Sicilia,ITG1
2021-01-08,PF/BT,190710.0,HSP11 - CASA DI CURA PROF.E.FALCIDIA SrL,SIC,60-69,2,0,0,2,0,0,0,2,0,2,Sicilia,ITG1
2021-01-08,PF/BT,190710.0,HSP11 - CASA DI CURA PROF.E.FALCIDIA SrL,SIC,70-79,2,0,0,2,0,0,0,2,0,2,Sicilia,ITG1
2021-01-08,PF/BT,190724.0,HSP11 - ISCAS MORGAGNI NORD SRL,SIC,20-29,2,9,0,11,0,0,0,11,0,11,Sicilia,ITG1
2021-01-08,PF/BT,190724.0,HSP11 - ISCAS MORGAGNI NORD SRL,SIC,30-39,4,9,0,11,2,0,0,13,0,13,Sicilia,ITG1
2021-01-08,PF/BT,190724.0,HSP11 - ISCAS MORGAGNI NORD SRL,SIC,40-49,16,13,0,17,12,0,0,29,0,29,Sicilia,ITG1
2021-01-08,PF/BT,190724.0,HSP11 - ISCAS MORGAGNI NORD SRL,SIC,50-59,15,18,0,24,9,0,0,33,0,33,Sicilia,ITG1
2021-01-08,PF/BT,190724.0,HSP11 - ISCAS MORGAGNI NORD SRL,SIC,60-69,6,9,0,13,2,0,0,15,0,15,Sicilia,ITG1
2021-01-08,PF/BT,190724.0,HSP11 - ISCAS MORGAGNI NORD SRL,SIC,70-79,1,0,0,1,0,0,0,1,0,1,Sicilia,ITG1
2021-01-08,PF/BT,190725.0,HSP11 - PRIVATE HOSPITAL ARGENTO srl,SIC,20-29,4,7,0,8,3,0,0,11,0,11,Sicilia,ITG1
2021-01-08,PF/BT,190725.0,HSP11 - PRIVATE HOSPITAL ARGENTO srl,SIC,30-39,6,1,0,4,3,0,0,7,0,7,Sicilia,ITG1
2021-01-08,PF/BT,190725.0,HSP11 - PRIVATE HOSPITAL ARGENTO srl,SIC,40-49,6,8,0,7,7,0,0,14,0,14,Sicilia,ITG1
2021-01-08,PF/BT,190725.0,HSP11 - PRIVATE HOSPITAL ARGENTO srl,SIC,50-59,2,5,0,6,1,0,0,7,0,7,Sicilia,ITG1
2021-01-08,PF/BT,190725.0,HSP11 - PRIVATE HOSPITAL ARGENTO srl,SIC,60-69,2,1,0,3,0,0,0,3,0,3,Sicilia,ITG1
2021-01-08,PF/BT,190725.0,HSP11 - PRIVATE HOSPITAL ARGENTO srl,SIC,70-79,2,0,0,2,0,0,0,2,0,2,Sicilia,ITG1
2021-01-08,PF/BT,190725.0,HSP11 - PRIVATE HOSPITAL ARGENTO srl,SIC,80-89,1,0,0,1,0,0,0,1,0,1,Sicilia,ITG1
2021-01-08,PF/BT,190921.0,HSP11 - A.O. per lEmergenza Cannizzaro,SIC,20-29,1,1,0,2,0,0,0,2,0,2,Sicilia,ITG1
2021-01-08,PF/BT,190921.0,HSP11 - A.O. per lEmergenza Cannizzaro,SIC,30-39,11,16,0,26,1,0,0,27,0,27,Sicilia,ITG1
2021-01-08,PF/BT,190921.0,HSP11 - A.O. per lEmergenza Cannizzaro,SIC,40-49,20,21,0,37,4,0,0,41,0,41,Sicilia,ITG1
2021-01-08,PF/BT,190921.0,HSP11 - A.O. per lEmergenza Cannizzaro,SIC,50-59,39,28,0,56,11,0,0,67,0,67,Sicilia,ITG1
2021-01-08,PF/BT,190921.0,HSP11 - A.O. per lEmergenza Cannizzaro,SIC,60-69,9,9,0,15,3,0,0,18,0,18,Sicilia,ITG1
2021-01-08,PF/BT,190921.0,HSP11 - A.O. per lEmergenza Cannizzaro,SIC,70-79,1,0,0,1,0,0,0,1,0,1,Sicilia,ITG1
2021-01-08,PF/BT,19092201.0,HSP11 - OSPEDALE GARIBALDI - CENTRO,SIC,20-29,2,2,0,2,0,0,2,4,0,4,Sicilia,ITG1
2021-01-08,PF/BT,19092201.0,HSP11 - OSPEDALE GARIBALDI - CENTRO,SIC,30-39,7,3,0,9,0,0,1,10,0,10,Sicilia,ITG1
2021-01-08,PF/BT,19092201.0,HSP11 - OSPEDALE GARIBALDI - CENTRO,SIC,40-49,5,4,0,7,0,0,2,9,0,9,Sicilia,ITG1
2021-01-08,PF/BT,19092201.0,HSP11 - OSPEDALE GARIBALDI - CENTRO,SIC,50-59,7,4,0,8,1,0,2,11,0,11,Sicilia,ITG1
2021-01-08,PF/BT,19092201.0,HSP11 - OSPEDALE GARIBALDI - CENTRO,SIC,60-69,2,0,0,2,0,0,0,2,0,2,Sicilia,ITG1
2021-01-08,PF/BT,19092204.0,HSP11 - NUOVO OSPEDALE GARIBALDI - NESIMA,SIC,20-29,1,2,0,3,0,0,0,3,0,3,Sicilia,ITG1
2021-01-08,PF/BT,19092204.0,HSP11 - NUOVO OSPEDALE GARIBALDI - NESIMA,SIC,30-39,1,3,0,4,0,0,0,4,0,4,Sicilia,ITG1
2021-01-08,PF/BT,19092204.0,HSP11 - NUOVO OSPEDALE GARIBALDI - NESIMA,SIC,40-49,10,13,0,21,2,0,0,23,0,23,Sicilia,ITG1
2021-01-08,PF/BT,19092204.0,HSP11 - NUOVO OSPEDALE GARIBALDI - NESIMA,SIC,50-59,8,23,0,28,3,0,0,31,0,31,Sicilia,ITG1
2021-01-08,PF/BT,19092204.0,HSP11 - NUOVO OSPEDALE GARIBALDI - NESIMA,SIC,60-69,6,10,0,13,2,0,1,16,0,16,Sicilia,ITG1
2021-01-08,PF/BT,19092204.0,HSP11 - NUOVO OSPEDALE GARIBALDI - NESIMA,SIC,70-79,1,0,0,1,0,0,0,1,0,1,Sicilia,ITG1
2021-01-08,PF/BT,19092301.0,HSP11 - PRESIDIO OSPEDALIERO GASPARE RODOLICO,SIC,20-29,5,4,0,9,0,0,0,9,0,9,Sicilia,ITG1
2021-01-08,PF/BT,19092301.0,HSP11 - PRESIDIO OSPEDALIERO GASPARE RODOLICO,SIC,30-39,21,22,1,43,0,0,0,43,0,43,Sicilia,ITG1
2021-01-08,PF/BT,19092301.0,HSP11 - PRESIDIO OSPEDALIERO GASPARE RODOLICO,SIC,40-49,36,41,0,77,0,0,0,77,0,77,Sicilia,ITG1
2021-01-08,PF/BT,19092301.0,HSP11 - PRESIDIO OSPEDALIERO GASPARE RODOLICO,SIC,50-59,39,37,0,76,0,0,0,76,0,76,Sicilia,ITG1
2021-01-08,PF/BT,19092301.0,HSP11 - PRESIDIO OSPEDALIERO GASPARE RODOLICO,SIC,60-69,23,29,0,52,0,0,0,52,0,52,Sicilia,ITG1
2021-01-08,PF/BT,19092301.0,HSP11 - PRESIDIO OSPEDALIERO GASPARE RODOLICO,SIC,70-79,3,0,0,3,0,0,0,3,0,3,Sicilia,ITG1
2021-01-08,PF/BT,19092304.0,HSP11 - PRESIDIO OSPEDALIERO S.MARCO,SIC,20-29,13,16,0,28,1,0,0,29,0,29,Sicilia,ITG1
2021-01-08,PF/BT,19092304.0,HSP11 - PRESIDIO OSPEDALIERO S.MARCO,SIC,30-39,12,18,1,29,1,0,0,30,0,30,Sicilia,ITG1
2021-01-08,PF/BT,19092304.0,HSP11 - PRESIDIO OSPEDALIERO S.MARCO,SIC,40-49,23,21,0,43,1,0,0,44,0,44,Sicilia,ITG1
2021-01-08,PF/BT,19092304.0,HSP11 - PRESIDIO OSPEDALIERO S.MARCO,SIC,50-59,11,20,0,30,1,0,0,31,0,31,Sicilia,ITG1
2021-01-08,PF/BT,19092304.0,HSP11 - PRESIDIO OSPEDALIERO S.MARCO,SIC,60-69,13,8,0,21,0,0,0,21,0,21,Sicilia,ITG1
2021-01-08,PF/BT,190924.0,HSP11 - Azienda Ospedaliera Papardo,SIC,20-29,4,0,0,0,0,0,4,4,0,4,Sicilia,ITG1
2021-01-08,PF/BT,190924.0,HSP11 - Azienda Ospedaliera Papardo,SIC,30-39,12,8,0,3,3,0,14,20,0,20,Sicilia,ITG1
2021-01-08,PF/BT,190924.0,HSP11 - Azienda Ospedaliera Papardo,SIC,40-49,16,8,0,12,2,0,10,24,0,24,Sicilia,ITG1
2021-01-08,PF/BT,190924.0,HSP11 - Azienda Ospedaliera Papardo,SIC,50-59,22,20,0,27,3,0,12,42,0,42,Sicilia,ITG1
2021-01-08,PF/BT,190924.0,HSP11 - Azienda Ospedaliera Papardo,SIC,60-69,8,3,0,7,0,0,4,11,0,11,Sicilia,ITG1
2021-01-08,PF/BT,190924.0,HSP11 - Azienda Ospedaliera Papardo,SIC,70-79,1,0,0,0,0,0,1,1,0,1,Sicilia,ITG1
2021-01-08,PF/BT,190925.0,A.O.U. Policlinico G.Martino,SIC,20-29,4,12,0,16,0,0,0,16,0,16,Sicilia,ITG1
2021-01-08,PF/BT,190925.0,A.O.U. Policlinico G.Martino,SIC,30-39,18,24,0,42,0,0,0,42,0,42,Sicilia,ITG1
2021-01-08,PF/BT,190925.0,A.O.U. Policlinico G.Martino,SIC,40-49,18,30,0,48,0,0,0,48,0,48,Sicilia,ITG1
2021-01-08,PF/BT,190925.0,A.O.U. Policlinico G.Martino,SIC,50-59,29,53,0,82,0,0,0,82,0,82,Sicilia,ITG1
2021-01-08,PF/BT,190925.0,A.O.U. Policlinico G.Martino,SIC,60-69,26,25,0,51,0,0,0,51,0,51,Sicilia,ITG1
2021-01-08,PF/BT,190925.0,A.O.U. Policlinico G.Martino,SIC,70-79,1,0,0,0,0,0,1,1,0,1,Sicilia,ITG1
2021-01-08,PF/BT,19092601.0,HSP11 - P.O. Villa Sofia,SIC,20-29,3,9,0,12,0,0,0,12,0,12,Sicilia,ITG1
2021-01-08,PF/BT,19092601.0,HSP11 - P.O. Villa Sofia,SIC,30-39,22,20,0,42,0,0,0,42,0,42,Sicilia,ITG1
2021-01-08,PF/BT,19092601.0,HSP11 - P.O. Villa Sofia,SIC,40-49,25,42,0,67,0,0,0,67,0,67,Sicilia,ITG1
2021-01-08,PF/BT,19092601.0,HSP11 - P.O. Villa Sofia,SIC,50-59,50,66,0,116,0,0,0,116,0,116,Sicilia,ITG1
2021-01-08,PF/BT,19092601.0,HSP11 - P.O. Villa Sofia,SIC,60-69,31,20,0,51,0,0,0,51,0,51,Sicilia,ITG1
2021-01-08,PF/BT,19092601.0,HSP11 - P.O. Villa Sofia,SIC,70-79,0,1,0,1,0,0,0,1,0,1,Sicilia,ITG1
2021-01-08,PF/BT,19092701.0,HSP11 - Ospedale Civico,SIC,20-29,6,15,0,21,0,0,0,21,0,21,Sicilia,ITG1
2021-01-08,PF/BT,19092701.0,HSP11 - Ospedale Civico,SIC,30-39,19,15,0,34,0,0,0,34,0,34,Sicilia,ITG1
2021-01-08,PF/BT,19092701.0,HSP11 - Ospedale Civico,SIC,40-49,26,22,0,44,4,0,0,48,0,48,Sicilia,ITG1
2021-01-08,PF/BT,19092701.0,HSP11 - Ospedale Civico,SIC,50-59,48,32,0,78,2,0,0,80,0,80,Sicilia,ITG1
2021-01-08,PF/BT,19092701.0,HSP11 - Ospedale Civico,SIC,60-69,26,7,0,31,2,0,0,33,0,33,Sicilia,ITG1
2021-01-08,PF/BT,19092702.0,HSP11 - Ospedale dei Bambini G. Di Cristina,SIC,20-29,5,3,0,8,0,0,0,8,0,8,Sicilia,ITG1
2021-01-08,PF/BT,19092702.0,HSP11 - Ospedale dei Bambini G. Di Cristina,SIC,30-39,3,7,0,10,0,0,0,10,0,10,Sicilia,ITG1
2021-01-08,PF/BT,19092702.0,HSP11 - Ospedale dei Bambini G. Di Cristina,SIC,40-49,7,12,0,19,0,0,0,19,0,19,Sicilia,ITG1
2021-01-08,PF/BT,19092702.0,HSP11 - Ospedale dei Bambini G. Di Cristina,SIC,50-59,19,30,0,49,0,0,0,49,0,49,Sicilia,ITG1
2021-01-08,PF/BT,19092702.0,HSP11 - Ospedale dei Bambini G. Di Cristina,SIC,60-69,7,17,0,24,0,0,0,24,0,24,Sicilia,ITG1
2021-01-08,PF/BT,190928.0,HSP11 - AZ.OSP.UNIV.P.GIACCONE,SIC,16-19,1,0,0,1,0,0,0,1,0,1,Sicilia,ITG1
2021-01-08,PF/BT,190928.0,HSP11 - AZ.OSP.UNIV.P.GIACCONE,SIC,20-29,25,26,0,50,1,0,0,51,0,51,Sicilia,ITG1
2021-01-08,PF/BT,190928.0,HSP11 - AZ.OSP.UNIV.P.GIACCONE,SIC,30-39,28,34,0,60,2,0,0,62,0,62,Sicilia,ITG1
2021-01-08,PF/BT,190928.0,HSP11 - AZ.OSP.UNIV.P.GIACCONE,SIC,40-49,20,25,0,43,0,0,2,45,0,45,Sicilia,ITG1
2021-01-08,PF/BT,190928.0,HSP11 - AZ.OSP.UNIV.P.GIACCONE,SIC,50-59,35,26,0,58,1,0,2,61,0,61,Sicilia,ITG1
2021-01-08,PF/BT,190928.0,HSP11 - AZ.OSP.UNIV.P.GIACCONE,SIC,60-69,25,20,0,42,2,0,1,45,0,45,Sicilia,ITG1
2021-01-08,PF/BT,190928.0,HSP11 - AZ.OSP.UNIV.P.GIACCONE,SIC,70-79,8,1,0,9,0,0,0,9,0,9,Sicilia,ITG1
2021-01-08,PF/BT,190928.0,HSP11 - AZ.OSP.UNIV.P.GIACCONE,SIC,80-89,1,0,0,1,0,0,0,1,0,1,Sicilia,ITG1
2021-01-08,PF/BT,190929.0,STS11 - IRCCS Ismett,SIC,20-29,2,1,0,1,2,0,0,3,0,3,Sicilia,ITG1
2021-01-08,PF/BT,190929.0,STS11 - IRCCS Ismett,SIC,30-39,7,8,0,4,11,0,0,15,0,15,Sicilia,ITG1
2021-01-08,PF/BT,190929.0,STS11 - IRCCS Ismett,SIC,40-49,6,10,0,7,9,0,0,16,0,16,Sicilia,ITG1
2021-01-08,PF/BT,190929.0,STS11 - IRCCS Ismett,SIC,50-59,5,2,0,2,5,0,0,7,0,7,Sicilia,ITG1
2021-01-08,PF/BT,190929.0,STS11 - IRCCS Ismett,SIC,60-69,0,1,0,0,1,0,0,1,0,1,Sicilia,ITG1
2021-01-08,PF/BT,190950.0,HSP11 - ASSOCIAZIONE OASI MARIA SS,SIC,20-29,1,4,0,5,0,0,0,5,0,5,Sicilia,ITG1
2021-01-08,PF/BT,190950.0,HSP11 - ASSOCIAZIONE OASI MARIA SS,SIC,30-39,6,13,0,17,0,0,2,19,0,19,Sicilia,ITG1
2021-01-08,PF/BT,190950.0,HSP11 - ASSOCIAZIONE OASI MARIA SS,SIC,40-49,11,31,0,37,0,0,5,42,0,42,Sicilia,ITG1
2021-01-08,PF/BT,190950.0,HSP11 - ASSOCIAZIONE OASI MARIA SS,SIC,50-59,11,31,0,34,0,0,8,42,0,42,Sicilia,ITG1
2021-01-08,PF/BT,190950.0,HSP11 - ASSOCIAZIONE OASI MARIA SS,SIC,60-69,4,7,0,7,0,0,4,11,0,11,Sicilia,ITG1
2021-01-08,PF/BT,19096001.0,HSP11 - IRCCS Centro Neurolesi,SIC,30-39,1,1,0,2,0,0,0,2,0,2,Sicilia,ITG1
2021-01-08,PF/BT,19096001.0,HSP11 - IRCCS Centro Neurolesi,SIC,40-49,1,1,0,2,0,0,0,2,0,2,Sicilia,ITG1
2021-01-08,PF/BT,19096001.0,HSP11 - IRCCS Centro Neurolesi,SIC,50-59,5,5,0,10,0,0,0,10,0,10,Sicilia,ITG1
2021-01-08,PF/BT,19096001.0,HSP11 - IRCCS Centro Neurolesi,SIC,60-69,24,8,0,32,0,0,0,32,0,32,Sicilia,ITG1
2021-01-08,PF/BT,19096001.0,HSP11 - IRCCS Centro Neurolesi,SIC,70-79,2,0,0,2,0,0,0,2,0,2,Sicilia,ITG1
2021-01-08,PF/BT,19096002.0,HSP11 - PRESIDIO OSPEDALIERO PIEMONTE,SIC,20-29,1,4,0,5,0,0,0,5,0,5,Sicilia,ITG1
2021-01-08,PF/BT,19096002.0,HSP11 - PRESIDIO OSPEDALIERO PIEMONTE,SIC,30-39,2,2,0,2,0,0,2,4,0,4,Sicilia,ITG1
2021-01-08,PF/BT,19096002.0,HSP11 - PRESIDIO OSPEDALIERO PIEMONTE,SIC,40-49,3,7,0,6,0,0,4,10,0,10,Sicilia,ITG1
2021-01-08,PF/BT,19096002.0,HSP11 - PRESIDIO OSPEDALIERO PIEMONTE,SIC,50-59,7,5,0,7,0,0,5,12,0,12,Sicilia,ITG1
2021-01-08,PF/BT,19096002.0,HSP11 - PRESIDIO OSPEDALIERO PIEMONTE,SIC,60-69,11,4,0,13,0,0,2,15,0,15,Sicilia,ITG1
2021-01-08,PF/BT,19096002.0,HSP11 - PRESIDIO OSPEDALIERO PIEMONTE,SIC,70-79,1,0,0,1,0,0,0,1,0,1,Sicilia,ITG1
2021-01-08,PF/BT,19096002.0,HSP11 - PRESIDIO OSPEDALIERO PIEMONTE,SIC,80-89,1,0,0,1,0,0,0,1,0,1,Sicilia,ITG1
2021-01-08,PF/BT,608200.0,STS11 - POLIAMBULATORIO San Giorgio,SIC,20-29,9,6,0,15,0,0,0,15,0,15,Sicilia,ITG1
2021-01-08,PF/BT,608200.0,STS11 - POLIAMBULATORIO San Giorgio,SIC,30-39,7,4,0,11,0,0,0,11,0,11,Sicilia,ITG1
2021-01-08,PF/BT,608200.0,STS11 - POLIAMBULATORIO San Giorgio,SIC,40-49,3,3,0,6,0,0,0,6,0,6,Sicilia,ITG1
2021-01-08,PF/BT,608200.0,STS11 - POLIAMBULATORIO San Giorgio,SIC,50-59,6,10,0,16,0,0,0,16,0,16,Sicilia,ITG1
2021-01-08,PF/BT,608200.0,STS11 - POLIAMBULATORIO San Giorgio,SIC,60-69,9,3,0,12,0,0,0,12,0,12,Sicilia,ITG1
2021-01-08,PF/BT,608400.0,STS11 - POLIAMBULATORIO  San Luigi,SIC,20-29,0,5,0,5,0,0,0,5,0,5,Sicilia,ITG1
2021-01-08,PF/BT,608400.0,STS11 - POLIAMBULATORIO  San Luigi,SIC,30-39,6,2,0,8,0,0,0,8,0,8,Sicilia,ITG1
2021-01-08,PF/BT,608400.0,STS11 - POLIAMBULATORIO  San Luigi,SIC,40-49,5,3,0,8,0,0,0,8,0,8,Sicilia,ITG1
2021-01-08,PF/BT,608400.0,STS11 - POLIAMBULATORIO  San Luigi,SIC,50-59,11,19,0,30,0,0,0,30,0,30,Sicilia,ITG1
2021-01-08,PF/BT,608400.0,STS11 - POLIAMBULATORIO  San Luigi,SIC,60-69,22,20,0,42,0,0,0,42,0,42,Sicilia,ITG1
2021-01-08,PF/BT,608400.0,STS11 - POLIAMBULATORIO  San Luigi,SIC,70-79,3,0,0,3,0,0,0,3,0,3,Sicilia,ITG1
2021-01-08,PF/BT,816400.0,STS11 - R.S.A. Societa Cooperativa Onlus GIOMATRIX a.r.l.,SIC,20-29,2,3,0,5,0,0,0,5,0,5,Sicilia,ITG1
2021-01-08,PF/BT,816400.0,STS11 - R.S.A. Societa Cooperativa Onlus GIOMATRIX a.r.l.,SIC,30-39,3,10,0,12,1,0,0,13,0,13,Sicilia,ITG1
2021-01-08,PF/BT,816400.0,STS11 - R.S.A. Societa Cooperativa Onlus GIOMATRIX a.r.l.,SIC,40-49,1,5,0,5,1,0,0,6,0,6,Sicilia,ITG1
2021-01-08,PF/BT,816400.0,STS11 - R.S.A. Societa Cooperativa Onlus GIOMATRIX a.r.l.,SIC,50-59,2,3,0,3,2,0,0,5,0,5,Sicilia,ITG1
2021-01-08,PF/BT,816400.0,STS11 - R.S.A. Societa Cooperativa Onlus GIOMATRIX a.r.l.,SIC,60-69,1,1,0,1,0,1,0,2,0,2,Sicilia,ITG1
2021-01-08,PF/BT,816400.0,STS11 - R.S.A. Societa Cooperativa Onlus GIOMATRIX a.r.l.,SIC,70-79,2,0,0,0,0,2,0,2,0,2,Sicilia,ITG1
2021-01-08,PF/BT,816400.0,STS11 - R.S.A. Societa Cooperativa Onlus GIOMATRIX a.r.l.,SIC,80-89,1,7,0,0,0,8,0,8,0,8,Sicilia,ITG1
2021-01-08,PF/BT,816400.0,STS11 - R.S.A. Societa Cooperativa Onlus GIOMATRIX a.r.l.,SIC,90+,0,5,0,0,0,5,0,5,0,5,Sicilia,ITG1
2021-01-09,PF/BT,190199.0,HSP11 - OSP. BUCCHERI LA FERLA FATEBENEFRATELLI,SIC,20-29,13,5,0,6,12,0,0,18,0,18,Sicilia,ITG1
2021-01-09,PF/BT,190199.0,HSP11 - OSP. BUCCHERI LA FERLA FATEBENEFRATELLI,SIC,30-39,10,3,0,5,8,0,0,13,0,13,Sicilia,ITG1
2021-01-09,PF/BT,190199.0,HSP11 - OSP. BUCCHERI LA FERLA FATEBENEFRATELLI,SIC,40-49,13,7,0,6,14,0,0,20,0,20,Sicilia,ITG1
2021-01-09,PF/BT,190199.0,HSP11 - OSP. BUCCHERI LA FERLA FATEBENEFRATELLI,SIC,50-59,15,18,0,23,10,0,0,33,0,33,Sicilia,ITG1
2021-01-09,PF/BT,190199.0,HSP11 - OSP. BUCCHERI LA FERLA FATEBENEFRATELLI,SIC,60-69,2,4,0,5,1,0,0,6,0,6,Sicilia,ITG1
2021-01-09,PF/BT,1902027.0,STRUTTURE PRIVATE NON CODIFICATE NSIS,SIC,20-29,4,1,0,5,0,0,0,5,0,5,Sicilia,ITG1
2021-01-09,PF/BT,1902027.0,STRUTTURE PRIVATE NON CODIFICATE NSIS,SIC,30-39,4,4,0,8,0,0,0,8,0,8,Sicilia,ITG1
2021-01-09,PF/BT,1902027.0,STRUTTURE PRIVATE NON CODIFICATE NSIS,SIC,40-49,5,14,0,19,0,0,0,19,0,19,Sicilia,ITG1
2021-01-09,PF/BT,1902027.0,STRUTTURE PRIVATE NON CODIFICATE NSIS,SIC,50-59,9,13,0,20,0,2,0,22,0,22,Sicilia,ITG1
2021-01-09,PF/BT,1902027.0,STRUTTURE PRIVATE NON CODIFICATE NSIS,SIC,60-69,7,12,0,13,0,5,1,19,0,19,Sicilia,ITG1
2021-01-09,PF/BT,1902027.0,STRUTTURE PRIVATE NON CODIFICATE NSIS,SIC,70-79,1,18,0,2,0,17,0,19,0,19,Sicilia,ITG1
2021-01-09,PF/BT,1902027.0,STRUTTURE PRIVATE NON CODIFICATE NSIS,SIC,80-89,14,41,0,1,0,54,0,55,0,55,Sicilia,ITG1
2021-01-09,PF/BT,1902027.0,STRUTTURE PRIVATE NON CODIFICATE NSIS,SIC,90+,7,31,0,0,0,38,0,38,0,38,Sicilia,ITG1
2021-01-09,PF/BT,1902037.0,STRUTTURE PRIVATE NON CODIFICATE NSIS,SIC,20-29,2,5,0,7,0,0,0,7,0,7,Sicilia,ITG1
2021-01-09,PF/BT,1902037.0,STRUTTURE PRIVATE NON CODIFICATE NSIS,SIC,30-39,2,7,0,9,0,0,0,9,0,9,Sicilia,ITG1
2021-01-09,PF/BT,1902037.0,STRUTTURE PRIVATE NON CODIFICATE NSIS,SIC,40-49,3,9,0,12,0,0,0,12,0,12,Sicilia,ITG1
2021-01-09,PF/BT,1902037.0,STRUTTURE PRIVATE NON CODIFICATE NSIS,SIC,50-59,3,3,0,6,0,0,0,6,0,6,Sicilia,ITG1
2021-01-09,PF/BT,1902037.0,STRUTTURE PRIVATE NON CODIFICATE NSIS,SIC,60-69,1,0,0,1,0,0,0,1,0,1,Sicilia,ITG1
2021-01-09,PF/BT,1902037.0,STRUTTURE PRIVATE NON CODIFICATE NSIS,SIC,70-79,3,2,0,2,0,3,0,5,0,5,Sicilia,ITG1
2021-01-09,PF/BT,1902037.0,STRUTTURE PRIVATE NON CODIFICATE NSIS,SIC,80-89,0,6,0,1,0,5,0,6,0,6,Sicilia,ITG1
2021-01-09,PF/BT,1902037.0,STRUTTURE PRIVATE NON CODIFICATE NSIS,SIC,90+,1,7,0,0,0,8,0,8,0,8,Sicilia,ITG1
2021-01-09,PF/BT,1902047.0,STRUTTURE PRIVATE NON CODIFICATE NSIS,SIC,20-29,1,3,0,4,0,0,0,4,0,4,Sicilia,ITG1
2021-01-09,PF/BT,1902047.0,STRUTTURE PRIVATE NON CODIFICATE NSIS,SIC,30-39,3,0,0,3,0,0,0,3,0,3,Sicilia,ITG1
2021-01-09,PF/BT,1902047.0,STRUTTURE PRIVATE NON CODIFICATE NSIS,SIC,40-49,4,2,0,6,0,0,0,6,0,6,Sicilia,ITG1
2021-01-09,PF/BT,1902047.0,STRUTTURE PRIVATE NON CODIFICATE NSIS,SIC,50-59,4,5,0,8,0,1,0,9,0,9,Sicilia,ITG1
2021-01-09,PF/BT,1902047.0,STRUTTURE PRIVATE NON CODIFICATE NSIS,SIC,60-69,3,7,0,7,0,3,0,10,0,10,Sicilia,ITG1
2021-01-09,PF/BT,1902047.0,STRUTTURE PRIVATE NON CODIFICATE NSIS,SIC,70-79,3,0,0,0,0,3,0,3,0,3,Sicilia,ITG1
2021-01-09,PF/BT,1902047.0,STRUTTURE PRIVATE NON CODIFICATE NSIS,SIC,80-89,8,5,0,0,0,13,0,13,0,13,Sicilia,ITG1
2021-01-09,PF/BT,1902047.0,STRUTTURE PRIVATE NON CODIFICATE NSIS,SIC,90+,3,9,0,0,0,12,0,12,0,12,Sicilia,ITG1
2021-01-09,PF/BT,1902057.0,STRUTTURE PRIVATE NON CODIFICATE NSIS,SIC,20-29,4,2,0,3,3,0,0,6,0,6,Sicilia,ITG1
2021-01-09,PF/BT,1902057.0,STRUTTURE PRIVATE NON CODIFICATE NSIS,SIC,30-39,11,7,0,14,4,0,0,18,0,18,Sicilia,ITG1
2021-01-09,PF/BT,1902057.0,STRUTTURE PRIVATE NON CODIFICATE NSIS,SIC,40-49,14,21,0,24,10,0,1,35,0,35,Sicilia,ITG1
2021-01-09,PF/BT,1902057.0,STRUTTURE PRIVATE NON CODIFICATE NSIS,SIC,50-59,28,21,0,40,7,0,2,49,0,49,Sicilia,ITG1
2021-01-09,PF/BT,1902057.0,STRUTTURE PRIVATE NON CODIFICATE NSIS,SIC,60-69,42,20,0,56,3,0,3,62,0,62,Sicilia,ITG1
2021-01-09,PF/BT,1902057.0,STRUTTURE PRIVATE NON CODIFICATE NSIS,SIC,70-79,3,1,0,1,0,0,3,4,0,4,Sicilia,ITG1
2021-01-09,PF/BT,1902057.0,STRUTTURE PRIVATE NON CODIFICATE NSIS,SIC,80-89,0,4,0,0,0,4,0,4,0,4,Sicilia,ITG1
2021-01-09,PF/BT,1902057.0,STRUTTURE PRIVATE NON CODIFICATE NSIS,SIC,90+,0,2,0,0,0,2,0,2,0,2,Sicilia,ITG1
2021-01-09,PF/BT,1902072.0,AMBULATORI VACCINALI NON CODIFICATI NSIS,SIC,20-29,15,31,0,21,5,0,20,46,0,46,Sicilia,ITG1
2021-01-09,PF/BT,1902072.0,AMBULATORI VACCINALI NON CODIFICATI NSIS,SIC,30-39,32,47,0,40,5,0,34,79,0,79,Sicilia,ITG1
2021-01-09,PF/BT,1902072.0,AMBULATORI VACCINALI NON CODIFICATI NSIS,SIC,40-49,37,61,0,50,12,0,36,98,0,98,Sicilia,ITG1
2021-01-09,PF/BT,1902072.0,AMBULATORI VACCINALI NON CODIFICATI NSIS,SIC,50-59,50,71,0,63,21,0,37,121,0,121,Sicilia,ITG1
2021-01-09,PF/BT,1902072.0,AMBULATORI VACCINALI NON CODIFICATI NSIS,SIC,60-69,41,33,0,49,9,0,16,74,0,74,Sicilia,ITG1
2021-01-09,PF/BT,1902072.0,AMBULATORI VACCINALI NON CODIFICATI NSIS,SIC,70-79,16,6,0,16,0,0,6,22,0,22,Sicilia,ITG1
2021-01-09,PF/BT,1902072.0,AMBULATORI VACCINALI NON CODIFICATI NSIS,SIC,80-89,0,1,0,0,0,0,1,1,0,1,Sicilia,ITG1
2021-01-09,PF/BT,1902072.0,AMBULATORI VACCINALI NON CODIFICATI NSIS,SIC,90+,1,0,0,0,0,0,1,1,0,1,Sicilia,ITG1
2021-01-09,PF/BT,1902077.0,STRUTTURE PRIVATE NON CODIFICATE NSIS,SIC,20-29,0,1,0,1,0,0,0,1,0,1,Sicilia,ITG1
2021-01-09,PF/BT,1902077.0,STRUTTURE PRIVATE NON CODIFICATE NSIS,SIC,30-39,1,8,0,9,0,0,0,9,0,9,Sicilia,ITG1
2021-01-09,PF/BT,1902077.0,STRUTTURE PRIVATE NON CODIFICATE NSIS,SIC,40-49,2,11,0,11,0,2,0,13,0,13,Sicilia,ITG1
2021-01-09,PF/BT,1902077.0,STRUTTURE PRIVATE NON CODIFICATE NSIS,SIC,50-59,1,10,0,9,0,1,1,11,0,11,Sicilia,ITG1
2021-01-09,PF/BT,1902077.0,STRUTTURE PRIVATE NON CODIFICATE NSIS,SIC,60-69,3,9,0,11,0,1,0,12,0,12,Sicilia,ITG1
2021-01-09,PF/BT,1902077.0,STRUTTURE PRIVATE NON CODIFICATE NSIS,SIC,70-79,5,11,0,1,0,15,0,16,0,16,Sicilia,ITG1
2021-01-09,PF/BT,1902077.0,STRUTTURE PRIVATE NON CODIFICATE NSIS,SIC,80-89,10,55,0,0,0,63,2,65,0,65,Sicilia,ITG1
2021-01-09,PF/BT,1902077.0,STRUTTURE PRIVATE NON CODIFICATE NSIS,SIC,90+,6,26,0,1,0,29,2,32,0,32,Sicilia,ITG1
2021-01-09,PF/BT,1902087.0,STRUTTURE PRIVATE NON CODIFICATE NSIS,SIC,20-29,3,3,0,3,0,1,2,6,0,6,Sicilia,ITG1
2021-01-09,PF/BT,1902087.0,STRUTTURE PRIVATE NON CODIFICATE NSIS,SIC,30-39,3,6,0,5,0,0,4,9,0,9,Sicilia,ITG1
2021-01-09,PF/BT,1902087.0,STRUTTURE PRIVATE NON CODIFICATE NSIS,SIC,40-49,2,13,0,7,0,2,6,15,0,15,Sicilia,ITG1
2021-01-09,PF/BT,1902087.0,STRUTTURE PRIVATE NON CODIFICATE NSIS,SIC,50-59,4,17,0,16,0,5,0,21,0,21,Sicilia,ITG1
2021-01-09,PF/BT,1902087.0,STRUTTURE PRIVATE NON CODIFICATE NSIS,SIC,60-69,20,12,0,8,0,24,0,32,0,32,Sicilia,ITG1
2021-01-09,PF/BT,1902087.0,STRUTTURE PRIVATE NON CODIFICATE NSIS,SIC,70-79,7,9,0,1,0,11,4,16,0,16,Sicilia,ITG1
2021-01-09,PF/BT,1902087.0,STRUTTURE PRIVATE NON CODIFICATE NSIS,SIC,80-89,8,15,0,0,0,9,14,23,0,23,Sicilia,ITG1
2021-01-09,PF/BT,1902087.0,STRUTTURE PRIVATE NON CODIFICATE NSIS,SIC,90+,1,11,0,1,0,2,9,12,0,12,Sicilia,ITG1
2021-01-09,PF/BT,190301.0,RIA11 - A.I.A.S.SEZ.DI AGRIGENTO ONLUS,SIC,16-19,1,0,0,0,0,0,1,1,0,1,Sicilia,ITG1
2021-01-09,PF/BT,190301.0,RIA11 - A.I.A.S.SEZ.DI AGRIGENTO ONLUS,SIC,20-29,13,15,0,21,0,0,7,28,0,28,Sicilia,ITG1
2021-01-09,PF/BT,190301.0,RIA11 - A.I.A.S.SEZ.DI AGRIGENTO ONLUS,SIC,30-39,22,26,0,44,1,0,3,48,0,48,Sicilia,ITG1
2021-01-09,PF/BT,190301.0,RIA11 - A.I.A.S.SEZ.DI AGRIGENTO ONLUS,SIC,40-49,31,44,0,57,2,0,16,75,0,75,Sicilia,ITG1
2021-01-09,PF/BT,190301.0,RIA11 - A.I.A.S.SEZ.DI AGRIGENTO ONLUS,SIC,50-59,41,53,0,70,6,0,18,94,0,94,Sicilia,ITG1
2021-01-09,PF/BT,190301.0,RIA11 - A.I.A.S.SEZ.DI AGRIGENTO ONLUS,SIC,60-69,33,22,0,51,1,0,3,55,0,55,Sicilia,ITG1
2021-01-09,PF/BT,190301.0,RIA11 - A.I.A.S.SEZ.DI AGRIGENTO ONLUS,SIC,70-79,9,1,0,10,0,0,0,10,0,10,Sicilia,ITG1
2021-01-09,PF/BT,190301.0,RIA11 - A.I.A.S.SEZ.DI AGRIGENTO ONLUS,SIC,80-89,1,0,0,0,0,0,1,1,0,1,Sicilia,ITG1
2021-01-09,PF/BT,190302.0,RIA11 - C.DELLA SPERANZA DON ANGELO G.,SIC,20-29,6,6,0,1,0,0,11,12,0,12,Sicilia,ITG1
2021-01-09,PF/BT,190302.0,RIA11 - C.DELLA SPERANZA DON ANGELO G.,SIC,30-39,11,21,0,1,0,0,31,32,0,32,Sicilia,ITG1
2021-01-09,PF/BT,190302.0,RIA11 - C.DELLA SPERANZA DON ANGELO G.,SIC,40-49,10,13,0,2,0,0,21,23,0,23,Sicilia,ITG1
2021-01-09,PF/BT,190302.0,RIA11 - C.DELLA SPERANZA DON ANGELO G.,SIC,50-59,12,17,0,7,0,0,22,29,0,29,Sicilia,ITG1
2021-01-09,PF/BT,190302.0,RIA11 - C.DELLA SPERANZA DON ANGELO G.,SIC,60-69,6,9,0,6,0,0,9,15,0,15,Sicilia,ITG1
2021-01-09,PF/BT,190302.0,RIA11 - C.DELLA SPERANZA DON ANGELO G.,SIC,70-79,2,1,0,0,0,0,3,3,0,3,Sicilia,ITG1
2021-01-09,PF/BT,190303.0,RIA11 - COMUNITA` DELLA SPERANZA,SIC,20-29,7,6,0,5,7,0,1,13,0,13,Sicilia,ITG1
2021-01-09,PF/BT,190303.0,RIA11 - COMUNITA` DELLA SPERANZA,SIC,30-39,2,8,0,7,2,0,1,10,0,10,Sicilia,ITG1
2021-01-09,PF/BT,190303.0,RIA11 - COMUNITA` DELLA SPERANZA,SIC,40-49,7,18,0,8,15,0,2,25,0,25,Sicilia,ITG1
2021-01-09,PF/BT,190303.0,RIA11 - COMUNITA` DELLA SPERANZA,SIC,50-59,4,8,0,2,9,0,1,12,0,12,Sicilia,ITG1
2021-01-09,PF/BT,190303.0,RIA11 - COMUNITA` DELLA SPERANZA,SIC,70-79,8,2,0,0,4,0,6,10,0,10,Sicilia,ITG1
2021-01-09,PF/BT,190303.0,RIA11 - COMUNITA` DELLA SPERANZA,SIC,80-89,2,5,0,0,4,0,3,7,0,7,Sicilia,ITG1
2021-01-09,PF/BT,190303.0,RIA11 - COMUNITA` DELLA SPERANZA,SIC,90+,0,1,0,0,1,0,0,1,0,1,Sicilia,ITG1
2021-01-09,PF/BT,190305.0,HSP11 - P.O. GIOVANNI PAOLO II,SIC,16-19,1,1,0,1,0,0,1,2,0,2,Sicilia,ITG1
2021-01-09,PF/BT,190305.0,HSP11 - P.O. GIOVANNI PAOLO II,SIC,20-29,10,15,0,20,4,0,1,25,0,25,Sicilia,ITG1
2021-01-09,PF/BT,190305.0,HSP11 - P.O. GIOVANNI PAOLO II,SIC,30-39,19,21,0,29,11,0,0,40,0,40,Sicilia,ITG1
2021-01-09,PF/BT,190305.0,HSP11 - P.O. GIOVANNI PAOLO II,SIC,40-49,18,30,0,23,23,0,2,48,0,48,Sicilia,ITG1
2021-01-09,PF/BT,190305.0,HSP11 - P.O. GIOVANNI PAOLO II,SIC,50-59,23,40,0,42,19,0,2,63,0,63,Sicilia,ITG1
2021-01-09,PF/BT,190305.0,HSP11 - P.O. GIOVANNI PAOLO II,SIC,60-69,18,13,0,23,8,0,0,31,0,31,Sicilia,ITG1
2021-01-09,PF/BT,190305.0,HSP11 - P.O. GIOVANNI PAOLO II,SIC,70-79,9,3,0,9,1,0,2,12,0,12,Sicilia,ITG1
2021-01-09,PF/BT,190305.0,HSP11 - P.O. GIOVANNI PAOLO II,SIC,80-89,2,3,0,0,0,0,5,5,0,5,Sicilia,ITG1
2021-01-09,PF/BT,190306.0,RIA11 - ASS. CASA FAM.ROSETTA ONILUS,SIC,20-29,19,12,0,17,10,0,4,31,0,31,Sicilia,ITG1
2021-01-09,PF/BT,190306.0,RIA11 - ASS. CASA FAM.ROSETTA ONILUS,SIC,30-39,16,13,0,21,6,0,2,29,0,29,Sicilia,ITG1
2021-01-09,PF/BT,190306.0,RIA11 - ASS. CASA FAM.ROSETTA ONILUS,SIC,40-49,13,12,0,16,5,0,4,25,0,25,Sicilia,ITG1
2021-01-09,PF/BT,190306.0,RIA11 - ASS. CASA FAM.ROSETTA ONILUS,SIC,50-59,11,30,0,29,10,0,2,41,0,41,Sicilia,ITG1
2021-01-09,PF/BT,190306.0,RIA11 - ASS. CASA FAM.ROSETTA ONILUS,SIC,60-69,24,16,0,33,7,0,0,40,0,40,Sicilia,ITG1
2021-01-09,PF/BT,190306.0,RIA11 - ASS. CASA FAM.ROSETTA ONILUS,SIC,70-79,3,0,0,3,0,0,0,3,0,3,Sicilia,ITG1
2021-01-09,PF/BT,190309.0,HSP11 - P.O. VITTORIO EMANUELE (ex AO),SIC,20-29,5,5,0,9,0,0,1,10,0,10,Sicilia,ITG1
2021-01-09,PF/BT,190309.0,HSP11 - P.O. VITTORIO EMANUELE (ex AO),SIC,30-39,6,5,0,7,0,0,4,11,0,11,Sicilia,ITG1
2021-01-09,PF/BT,190309.0,HSP11 - P.O. VITTORIO EMANUELE (ex AO),SIC,40-49,11,7,0,12,0,0,6,18,0,18,Sicilia,ITG1
2021-01-09,PF/BT,190309.0,HSP11 - P.O. VITTORIO EMANUELE (ex AO),SIC,50-59,12,9,0,14,0,0,7,21,0,21,Sicilia,ITG1
2021-01-09,PF/BT,190309.0,HSP11 - P.O. VITTORIO EMANUELE (ex AO),SIC,60-69,10,9,0,15,0,0,4,19,0,19,Sicilia,ITG1
2021-01-09,PF/BT,190312.0,HSP11 - P.O. S. Marta e S. Venera Acireale,SIC,20-29,6,7,0,13,0,0,0,13,0,13,Sicilia,ITG1
2021-01-09,PF/BT,190312.0,HSP11 - P.O. S. Marta e S. Venera Acireale,SIC,30-39,9,9,0,16,2,0,0,18,0,18,Sicilia,ITG1
2021-01-09,PF/BT,190312.0,HSP11 - P.O. S. Marta e S. Venera Acireale,SIC,40-49,9,12,0,19,2,0,0,21,0,21,Sicilia,ITG1
2021-01-09,PF/BT,190312.0,HSP11 - P.O. S. Marta e S. Venera Acireale,SIC,50-59,12,16,0,25,3,0,0,28,0,28,Sicilia,ITG1
2021-01-09,PF/BT,190312.0,HSP11 - P.O. S. Marta e S. Venera Acireale,SIC,60-69,17,10,0,27,0,0,0,27,0,27,Sicilia,ITG1
2021-01-09,PF/BT,190312.0,HSP11 - P.O. S. Marta e S. Venera Acireale,SIC,70-79,4,2,0,6,0,0,0,6,0,6,Sicilia,ITG1
2021-01-09,PF/BT,190312.0,HSP11 - P.O. S. Marta e S. Venera Acireale,SIC,80-89,1,0,0,1,0,0,0,1,0,1,Sicilia,ITG1
2021-01-09,PF/BT,190313.0,RIA11 - IST.RIAB.VILLAG. SAN GIUSEPPE,SIC,20-29,4,6,0,9,0,0,1,10,0,10,Sicilia,ITG1
2021-01-09,PF/BT,190313.0,RIA11 - IST.RIAB.VILLAG. SAN GIUSEPPE,SIC,30-39,8,7,0,13,0,0,2,15,0,15,Sicilia,ITG1
2021-01-09,PF/BT,190313.0,RIA11 - IST.RIAB.VILLAG. SAN GIUSEPPE,SIC,40-49,11,14,0,22,0,0,3,25,0,25,Sicilia,ITG1
2021-01-09,PF/BT,190313.0,RIA11 - IST.RIAB.VILLAG. SAN GIUSEPPE,SIC,50-59,12,13,0,20,1,0,4,25,0,25,Sicilia,ITG1
2021-01-09,PF/BT,190313.0,RIA11 - IST.RIAB.VILLAG. SAN GIUSEPPE,SIC,60-69,18,12,0,26,0,0,4,30,0,30,Sicilia,ITG1
2021-01-09,PF/BT,190313.0,RIA11 - IST.RIAB.VILLAG. SAN GIUSEPPE,SIC,70-79,1,1,0,2,0,0,0,2,0,2,Sicilia,ITG1
2021-01-09,PF/BT,190313.0,RIA11 - IST.RIAB.VILLAG. SAN GIUSEPPE,SIC,80-89,1,0,0,1,0,0,0,1,0,1,Sicilia,ITG1
2021-01-09,PF/BT,190314.0,RIA11 - ASS.J.F.KENNEDY ACIREALE,SIC,20-29,3,7,0,10,0,0,0,10,0,10,Sicilia,ITG1
2021-01-09,PF/BT,190314.0,RIA11 - ASS.J.F.KENNEDY ACIREALE,SIC,30-39,9,8,0,17,0,0,0,17,0,17,Sicilia,ITG1
2021-01-09,PF/BT,190314.0,RIA11 - ASS.J.F.KENNEDY ACIREALE,SIC,40-49,12,16,0,28,0,0,0,28,0,28,Sicilia,ITG1
2021-01-09,PF/BT,190314.0,RIA11 - ASS.J.F.KENNEDY ACIREALE,SIC,50-59,5,19,0,24,0,0,0,24,0,24,Sicilia,ITG1
2021-01-09,PF/BT,190314.0,RIA11 - ASS.J.F.KENNEDY ACIREALE,SIC,60-69,3,4,0,7,0,0,0,7,0,7,Sicilia,ITG1
2021-01-09,PF/BT,190314.0,RIA11 - ASS.J.F.KENNEDY ACIREALE,SIC,70-79,2,0,0,2,0,0,0,2,0,2,Sicilia,ITG1
2021-01-09,PF/BT,190314.0,RIA11 - ASS.J.F.KENNEDY ACIREALE,SIC,80-89,2,0,0,2,0,0,0,2,0,2,Sicilia,ITG1
2021-01-09,PF/BT,190316.0,RIA11 - ASS.J.F.KENNEDY - C.RIAB.ONLUS,SIC,20-29,5,2,0,6,1,0,0,7,0,7,Sicilia,ITG1
2021-01-09,PF/BT,190316.0,RIA11 - ASS.J.F.KENNEDY - C.RIAB.ONLUS,SIC,30-39,0,4,0,4,0,0,0,4,0,4,Sicilia,ITG1
2021-01-09,PF/BT,190316.0,RIA11 - ASS.J.F.KENNEDY - C.RIAB.ONLUS,SIC,40-49,2,8,0,7,3,0,0,10,0,10,Sicilia,ITG1
2021-01-09,PF/BT,190316.0,RIA11 - ASS.J.F.KENNEDY - C.RIAB.ONLUS,SIC,50-59,5,7,0,10,2,0,0,12,0,12,Sicilia,ITG1
2021-01-09,PF/BT,190316.0,RIA11 - ASS.J.F.KENNEDY - C.RIAB.ONLUS,SIC,60-69,6,3,0,7,2,0,0,9,0,9,Sicilia,ITG1
2021-01-09,PF/BT,190317.0,HSP11 - P.O. Gravina e S. Pietro Caltagirone,SIC,20-29,1,1,0,1,1,0,0,2,0,2,Sicilia,ITG1
2021-01-09,PF/BT,190317.0,HSP11 - P.O. Gravina e S. Pietro Caltagirone,SIC,30-39,1,2,0,2,1,0,0,3,0,3,Sicilia,ITG1
2021-01-09,PF/BT,190317.0,HSP11 - P.O. Gravina e S. Pietro Caltagirone,SIC,40-49,1,3,0,1,3,0,0,4,0,4,Sicilia,ITG1
2021-01-09,PF/BT,190317.0,HSP11 - P.O. Gravina e S. Pietro Caltagirone,SIC,50-59,6,8,0,4,10,0,0,14,0,14,Sicilia,ITG1
2021-01-09,PF/BT,190317.0,HSP11 - P.O. Gravina e S. Pietro Caltagirone,SIC,60-69,2,5,0,5,2,0,0,7,0,7,Sicilia,ITG1
2021-01-09,PF/BT,190318.0,RIA11 - ASS.ISTITUTO REGINA VIRGINUM,SIC,16-19,3,1,0,4,0,0,0,4,0,4,Sicilia,ITG1
2021-01-09,PF/BT,190318.0,RIA11 - ASS.ISTITUTO REGINA VIRGINUM,SIC,20-29,4,10,0,14,0,0,0,14,0,14,Sicilia,ITG1
2021-01-09,PF/BT,190318.0,RIA11 - ASS.ISTITUTO REGINA VIRGINUM,SIC,30-39,4,6,0,9,0,0,1,10,0,10,Sicilia,ITG1
2021-01-09,PF/BT,190318.0,RIA11 - ASS.ISTITUTO REGINA VIRGINUM,SIC,40-49,6,3,0,9,0,0,0,9,0,9,Sicilia,ITG1
2021-01-09,PF/BT,190318.0,RIA11 - ASS.ISTITUTO REGINA VIRGINUM,SIC,50-59,9,5,0,14,0,0,0,14,0,14,Sicilia,ITG1
2021-01-09,PF/BT,190318.0,RIA11 - ASS.ISTITUTO REGINA VIRGINUM,SIC,60-69,7,2,0,9,0,0,0,9,0,9,Sicilia,ITG1
2021-01-09,PF/BT,190319.0,HSP11 - P. O. UMBERTO I,SIC,20-29,5,3,0,7,0,0,1,8,0,8,Sicilia,ITG1
2021-01-09,PF/BT,190319.0,HSP11 - P. O. UMBERTO I,SIC,30-39,7,4,0,9,0,0,2,11,0,11,Sicilia,ITG1
2021-01-09,PF/BT,190319.0,HSP11 - P. O. UMBERTO I,SIC,40-49,5,7,0,11,0,0,1,12,0,12,Sicilia,ITG1
2021-01-09,PF/BT,190319.0,HSP11 - P. O. UMBERTO I,SIC,50-59,11,7,0,18,0,0,0,18,0,18,Sicilia,ITG1
2021-01-09,PF/BT,190319.0,HSP11 - P. O. UMBERTO I,SIC,60-69,11,11,0,22,0,0,0,22,0,22,Sicilia,ITG1
2021-01-09,PF/BT,190326.0,HSP11 - P.O. S. VINCENZO TAORMINA,SIC,30-39,8,12,0,19,1,0,0,20,0,20,Sicilia,ITG1
2021-01-09,PF/BT,190326.0,HSP11 - P.O. S. VINCENZO TAORMINA,SIC,40-49,14,30,0,41,3,0,0,44,0,44,Sicilia,ITG1
2021-01-09,PF/BT,190326.0,HSP11 - P.O. S. VINCENZO TAORMINA,SIC,50-59,36,47,0,81,2,0,0,83,0,83,Sicilia,ITG1
2021-01-09,PF/BT,190326.0,HSP11 - P.O. S. VINCENZO TAORMINA,SIC,60-69,6,15,0,21,0,0,0,21,0,21,Sicilia,ITG1
2021-01-09,PF/BT,190328.0,HSP11 - P.O. BARONE-ROMEO PATTI,SIC,20-29,1,1,0,1,1,0,0,2,0,2,Sicilia,ITG1
2021-01-09,PF/BT,190328.0,HSP11 - P.O. BARONE-ROMEO PATTI,SIC,30-39,0,2,0,1,1,0,0,2,0,2,Sicilia,ITG1
2021-01-09,PF/BT,190328.0,HSP11 - P.O. BARONE-ROMEO PATTI,SIC,40-49,2,1,0,2,1,0,0,3,0,3,Sicilia,ITG1
2021-01-09,PF/BT,190328.0,HSP11 - P.O. BARONE-ROMEO PATTI,SIC,50-59,4,5,0,5,4,0,0,9,0,9,Sicilia,ITG1
2021-01-09,PF/BT,190328.0,HSP11 - P.O. BARONE-ROMEO PATTI,SIC,60-69,2,0,0,0,2,0,0,2,0,2,Sicilia,ITG1
2021-01-09,PF/BT,190328.0,HSP11 - P.O. BARONE-ROMEO PATTI,SIC,70-79,1,1,0,0,0,2,0,2,0,2,Sicilia,ITG1
2021-01-09,PF/BT,190328.0,HSP11 - P.O. BARONE-ROMEO PATTI,SIC,80-89,1,7,0,1,0,7,0,8,0,8,Sicilia,ITG1
2021-01-09,PF/BT,190328.0,HSP11 - P.O. BARONE-ROMEO PATTI,SIC,90+,1,1,0,0,0,2,0,2,0,2,Sicilia,ITG1
2021-01-09,PF/BT,190330.0,P.O. DEI BIANCHI CORLEONE,SIC,20-29,4,4,0,8,0,0,0,8,0,8,Sicilia,ITG1
2021-01-09,PF/BT,190330.0,P.O. DEI BIANCHI CORLEONE,SIC,30-39,10,2,0,11,1,0,0,12,0,12,Sicilia,ITG1
2021-01-09,PF/BT,190330.0,P.O. DEI BIANCHI CORLEONE,SIC,40-49,10,5,0,14,1,0,0,15,0,15,Sicilia,ITG1
2021-01-09,PF/BT,190330.0,P.O. DEI BIANCHI CORLEONE,SIC,50-59,9,7,0,12,4,0,0,16,0,16,Sicilia,ITG1
2021-01-09,PF/BT,190330.0,P.O. DEI BIANCHI CORLEONE,SIC,60-69,5,7,0,9,3,0,0,12,0,12,Sicilia,ITG1
2021-01-09,PF/BT,190330.0,P.O. DEI BIANCHI CORLEONE,SIC,70-79,3,0,0,0,3,0,0,3,0,3,Sicilia,ITG1
2021-01-09,PF/BT,190332.0,HSP11 - P.O. CIVICO PARTINICO,SIC,20-29,5,9,0,13,1,0,0,14,0,14,Sicilia,ITG1
2021-01-09,PF/BT,190332.0,HSP11 - P.O. CIVICO PARTINICO,SIC,30-39,7,18,0,21,4,0,0,25,0,25,Sicilia,ITG1
2021-01-09,PF/BT,190332.0,HSP11 - P.O. CIVICO PARTINICO,SIC,40-49,9,12,0,17,4,0,0,21,0,21,Sicilia,ITG1
2021-01-09,PF/BT,190332.0,HSP11 - P.O. CIVICO PARTINICO,SIC,50-59,12,7,0,13,6,0,0,19,0,19,Sicilia,ITG1
2021-01-09,PF/BT,190332.0,HSP11 - P.O. CIVICO PARTINICO,SIC,60-69,11,5,0,10,6,0,0,16,0,16,Sicilia,ITG1
2021-01-09,PF/BT,190332.0,HSP11 - P.O. CIVICO PARTINICO,SIC,70-79,5,1,0,4,2,0,0,6,0,6,Sicilia,ITG1
2021-01-09,PF/BT,190334.0,HSP11 - P.O. S. CIMINO TERMINI IMERESE,SIC,20-29,3,3,0,6,0,0,0,6,0,6,Sicilia,ITG1
2021-01-09,PF/BT,190334.0,HSP11 - P.O. S. CIMINO TERMINI IMERESE,SIC,30-39,10,19,0,25,4,0,0,29,0,29,Sicilia,ITG1
2021-01-09,PF/BT,190334.0,HSP11 - P.O. S. CIMINO TERMINI IMERESE,SIC,40-49,12,14,0,16,10,0,0,26,0,26,Sicilia,ITG1
2021-01-09,PF/BT,190334.0,HSP11 - P.O. S. CIMINO TERMINI IMERESE,SIC,50-59,14,20,0,31,3,0,0,34,0,34,Sicilia,ITG1
2021-01-09,PF/BT,190334.0,HSP11 - P.O. S. CIMINO TERMINI IMERESE,SIC,60-69,34,14,0,47,1,0,0,48,0,48,Sicilia,ITG1
2021-01-09,PF/BT,190334.0,HSP11 - P.O. S. CIMINO TERMINI IMERESE,SIC,70-79,0,1,0,1,0,0,0,1,0,1,Sicilia,ITG1
2021-01-09,PF/BT,190335.0,HSP11 - P.O. G. F. INGRASSIA,SIC,20-29,0,2,0,2,0,0,0,2,0,2,Sicilia,ITG1
2021-01-09,PF/BT,190335.0,HSP11 - P.O. G. F. INGRASSIA,SIC,30-39,3,1,0,4,0,0,0,4,0,4,Sicilia,ITG1
2021-01-09,PF/BT,190335.0,HSP11 - P.O. G. F. INGRASSIA,SIC,40-49,1,3,0,4,0,0,0,4,0,4,Sicilia,ITG1
2021-01-09,PF/BT,190335.0,HSP11 - P.O. G. F. INGRASSIA,SIC,50-59,2,0,0,2,0,0,0,2,0,2,Sicilia,ITG1
2021-01-09,PF/BT,190335.0,HSP11 - P.O. G. F. INGRASSIA,SIC,60-69,7,4,0,11,0,0,0,11,0,11,Sicilia,ITG1
2021-01-09,PF/BT,190335.0,HSP11 - P.O. G. F. INGRASSIA,SIC,70-79,1,0,0,1,0,0,0,1,0,1,Sicilia,ITG1
2021-01-09,PF/BT,190335.0,HSP11 - P.O. G. F. INGRASSIA,SIC,80-89,1,1,0,2,0,0,0,2,0,2,Sicilia,ITG1
2021-01-09,PF/BT,190337.0,HSP11 - P.O. VILLA DELLE GINESTRE,SIC,20-29,14,9,0,17,5,0,1,23,0,23,Sicilia,ITG1
2021-01-09,PF/BT,190337.0,HSP11 - P.O. VILLA DELLE GINESTRE,SIC,30-39,29,19,0,35,11,0,2,48,0,48,Sicilia,ITG1
2021-01-09,PF/BT,190337.0,HSP11 - P.O. VILLA DELLE GINESTRE,SIC,40-49,24,22,0,30,13,0,3,46,0,46,Sicilia,ITG1
2021-01-09,PF/BT,190337.0,HSP11 - P.O. VILLA DELLE GINESTRE,SIC,50-59,33,27,0,42,14,0,4,60,0,60,Sicilia,ITG1
2021-01-09,PF/BT,190337.0,HSP11 - P.O. VILLA DELLE GINESTRE,SIC,60-69,45,22,0,59,7,0,1,67,0,67,Sicilia,ITG1
2021-01-09,PF/BT,190337.0,HSP11 - P.O. VILLA DELLE GINESTRE,SIC,70-79,14,0,0,13,1,0,0,14,0,14,Sicilia,ITG1
2021-01-09,PF/BT,190337.0,HSP11 - P.O. VILLA DELLE GINESTRE,SIC,80-89,1,0,0,1,0,0,0,1,0,1,Sicilia,ITG1
2021-01-09,PF/BT,190339.0,HSP11 - OSPEDALE REGINA MARGHERITA  COMISO,SIC,16-19,0,1,0,1,0,0,0,1,0,1,Sicilia,ITG1
2021-01-09,PF/BT,190339.0,HSP11 - OSPEDALE REGINA MARGHERITA  COMISO,SIC,20-29,1,0,0,1,0,0,0,1,0,1,Sicilia,ITG1
2021-01-09,PF/BT,190339.0,HSP11 - OSPEDALE REGINA MARGHERITA  COMISO,SIC,30-39,0,3,0,3,0,0,0,3,0,3,Sicilia,ITG1
2021-01-09,PF/BT,190339.0,HSP11 - OSPEDALE REGINA MARGHERITA  COMISO,SIC,40-49,7,1,0,8,0,0,0,8,0,8,Sicilia,ITG1
2021-01-09,PF/BT,190339.0,HSP11 - OSPEDALE REGINA MARGHERITA  COMISO,SIC,50-59,8,11,0,19,0,0,0,19,0,19,Sicilia,ITG1
2021-01-09,PF/BT,190339.0,HSP11 - OSPEDALE REGINA MARGHERITA  COMISO,SIC,60-69,3,1,0,4,0,0,0,4,0,4,Sicilia,ITG1
2021-01-09,PF/BT,190339.0,HSP11 - OSPEDALE REGINA MARGHERITA  COMISO,SIC,70-79,1,0,0,1,0,0,0,1,0,1,Sicilia,ITG1
2021-01-09,PF/BT,190340.0,HSP11 - OSPEDALE MAGGIORE MODICA,SIC,20-29,0,2,0,2,0,0,0,2,0,2,Sicilia,ITG1
2021-01-09,PF/BT,190340.0,HSP11 - OSPEDALE MAGGIORE MODICA,SIC,30-39,1,6,0,4,3,0,0,7,0,7,Sicilia,ITG1
2021-01-09,PF/BT,190340.0,HSP11 - OSPEDALE MAGGIORE MODICA,SIC,40-49,3,8,0,9,2,0,0,11,0,11,Sicilia,ITG1
2021-01-09,PF/BT,190340.0,HSP11 - OSPEDALE MAGGIORE MODICA,SIC,50-59,10,20,0,22,8,0,0,30,0,30,Sicilia,ITG1
2021-01-09,PF/BT,190340.0,HSP11 - OSPEDALE MAGGIORE MODICA,SIC,60-69,6,10,0,16,0,0,0,16,0,16,Sicilia,ITG1
2021-01-09,PF/BT,190342.0,HSP11 - OSPEDALE GUZZARDI VITTORIA,SIC,20-29,0,1,0,1,0,0,0,1,0,1,Sicilia,ITG1
2021-01-09,PF/BT,190342.0,HSP11 - OSPEDALE GUZZARDI VITTORIA,SIC,30-39,1,4,0,5,0,0,0,5,0,5,Sicilia,ITG1
2021-01-09,PF/BT,190342.0,HSP11 - OSPEDALE GUZZARDI VITTORIA,SIC,40-49,5,2,0,7,0,0,0,7,0,7,Sicilia,ITG1
2021-01-09,PF/BT,190342.0,HSP11 - OSPEDALE GUZZARDI VITTORIA,SIC,50-59,3,9,0,12,0,0,0,12,0,12,Sicilia,ITG1
2021-01-09,PF/BT,190342.0,HSP11 - OSPEDALE GUZZARDI VITTORIA,SIC,60-69,1,4,0,4,1,0,0,5,0,5,Sicilia,ITG1
2021-01-09,PF/BT,190343.0,HSP11 - P.O. DI MARIA AVOLA,SIC,20-29,0,1,0,1,0,0,0,1,0,1,Sicilia,ITG1
2021-01-09,PF/BT,190343.0,HSP11 - P.O. DI MARIA AVOLA,SIC,30-39,1,2,0,3,0,0,0,3,0,3,Sicilia,ITG1
2021-01-09,PF/BT,190343.0,HSP11 - P.O. DI MARIA AVOLA,SIC,40-49,7,10,0,17,0,0,0,17,0,17,Sicilia,ITG1
2021-01-09,PF/BT,190343.0,HSP11 - P.O. DI MARIA AVOLA,SIC,50-59,10,12,0,21,0,0,1,22,0,22,Sicilia,ITG1
2021-01-09,PF/BT,190343.0,HSP11 - P.O. DI MARIA AVOLA,SIC,60-69,16,7,0,23,0,0,0,23,0,23,Sicilia,ITG1
2021-01-09,PF/BT,190345.0,HSP11 - P.O. UMBERTO I (EX A.O.),SIC,20-29,0,9,0,2,0,0,7,9,0,9,Sicilia,ITG1
2021-01-09,PF/BT,190345.0,HSP11 - P.O. UMBERTO I (EX A.O.),SIC,30-39,11,22,0,14,0,0,19,33,0,33,Sicilia,ITG1
2021-01-09,PF/BT,190345.0,HSP11 - P.O. UMBERTO I (EX A.O.),SIC,40-49,13,16,0,13,0,0,16,29,0,29,Sicilia,ITG1
2021-01-09,PF/BT,190345.0,HSP11 - P.O. UMBERTO I (EX A.O.),SIC,50-59,13,30,0,27,0,0,16,43,0,43,Sicilia,ITG1
2021-01-09,PF/BT,190345.0,HSP11 - P.O. UMBERTO I (EX A.O.),SIC,60-69,24,19,0,16,0,0,27,43,0,43,Sicilia,ITG1
2021-01-09,PF/BT,190346.0,HSP11 - P.O. MUSCATELLO AUGUSTA,SIC,20-29,0,1,0,1,0,0,0,1,0,1,Sicilia,ITG1
2021-01-09,PF/BT,190346.0,HSP11 - P.O. MUSCATELLO AUGUSTA,SIC,40-49,1,3,0,4,0,0,0,4,0,4,Sicilia,ITG1
2021-01-09,PF/BT,190346.0,HSP11 - P.O. MUSCATELLO AUGUSTA,SIC,50-59,2,0,0,2,0,0,0,2,0,2,Sicilia,ITG1
2021-01-09,PF/BT,190346.0,HSP11 - P.O. MUSCATELLO AUGUSTA,SIC,60-69,4,1,0,5,0,0,0,5,0,5,Sicilia,ITG1
2021-01-09,PF/BT,190347.0,HSP11 - OSPEDALE GENERALE DI ZONA,SIC,16-19,1,0,0,0,1,0,0,1,0,1,Sicilia,ITG1
2021-01-09,PF/BT,190347.0,HSP11 - OSPEDALE GENERALE DI ZONA,SIC,20-29,4,2,0,3,3,0,0,6,0,6,Sicilia,ITG1
2021-01-09,PF/BT,190347.0,HSP11 - OSPEDALE GENERALE DI ZONA,SIC,30-39,1,6,0,4,3,0,0,7,0,7,Sicilia,ITG1
2021-01-09,PF/BT,190347.0,HSP11 - OSPEDALE GENERALE DI ZONA,SIC,40-49,5,7,0,9,3,0,0,12,0,12,Sicilia,ITG1
2021-01-09,PF/BT,190347.0,HSP11 - OSPEDALE GENERALE DI ZONA,SIC,50-59,4,12,0,12,4,0,0,16,0,16,Sicilia,ITG1
2021-01-09,PF/BT,190347.0,HSP11 - OSPEDALE GENERALE DI ZONA,SIC,60-69,10,7,0,16,1,0,0,17,0,17,Sicilia,ITG1
2021-01-09,PF/BT,190347.0,HSP11 - OSPEDALE GENERALE DI ZONA,SIC,70-79,1,0,0,1,0,0,0,1,0,1,Sicilia,ITG1
2021-01-09,PF/BT,190349.0,HSP11 - P.O. SAN VITO E SANTO SPIRITO -ALCAMO,SIC,20-29,2,3,0,0,0,0,5,5,0,5,Sicilia,ITG1
2021-01-09,PF/BT,190349.0,HSP11 - P.O. SAN VITO E SANTO SPIRITO -ALCAMO,SIC,30-39,2,13,0,8,0,0,7,15,0,15,Sicilia,ITG1
2021-01-09,PF/BT,190349.0,HSP11 - P.O. SAN VITO E SANTO SPIRITO -ALCAMO,SIC,40-49,4,11,0,10,2,0,3,15,0,15,Sicilia,ITG1
2021-01-09,PF/BT,190349.0,HSP11 - P.O. SAN VITO E SANTO SPIRITO -ALCAMO,SIC,50-59,4,10,0,12,1,0,1,14,0,14,Sicilia,ITG1
2021-01-09,PF/BT,190349.0,HSP11 - P.O. SAN VITO E SANTO SPIRITO -ALCAMO,SIC,60-69,8,2,0,9,0,0,1,10,0,10,Sicilia,ITG1
2021-01-09,PF/BT,190349.0,HSP11 - P.O. SAN VITO E SANTO SPIRITO -ALCAMO,SIC,70-79,1,0,0,0,0,0,1,1,0,1,Sicilia,ITG1
2021-01-09,PF/BT,190351.0,HSP11 - P.O. S. ANTONIO ABATE  - TRAPANI,SIC,20-29,9,12,0,17,4,0,0,21,0,21,Sicilia,ITG1
2021-01-09,PF/BT,190351.0,HSP11 - P.O. S. ANTONIO ABATE  - TRAPANI,SIC,30-39,14,26,0,26,14,0,0,40,0,40,Sicilia,ITG1
2021-01-09,PF/BT,190351.0,HSP11 - P.O. S. ANTONIO ABATE  - TRAPANI,SIC,40-49,16,26,0,29,13,0,0,42,0,42,Sicilia,ITG1
2021-01-09,PF/BT,190351.0,HSP11 - P.O. S. ANTONIO ABATE  - TRAPANI,SIC,50-59,18,12,0,17,13,0,0,30,0,30,Sicilia,ITG1
2021-01-09,PF/BT,190351.0,HSP11 - P.O. S. ANTONIO ABATE  - TRAPANI,SIC,60-69,19,15,0,26,8,0,0,34,0,34,Sicilia,ITG1
2021-01-09,PF/BT,190351.0,HSP11 - P.O. S. ANTONIO ABATE  - TRAPANI,SIC,70-79,5,2,0,3,4,0,0,7,0,7,Sicilia,ITG1
2021-01-09,PF/BT,190352.0,HSP11 - P.O. V.EMANUELE II CASTELVETRANO,SIC,20-29,4,2,0,6,0,0,0,6,0,6,Sicilia,ITG1
2021-01-09,PF/BT,190352.0,HSP11 - P.O. V.EMANUELE II CASTELVETRANO,SIC,30-39,11,1,0,12,0,0,0,12,0,12,Sicilia,ITG1
2021-01-09,PF/BT,190352.0,HSP11 - P.O. V.EMANUELE II CASTELVETRANO,SIC,40-49,10,11,0,13,5,0,3,21,0,21,Sicilia,ITG1
2021-01-09,PF/BT,190352.0,HSP11 - P.O. V.EMANUELE II CASTELVETRANO,SIC,50-59,13,18,0,25,6,0,0,31,0,31,Sicilia,ITG1
2021-01-09,PF/BT,190352.0,HSP11 - P.O. V.EMANUELE II CASTELVETRANO,SIC,60-69,4,9,0,9,2,0,2,13,0,13,Sicilia,ITG1
2021-01-09,PF/BT,190352.0,HSP11 - P.O. V.EMANUELE II CASTELVETRANO,SIC,70-79,2,0,0,2,0,0,0,2,0,2,Sicilia,ITG1
2021-01-09,PF/BT,190353.0,HSP11 - P.O.PAOLO BORSELLINO - MARSALA,SIC,20-29,9,12,0,21,0,0,0,21,0,21,Sicilia,ITG1
2021-01-09,PF/BT,190353.0,HSP11 - P.O.PAOLO BORSELLINO - MARSALA,SIC,30-39,7,15,0,22,0,0,0,22,0,22,Sicilia,ITG1
2021-01-09,PF/BT,190353.0,HSP11 - P.O.PAOLO BORSELLINO - MARSALA,SIC,40-49,12,22,0,34,0,0,0,34,0,34,Sicilia,ITG1
2021-01-09,PF/BT,190353.0,HSP11 - P.O.PAOLO BORSELLINO - MARSALA,SIC,50-59,6,16,0,22,0,0,0,22,0,22,Sicilia,ITG1
2021-01-09,PF/BT,190353.0,HSP11 - P.O.PAOLO BORSELLINO - MARSALA,SIC,60-69,7,13,0,20,0,0,0,20,0,20,Sicilia,ITG1
2021-01-09,PF/BT,190353.0,HSP11 - P.O.PAOLO BORSELLINO - MARSALA,SIC,70-79,2,3,0,5,0,0,0,5,0,5,Sicilia,ITG1
2021-01-09,PF/BT,190353.0,HSP11 - P.O.PAOLO BORSELLINO - MARSALA,SIC,80-89,1,0,0,1,0,0,0,1,0,1,Sicilia,ITG1
2021-01-09,PF/BT,190355.0,HSP11 - P.O. VITTORIO EMANUELE III - SALEMI,SIC,16-19,1,0,0,0,1,0,0,1,0,1,Sicilia,ITG1
2021-01-09,PF/BT,190355.0,HSP11 - P.O. VITTORIO EMANUELE III - SALEMI,SIC,20-29,6,2,0,3,5,0,0,8,0,8,Sicilia,ITG1
2021-01-09,PF/BT,190355.0,HSP11 - P.O. VITTORIO EMANUELE III - SALEMI,SIC,30-39,3,1,0,3,1,0,0,4,0,4,Sicilia,ITG1
2021-01-09,PF/BT,190355.0,HSP11 - P.O. VITTORIO EMANUELE III - SALEMI,SIC,40-49,7,10,0,7,10,0,0,17,0,17,Sicilia,ITG1
2021-01-09,PF/BT,190355.0,HSP11 - P.O. VITTORIO EMANUELE III - SALEMI,SIC,50-59,13,22,0,6,29,0,0,35,0,35,Sicilia,ITG1
2021-01-09,PF/BT,190355.0,HSP11 - P.O. VITTORIO EMANUELE III - SALEMI,SIC,60-69,5,7,0,7,5,0,0,12,0,12,Sicilia,ITG1
2021-01-09,PF/BT,190355.0,HSP11 - P.O. VITTORIO EMANUELE III - SALEMI,SIC,70-79,1,0,0,0,1,0,0,1,0,1,Sicilia,ITG1
2021-01-09,PF/BT,190513.0,HSP11 - CASA DI CURA G.B. MORGAGNI S.R.L.,SIC,20-29,4,13,0,7,8,0,2,17,0,17,Sicilia,ITG1
2021-01-09,PF/BT,190513.0,HSP11 - CASA DI CURA G.B. MORGAGNI S.R.L.,SIC,30-39,6,12,0,6,9,0,3,18,0,18,Sicilia,ITG1
2021-01-09,PF/BT,190513.0,HSP11 - CASA DI CURA G.B. MORGAGNI S.R.L.,SIC,40-49,7,23,0,11,7,0,12,30,0,30,Sicilia,ITG1
2021-01-09,PF/BT,190513.0,HSP11 - CASA DI CURA G.B. MORGAGNI S.R.L.,SIC,50-59,10,14,0,6,6,0,12,24,0,24,Sicilia,ITG1
2021-01-09,PF/BT,190513.0,HSP11 - CASA DI CURA G.B. MORGAGNI S.R.L.,SIC,60-69,6,5,0,7,0,0,4,11,0,11,Sicilia,ITG1
2021-01-09,PF/BT,190513.0,HSP11 - CASA DI CURA G.B. MORGAGNI S.R.L.,SIC,70-79,1,0,0,1,0,0,0,1,0,1,Sicilia,ITG1
2021-01-09,PF/BT,190513.0,HSP11 - CASA DI CURA G.B. MORGAGNI S.R.L.,SIC,80-89,1,0,0,1,0,0,0,1,0,1,Sicilia,ITG1
2021-01-09,PF/BT,190519.0,HSP11 - HUMANITAS ISTITUTO CLINICO CATANESE,SIC,20-29,8,9,0,5,12,0,0,17,0,17,Sicilia,ITG1
2021-01-09,PF/BT,190519.0,HSP11 - HUMANITAS ISTITUTO CLINICO CATANESE,SIC,30-39,29,14,0,10,33,0,0,43,0,43,Sicilia,ITG1
2021-01-09,PF/BT,190519.0,HSP11 - HUMANITAS ISTITUTO CLINICO CATANESE,SIC,40-49,20,14,0,13,21,0,0,34,0,34,Sicilia,ITG1
2021-01-09,PF/BT,190519.0,HSP11 - HUMANITAS ISTITUTO CLINICO CATANESE,SIC,50-59,14,5,0,11,8,0,0,19,0,19,Sicilia,ITG1
2021-01-09,PF/BT,190519.0,HSP11 - HUMANITAS ISTITUTO CLINICO CATANESE,SIC,60-69,4,1,0,2,3,0,0,5,0,5,Sicilia,ITG1
2021-01-09,PF/BT,190519.0,HSP11 - HUMANITAS ISTITUTO CLINICO CATANESE,SIC,70-79,2,0,0,2,0,0,0,2,0,2,Sicilia,ITG1
2021-01-09,PF/BT,190520.0,HSP11 - CASA CURA CENTRO CATANESE MED. E CH.,SIC,20-29,5,3,0,7,1,0,0,8,0,8,Sicilia,ITG1
2021-01-09,PF/BT,190520.0,HSP11 - CASA CURA CENTRO CATANESE MED. E CH.,SIC,30-39,2,4,0,4,2,0,0,6,0,6,Sicilia,ITG1
2021-01-09,PF/BT,190520.0,HSP11 - CASA CURA CENTRO CATANESE MED. E CH.,SIC,40-49,3,7,0,3,7,0,0,10,0,10,Sicilia,ITG1
2021-01-09,PF/BT,190520.0,HSP11 - CASA CURA CENTRO CATANESE MED. E CH.,SIC,50-59,1,4,0,3,2,0,0,5,0,5,Sicilia,ITG1
2021-01-09,PF/BT,190520.0,HSP11 - CASA CURA CENTRO CATANESE MED. E CH.,SIC,60-69,2,3,0,2,3,0,0,5,0,5,Sicilia,ITG1
2021-01-09,PF/BT,190520.0,HSP11 - CASA CURA CENTRO CATANESE MED. E CH.,SIC,70-79,1,0,0,0,1,0,0,1,0,1,Sicilia,ITG1
2021-01-09,PF/BT,190520.0,HSP11 - CASA CURA CENTRO CATANESE MED. E CH.,SIC,80-89,1,0,0,0,1,0,0,1,0,1,Sicilia,ITG1
2021-01-09,PF/BT,190523.0,HSP11 - CASA DI CURA GIBIINO SRL,SIC,20-29,2,5,0,6,0,0,1,7,0,7,Sicilia,ITG1
2021-01-09,PF/BT,190523.0,HSP11 - CASA DI CURA GIBIINO SRL,SIC,30-39,9,6,0,8,3,0,4,15,0,15,Sicilia,ITG1
2021-01-09,PF/BT,190523.0,HSP11 - CASA DI CURA GIBIINO SRL,SIC,40-49,3,3,0,4,2,0,0,6,0,6,Sicilia,ITG1
2021-01-09,PF/BT,190523.0,HSP11 - CASA DI CURA GIBIINO SRL,SIC,50-59,8,6,0,10,1,0,3,14,0,14,Sicilia,ITG1
2021-01-09,PF/BT,190523.0,HSP11 - CASA DI CURA GIBIINO SRL,SIC,60-69,6,3,0,7,1,0,1,9,0,9,Sicilia,ITG1
2021-01-09,PF/BT,190523.0,HSP11 - CASA DI CURA GIBIINO SRL,SIC,70-79,3,0,0,3,0,0,0,3,0,3,Sicilia,ITG1
2021-01-09,PF/BT,190525.0,HSP11 - CASA DI CURA S.CAMILLO,SIC,30-39,0,1,0,1,0,0,0,1,0,1,Sicilia,ITG1
2021-01-09,PF/BT,190525.0,HSP11 - CASA DI CURA S.CAMILLO,SIC,40-49,0,1,0,1,0,0,0,1,0,1,Sicilia,ITG1
2021-01-09,PF/BT,190525.0,HSP11 - CASA DI CURA S.CAMILLO,SIC,50-59,2,3,0,2,0,0,3,5,0,5,Sicilia,ITG1
2021-01-09,PF/BT,190525.0,HSP11 - CASA DI CURA S.CAMILLO,SIC,60-69,1,1,0,2,0,0,0,2,0,2,Sicilia,ITG1
2021-01-09,PF/BT,190525.0,HSP11 - CASA DI CURA S.CAMILLO,SIC,70-79,3,0,0,3,0,0,0,3,0,3,Sicilia,ITG1
2021-01-09,PF/BT,190530.0,HSP11 - C.O.T. S.P.A. (CURE ORTOPED. TRAUM.),SIC,20-29,3,0,0,1,2,0,0,3,0,3,Sicilia,ITG1
2021-01-09,PF/BT,190530.0,HSP11 - C.O.T. S.P.A. (CURE ORTOPED. TRAUM.),SIC,30-39,3,4,0,5,2,0,0,7,0,7,Sicilia,ITG1
2021-01-09,PF/BT,190530.0,HSP11 - C.O.T. S.P.A. (CURE ORTOPED. TRAUM.),SIC,40-49,3,1,0,4,0,0,0,4,0,4,Sicilia,ITG1
2021-01-09,PF/BT,190530.0,HSP11 - C.O.T. S.P.A. (CURE ORTOPED. TRAUM.),SIC,50-59,3,5,0,7,1,0,0,8,0,8,Sicilia,ITG1
2021-01-09,PF/BT,190530.0,HSP11 - C.O.T. S.P.A. (CURE ORTOPED. TRAUM.),SIC,70-79,2,0,0,2,0,0,0,2,0,2,Sicilia,ITG1
2021-01-09,PF/BT,190533.0,HSP11 - CASA DI CURA CANDELA SPA,SIC,20-29,3,10,0,13,0,0,0,13,0,13,Sicilia,ITG1
2021-01-09,PF/BT,190533.0,HSP11 - CASA DI CURA CANDELA SPA,SIC,30-39,11,8,0,19,0,0,0,19,0,19,Sicilia,ITG1
2021-01-09,PF/BT,190533.0,HSP11 - CASA DI CURA CANDELA SPA,SIC,40-49,12,24,0,35,0,0,1,36,0,36,Sicilia,ITG1
2021-01-09,PF/BT,190533.0,HSP11 - CASA DI CURA CANDELA SPA,SIC,50-59,16,13,0,27,0,0,2,29,0,29,Sicilia,ITG1
2021-01-09,PF/BT,190533.0,HSP11 - CASA DI CURA CANDELA SPA,SIC,60-69,24,5,0,29,0,0,0,29,0,29,Sicilia,ITG1
2021-01-09,PF/BT,190533.0,HSP11 - CASA DI CURA CANDELA SPA,SIC,70-79,2,1,0,3,0,0,0,3,0,3,Sicilia,ITG1
2021-01-09,PF/BT,190533.0,HSP11 - CASA DI CURA CANDELA SPA,SIC,80-89,2,0,0,2,0,0,0,2,0,2,Sicilia,ITG1
2021-01-09,PF/BT,190536.0,HSP11 - CASA DI CURA TRIOLO ZANCLA S.P.A.,SIC,20-29,1,3,0,4,0,0,0,4,0,4,Sicilia,ITG1
2021-01-09,PF/BT,190536.0,HSP11 - CASA DI CURA TRIOLO ZANCLA S.P.A.,SIC,30-39,2,8,0,10,0,0,0,10,0,10,Sicilia,ITG1
2021-01-09,PF/BT,190536.0,HSP11 - CASA DI CURA TRIOLO ZANCLA S.P.A.,SIC,40-49,5,3,0,8,0,0,0,8,0,8,Sicilia,ITG1
2021-01-09,PF/BT,190536.0,HSP11 - CASA DI CURA TRIOLO ZANCLA S.P.A.,SIC,50-59,7,5,0,12,0,0,0,12,0,12,Sicilia,ITG1
2021-01-09,PF/BT,190536.0,HSP11 - CASA DI CURA TRIOLO ZANCLA S.P.A.,SIC,60-69,1,6,0,7,0,0,0,7,0,7,Sicilia,ITG1
2021-01-09,PF/BT,190536.0,HSP11 - CASA DI CURA TRIOLO ZANCLA S.P.A.,SIC,70-79,1,0,0,1,0,0,0,1,0,1,Sicilia,ITG1
2021-01-09,PF/BT,190537.0,HSP11 - CASA DI CURA SERENA S.P.A.,SIC,20-29,1,6,0,6,1,0,0,7,0,7,Sicilia,ITG1
2021-01-09,PF/BT,190537.0,HSP11 - CASA DI CURA SERENA S.P.A.,SIC,30-39,2,3,0,5,0,0,0,5,0,5,Sicilia,ITG1
2021-01-09,PF/BT,190537.0,HSP11 - CASA DI CURA SERENA S.P.A.,SIC,40-49,2,6,0,8,0,0,0,8,0,8,Sicilia,ITG1
2021-01-09,PF/BT,190537.0,HSP11 - CASA DI CURA SERENA S.P.A.,SIC,50-59,4,1,0,5,0,0,0,5,0,5,Sicilia,ITG1
2021-01-09,PF/BT,190537.0,HSP11 - CASA DI CURA SERENA S.P.A.,SIC,60-69,3,0,0,3,0,0,0,3,0,3,Sicilia,ITG1
2021-01-09,PF/BT,190537.0,HSP11 - CASA DI CURA SERENA S.P.A.,SIC,70-79,1,0,0,1,0,0,0,1,0,1,Sicilia,ITG1
2021-01-09,PF/BT,190538.0,HSP11 - CASA DI CURA NOTO PASQUALINO S.R.L.,SIC,20-29,2,1,0,3,0,0,0,3,0,3,Sicilia,ITG1
2021-01-09,PF/BT,190538.0,HSP11 - CASA DI CURA NOTO PASQUALINO S.R.L.,SIC,30-39,5,3,0,8,0,0,0,8,0,8,Sicilia,ITG1
2021-01-09,PF/BT,190538.0,HSP11 - CASA DI CURA NOTO PASQUALINO S.R.L.,SIC,40-49,12,9,0,19,2,0,0,21,0,21,Sicilia,ITG1
2021-01-09,PF/BT,190538.0,HSP11 - CASA DI CURA NOTO PASQUALINO S.R.L.,SIC,50-59,18,9,0,26,1,0,0,27,0,27,Sicilia,ITG1
2021-01-09,PF/BT,190538.0,HSP11 - CASA DI CURA NOTO PASQUALINO S.R.L.,SIC,60-69,12,1,0,11,2,0,0,13,0,13,Sicilia,ITG1
2021-01-09,PF/BT,190538.0,HSP11 - CASA DI CURA NOTO PASQUALINO S.R.L.,SIC,70-79,4,0,0,4,0,0,0,4,0,4,Sicilia,ITG1
2021-01-09,PF/BT,190538.0,HSP11 - CASA DI CURA NOTO PASQUALINO S.R.L.,SIC,80-89,0,2,0,0,2,0,0,2,0,2,Sicilia,ITG1
2021-01-09,PF/BT,190540.0,HSP11 - NUOVA CASA DI CURA DEMMA srl,SIC,20-29,0,3,0,3,0,0,0,3,0,3,Sicilia,ITG1
2021-01-09,PF/BT,190540.0,HSP11 - NUOVA CASA DI CURA DEMMA srl,SIC,30-39,4,2,0,5,1,0,0,6,0,6,Sicilia,ITG1
2021-01-09,PF/BT,190540.0,HSP11 - NUOVA CASA DI CURA DEMMA srl,SIC,40-49,2,4,0,4,2,0,0,6,0,6,Sicilia,ITG1
2021-01-09,PF/BT,190540.0,HSP11 - NUOVA CASA DI CURA DEMMA srl,SIC,50-59,7,2,0,6,3,0,0,9,0,9,Sicilia,ITG1
2021-01-09,PF/BT,190540.0,HSP11 - NUOVA CASA DI CURA DEMMA srl,SIC,60-69,4,1,0,4,1,0,0,5,0,5,Sicilia,ITG1
2021-01-09,PF/BT,190540.0,HSP11 - NUOVA CASA DI CURA DEMMA srl,SIC,70-79,1,0,0,1,0,0,0,1,0,1,Sicilia,ITG1
2021-01-09,PF/BT,190542.0,HSP11 - CASA DI CURA TORINA,SIC,20-29,3,5,0,6,0,0,2,8,0,8,Sicilia,ITG1
2021-01-09,PF/BT,190542.0,HSP11 - CASA DI CURA TORINA,SIC,30-39,6,1,0,3,0,0,4,7,0,7,Sicilia,ITG1
2021-01-09,PF/BT,190542.0,HSP11 - CASA DI CURA TORINA,SIC,40-49,14,9,0,20,0,0,3,23,0,23,Sicilia,ITG1
2021-01-09,PF/BT,190542.0,HSP11 - CASA DI CURA TORINA,SIC,50-59,10,7,0,15,0,0,2,17,0,17,Sicilia,ITG1
2021-01-09,PF/BT,190542.0,HSP11 - CASA DI CURA TORINA,SIC,60-69,12,8,0,20,0,0,0,20,0,20,Sicilia,ITG1
2021-01-09,PF/BT,190542.0,HSP11 - CASA DI CURA TORINA,SIC,70-79,2,0,0,2,0,0,0,2,0,2,Sicilia,ITG1
2021-01-09,PF/BT,190542.0,HSP11 - CASA DI CURA TORINA,SIC,80-89,1,0,0,1,0,0,0,1,0,1,Sicilia,ITG1
2021-01-09,PF/BT,190545.0,HSP11 - CASA DI CURE COSENTINO DI KAROL  S.R.L.,SIC,20-29,5,5,0,6,4,0,0,10,0,10,Sicilia,ITG1
2021-01-09,PF/BT,190545.0,HSP11 - CASA DI CURE COSENTINO DI KAROL  S.R.L.,SIC,30-39,11,7,0,14,4,0,0,18,0,18,Sicilia,ITG1
2021-01-09,PF/BT,190545.0,HSP11 - CASA DI CURE COSENTINO DI KAROL  S.R.L.,SIC,40-49,9,9,0,11,7,0,0,18,0,18,Sicilia,ITG1
2021-01-09,PF/BT,190545.0,HSP11 - CASA DI CURE COSENTINO DI KAROL  S.R.L.,SIC,50-59,4,1,0,3,2,0,0,5,0,5,Sicilia,ITG1
2021-01-09,PF/BT,190545.0,HSP11 - CASA DI CURE COSENTINO DI KAROL  S.R.L.,SIC,60-69,6,1,0,6,1,0,0,7,0,7,Sicilia,ITG1
2021-01-09,PF/BT,190545.0,HSP11 - CASA DI CURE COSENTINO DI KAROL  S.R.L.,SIC,80-89,0,1,0,0,1,0,0,1,0,1,Sicilia,ITG1
2021-01-09,PF/BT,190551.0,HSP11 - CASA DI CURA LA MADDALENA S.P.A.,SIC,20-29,5,7,0,12,0,0,0,12,0,12,Sicilia,ITG1
2021-01-09,PF/BT,190551.0,HSP11 - CASA DI CURA LA MADDALENA S.P.A.,SIC,30-39,5,10,0,15,0,0,0,15,0,15,Sicilia,ITG1
2021-01-09,PF/BT,190551.0,HSP11 - CASA DI CURA LA MADDALENA S.P.A.,SIC,40-49,7,14,0,21,0,0,0,21,0,21,Sicilia,ITG1
2021-01-09,PF/BT,190551.0,HSP11 - CASA DI CURA LA MADDALENA S.P.A.,SIC,50-59,10,7,0,17,0,0,0,17,0,17,Sicilia,ITG1
2021-01-09,PF/BT,190551.0,HSP11 - CASA DI CURA LA MADDALENA S.P.A.,SIC,60-69,7,4,0,11,0,0,0,11,0,11,Sicilia,ITG1
2021-01-09,PF/BT,190551.0,HSP11 - CASA DI CURA LA MADDALENA S.P.A.,SIC,70-79,0,1,0,1,0,0,0,1,0,1,Sicilia,ITG1
2021-01-09,PF/BT,190551.0,HSP11 - CASA DI CURA LA MADDALENA S.P.A.,SIC,90+,1,0,0,1,0,0,0,1,0,1,Sicilia,ITG1
2021-01-09,PF/BT,190552.0,HSP11 - CASA DI CURA CLINICA DEL MEDITERRANEO,SIC,30-39,0,1,0,0,0,0,1,1,0,1,Sicilia,ITG1
2021-01-09,PF/BT,190552.0,HSP11 - CASA DI CURA CLINICA DEL MEDITERRANEO,SIC,40-49,2,0,0,1,0,0,1,2,0,2,Sicilia,ITG1
2021-01-09,PF/BT,190552.0,HSP11 - CASA DI CURA CLINICA DEL MEDITERRANEO,SIC,50-59,0,2,0,1,1,0,0,2,0,2,Sicilia,ITG1
2021-01-09,PF/BT,190552.0,HSP11 - CASA DI CURA CLINICA DEL MEDITERRANEO,SIC,60-69,0,1,0,1,0,0,0,1,0,1,Sicilia,ITG1
2021-01-09,PF/BT,190710.0,HSP11 - CASA DI CURA PROF.E.FALCIDIA SrL,SIC,20-29,0,6,0,6,0,0,0,6,0,6,Sicilia,ITG1
2021-01-09,PF/BT,190710.0,HSP11 - CASA DI CURA PROF.E.FALCIDIA SrL,SIC,30-39,0,3,0,2,1,0,0,3,0,3,Sicilia,ITG1
2021-01-09,PF/BT,190710.0,HSP11 - CASA DI CURA PROF.E.FALCIDIA SrL,SIC,40-49,0,3,0,2,1,0,0,3,0,3,Sicilia,ITG1
2021-01-09,PF/BT,190710.0,HSP11 - CASA DI CURA PROF.E.FALCIDIA SrL,SIC,50-59,0,4,0,1,3,0,0,4,0,4,Sicilia,ITG1
2021-01-09,PF/BT,190710.0,HSP11 - CASA DI CURA PROF.E.FALCIDIA SrL,SIC,60-69,2,1,0,3,0,0,0,3,0,3,Sicilia,ITG1
2021-01-09,PF/BT,190710.0,HSP11 - CASA DI CURA PROF.E.FALCIDIA SrL,SIC,70-79,4,1,0,5,0,0,0,5,0,5,Sicilia,ITG1
2021-01-09,PF/BT,190724.0,HSP11 - ISCAS MORGAGNI NORD SRL,SIC,20-29,8,6,0,11,3,0,0,14,0,14,Sicilia,ITG1
2021-01-09,PF/BT,190724.0,HSP11 - ISCAS MORGAGNI NORD SRL,SIC,30-39,7,3,0,8,2,0,0,10,0,10,Sicilia,ITG1
2021-01-09,PF/BT,190724.0,HSP11 - ISCAS MORGAGNI NORD SRL,SIC,40-49,3,10,0,11,2,0,0,13,0,13,Sicilia,ITG1
2021-01-09,PF/BT,190724.0,HSP11 - ISCAS MORGAGNI NORD SRL,SIC,50-59,9,16,0,16,9,0,0,25,0,25,Sicilia,ITG1
2021-01-09,PF/BT,190724.0,HSP11 - ISCAS MORGAGNI NORD SRL,SIC,60-69,5,4,0,5,4,0,0,9,0,9,Sicilia,ITG1
2021-01-09,PF/BT,190724.0,HSP11 - ISCAS MORGAGNI NORD SRL,SIC,70-79,1,0,0,1,0,0,0,1,0,1,Sicilia,ITG1
2021-01-09,PF/BT,190726.0,HSP11 - ISTITUTO CLINICO VIDIMURA srl,SIC,40-49,1,0,0,0,0,0,1,1,0,1,Sicilia,ITG1
2021-01-09,PF/BT,190726.0,HSP11 - ISTITUTO CLINICO VIDIMURA srl,SIC,50-59,1,0,0,1,0,0,0,1,0,1,Sicilia,ITG1
2021-01-09,PF/BT,190726.0,HSP11 - ISTITUTO CLINICO VIDIMURA srl,SIC,60-69,4,0,0,0,0,0,4,4,0,4,Sicilia,ITG1
2021-01-09,PF/BT,190921.0,HSP11 - A.O. per lEmergenza Cannizzaro,SIC,20-29,2,1,0,2,1,0,0,3,0,3,Sicilia,ITG1
2021-01-09,PF/BT,190921.0,HSP11 - A.O. per lEmergenza Cannizzaro,SIC,30-39,6,4,0,10,0,0,0,10,0,10,Sicilia,ITG1
2021-01-09,PF/BT,190921.0,HSP11 - A.O. per lEmergenza Cannizzaro,SIC,40-49,10,10,0,19,1,0,0,20,0,20,Sicilia,ITG1
2021-01-09,PF/BT,190921.0,HSP11 - A.O. per lEmergenza Cannizzaro,SIC,50-59,15,14,0,29,0,0,0,29,0,29,Sicilia,ITG1
2021-01-09,PF/BT,190921.0,HSP11 - A.O. per lEmergenza Cannizzaro,SIC,60-69,4,9,0,10,3,0,0,13,0,13,Sicilia,ITG1
2021-01-09,PF/BT,190921.0,HSP11 - A.O. per lEmergenza Cannizzaro,SIC,70-79,2,1,0,2,1,0,0,3,0,3,Sicilia,ITG1
2021-01-09,PF/BT,19092201.0,HSP11 - OSPEDALE GARIBALDI - CENTRO,SIC,30-39,1,1,0,2,0,0,0,2,0,2,Sicilia,ITG1
2021-01-09,PF/BT,19092201.0,HSP11 - OSPEDALE GARIBALDI - CENTRO,SIC,40-49,0,3,0,3,0,0,0,3,0,3,Sicilia,ITG1
2021-01-09,PF/BT,19092201.0,HSP11 - OSPEDALE GARIBALDI - CENTRO,SIC,50-59,0,3,0,3,0,0,0,3,0,3,Sicilia,ITG1
2021-01-09,PF/BT,19092201.0,HSP11 - OSPEDALE GARIBALDI - CENTRO,SIC,60-69,1,3,0,4,0,0,0,4,0,4,Sicilia,ITG1
2021-01-09,PF/BT,19092204.0,HSP11 - NUOVO OSPEDALE GARIBALDI - NESIMA,SIC,20-29,4,2,0,6,0,0,0,6,0,6,Sicilia,ITG1
2021-01-09,PF/BT,19092204.0,HSP11 - NUOVO OSPEDALE GARIBALDI - NESIMA,SIC,30-39,2,3,0,5,0,0,0,5,0,5,Sicilia,ITG1
2021-01-09,PF/BT,19092204.0,HSP11 - NUOVO OSPEDALE GARIBALDI - NESIMA,SIC,40-49,3,5,0,7,1,0,0,8,0,8,Sicilia,ITG1
2021-01-09,PF/BT,19092204.0,HSP11 - NUOVO OSPEDALE GARIBALDI - NESIMA,SIC,50-59,7,6,0,11,2,0,0,13,0,13,Sicilia,ITG1
2021-01-09,PF/BT,19092204.0,HSP11 - NUOVO OSPEDALE GARIBALDI - NESIMA,SIC,60-69,3,4,0,7,0,0,0,7,0,7,Sicilia,ITG1
2021-01-09,PF/BT,19092301.0,HSP11 - PRESIDIO OSPEDALIERO GASPARE RODOLICO,SIC,16-19,2,1,0,3,0,0,0,3,0,3,Sicilia,ITG1
2021-01-09,PF/BT,19092301.0,HSP11 - PRESIDIO OSPEDALIERO GASPARE RODOLICO,SIC,20-29,5,6,1,11,0,0,0,11,0,11,Sicilia,ITG1
2021-01-09,PF/BT,19092301.0,HSP11 - PRESIDIO OSPEDALIERO GASPARE RODOLICO,SIC,30-39,14,14,0,28,0,0,0,28,0,28,Sicilia,ITG1
2021-01-09,PF/BT,19092301.0,HSP11 - PRESIDIO OSPEDALIERO GASPARE RODOLICO,SIC,40-49,18,18,0,36,0,0,0,36,0,36,Sicilia,ITG1
2021-01-09,PF/BT,19092301.0,HSP11 - PRESIDIO OSPEDALIERO GASPARE RODOLICO,SIC,50-59,15,19,0,34,0,0,0,34,0,34,Sicilia,ITG1
2021-01-09,PF/BT,19092301.0,HSP11 - PRESIDIO OSPEDALIERO GASPARE RODOLICO,SIC,60-69,7,6,0,13,0,0,0,13,0,13,Sicilia,ITG1
2021-01-09,PF/BT,19092304.0,HSP11 - PRESIDIO OSPEDALIERO S.MARCO,SIC,20-29,8,14,0,22,0,0,0,22,0,22,Sicilia,ITG1
2021-01-09,PF/BT,19092304.0,HSP11 - PRESIDIO OSPEDALIERO S.MARCO,SIC,30-39,10,7,0,16,1,0,0,17,0,17,Sicilia,ITG1
2021-01-09,PF/BT,19092304.0,HSP11 - PRESIDIO OSPEDALIERO S.MARCO,SIC,40-49,6,12,0,17,1,0,0,18,0,18,Sicilia,ITG1
2021-01-09,PF/BT,19092304.0,HSP11 - PRESIDIO OSPEDALIERO S.MARCO,SIC,50-59,11,11,0,21,1,0,0,22,0,22,Sicilia,ITG1
2021-01-09,PF/BT,19092304.0,HSP11 - PRESIDIO OSPEDALIERO S.MARCO,SIC,60-69,10,5,0,15,0,0,0,15,0,15,Sicilia,ITG1
2021-01-09,PF/BT,19092304.0,HSP11 - PRESIDIO OSPEDALIERO S.MARCO,SIC,70-79,2,0,0,2,0,0,0,2,0,2,Sicilia,ITG1
2021-01-09,PF/BT,190924.0,HSP11 - Azienda Ospedaliera Papardo,SIC,20-29,2,4,0,3,0,0,3,6,0,6,Sicilia,ITG1
2021-01-09,PF/BT,190924.0,HSP11 - Azienda Ospedaliera Papardo,SIC,30-39,6,4,0,4,0,0,6,10,0,10,Sicilia,ITG1
2021-01-09,PF/BT,190924.0,HSP11 - Azienda Ospedaliera Papardo,SIC,40-49,11,5,0,8,0,0,8,16,0,16,Sicilia,ITG1
2021-01-09,PF/BT,190924.0,HSP11 - Azienda Ospedaliera Papardo,SIC,50-59,8,10,0,15,0,0,3,18,0,18,Sicilia,ITG1
2021-01-09,PF/BT,190924.0,HSP11 - Azienda Ospedaliera Papardo,SIC,60-69,9,7,0,12,0,0,4,16,0,16,Sicilia,ITG1
2021-01-09,PF/BT,19092501.0,HSP11 - COVID HOSPITAL,SIC,20-29,15,24,0,39,0,0,0,39,0,39,Sicilia,ITG1
2021-01-09,PF/BT,19092501.0,HSP11 - COVID HOSPITAL,SIC,30-39,16,28,0,44,0,0,0,44,0,44,Sicilia,ITG1
2021-01-09,PF/BT,19092501.0,HSP11 - COVID HOSPITAL,SIC,40-49,13,27,0,40,0,0,0,40,0,40,Sicilia,ITG1
2021-01-09,PF/BT,19092501.0,HSP11 - COVID HOSPITAL,SIC,50-59,17,40,0,57,0,0,0,57,0,57,Sicilia,ITG1
2021-01-09,PF/BT,19092501.0,HSP11 - COVID HOSPITAL,SIC,60-69,17,19,0,36,0,0,0,36,0,36,Sicilia,ITG1
2021-01-09,PF/BT,19092601.0,HSP11 - P.O. Villa Sofia,SIC,20-29,1,5,0,6,0,0,0,6,0,6,Sicilia,ITG1
2021-01-09,PF/BT,19092601.0,HSP11 - P.O. Villa Sofia,SIC,30-39,13,11,0,24,0,0,0,24,0,24,Sicilia,ITG1
2021-01-09,PF/BT,19092601.0,HSP11 - P.O. Villa Sofia,SIC,40-49,9,33,0,42,0,0,0,42,0,42,Sicilia,ITG1
2021-01-09,PF/BT,19092601.0,HSP11 - P.O. Villa Sofia,SIC,50-59,24,22,0,46,0,0,0,46,0,46,Sicilia,ITG1
2021-01-09,PF/BT,19092601.0,HSP11 - P.O. Villa Sofia,SIC,60-69,10,10,0,20,0,0,0,20,0,20,Sicilia,ITG1
2021-01-09,PF/BT,19092701.0,HSP11 - Ospedale Civico,SIC,20-29,4,9,0,11,2,0,0,13,0,13,Sicilia,ITG1
2021-01-09,PF/BT,19092701.0,HSP11 - Ospedale Civico,SIC,30-39,17,13,0,24,6,0,0,30,0,30,Sicilia,ITG1
2021-01-09,PF/BT,19092701.0,HSP11 - Ospedale Civico,SIC,40-49,12,13,0,19,6,0,0,25,0,25,Sicilia,ITG1
2021-01-09,PF/BT,19092701.0,HSP11 - Ospedale Civico,SIC,50-59,36,38,0,53,21,0,0,74,0,74,Sicilia,ITG1
2021-01-09,PF/BT,19092701.0,HSP11 - Ospedale Civico,SIC,60-69,21,17,0,30,8,0,0,38,0,38,Sicilia,ITG1
2021-01-09,PF/BT,19092702.0,HSP11 - Ospedale dei Bambini G. Di Cristina,SIC,20-29,1,1,0,2,0,0,0,2,0,2,Sicilia,ITG1
2021-01-09,PF/BT,19092702.0,HSP11 - Ospedale dei Bambini G. Di Cristina,SIC,30-39,4,2,0,6,0,0,0,6,0,6,Sicilia,ITG1
2021-01-09,PF/BT,19092702.0,HSP11 - Ospedale dei Bambini G. Di Cristina,SIC,40-49,15,3,0,7,11,0,0,18,0,18,Sicilia,ITG1
2021-01-09,PF/BT,19092702.0,HSP11 - Ospedale dei Bambini G. Di Cristina,SIC,50-59,19,5,0,15,9,0,0,24,0,24,Sicilia,ITG1
2021-01-09,PF/BT,19092702.0,HSP11 - Ospedale dei Bambini G. Di Cristina,SIC,60-69,15,3,0,8,10,0,0,18,0,18,Sicilia,ITG1
2021-01-09,PF/BT,190928.0,HSP11 - AZ.OSP.UNIV.P.GIACCONE,SIC,20-29,19,15,0,30,4,0,0,34,0,34,Sicilia,ITG1
2021-01-09,PF/BT,190928.0,HSP11 - AZ.OSP.UNIV.P.GIACCONE,SIC,30-39,19,14,0,25,8,0,0,33,0,33,Sicilia,ITG1
2021-01-09,PF/BT,190928.0,HSP11 - AZ.OSP.UNIV.P.GIACCONE,SIC,40-49,19,20,0,24,15,0,0,39,0,39,Sicilia,ITG1
2021-01-09,PF/BT,190928.0,HSP11 - AZ.OSP.UNIV.P.GIACCONE,SIC,50-59,26,22,0,34,14,0,0,48,0,48,Sicilia,ITG1
2021-01-09,PF/BT,190928.0,HSP11 - AZ.OSP.UNIV.P.GIACCONE,SIC,60-69,21,16,0,32,5,0,0,37,0,37,Sicilia,ITG1
2021-01-09,PF/BT,190928.0,HSP11 - AZ.OSP.UNIV.P.GIACCONE,SIC,70-79,10,2,0,12,0,0,0,12,0,12,Sicilia,ITG1
2021-01-09,PF/BT,190928.0,HSP11 - AZ.OSP.UNIV.P.GIACCONE,SIC,80-89,1,0,0,1,0,0,0,1,0,1,Sicilia,ITG1
2021-01-09,PF/BT,190950.0,HSP11 - ASSOCIAZIONE OASI MARIA SS,SIC,20-29,0,1,0,0,0,0,1,1,0,1,Sicilia,ITG1
2021-01-09,PF/BT,190950.0,HSP11 - ASSOCIAZIONE OASI MARIA SS,SIC,30-39,4,2,0,3,0,0,3,6,0,6,Sicilia,ITG1
2021-01-09,PF/BT,190950.0,HSP11 - ASSOCIAZIONE OASI MARIA SS,SIC,40-49,10,5,0,1,0,0,14,15,0,15,Sicilia,ITG1
2021-01-09,PF/BT,190950.0,HSP11 - ASSOCIAZIONE OASI MARIA SS,SIC,50-59,18,13,0,1,0,0,30,31,0,31,Sicilia,ITG1
2021-01-09,PF/BT,190950.0,HSP11 - ASSOCIAZIONE OASI MARIA SS,SIC,60-69,6,1,0,1,0,0,6,7,0,7,Sicilia,ITG1
2021-01-09,PF/BT,608200.0,STS11 - POLIAMBULATORIO San Giorgio,SIC,16-19,1,0,0,1,0,0,0,1,0,1,Sicilia,ITG1
2021-01-09,PF/BT,608200.0,STS11 - POLIAMBULATORIO San Giorgio,SIC,20-29,1,2,0,3,0,0,0,3,0,3,Sicilia,ITG1
2021-01-09,PF/BT,608200.0,STS11 - POLIAMBULATORIO San Giorgio,SIC,30-39,6,8,0,14,0,0,0,14,0,14,Sicilia,ITG1
2021-01-09,PF/BT,608200.0,STS11 - POLIAMBULATORIO San Giorgio,SIC,40-49,3,7,0,10,0,0,0,10,0,10,Sicilia,ITG1
2021-01-09,PF/BT,608200.0,STS11 - POLIAMBULATORIO San Giorgio,SIC,50-59,4,9,0,13,0,0,0,13,0,13,Sicilia,ITG1
2021-01-09,PF/BT,608200.0,STS11 - POLIAMBULATORIO San Giorgio,SIC,60-69,4,4,0,8,0,0,0,8,0,8,Sicilia,ITG1
2021-01-09,PF/BT,608200.0,STS11 - POLIAMBULATORIO San Giorgio,SIC,70-79,4,1,0,5,0,0,0,5,0,5,Sicilia,ITG1
2021-01-09,PF/BT,608400.0,STS11 - POLIAMBULATORIO  San Luigi,SIC,20-29,17,23,0,40,0,0,0,40,0,40,Sicilia,ITG1
2021-01-09,PF/BT,608400.0,STS11 - POLIAMBULATORIO  San Luigi,SIC,30-39,10,11,0,21,0,0,0,21,0,21,Sicilia,ITG1
2021-01-09,PF/BT,608400.0,STS11 - POLIAMBULATORIO  San Luigi,SIC,40-49,3,5,0,8,0,0,0,8,0,8,Sicilia,ITG1
2021-01-09,PF/BT,608400.0,STS11 - POLIAMBULATORIO  San Luigi,SIC,50-59,4,6,0,10,0,0,0,10,0,10,Sicilia,ITG1
2021-01-09,PF/BT,608400.0,STS11 - POLIAMBULATORIO  San Luigi,SIC,60-69,16,11,0,27,0,0,0,27,0,27,Sicilia,ITG1
2021-01-09,PF/BT,608400.0,STS11 - POLIAMBULATORIO  San Luigi,SIC,70-79,6,1,0,7,0,0,0,7,0,7,Sicilia,ITG1
2021-01-09,PF/BT,816100.0,STS11 - RSA - CASA SAN CALOGERO - OPERA DON GUANELLA,SIC,50-59,1,0,0,1,0,0,0,1,0,1,Sicilia,ITG1
2021-01-09,PF/BT,816100.0,STS11 - RSA - CASA SAN CALOGERO - OPERA DON GUANELLA,SIC,60-69,2,0,0,1,0,1,0,2,0,2,Sicilia,ITG1
2021-01-09,PF/BT,816100.0,STS11 - RSA - CASA SAN CALOGERO - OPERA DON GUANELLA,SIC,70-79,2,7,0,0,0,9,0,9,0,9,Sicilia,ITG1
2021-01-09,PF/BT,816100.0,STS11 - RSA - CASA SAN CALOGERO - OPERA DON GUANELLA,SIC,80-89,6,17,0,1,0,22,0,23,0,23,Sicilia,ITG1
2021-01-09,PF/BT,816100.0,STS11 - RSA - CASA SAN CALOGERO - OPERA DON GUANELLA,SIC,90+,2,5,0,0,0,7,0,7,0,7,Sicilia,ITG1
2021-01-09,PF/BT,820600.0,STS11 - CTA VILLA LETIZIA SRL,SIC,20-29,0,3,0,2,0,0,1,3,0,3,Sicilia,ITG1
2021-01-09,PF/BT,820600.0,STS11 - CTA VILLA LETIZIA SRL,SIC,30-39,2,0,0,0,0,0,2,2,0,2,Sicilia,ITG1
2021-01-09,PF/BT,820600.0,STS11 - CTA VILLA LETIZIA SRL,SIC,40-49,8,6,0,4,0,0,10,14,0,14,Sicilia,ITG1
2021-01-09,PF/BT,820600.0,STS11 - CTA VILLA LETIZIA SRL,SIC,50-59,12,10,0,7,0,0,15,22,0,22,Sicilia,ITG1
2021-01-09,PF/BT,820600.0,STS11 - CTA VILLA LETIZIA SRL,SIC,60-69,7,3,0,2,0,0,8,10,0,10,Sicilia,ITG1
2021-01-09,PF/BT,820600.0,STS11 - CTA VILLA LETIZIA SRL,SIC,70-79,1,1,0,0,0,0,2,2,0,2,Sicilia,ITG1
2021-01-09,PF/BT,820600.0,STS11 - CTA VILLA LETIZIA SRL,SIC,80-89,1,0,0,0,0,0,1,1,0,1,Sicilia,ITG1
2021-01-09,PF/BT,824601.0,STS11 - CTA BELVEDERE SRL,SIC,20-29,1,0,0,1,0,0,0,1,0,1,Sicilia,ITG1
2021-01-09,PF/BT,824601.0,STS11 - CTA BELVEDERE SRL,SIC,30-39,7,2,0,7,0,0,2,9,0,9,Sicilia,ITG1
2021-01-09,PF/BT,824601.0,STS11 - CTA BELVEDERE SRL,SIC,40-49,11,11,0,9,0,0,13,22,0,22,Sicilia,ITG1
2021-01-09,PF/BT,824601.0,STS11 - CTA BELVEDERE SRL,SIC,50-59,7,9,0,9,0,0,7,16,0,16,Sicilia,ITG1
2021-01-09,PF/BT,824601.0,STS11 - CTA BELVEDERE SRL,SIC,60-69,7,2,0,2,0,0,7,9,0,9,Sicilia,ITG1
2021-01-09,PF/BT,824601.0,STS11 - CTA BELVEDERE SRL,SIC,70-79,1,2,0,0,0,0,3,3,0,3,Sicilia,ITG1
2021-01-09,PF/BT,830200.0,STS11 - RESIDENZA SANITARIA ARKA SRL,SIC,20-29,1,5,0,6,0,0,0,6,0,6,Sicilia,ITG1
2021-01-09,PF/BT,830200.0,STS11 - RESIDENZA SANITARIA ARKA SRL,SIC,30-39,3,1,0,4,0,0,0,4,0,4,Sicilia,ITG1
2021-01-09,PF/BT,830200.0,STS11 - RESIDENZA SANITARIA ARKA SRL,SIC,40-49,2,3,0,4,0,1,0,5,0,5,Sicilia,ITG1
2021-01-09,PF/BT,830200.0,STS11 - RESIDENZA SANITARIA ARKA SRL,SIC,50-59,6,4,0,6,0,4,0,10,0,10,Sicilia,ITG1
2021-01-09,PF/BT,830200.0,STS11 - RESIDENZA SANITARIA ARKA SRL,SIC,60-69,0,2,0,1,0,1,0,2,0,2,Sicilia,ITG1
2021-01-09,PF/BT,830200.0,STS11 - RESIDENZA SANITARIA ARKA SRL,SIC,80-89,0,2,0,0,0,2,0,2,0,2,Sicilia,ITG1
2021-01-09,PF/BT,830400.0,STS11 - R.S.A.  VILLA PACIS S.FRANCESCO  SRL,SIC,20-29,4,12,0,13,3,0,0,16,0,16,Sicilia,ITG1
2021-01-09,PF/BT,830400.0,STS11 - R.S.A.  VILLA PACIS S.FRANCESCO  SRL,SIC,30-39,6,10,0,10,6,0,0,16,0,16,Sicilia,ITG1
2021-01-09,PF/BT,830400.0,STS11 - R.S.A.  VILLA PACIS S.FRANCESCO  SRL,SIC,40-49,4,4,0,2,5,1,0,8,0,8,Sicilia,ITG1
2021-01-09,PF/BT,830400.0,STS11 - R.S.A.  VILLA PACIS S.FRANCESCO  SRL,SIC,50-59,0,5,0,3,2,0,0,5,0,5,Sicilia,ITG1
2021-01-09,PF/BT,830400.0,STS11 - R.S.A.  VILLA PACIS S.FRANCESCO  SRL,SIC,60-69,5,5,0,2,1,7,0,10,0,10,Sicilia,ITG1
2021-01-09,PF/BT,830400.0,STS11 - R.S.A.  VILLA PACIS S.FRANCESCO  SRL,SIC,70-79,3,5,0,0,1,7,0,8,0,8,Sicilia,ITG1
2021-01-09,PF/BT,830400.0,STS11 - R.S.A.  VILLA PACIS S.FRANCESCO  SRL,SIC,80-89,7,25,0,0,0,32,0,32,0,32,Sicilia,ITG1
2021-01-09,PF/BT,830400.0,STS11 - R.S.A.  VILLA PACIS S.FRANCESCO  SRL,SIC,90+,1,15,0,0,0,16,0,16,0,16,Sicilia,ITG1
2021-01-10,PF/BT,1902017.0,STRUTTURE PRIVATE NON CODIFICATE NSIS,SIC,20-29,4,10,0,6,0,0,8,14,0,14,Sicilia,ITG1
2021-01-10,PF/BT,1902017.0,STRUTTURE PRIVATE NON CODIFICATE NSIS,SIC,30-39,4,5,0,7,0,0,2,9,0,9,Sicilia,ITG1
2021-01-10,PF/BT,1902017.0,STRUTTURE PRIVATE NON CODIFICATE NSIS,SIC,40-49,3,13,0,7,0,1,8,16,0,16,Sicilia,ITG1
2021-01-10,PF/BT,1902017.0,STRUTTURE PRIVATE NON CODIFICATE NSIS,SIC,50-59,5,9,0,3,0,3,8,14,0,14,Sicilia,ITG1
2021-01-10,PF/BT,1902017.0,STRUTTURE PRIVATE NON CODIFICATE NSIS,SIC,60-69,2,2,0,2,0,1,1,4,0,4,Sicilia,ITG1
2021-01-10,PF/BT,1902017.0,STRUTTURE PRIVATE NON CODIFICATE NSIS,SIC,70-79,9,13,0,1,0,20,1,22,0,22,Sicilia,ITG1
2021-01-10,PF/BT,1902017.0,STRUTTURE PRIVATE NON CODIFICATE NSIS,SIC,80-89,14,28,0,0,0,39,3,42,0,42,Sicilia,ITG1
2021-01-10,PF/BT,1902017.0,STRUTTURE PRIVATE NON CODIFICATE NSIS,SIC,90+,3,24,0,0,0,25,2,27,0,27,Sicilia,ITG1
2021-01-10,PF/BT,1902027.0,STRUTTURE PRIVATE NON CODIFICATE NSIS,SIC,20-29,5,8,0,13,0,0,0,13,0,13,Sicilia,ITG1
2021-01-10,PF/BT,1902027.0,STRUTTURE PRIVATE NON CODIFICATE NSIS,SIC,30-39,7,4,0,11,0,0,0,11,0,11,Sicilia,ITG1
2021-01-10,PF/BT,1902027.0,STRUTTURE PRIVATE NON CODIFICATE NSIS,SIC,40-49,5,19,0,21,1,2,0,24,0,24,Sicilia,ITG1
2021-01-10,PF/BT,1902027.0,STRUTTURE PRIVATE NON CODIFICATE NSIS,SIC,50-59,8,9,0,11,3,3,0,17,0,17,Sicilia,ITG1
2021-01-10,PF/BT,1902027.0,STRUTTURE PRIVATE NON CODIFICATE NSIS,SIC,60-69,3,4,0,1,1,5,0,7,0,7,Sicilia,ITG1
2021-01-10,PF/BT,1902027.0,STRUTTURE PRIVATE NON CODIFICATE NSIS,SIC,70-79,9,11,0,0,0,20,0,20,0,20,Sicilia,ITG1
2021-01-10,PF/BT,1902027.0,STRUTTURE PRIVATE NON CODIFICATE NSIS,SIC,80-89,9,32,0,0,0,41,0,41,0,41,Sicilia,ITG1
2021-01-10,PF/BT,1902027.0,STRUTTURE PRIVATE NON CODIFICATE NSIS,SIC,90+,7,14,0,0,0,21,0,21,0,21,Sicilia,ITG1
2021-01-10,PF/BT,1902037.0,STRUTTURE PRIVATE NON CODIFICATE NSIS,SIC,20-29,4,4,0,1,1,0,6,8,0,8,Sicilia,ITG1
2021-01-10,PF/BT,1902037.0,STRUTTURE PRIVATE NON CODIFICATE NSIS,SIC,30-39,7,4,0,1,0,0,10,11,0,11,Sicilia,ITG1
2021-01-10,PF/BT,1902037.0,STRUTTURE PRIVATE NON CODIFICATE NSIS,SIC,40-49,7,7,0,1,4,0,9,14,0,14,Sicilia,ITG1
2021-01-10,PF/BT,1902037.0,STRUTTURE PRIVATE NON CODIFICATE NSIS,SIC,50-59,6,2,0,2,1,0,5,8,0,8,Sicilia,ITG1
2021-01-10,PF/BT,1902037.0,STRUTTURE PRIVATE NON CODIFICATE NSIS,SIC,60-69,1,2,0,0,1,0,2,3,0,3,Sicilia,ITG1
2021-01-10,PF/BT,1902057.0,STRUTTURE PRIVATE NON CODIFICATE NSIS,SIC,20-29,1,1,0,2,0,0,0,2,0,2,Sicilia,ITG1
2021-01-10,PF/BT,1902057.0,STRUTTURE PRIVATE NON CODIFICATE NSIS,SIC,30-39,1,2,0,3,0,0,0,3,0,3,Sicilia,ITG1
2021-01-10,PF/BT,1902057.0,STRUTTURE PRIVATE NON CODIFICATE NSIS,SIC,40-49,4,7,0,10,0,1,0,11,0,11,Sicilia,ITG1
2021-01-10,PF/BT,1902057.0,STRUTTURE PRIVATE NON CODIFICATE NSIS,SIC,50-59,9,16,0,20,2,3,0,25,0,25,Sicilia,ITG1
2021-01-10,PF/BT,1902057.0,STRUTTURE PRIVATE NON CODIFICATE NSIS,SIC,60-69,14,16,0,26,0,4,0,30,0,30,Sicilia,ITG1
2021-01-10,PF/BT,1902057.0,STRUTTURE PRIVATE NON CODIFICATE NSIS,SIC,70-79,2,11,0,2,0,11,0,13,0,13,Sicilia,ITG1
2021-01-10,PF/BT,1902057.0,STRUTTURE PRIVATE NON CODIFICATE NSIS,SIC,80-89,2,38,0,0,0,40,0,40,0,40,Sicilia,ITG1
2021-01-10,PF/BT,1902057.0,STRUTTURE PRIVATE NON CODIFICATE NSIS,SIC,90+,5,34,0,0,0,39,0,39,0,39,Sicilia,ITG1
2021-01-10,PF/BT,1902077.0,STRUTTURE PRIVATE NON CODIFICATE NSIS,SIC,30-39,1,3,0,4,0,0,0,4,0,4,Sicilia,ITG1
2021-01-10,PF/BT,1902077.0,STRUTTURE PRIVATE NON CODIFICATE NSIS,SIC,40-49,0,3,0,2,0,1,0,3,0,3,Sicilia,ITG1
2021-01-10,PF/BT,1902077.0,STRUTTURE PRIVATE NON CODIFICATE NSIS,SIC,50-59,3,6,0,6,0,3,0,9,0,9,Sicilia,ITG1
2021-01-10,PF/BT,1902077.0,STRUTTURE PRIVATE NON CODIFICATE NSIS,SIC,60-69,5,3,0,1,0,7,0,8,0,8,Sicilia,ITG1
2021-01-10,PF/BT,1902077.0,STRUTTURE PRIVATE NON CODIFICATE NSIS,SIC,70-79,7,1,0,1,0,7,0,8,0,8,Sicilia,ITG1
2021-01-10,PF/BT,1902077.0,STRUTTURE PRIVATE NON CODIFICATE NSIS,SIC,80-89,5,2,0,0,0,7,0,7,0,7,Sicilia,ITG1
2021-01-10,PF/BT,1902077.0,STRUTTURE PRIVATE NON CODIFICATE NSIS,SIC,90+,1,2,0,0,0,3,0,3,0,3,Sicilia,ITG1
2021-01-10,PF/BT,1902087.0,STRUTTURE PRIVATE NON CODIFICATE NSIS,SIC,20-29,0,5,0,4,0,1,0,5,0,5,Sicilia,ITG1
2021-01-10,PF/BT,1902087.0,STRUTTURE PRIVATE NON CODIFICATE NSIS,SIC,30-39,2,6,0,8,0,0,0,8,0,8,Sicilia,ITG1
2021-01-10,PF/BT,1902087.0,STRUTTURE PRIVATE NON CODIFICATE NSIS,SIC,40-49,1,9,0,10,0,0,0,10,0,10,Sicilia,ITG1
2021-01-10,PF/BT,1902087.0,STRUTTURE PRIVATE NON CODIFICATE NSIS,SIC,50-59,4,9,0,13,0,0,0,13,0,13,Sicilia,ITG1
2021-01-10,PF/BT,1902087.0,STRUTTURE PRIVATE NON CODIFICATE NSIS,SIC,60-69,1,1,0,0,0,2,0,2,0,2,Sicilia,ITG1
2021-01-10,PF/BT,1902087.0,STRUTTURE PRIVATE NON CODIFICATE NSIS,SIC,70-79,4,3,0,0,0,7,0,7,0,7,Sicilia,ITG1
2021-01-10,PF/BT,1902087.0,STRUTTURE PRIVATE NON CODIFICATE NSIS,SIC,80-89,10,16,0,1,0,24,1,26,0,26,Sicilia,ITG1
2021-01-10,PF/BT,1902087.0,STRUTTURE PRIVATE NON CODIFICATE NSIS,SIC,90+,2,14,0,0,0,16,0,16,0,16,Sicilia,ITG1
2021-01-10,PF/BT,190301.0,RIA11 - A.I.A.S.SEZ.DI AGRIGENTO ONLUS,SIC,16-19,0,1,0,0,0,0,1,1,0,1,Sicilia,ITG1
2021-01-10,PF/BT,190301.0,RIA11 - A.I.A.S.SEZ.DI AGRIGENTO ONLUS,SIC,20-29,17,22,0,24,0,0,15,39,0,39,Sicilia,ITG1
2021-01-10,PF/BT,190301.0,RIA11 - A.I.A.S.SEZ.DI AGRIGENTO ONLUS,SIC,30-39,23,29,0,38,1,0,13,52,0,52,Sicilia,ITG1
2021-01-10,PF/BT,190301.0,RIA11 - A.I.A.S.SEZ.DI AGRIGENTO ONLUS,SIC,40-49,23,29,0,34,2,0,16,52,0,52,Sicilia,ITG1
2021-01-10,PF/BT,190301.0,RIA11 - A.I.A.S.SEZ.DI AGRIGENTO ONLUS,SIC,50-59,21,34,0,31,2,0,22,55,0,55,Sicilia,ITG1
2021-01-10,PF/BT,190301.0,RIA11 - A.I.A.S.SEZ.DI AGRIGENTO ONLUS,SIC,60-69,25,20,0,38,1,0,6,45,0,45,Sicilia,ITG1
2021-01-10,PF/BT,190301.0,RIA11 - A.I.A.S.SEZ.DI AGRIGENTO ONLUS,SIC,70-79,8,2,0,8,0,0,2,10,0,10,Sicilia,ITG1
2021-01-10,PF/BT,190302.0,RIA11 - C.DELLA SPERANZA DON ANGELO G.,SIC,20-29,0,4,0,0,0,0,4,4,0,4,Sicilia,ITG1
2021-01-10,PF/BT,190302.0,RIA11 - C.DELLA SPERANZA DON ANGELO G.,SIC,30-39,5,6,0,0,0,0,11,11,0,11,Sicilia,ITG1
2021-01-10,PF/BT,190302.0,RIA11 - C.DELLA SPERANZA DON ANGELO G.,SIC,40-49,4,12,0,0,0,0,16,16,0,16,Sicilia,ITG1
2021-01-10,PF/BT,190302.0,RIA11 - C.DELLA SPERANZA DON ANGELO G.,SIC,50-59,7,14,0,2,0,0,19,21,0,21,Sicilia,ITG1
2021-01-10,PF/BT,190302.0,RIA11 - C.DELLA SPERANZA DON ANGELO G.,SIC,60-69,6,3,0,2,0,0,7,9,0,9,Sicilia,ITG1
2021-01-10,PF/BT,190302.0,RIA11 - C.DELLA SPERANZA DON ANGELO G.,SIC,70-79,1,3,0,0,0,0,4,4,0,4,Sicilia,ITG1
2021-01-10,PF/BT,190303.0,RIA11 - COMUNITA` DELLA SPERANZA,SIC,16-19,0,1,0,1,0,0,0,1,0,1,Sicilia,ITG1
2021-01-10,PF/BT,190303.0,RIA11 - COMUNITA` DELLA SPERANZA,SIC,20-29,7,7,0,11,0,0,3,14,0,14,Sicilia,ITG1
2021-01-10,PF/BT,190303.0,RIA11 - COMUNITA` DELLA SPERANZA,SIC,30-39,15,12,0,20,6,0,1,27,0,27,Sicilia,ITG1
2021-01-10,PF/BT,190303.0,RIA11 - COMUNITA` DELLA SPERANZA,SIC,40-49,6,12,0,7,10,0,1,18,0,18,Sicilia,ITG1
2021-01-10,PF/BT,190303.0,RIA11 - COMUNITA` DELLA SPERANZA,SIC,50-59,9,9,0,11,4,0,3,18,0,18,Sicilia,ITG1
2021-01-10,PF/BT,190303.0,RIA11 - COMUNITA` DELLA SPERANZA,SIC,60-69,6,5,0,5,4,0,2,11,0,11,Sicilia,ITG1
2021-01-10,PF/BT,190303.0,RIA11 - COMUNITA` DELLA SPERANZA,SIC,70-79,1,1,0,1,0,0,1,2,0,2,Sicilia,ITG1
2021-01-10,PF/BT,190303.0,RIA11 - COMUNITA` DELLA SPERANZA,SIC,80-89,29,30,0,1,0,0,58,59,0,59,Sicilia,ITG1
2021-01-10,PF/BT,190303.0,RIA11 - COMUNITA` DELLA SPERANZA,SIC,90+,0,6,0,0,0,0,6,6,0,6,Sicilia,ITG1
2021-01-10,PF/BT,190304.0,RIA11 - Ass.ne Casa Famiglia Rosetta,SIC,20-29,2,2,0,1,3,0,0,4,0,4,Sicilia,ITG1
2021-01-10,PF/BT,190304.0,RIA11 - Ass.ne Casa Famiglia Rosetta,SIC,30-39,4,9,0,3,10,0,0,13,0,13,Sicilia,ITG1
2021-01-10,PF/BT,190304.0,RIA11 - Ass.ne Casa Famiglia Rosetta,SIC,40-49,5,4,0,2,7,0,0,9,0,9,Sicilia,ITG1
2021-01-10,PF/BT,190304.0,RIA11 - Ass.ne Casa Famiglia Rosetta,SIC,50-59,1,9,0,7,3,0,0,10,0,10,Sicilia,ITG1
2021-01-10,PF/BT,190304.0,RIA11 - Ass.ne Casa Famiglia Rosetta,SIC,60-69,2,1,0,1,1,1,0,3,0,3,Sicilia,ITG1
2021-01-10,PF/BT,190304.0,RIA11 - Ass.ne Casa Famiglia Rosetta,SIC,80-89,22,31,0,0,0,53,0,53,0,53,Sicilia,ITG1
2021-01-10,PF/BT,190304.0,RIA11 - Ass.ne Casa Famiglia Rosetta,SIC,90+,15,11,0,0,0,26,0,26,0,26,Sicilia,ITG1
2021-01-10,PF/BT,190305.0,HSP11 - P.O. GIOVANNI PAOLO II,SIC,16-19,19,2,0,0,3,0,18,21,0,21,Sicilia,ITG1
2021-01-10,PF/BT,190305.0,HSP11 - P.O. GIOVANNI PAOLO II,SIC,20-29,16,6,0,2,6,0,14,22,0,22,Sicilia,ITG1
2021-01-10,PF/BT,190305.0,HSP11 - P.O. GIOVANNI PAOLO II,SIC,30-39,11,13,0,7,8,0,9,24,0,24,Sicilia,ITG1
2021-01-10,PF/BT,190305.0,HSP11 - P.O. GIOVANNI PAOLO II,SIC,40-49,20,22,1,5,19,0,18,42,0,42,Sicilia,ITG1
2021-01-10,PF/BT,190305.0,HSP11 - P.O. GIOVANNI PAOLO II,SIC,50-59,17,27,0,7,21,0,16,44,0,44,Sicilia,ITG1
2021-01-10,PF/BT,190305.0,HSP11 - P.O. GIOVANNI PAOLO II,SIC,60-69,20,11,0,10,9,0,12,31,0,31,Sicilia,ITG1
2021-01-10,PF/BT,190305.0,HSP11 - P.O. GIOVANNI PAOLO II,SIC,70-79,10,5,0,3,2,0,10,15,0,15,Sicilia,ITG1
2021-01-10,PF/BT,190305.0,HSP11 - P.O. GIOVANNI PAOLO II,SIC,80-89,12,10,0,0,1,0,21,22,0,22,Sicilia,ITG1
2021-01-10,PF/BT,190305.0,HSP11 - P.O. GIOVANNI PAOLO II,SIC,90+,0,1,0,0,0,0,1,1,0,1,Sicilia,ITG1
2021-01-10,PF/BT,190306.0,RIA11 - ASS. CASA FAM.ROSETTA ONILUS,SIC,20-29,0,1,0,0,1,0,0,1,0,1,Sicilia,ITG1
2021-01-10,PF/BT,190306.0,RIA11 - ASS. CASA FAM.ROSETTA ONILUS,SIC,30-39,3,0,0,0,3,0,0,3,0,3,Sicilia,ITG1
2021-01-10,PF/BT,190306.0,RIA11 - ASS. CASA FAM.ROSETTA ONILUS,SIC,40-49,1,0,0,0,1,0,0,1,0,1,Sicilia,ITG1
2021-01-10,PF/BT,190306.0,RIA11 - ASS. CASA FAM.ROSETTA ONILUS,SIC,50-59,1,0,0,1,0,0,0,1,0,1,Sicilia,ITG1
2021-01-10,PF/BT,190309.0,HSP11 - P.O. VITTORIO EMANUELE (ex AO),SIC,20-29,10,7,0,15,0,0,2,17,0,17,Sicilia,ITG1
2021-01-10,PF/BT,190309.0,HSP11 - P.O. VITTORIO EMANUELE (ex AO),SIC,30-39,16,10,0,22,0,0,4,26,0,26,Sicilia,ITG1
2021-01-10,PF/BT,190309.0,HSP11 - P.O. VITTORIO EMANUELE (ex AO),SIC,40-49,7,16,0,22,0,0,1,23,0,23,Sicilia,ITG1
2021-01-10,PF/BT,190309.0,HSP11 - P.O. VITTORIO EMANUELE (ex AO),SIC,50-59,17,6,0,23,0,0,0,23,0,23,Sicilia,ITG1
2021-01-10,PF/BT,190309.0,HSP11 - P.O. VITTORIO EMANUELE (ex AO),SIC,60-69,9,5,0,14,0,0,0,14,0,14,Sicilia,ITG1
2021-01-10,PF/BT,190309.0,HSP11 - P.O. VITTORIO EMANUELE (ex AO),SIC,70-79,5,0,0,5,0,0,0,5,0,5,Sicilia,ITG1
2021-01-10,PF/BT,190312.0,HSP11 - P.O. S. Marta e S. Venera Acireale,SIC,20-29,5,0,0,2,3,0,0,5,0,5,Sicilia,ITG1
2021-01-10,PF/BT,190312.0,HSP11 - P.O. S. Marta e S. Venera Acireale,SIC,30-39,5,5,0,5,5,0,0,10,0,10,Sicilia,ITG1
2021-01-10,PF/BT,190312.0,HSP11 - P.O. S. Marta e S. Venera Acireale,SIC,40-49,4,6,0,7,3,0,0,10,0,10,Sicilia,ITG1
2021-01-10,PF/BT,190312.0,HSP11 - P.O. S. Marta e S. Venera Acireale,SIC,50-59,3,15,0,16,2,0,0,18,0,18,Sicilia,ITG1
2021-01-10,PF/BT,190312.0,HSP11 - P.O. S. Marta e S. Venera Acireale,SIC,60-69,12,5,0,14,3,0,0,17,0,17,Sicilia,ITG1
2021-01-10,PF/BT,190313.0,RIA11 - IST.RIAB.VILLAG. SAN GIUSEPPE,SIC,16-19,0,1,0,1,0,0,0,1,0,1,Sicilia,ITG1
2021-01-10,PF/BT,190313.0,RIA11 - IST.RIAB.VILLAG. SAN GIUSEPPE,SIC,20-29,1,3,0,4,0,0,0,4,0,4,Sicilia,ITG1
2021-01-10,PF/BT,190313.0,RIA11 - IST.RIAB.VILLAG. SAN GIUSEPPE,SIC,30-39,10,7,0,14,0,0,3,17,0,17,Sicilia,ITG1
2021-01-10,PF/BT,190313.0,RIA11 - IST.RIAB.VILLAG. SAN GIUSEPPE,SIC,40-49,1,8,0,5,1,0,3,9,0,9,Sicilia,ITG1
2021-01-10,PF/BT,190313.0,RIA11 - IST.RIAB.VILLAG. SAN GIUSEPPE,SIC,50-59,6,8,0,10,0,0,4,14,0,14,Sicilia,ITG1
2021-01-10,PF/BT,190313.0,RIA11 - IST.RIAB.VILLAG. SAN GIUSEPPE,SIC,60-69,16,4,0,18,0,0,2,20,0,20,Sicilia,ITG1
2021-01-10,PF/BT,190313.0,RIA11 - IST.RIAB.VILLAG. SAN GIUSEPPE,SIC,70-79,1,0,0,1,0,0,0,1,0,1,Sicilia,ITG1
2021-01-10,PF/BT,190314.0,RIA11 - ASS.J.F.KENNEDY ACIREALE,SIC,20-29,1,0,0,1,0,0,0,1,0,1,Sicilia,ITG1
2021-01-10,PF/BT,190314.0,RIA11 - ASS.J.F.KENNEDY ACIREALE,SIC,30-39,1,2,0,3,0,0,0,3,0,3,Sicilia,ITG1
2021-01-10,PF/BT,190314.0,RIA11 - ASS.J.F.KENNEDY ACIREALE,SIC,40-49,3,2,0,5,0,0,0,5,0,5,Sicilia,ITG1
2021-01-10,PF/BT,190314.0,RIA11 - ASS.J.F.KENNEDY ACIREALE,SIC,50-59,1,1,0,2,0,0,0,2,0,2,Sicilia,ITG1
2021-01-10,PF/BT,190314.0,RIA11 - ASS.J.F.KENNEDY ACIREALE,SIC,60-69,2,4,0,6,0,0,0,6,0,6,Sicilia,ITG1
2021-01-10,PF/BT,190314.0,RIA11 - ASS.J.F.KENNEDY ACIREALE,SIC,70-79,1,0,0,1,0,0,0,1,0,1,Sicilia,ITG1
2021-01-10,PF/BT,190316.0,RIA11 - ASS.J.F.KENNEDY - C.RIAB.ONLUS,SIC,20-29,5,9,0,11,3,0,0,14,0,14,Sicilia,ITG1
2021-01-10,PF/BT,190316.0,RIA11 - ASS.J.F.KENNEDY - C.RIAB.ONLUS,SIC,30-39,8,6,0,8,6,0,0,14,0,14,Sicilia,ITG1
2021-01-10,PF/BT,190316.0,RIA11 - ASS.J.F.KENNEDY - C.RIAB.ONLUS,SIC,40-49,1,14,0,10,5,0,0,15,0,15,Sicilia,ITG1
2021-01-10,PF/BT,190316.0,RIA11 - ASS.J.F.KENNEDY - C.RIAB.ONLUS,SIC,50-59,5,19,0,17,7,0,0,24,0,24,Sicilia,ITG1
2021-01-10,PF/BT,190316.0,RIA11 - ASS.J.F.KENNEDY - C.RIAB.ONLUS,SIC,60-69,10,11,0,12,9,0,0,21,0,21,Sicilia,ITG1
2021-01-10,PF/BT,190316.0,RIA11 - ASS.J.F.KENNEDY - C.RIAB.ONLUS,SIC,70-79,1,1,0,1,1,0,0,2,0,2,Sicilia,ITG1
2021-01-10,PF/BT,190317.0,HSP11 - P.O. Gravina e S. Pietro Caltagirone,SIC,20-29,1,1,0,1,1,0,0,2,0,2,Sicilia,ITG1
2021-01-10,PF/BT,190317.0,HSP11 - P.O. Gravina e S. Pietro Caltagirone,SIC,30-39,1,1,0,1,1,0,0,2,0,2,Sicilia,ITG1
2021-01-10,PF/BT,190317.0,HSP11 - P.O. Gravina e S. Pietro Caltagirone,SIC,40-49,2,4,0,3,3,0,0,6,0,6,Sicilia,ITG1
2021-01-10,PF/BT,190317.0,HSP11 - P.O. Gravina e S. Pietro Caltagirone,SIC,50-59,1,4,0,4,1,0,0,5,0,5,Sicilia,ITG1
2021-01-10,PF/BT,190317.0,HSP11 - P.O. Gravina e S. Pietro Caltagirone,SIC,60-69,1,2,0,2,1,0,0,3,0,3,Sicilia,ITG1
2021-01-10,PF/BT,190330.0,HSP11 - P.O. DEI BIANCHI CORLEONE,SIC,20-29,5,1,0,5,1,0,0,6,0,6,Sicilia,ITG1
2021-01-10,PF/BT,190330.0,HSP11 - P.O. DEI BIANCHI CORLEONE,SIC,30-39,2,5,0,4,3,0,0,7,0,7,Sicilia,ITG1
2021-01-10,PF/BT,190330.0,HSP11 - P.O. DEI BIANCHI CORLEONE,SIC,40-49,8,4,0,5,7,0,0,12,0,12,Sicilia,ITG1
2021-01-10,PF/BT,190330.0,HSP11 - P.O. DEI BIANCHI CORLEONE,SIC,50-59,4,7,0,9,2,0,0,11,0,11,Sicilia,ITG1
2021-01-10,PF/BT,190330.0,HSP11 - P.O. DEI BIANCHI CORLEONE,SIC,60-69,5,5,0,4,6,0,0,10,0,10,Sicilia,ITG1
2021-01-10,PF/BT,190330.0,HSP11 - P.O. DEI BIANCHI CORLEONE,SIC,70-79,1,0,0,1,0,0,0,1,0,1,Sicilia,ITG1
2021-01-10,PF/BT,190330.0,HSP11 - P.O. DEI BIANCHI CORLEONE,SIC,80-89,1,0,0,0,1,0,0,1,0,1,Sicilia,ITG1
2021-01-10,PF/BT,190332.0,HSP11 - P.O. CIVICO PARTINICO,SIC,30-39,2,3,0,4,1,0,0,5,0,5,Sicilia,ITG1
2021-01-10,PF/BT,190332.0,HSP11 - P.O. CIVICO PARTINICO,SIC,40-49,4,4,0,7,1,0,0,8,0,8,Sicilia,ITG1
2021-01-10,PF/BT,190332.0,HSP11 - P.O. CIVICO PARTINICO,SIC,50-59,3,1,0,2,2,0,0,4,0,4,Sicilia,ITG1
2021-01-10,PF/BT,190332.0,HSP11 - P.O. CIVICO PARTINICO,SIC,60-69,0,1,0,1,0,0,0,1,0,1,Sicilia,ITG1
2021-01-10,PF/BT,190334.0,HSP11 - P.O. S. CIMINO TERMINI IMERESE,SIC,20-29,2,1,0,3,0,0,0,3,0,3,Sicilia,ITG1
2021-01-10,PF/BT,190334.0,HSP11 - P.O. S. CIMINO TERMINI IMERESE,SIC,30-39,5,6,0,8,3,0,0,11,0,11,Sicilia,ITG1
2021-01-10,PF/BT,190334.0,HSP11 - P.O. S. CIMINO TERMINI IMERESE,SIC,40-49,1,4,0,1,4,0,0,5,0,5,Sicilia,ITG1
2021-01-10,PF/BT,190334.0,HSP11 - P.O. S. CIMINO TERMINI IMERESE,SIC,50-59,2,6,0,5,3,0,0,8,0,8,Sicilia,ITG1
2021-01-10,PF/BT,190334.0,HSP11 - P.O. S. CIMINO TERMINI IMERESE,SIC,60-69,4,4,0,7,1,0,0,8,0,8,Sicilia,ITG1
2021-01-10,PF/BT,190334.0,HSP11 - P.O. S. CIMINO TERMINI IMERESE,SIC,70-79,1,0,0,1,0,0,0,1,0,1,Sicilia,ITG1
2021-01-10,PF/BT,190335.0,HSP11 - P.O. G. F. INGRASSIA,SIC,20-29,3,2,0,5,0,0,0,5,0,5,Sicilia,ITG1
2021-01-10,PF/BT,190335.0,HSP11 - P.O. G. F. INGRASSIA,SIC,30-39,4,0,0,4,0,0,0,4,0,4,Sicilia,ITG1
2021-01-10,PF/BT,190335.0,HSP11 - P.O. G. F. INGRASSIA,SIC,40-49,0,2,0,2,0,0,0,2,0,2,Sicilia,ITG1
2021-01-10,PF/BT,190335.0,HSP11 - P.O. G. F. INGRASSIA,SIC,50-59,2,3,0,5,0,0,0,5,0,5,Sicilia,ITG1
2021-01-10,PF/BT,190335.0,HSP11 - P.O. G. F. INGRASSIA,SIC,60-69,7,6,0,12,0,0,1,13,0,13,Sicilia,ITG1
2021-01-10,PF/BT,190335.0,HSP11 - P.O. G. F. INGRASSIA,SIC,80-89,1,0,0,1,0,0,0,1,0,1,Sicilia,ITG1
2021-01-10,PF/BT,190337.0,HSP11 - P.O. VILLA DELLE GINESTRE,SIC,20-29,5,3,0,8,0,0,0,8,0,8,Sicilia,ITG1
2021-01-10,PF/BT,190337.0,HSP11 - P.O. VILLA DELLE GINESTRE,SIC,30-39,8,9,0,14,2,0,1,17,0,17,Sicilia,ITG1
2021-01-10,PF/BT,190337.0,HSP11 - P.O. VILLA DELLE GINESTRE,SIC,40-49,8,10,0,11,3,0,4,18,0,18,Sicilia,ITG1
2021-01-10,PF/BT,190337.0,HSP11 - P.O. VILLA DELLE GINESTRE,SIC,50-59,14,20,0,29,2,0,3,34,0,34,Sicilia,ITG1
2021-01-10,PF/BT,190337.0,HSP11 - P.O. VILLA DELLE GINESTRE,SIC,60-69,25,22,0,47,0,0,0,47,0,47,Sicilia,ITG1
2021-01-10,PF/BT,190337.0,HSP11 - P.O. VILLA DELLE GINESTRE,SIC,70-79,10,4,0,12,1,0,1,14,0,14,Sicilia,ITG1
2021-01-10,PF/BT,190337.0,HSP11 - P.O. VILLA DELLE GINESTRE,SIC,80-89,1,0,0,1,0,0,0,1,0,1,Sicilia,ITG1
2021-01-10,PF/BT,190343.0,HSP11 - P.O. DI MARIA AVOLA,SIC,20-29,1,0,0,1,0,0,0,1,0,1,Sicilia,ITG1
2021-01-10,PF/BT,190343.0,HSP11 - P.O. DI MARIA AVOLA,SIC,30-39,3,0,0,3,0,0,0,3,0,3,Sicilia,ITG1
2021-01-10,PF/BT,190343.0,HSP11 - P.O. DI MARIA AVOLA,SIC,40-49,4,3,0,5,0,0,2,7,0,7,Sicilia,ITG1
2021-01-10,PF/BT,190343.0,HSP11 - P.O. DI MARIA AVOLA,SIC,50-59,2,4,0,5,0,0,1,6,0,6,Sicilia,ITG1
2021-01-10,PF/BT,190343.0,HSP11 - P.O. DI MARIA AVOLA,SIC,60-69,5,2,0,5,0,0,2,7,0,7,Sicilia,ITG1
2021-01-10,PF/BT,190345.0,HSP11 - P.O. UMBERTO I (EX A.O.),SIC,20-29,1,0,0,1,0,0,0,1,0,1,Sicilia,ITG1
2021-01-10,PF/BT,190345.0,HSP11 - P.O. UMBERTO I (EX A.O.),SIC,30-39,1,4,0,5,0,0,0,5,0,5,Sicilia,ITG1
2021-01-10,PF/BT,190345.0,HSP11 - P.O. UMBERTO I (EX A.O.),SIC,40-49,1,2,0,3,0,0,0,3,0,3,Sicilia,ITG1
2021-01-10,PF/BT,190345.0,HSP11 - P.O. UMBERTO I (EX A.O.),SIC,50-59,0,5,0,5,0,0,0,5,0,5,Sicilia,ITG1
2021-01-10,PF/BT,190345.0,HSP11 - P.O. UMBERTO I (EX A.O.),SIC,60-69,2,2,0,4,0,0,0,4,0,4,Sicilia,ITG1
2021-01-10,PF/BT,190347.0,HSP11 - OSPEDALE GENERALE DI ZONA,SIC,60-69,5,1,0,6,0,0,0,6,0,6,Sicilia,ITG1
2021-01-10,PF/BT,190349.0,HSP11 - P.O. SAN VITO E SANTO SPIRITO -ALCAMO,SIC,20-29,4,4,0,4,1,0,3,8,0,8,Sicilia,ITG1
2021-01-10,PF/BT,190349.0,HSP11 - P.O. SAN VITO E SANTO SPIRITO -ALCAMO,SIC,30-39,2,2,0,2,0,0,2,4,0,4,Sicilia,ITG1
2021-01-10,PF/BT,190349.0,HSP11 - P.O. SAN VITO E SANTO SPIRITO -ALCAMO,SIC,40-49,2,13,0,11,0,1,3,15,0,15,Sicilia,ITG1
2021-01-10,PF/BT,190349.0,HSP11 - P.O. SAN VITO E SANTO SPIRITO -ALCAMO,SIC,50-59,7,14,0,13,0,6,2,21,0,21,Sicilia,ITG1
2021-01-10,PF/BT,190349.0,HSP11 - P.O. SAN VITO E SANTO SPIRITO -ALCAMO,SIC,60-69,10,5,0,7,0,7,1,15,0,15,Sicilia,ITG1
2021-01-10,PF/BT,190349.0,HSP11 - P.O. SAN VITO E SANTO SPIRITO -ALCAMO,SIC,70-79,3,2,0,1,0,4,0,5,0,5,Sicilia,ITG1
2021-01-10,PF/BT,190349.0,HSP11 - P.O. SAN VITO E SANTO SPIRITO -ALCAMO,SIC,80-89,3,5,0,0,0,8,0,8,0,8,Sicilia,ITG1
2021-01-10,PF/BT,190349.0,HSP11 - P.O. SAN VITO E SANTO SPIRITO -ALCAMO,SIC,90+,1,1,0,0,0,2,0,2,0,2,Sicilia,ITG1
2021-01-10,PF/BT,190351.0,HSP11 - P.O. S. ANTONIO ABATE  - TRAPANI,SIC,16-19,0,1,0,1,0,0,0,1,0,1,Sicilia,ITG1
2021-01-10,PF/BT,190351.0,HSP11 - P.O. S. ANTONIO ABATE  - TRAPANI,SIC,20-29,9,4,0,11,2,0,0,13,0,13,Sicilia,ITG1
2021-01-10,PF/BT,190351.0,HSP11 - P.O. S. ANTONIO ABATE  - TRAPANI,SIC,30-39,17,24,0,38,3,0,0,41,0,41,Sicilia,ITG1
2021-01-10,PF/BT,190351.0,HSP11 - P.O. S. ANTONIO ABATE  - TRAPANI,SIC,40-49,15,22,0,29,8,0,0,37,0,37,Sicilia,ITG1
2021-01-10,PF/BT,190351.0,HSP11 - P.O. S. ANTONIO ABATE  - TRAPANI,SIC,50-59,11,39,0,43,7,0,0,50,0,50,Sicilia,ITG1
2021-01-10,PF/BT,190351.0,HSP11 - P.O. S. ANTONIO ABATE  - TRAPANI,SIC,60-69,16,25,0,37,4,0,0,41,0,41,Sicilia,ITG1
2021-01-10,PF/BT,190351.0,HSP11 - P.O. S. ANTONIO ABATE  - TRAPANI,SIC,70-79,5,1,0,5,1,0,0,6,0,6,Sicilia,ITG1
2021-01-10,PF/BT,190351.0,HSP11 - P.O. S. ANTONIO ABATE  - TRAPANI,SIC,80-89,1,0,0,1,0,0,0,1,0,1,Sicilia,ITG1
2021-01-10,PF/BT,190352.0,HSP11 - P.O. V.EMANUELE II CASTELVETRANO,SIC,30-39,2,1,0,3,0,0,0,3,0,3,Sicilia,ITG1
2021-01-10,PF/BT,190352.0,HSP11 - P.O. V.EMANUELE II CASTELVETRANO,SIC,40-49,1,3,0,3,1,0,0,4,0,4,Sicilia,ITG1
2021-01-10,PF/BT,190352.0,HSP11 - P.O. V.EMANUELE II CASTELVETRANO,SIC,50-59,6,3,0,6,3,0,0,9,0,9,Sicilia,ITG1
2021-01-10,PF/BT,190352.0,HSP11 - P.O. V.EMANUELE II CASTELVETRANO,SIC,60-69,0,2,0,1,1,0,0,2,0,2,Sicilia,ITG1
2021-01-10,PF/BT,190353.0,HSP11 - P.O.PAOLO BORSELLINO - MARSALA,SIC,20-29,2,3,0,5,0,0,0,5,0,5,Sicilia,ITG1
2021-01-10,PF/BT,190353.0,HSP11 - P.O.PAOLO BORSELLINO - MARSALA,SIC,30-39,4,8,0,12,0,0,0,12,0,12,Sicilia,ITG1
2021-01-10,PF/BT,190353.0,HSP11 - P.O.PAOLO BORSELLINO - MARSALA,SIC,40-49,6,8,0,14,0,0,0,14,0,14,Sicilia,ITG1
2021-01-10,PF/BT,190353.0,HSP11 - P.O.PAOLO BORSELLINO - MARSALA,SIC,50-59,2,5,0,7,0,0,0,7,0,7,Sicilia,ITG1
2021-01-10,PF/BT,190353.0,HSP11 - P.O.PAOLO BORSELLINO - MARSALA,SIC,60-69,3,1,0,4,0,0,0,4,0,4,Sicilia,ITG1
2021-01-10,PF/BT,190354.0,HSP11 - P.O.ABELE AJELLO-MAZARA D.VALLO,SIC,20-29,4,3,0,7,0,0,0,7,0,7,Sicilia,ITG1
2021-01-10,PF/BT,190354.0,HSP11 - P.O.ABELE AJELLO-MAZARA D.VALLO,SIC,30-39,4,10,0,13,1,0,0,14,0,14,Sicilia,ITG1
2021-01-10,PF/BT,190354.0,HSP11 - P.O.ABELE AJELLO-MAZARA D.VALLO,SIC,40-49,10,21,0,30,1,0,0,31,0,31,Sicilia,ITG1
2021-01-10,PF/BT,190354.0,HSP11 - P.O.ABELE AJELLO-MAZARA D.VALLO,SIC,50-59,9,26,0,32,3,0,0,35,0,35,Sicilia,ITG1
2021-01-10,PF/BT,190354.0,HSP11 - P.O.ABELE AJELLO-MAZARA D.VALLO,SIC,60-69,7,7,0,11,3,0,0,14,0,14,Sicilia,ITG1
2021-01-10,PF/BT,190354.0,HSP11 - P.O.ABELE AJELLO-MAZARA D.VALLO,SIC,70-79,1,0,0,0,1,0,0,1,0,1,Sicilia,ITG1
2021-01-10,PF/BT,190523.0,HSP11 - CASA DI CURA GIBIINO SRL,SIC,20-29,1,5,0,6,0,0,0,6,0,6,Sicilia,ITG1
2021-01-10,PF/BT,190523.0,HSP11 - CASA DI CURA GIBIINO SRL,SIC,30-39,10,4,0,9,0,0,5,14,0,14,Sicilia,ITG1
2021-01-10,PF/BT,190523.0,HSP11 - CASA DI CURA GIBIINO SRL,SIC,40-49,5,5,0,6,2,0,2,10,0,10,Sicilia,ITG1
2021-01-10,PF/BT,190523.0,HSP11 - CASA DI CURA GIBIINO SRL,SIC,50-59,4,8,0,1,3,0,8,12,0,12,Sicilia,ITG1
2021-01-10,PF/BT,190523.0,HSP11 - CASA DI CURA GIBIINO SRL,SIC,60-69,4,2,0,5,0,0,1,6,0,6,Sicilia,ITG1
2021-01-10,PF/BT,190523.0,HSP11 - CASA DI CURA GIBIINO SRL,SIC,70-79,6,0,0,5,0,0,1,6,0,6,Sicilia,ITG1
2021-01-10,PF/BT,190536.0,HSP11 - CASA DI CURA TRIOLO ZANCLA S.P.A.,SIC,20-29,1,0,0,1,0,0,0,1,0,1,Sicilia,ITG1
2021-01-10,PF/BT,190536.0,HSP11 - CASA DI CURA TRIOLO ZANCLA S.P.A.,SIC,30-39,1,0,0,1,0,0,0,1,0,1,Sicilia,ITG1
2021-01-10,PF/BT,190536.0,HSP11 - CASA DI CURA TRIOLO ZANCLA S.P.A.,SIC,40-49,2,1,0,3,0,0,0,3,0,3,Sicilia,ITG1
2021-01-10,PF/BT,190536.0,HSP11 - CASA DI CURA TRIOLO ZANCLA S.P.A.,SIC,50-59,3,4,0,7,0,0,0,7,0,7,Sicilia,ITG1
2021-01-10,PF/BT,190536.0,HSP11 - CASA DI CURA TRIOLO ZANCLA S.P.A.,SIC,60-69,7,3,0,9,1,0,0,10,0,10,Sicilia,ITG1
2021-01-10,PF/BT,190536.0,HSP11 - CASA DI CURA TRIOLO ZANCLA S.P.A.,SIC,70-79,1,1,0,0,2,0,0,2,0,2,Sicilia,ITG1
2021-01-10,PF/BT,190537.0,HSP11 - CASA DI CURA SERENA S.P.A.,SIC,20-29,1,0,0,1,0,0,0,1,0,1,Sicilia,ITG1
2021-01-10,PF/BT,190537.0,HSP11 - CASA DI CURA SERENA S.P.A.,SIC,30-39,1,1,0,2,0,0,0,2,0,2,Sicilia,ITG1
2021-01-10,PF/BT,190537.0,HSP11 - CASA DI CURA SERENA S.P.A.,SIC,40-49,0,4,0,4,0,0,0,4,0,4,Sicilia,ITG1
2021-01-10,PF/BT,190537.0,HSP11 - CASA DI CURA SERENA S.P.A.,SIC,50-59,4,3,0,7,0,0,0,7,0,7,Sicilia,ITG1
2021-01-10,PF/BT,190537.0,HSP11 - CASA DI CURA SERENA S.P.A.,SIC,60-69,3,3,0,6,0,0,0,6,0,6,Sicilia,ITG1
2021-01-10,PF/BT,190537.0,HSP11 - CASA DI CURA SERENA S.P.A.,SIC,70-79,4,0,0,4,0,0,0,4,0,4,Sicilia,ITG1
2021-01-10,PF/BT,190541.0,HSP11 - CASA DI CURA MACCHIARELLA S.P.A.,SIC,20-29,1,0,0,1,0,0,0,1,0,1,Sicilia,ITG1
2021-01-10,PF/BT,190541.0,HSP11 - CASA DI CURA MACCHIARELLA S.P.A.,SIC,30-39,8,6,0,11,3,0,0,14,0,14,Sicilia,ITG1
2021-01-10,PF/BT,190541.0,HSP11 - CASA DI CURA MACCHIARELLA S.P.A.,SIC,40-49,8,7,0,11,4,0,0,15,0,15,Sicilia,ITG1
2021-01-10,PF/BT,190541.0,HSP11 - CASA DI CURA MACCHIARELLA S.P.A.,SIC,50-59,7,5,0,11,1,0,0,12,0,12,Sicilia,ITG1
2021-01-10,PF/BT,190541.0,HSP11 - CASA DI CURA MACCHIARELLA S.P.A.,SIC,60-69,5,1,0,5,1,0,0,6,0,6,Sicilia,ITG1
2021-01-10,PF/BT,190541.0,HSP11 - CASA DI CURA MACCHIARELLA S.P.A.,SIC,70-79,1,0,0,1,0,0,0,1,0,1,Sicilia,ITG1
2021-01-10,PF/BT,190541.0,HSP11 - CASA DI CURA MACCHIARELLA S.P.A.,SIC,80-89,1,0,0,1,0,0,0,1,0,1,Sicilia,ITG1
2021-01-10,PF/BT,190551.0,HSP11 - CASA DI CURA LA MADDALENA S.P.A.,SIC,20-29,10,7,0,17,0,0,0,17,0,17,Sicilia,ITG1
2021-01-10,PF/BT,190551.0,HSP11 - CASA DI CURA LA MADDALENA S.P.A.,SIC,30-39,22,12,0,34,0,0,0,34,0,34,Sicilia,ITG1
2021-01-10,PF/BT,190551.0,HSP11 - CASA DI CURA LA MADDALENA S.P.A.,SIC,40-49,19,21,0,40,0,0,0,40,0,40,Sicilia,ITG1
2021-01-10,PF/BT,190551.0,HSP11 - CASA DI CURA LA MADDALENA S.P.A.,SIC,50-59,29,8,0,37,0,0,0,37,0,37,Sicilia,ITG1
2021-01-10,PF/BT,190551.0,HSP11 - CASA DI CURA LA MADDALENA S.P.A.,SIC,60-69,4,5,0,9,0,0,0,9,0,9,Sicilia,ITG1
2021-01-10,PF/BT,190551.0,HSP11 - CASA DI CURA LA MADDALENA S.P.A.,SIC,70-79,1,0,0,1,0,0,0,1,0,1,Sicilia,ITG1
2021-01-10,PF/BT,190602.0,HSP11 - CENTRO ANDROS S.R.L.,SIC,20-29,0,4,0,3,1,0,0,4,0,4,Sicilia,ITG1
2021-01-10,PF/BT,190602.0,HSP11 - CENTRO ANDROS S.R.L.,SIC,30-39,5,4,0,4,5,0,0,9,0,9,Sicilia,ITG1
2021-01-10,PF/BT,190602.0,HSP11 - CENTRO ANDROS S.R.L.,SIC,40-49,10,13,0,14,9,0,0,23,0,23,Sicilia,ITG1
2021-01-10,PF/BT,190602.0,HSP11 - CENTRO ANDROS S.R.L.,SIC,50-59,3,9,0,5,7,0,0,12,0,12,Sicilia,ITG1
2021-01-10,PF/BT,190602.0,HSP11 - CENTRO ANDROS S.R.L.,SIC,60-69,9,2,0,10,1,0,0,11,0,11,Sicilia,ITG1
2021-01-10,PF/BT,190602.0,HSP11 - CENTRO ANDROS S.R.L.,SIC,70-79,1,0,0,1,0,0,0,1,0,1,Sicilia,ITG1
2021-01-10,PF/BT,190720.0,HSP11 - CASA DI CURA MARIA ELEONORA HOSPITAL srl,SIC,20-29,8,9,0,17,0,0,0,17,0,17,Sicilia,ITG1
2021-01-10,PF/BT,190720.0,HSP11 - CASA DI CURA MARIA ELEONORA HOSPITAL srl,SIC,30-39,13,6,0,16,3,0,0,19,0,19,Sicilia,ITG1
2021-01-10,PF/BT,190720.0,HSP11 - CASA DI CURA MARIA ELEONORA HOSPITAL srl,SIC,40-49,11,15,0,21,5,0,0,26,0,26,Sicilia,ITG1
2021-01-10,PF/BT,190720.0,HSP11 - CASA DI CURA MARIA ELEONORA HOSPITAL srl,SIC,50-59,18,18,0,31,5,0,0,36,0,36,Sicilia,ITG1
2021-01-10,PF/BT,190720.0,HSP11 - CASA DI CURA MARIA ELEONORA HOSPITAL srl,SIC,60-69,5,3,0,5,3,0,0,8,0,8,Sicilia,ITG1
2021-01-10,PF/BT,190720.0,HSP11 - CASA DI CURA MARIA ELEONORA HOSPITAL srl,SIC,70-79,1,0,0,1,0,0,0,1,0,1,Sicilia,ITG1
2021-01-10,PF/BT,190720.0,HSP11 - CASA DI CURA MARIA ELEONORA HOSPITAL srl,SIC,80-89,1,0,0,1,0,0,0,1,0,1,Sicilia,ITG1
2021-01-10,PF/BT,190921.0,HSP11 - A.O. per lEmergenza Cannizzaro,SIC,20-29,1,0,0,1,0,0,0,1,0,1,Sicilia,ITG1
2021-01-10,PF/BT,190921.0,HSP11 - A.O. per lEmergenza Cannizzaro,SIC,30-39,2,3,0,5,0,0,0,5,0,5,Sicilia,ITG1
2021-01-10,PF/BT,190921.0,HSP11 - A.O. per lEmergenza Cannizzaro,SIC,40-49,4,2,0,6,0,0,0,6,0,6,Sicilia,ITG1
2021-01-10,PF/BT,190921.0,HSP11 - A.O. per lEmergenza Cannizzaro,SIC,50-59,2,2,0,1,3,0,0,4,0,4,Sicilia,ITG1
2021-01-10,PF/BT,190921.0,HSP11 - A.O. per lEmergenza Cannizzaro,SIC,70-79,1,0,0,0,1,0,0,1,0,1,Sicilia,ITG1
2021-01-10,PF/BT,190921.0,HSP11 - A.O. per lEmergenza Cannizzaro,SIC,80-89,1,0,0,0,1,0,0,1,0,1,Sicilia,ITG1
2021-01-10,PF/BT,19092204.0,HSP11 - NUOVO OSPEDALE GARIBALDI - NESIMA,SIC,20-29,0,2,0,2,0,0,0,2,0,2,Sicilia,ITG1
2021-01-10,PF/BT,19092204.0,HSP11 - NUOVO OSPEDALE GARIBALDI - NESIMA,SIC,30-39,2,0,0,1,1,0,0,2,0,2,Sicilia,ITG1
2021-01-10,PF/BT,19092204.0,HSP11 - NUOVO OSPEDALE GARIBALDI - NESIMA,SIC,40-49,0,3,0,3,0,0,0,3,0,3,Sicilia,ITG1
2021-01-10,PF/BT,19092204.0,HSP11 - NUOVO OSPEDALE GARIBALDI - NESIMA,SIC,50-59,0,4,0,4,0,0,0,4,0,4,Sicilia,ITG1
2021-01-10,PF/BT,19092204.0,HSP11 - NUOVO OSPEDALE GARIBALDI - NESIMA,SIC,60-69,0,2,0,1,1,0,0,2,0,2,Sicilia,ITG1
2021-01-10,PF/BT,19092501.0,HSP11 - COVID HOSPITAL,SIC,20-29,9,5,0,14,0,0,0,14,0,14,Sicilia,ITG1
2021-01-10,PF/BT,19092501.0,HSP11 - COVID HOSPITAL,SIC,30-39,6,12,0,18,0,0,0,18,0,18,Sicilia,ITG1
2021-01-10,PF/BT,19092501.0,HSP11 - COVID HOSPITAL,SIC,40-49,6,7,0,13,0,0,0,13,0,13,Sicilia,ITG1
2021-01-10,PF/BT,19092501.0,HSP11 - COVID HOSPITAL,SIC,50-59,6,21,0,27,0,0,0,27,0,27,Sicilia,ITG1
2021-01-10,PF/BT,19092501.0,HSP11 - COVID HOSPITAL,SIC,60-69,11,7,0,18,0,0,0,18,0,18,Sicilia,ITG1
2021-01-10,PF/BT,19092701.0,HSP11 - Ospedale Civico,SIC,20-29,2,2,0,0,4,0,0,4,0,4,Sicilia,ITG1
2021-01-10,PF/BT,19092701.0,HSP11 - Ospedale Civico,SIC,30-39,3,4,0,0,7,0,0,7,0,7,Sicilia,ITG1
2021-01-10,PF/BT,19092701.0,HSP11 - Ospedale Civico,SIC,40-49,6,20,0,1,25,0,0,26,0,26,Sicilia,ITG1
2021-01-10,PF/BT,19092701.0,HSP11 - Ospedale Civico,SIC,50-59,4,33,0,3,34,0,0,37,0,37,Sicilia,ITG1
2021-01-10,PF/BT,19092701.0,HSP11 - Ospedale Civico,SIC,60-69,3,18,0,4,17,0,0,21,0,21,Sicilia,ITG1
2021-01-10,PF/BT,19092701.0,HSP11 - Ospedale Civico,SIC,80-89,0,1,0,0,1,0,0,1,0,1,Sicilia,ITG1
2021-01-10,PF/BT,19092702.0,HSP11 - Ospedale dei Bambini G. Di Cristina,SIC,20-29,2,0,0,2,0,0,0,2,0,2,Sicilia,ITG1
2021-01-10,PF/BT,19092702.0,HSP11 - Ospedale dei Bambini G. Di Cristina,SIC,30-39,5,2,0,6,1,0,0,7,0,7,Sicilia,ITG1
2021-01-10,PF/BT,19092702.0,HSP11 - Ospedale dei Bambini G. Di Cristina,SIC,40-49,6,6,0,11,1,0,0,12,0,12,Sicilia,ITG1
2021-01-10,PF/BT,19092702.0,HSP11 - Ospedale dei Bambini G. Di Cristina,SIC,50-59,12,7,0,18,1,0,0,19,0,19,Sicilia,ITG1
2021-01-10,PF/BT,19092702.0,HSP11 - Ospedale dei Bambini G. Di Cristina,SIC,60-69,4,7,0,11,0,0,0,11,0,11,Sicilia,ITG1
2021-01-10,PF/BT,190928.0,HSP11 - AZ.OSP.UNIV.P.GIACCONE,SIC,20-29,8,13,0,21,0,0,0,21,0,21,Sicilia,ITG1
2021-01-10,PF/BT,190928.0,HSP11 - AZ.OSP.UNIV.P.GIACCONE,SIC,30-39,14,5,0,11,6,0,2,19,0,19,Sicilia,ITG1
2021-01-10,PF/BT,190928.0,HSP11 - AZ.OSP.UNIV.P.GIACCONE,SIC,40-49,17,16,0,27,3,0,3,33,0,33,Sicilia,ITG1
2021-01-10,PF/BT,190928.0,HSP11 - AZ.OSP.UNIV.P.GIACCONE,SIC,50-59,14,14,0,21,4,0,3,28,0,28,Sicilia,ITG1
2021-01-10,PF/BT,190928.0,HSP11 - AZ.OSP.UNIV.P.GIACCONE,SIC,60-69,7,5,0,8,1,0,3,12,0,12,Sicilia,ITG1
2021-01-10,PF/BT,190928.0,HSP11 - AZ.OSP.UNIV.P.GIACCONE,SIC,70-79,4,1,0,3,2,0,0,5,0,5,Sicilia,ITG1
2021-01-10,PF/BT,190928.0,HSP11 - AZ.OSP.UNIV.P.GIACCONE,SIC,80-89,1,0,0,1,0,0,0,1,0,1,Sicilia,ITG1
2021-01-10,PF/BT,608200.0,STS11 - POLIAMBULATORIO San Giorgio,SIC,16-19,0,2,0,2,0,0,0,2,0,2,Sicilia,ITG1
2021-01-10,PF/BT,608200.0,STS11 - POLIAMBULATORIO San Giorgio,SIC,20-29,6,4,0,10,0,0,0,10,0,10,Sicilia,ITG1
2021-01-10,PF/BT,608200.0,STS11 - POLIAMBULATORIO San Giorgio,SIC,30-39,7,5,0,12,0,0,0,12,0,12,Sicilia,ITG1
2021-01-10,PF/BT,608200.0,STS11 - POLIAMBULATORIO San Giorgio,SIC,40-49,6,6,0,12,0,0,0,12,0,12,Sicilia,ITG1
2021-01-10,PF/BT,608200.0,STS11 - POLIAMBULATORIO San Giorgio,SIC,50-59,4,7,0,11,0,0,0,11,0,11,Sicilia,ITG1
2021-01-10,PF/BT,608200.0,STS11 - POLIAMBULATORIO San Giorgio,SIC,60-69,6,7,0,13,0,0,0,13,0,13,Sicilia,ITG1
2021-01-10,PF/BT,608400.0,STS11 - POLIAMBULATORIO  San Luigi,SIC,16-19,0,1,0,1,0,0,0,1,0,1,Sicilia,ITG1
2021-01-10,PF/BT,608400.0,STS11 - POLIAMBULATORIO  San Luigi,SIC,20-29,9,8,0,17,0,0,0,17,0,17,Sicilia,ITG1
2021-01-10,PF/BT,608400.0,STS11 - POLIAMBULATORIO  San Luigi,SIC,30-39,4,13,0,17,0,0,0,17,0,17,Sicilia,ITG1
2021-01-10,PF/BT,608400.0,STS11 - POLIAMBULATORIO  San Luigi,SIC,40-49,11,24,0,35,0,0,0,35,0,35,Sicilia,ITG1
2021-01-10,PF/BT,608400.0,STS11 - POLIAMBULATORIO  San Luigi,SIC,50-59,9,17,0,26,0,0,0,26,0,26,Sicilia,ITG1
2021-01-10,PF/BT,608400.0,STS11 - POLIAMBULATORIO  San Luigi,SIC,60-69,10,15,0,25,0,0,0,25,0,25,Sicilia,ITG1
2021-01-10,PF/BT,608400.0,STS11 - POLIAMBULATORIO  San Luigi,SIC,70-79,9,2,0,11,0,0,0,11,0,11,Sicilia,ITG1
2021-01-10,PF/BT,830600.0,STS11 - CTA SANTO PIETRO,SIC,30-39,3,0,0,0,0,0,3,3,0,3,Sicilia,ITG1
2021-01-10,PF/BT,830600.0,STS11 - CTA SANTO PIETRO,SIC,40-49,3,1,0,2,0,0,2,4,0,4,Sicilia,ITG1
2021-01-10,PF/BT,830600.0,STS11 - CTA SANTO PIETRO,SIC,50-59,3,2,0,1,2,0,2,5,0,5,Sicilia,ITG1
2021-01-10,PF/BT,830600.0,STS11 - CTA SANTO PIETRO,SIC,60-69,2,2,0,3,1,0,0,4,0,4,Sicilia,ITG1
2021-01-11,PF/BT,1902017.0,STRUTTURE PRIVATE NON CODIFICATE NSIS,SIC,20-29,0,1,0,0,0,0,1,1,0,1,Sicilia,ITG1
2021-01-11,PF/BT,1902017.0,STRUTTURE PRIVATE NON CODIFICATE NSIS,SIC,30-39,0,2,0,1,0,0,1,2,0,2,Sicilia,ITG1
2021-01-11,PF/BT,1902017.0,STRUTTURE PRIVATE NON CODIFICATE NSIS,SIC,40-49,2,9,0,9,0,1,1,11,0,11,Sicilia,ITG1
2021-01-11,PF/BT,1902017.0,STRUTTURE PRIVATE NON CODIFICATE NSIS,SIC,50-59,2,1,0,2,0,1,0,3,0,3,Sicilia,ITG1
2021-01-11,PF/BT,1902017.0,STRUTTURE PRIVATE NON CODIFICATE NSIS,SIC,60-69,6,4,0,1,0,7,2,10,0,10,Sicilia,ITG1
2021-01-11,PF/BT,1902017.0,STRUTTURE PRIVATE NON CODIFICATE NSIS,SIC,70-79,0,3,0,0,0,3,0,3,0,3,Sicilia,ITG1
2021-01-11,PF/BT,1902017.0,STRUTTURE PRIVATE NON CODIFICATE NSIS,SIC,80-89,4,7,0,1,0,10,0,11,0,11,Sicilia,ITG1
2021-01-11,PF/BT,1902017.0,STRUTTURE PRIVATE NON CODIFICATE NSIS,SIC,90+,2,5,0,0,0,7,0,7,0,7,Sicilia,ITG1
2021-01-11,PF/BT,1902027.0,STRUTTURE PRIVATE NON CODIFICATE NSIS,SIC,20-29,5,4,0,9,0,0,0,9,0,9,Sicilia,ITG1
2021-01-11,PF/BT,1902027.0,STRUTTURE PRIVATE NON CODIFICATE NSIS,SIC,30-39,7,8,0,14,0,0,1,15,0,15,Sicilia,ITG1
2021-01-11,PF/BT,1902027.0,STRUTTURE PRIVATE NON CODIFICATE NSIS,SIC,40-49,4,13,0,16,0,1,0,17,0,17,Sicilia,ITG1
2021-01-11,PF/BT,1902027.0,STRUTTURE PRIVATE NON CODIFICATE NSIS,SIC,50-59,2,6,0,6,0,2,0,8,0,8,Sicilia,ITG1
2021-01-11,PF/BT,1902027.0,STRUTTURE PRIVATE NON CODIFICATE NSIS,SIC,60-69,8,6,0,2,0,12,0,14,0,14,Sicilia,ITG1
2021-01-11,PF/BT,1902027.0,STRUTTURE PRIVATE NON CODIFICATE NSIS,SIC,70-79,2,12,0,0,0,14,0,14,0,14,Sicilia,ITG1
2021-01-11,PF/BT,1902027.0,STRUTTURE PRIVATE NON CODIFICATE NSIS,SIC,80-89,19,37,0,0,0,56,0,56,0,56,Sicilia,ITG1
2021-01-11,PF/BT,1902027.0,STRUTTURE PRIVATE NON CODIFICATE NSIS,SIC,90+,7,9,0,0,0,16,0,16,0,16,Sicilia,ITG1
2021-01-11,PF/BT,1902047.0,STRUTTURE PRIVATE NON CODIFICATE NSIS,SIC,20-29,0,1,0,1,0,0,0,1,0,1,Sicilia,ITG1
2021-01-11,PF/BT,1902047.0,STRUTTURE PRIVATE NON CODIFICATE NSIS,SIC,30-39,2,1,0,3,0,0,0,3,0,3,Sicilia,ITG1
2021-01-11,PF/BT,1902047.0,STRUTTURE PRIVATE NON CODIFICATE NSIS,SIC,40-49,0,4,0,4,0,0,0,4,0,4,Sicilia,ITG1
2021-01-11,PF/BT,1902047.0,STRUTTURE PRIVATE NON CODIFICATE NSIS,SIC,50-59,0,2,0,2,0,0,0,2,0,2,Sicilia,ITG1
2021-01-11,PF/BT,1902047.0,STRUTTURE PRIVATE NON CODIFICATE NSIS,SIC,60-69,1,2,0,3,0,0,0,3,0,3,Sicilia,ITG1
2021-01-11,PF/BT,1902047.0,STRUTTURE PRIVATE NON CODIFICATE NSIS,SIC,70-79,0,2,0,1,0,1,0,2,0,2,Sicilia,ITG1
2021-01-11,PF/BT,1902047.0,STRUTTURE PRIVATE NON CODIFICATE NSIS,SIC,80-89,2,9,0,7,0,4,0,11,0,11,Sicilia,ITG1
2021-01-11,PF/BT,1902047.0,STRUTTURE PRIVATE NON CODIFICATE NSIS,SIC,90+,0,4,0,1,0,3,0,4,0,4,Sicilia,ITG1
2021-01-11,PF/BT,1902072.0,AMBULATORI VACCINALI NON CODIFICATI NSIS,SIC,16-19,0,1,0,0,0,0,1,1,0,1,Sicilia,ITG1
2021-01-11,PF/BT,1902072.0,AMBULATORI VACCINALI NON CODIFICATI NSIS,SIC,20-29,8,26,0,20,5,0,9,34,0,34,Sicilia,ITG1
2021-01-11,PF/BT,1902072.0,AMBULATORI VACCINALI NON CODIFICATI NSIS,SIC,30-39,17,31,0,22,9,0,17,48,0,48,Sicilia,ITG1
2021-01-11,PF/BT,1902072.0,AMBULATORI VACCINALI NON CODIFICATI NSIS,SIC,40-49,31,51,0,43,22,0,17,82,0,82,Sicilia,ITG1
2021-01-11,PF/BT,1902072.0,AMBULATORI VACCINALI NON CODIFICATI NSIS,SIC,50-59,31,56,0,48,26,0,13,87,0,87,Sicilia,ITG1
2021-01-11,PF/BT,1902072.0,AMBULATORI VACCINALI NON CODIFICATI NSIS,SIC,60-69,38,45,0,61,16,1,5,83,0,83,Sicilia,ITG1
2021-01-11,PF/BT,1902072.0,AMBULATORI VACCINALI NON CODIFICATI NSIS,SIC,70-79,13,4,0,9,3,1,4,17,0,17,Sicilia,ITG1
2021-01-11,PF/BT,1902072.0,AMBULATORI VACCINALI NON CODIFICATI NSIS,SIC,80-89,4,3,0,3,0,3,1,7,0,7,Sicilia,ITG1
2021-01-11,PF/BT,1902077.0,STRUTTURE PRIVATE NON CODIFICATE NSIS,SIC,16-19,0,1,0,1,0,0,0,1,0,1,Sicilia,ITG1
2021-01-11,PF/BT,1902077.0,STRUTTURE PRIVATE NON CODIFICATE NSIS,SIC,20-29,3,7,0,8,0,0,2,10,0,10,Sicilia,ITG1
2021-01-11,PF/BT,1902077.0,STRUTTURE PRIVATE NON CODIFICATE NSIS,SIC,30-39,6,11,0,17,0,0,0,17,0,17,Sicilia,ITG1
2021-01-11,PF/BT,1902077.0,STRUTTURE PRIVATE NON CODIFICATE NSIS,SIC,40-49,3,23,0,25,1,0,0,26,0,26,Sicilia,ITG1
2021-01-11,PF/BT,1902077.0,STRUTTURE PRIVATE NON CODIFICATE NSIS,SIC,50-59,2,26,0,28,0,0,0,28,0,28,Sicilia,ITG1
2021-01-11,PF/BT,1902077.0,STRUTTURE PRIVATE NON CODIFICATE NSIS,SIC,60-69,3,7,0,5,1,4,0,10,0,10,Sicilia,ITG1
2021-01-11,PF/BT,1902077.0,STRUTTURE PRIVATE NON CODIFICATE NSIS,SIC,70-79,7,6,0,0,1,11,1,13,0,13,Sicilia,ITG1
2021-01-11,PF/BT,1902077.0,STRUTTURE PRIVATE NON CODIFICATE NSIS,SIC,80-89,14,19,0,0,0,33,0,33,0,33,Sicilia,ITG1
2021-01-11,PF/BT,1902077.0,STRUTTURE PRIVATE NON CODIFICATE NSIS,SIC,90+,6,9,0,0,0,15,0,15,0,15,Sicilia,ITG1
2021-01-11,PF/BT,190301.0,RIA11 - A.I.A.S.SEZ.DI AGRIGENTO ONLUS,SIC,16-19,1,0,0,0,0,0,1,1,0,1,Sicilia,ITG1
2021-01-11,PF/BT,190301.0,RIA11 - A.I.A.S.SEZ.DI AGRIGENTO ONLUS,SIC,20-29,15,10,0,14,5,0,6,25,0,25,Sicilia,ITG1
2021-01-11,PF/BT,190301.0,RIA11 - A.I.A.S.SEZ.DI AGRIGENTO ONLUS,SIC,30-39,15,21,0,31,0,0,5,36,0,36,Sicilia,ITG1
2021-01-11,PF/BT,190301.0,RIA11 - A.I.A.S.SEZ.DI AGRIGENTO ONLUS,SIC,40-49,27,27,0,39,2,0,13,54,0,54,Sicilia,ITG1
2021-01-11,PF/BT,190301.0,RIA11 - A.I.A.S.SEZ.DI AGRIGENTO ONLUS,SIC,50-59,32,41,0,34,4,0,35,73,0,73,Sicilia,ITG1
2021-01-11,PF/BT,190301.0,RIA11 - A.I.A.S.SEZ.DI AGRIGENTO ONLUS,SIC,60-69,15,24,0,23,1,0,15,39,0,39,Sicilia,ITG1
2021-01-11,PF/BT,190301.0,RIA11 - A.I.A.S.SEZ.DI AGRIGENTO ONLUS,SIC,70-79,3,1,0,3,1,0,0,4,0,4,Sicilia,ITG1
2021-01-11,PF/BT,190301.0,RIA11 - A.I.A.S.SEZ.DI AGRIGENTO ONLUS,SIC,80-89,1,0,0,1,0,0,0,1,0,1,Sicilia,ITG1
2021-01-11,PF/BT,190302.0,RIA11 - C.DELLA SPERANZA DON ANGELO G.,SIC,20-29,1,0,0,0,0,0,1,1,0,1,Sicilia,ITG1
2021-01-11,PF/BT,190302.0,RIA11 - C.DELLA SPERANZA DON ANGELO G.,SIC,30-39,4,3,0,1,0,0,6,7,0,7,Sicilia,ITG1
2021-01-11,PF/BT,190302.0,RIA11 - C.DELLA SPERANZA DON ANGELO G.,SIC,40-49,5,6,0,0,0,0,11,11,0,11,Sicilia,ITG1
2021-01-11,PF/BT,190302.0,RIA11 - C.DELLA SPERANZA DON ANGELO G.,SIC,50-59,8,6,0,4,0,0,10,14,0,14,Sicilia,ITG1
2021-01-11,PF/BT,190302.0,RIA11 - C.DELLA SPERANZA DON ANGELO G.,SIC,60-69,7,4,0,4,0,0,7,11,0,11,Sicilia,ITG1
2021-01-11,PF/BT,190302.0,RIA11 - C.DELLA SPERANZA DON ANGELO G.,SIC,70-79,1,2,0,0,0,0,3,3,0,3,Sicilia,ITG1
2021-01-11,PF/BT,190302.0,RIA11 - C.DELLA SPERANZA DON ANGELO G.,SIC,80-89,1,0,0,0,0,0,1,1,0,1,Sicilia,ITG1
2021-01-11,PF/BT,190303.0,RIA11 - COMUNITA` DELLA SPERANZA,SIC,20-29,1,2,0,3,0,0,0,3,0,3,Sicilia,ITG1
2021-01-11,PF/BT,190303.0,RIA11 - COMUNITA` DELLA SPERANZA,SIC,30-39,5,2,0,3,3,0,1,7,0,7,Sicilia,ITG1
2021-01-11,PF/BT,190303.0,RIA11 - COMUNITA` DELLA SPERANZA,SIC,40-49,1,6,0,3,4,0,0,7,0,7,Sicilia,ITG1
2021-01-11,PF/BT,190303.0,RIA11 - COMUNITA` DELLA SPERANZA,SIC,50-59,3,6,0,7,1,0,1,9,0,9,Sicilia,ITG1
2021-01-11,PF/BT,190303.0,RIA11 - COMUNITA` DELLA SPERANZA,SIC,60-69,2,3,0,5,0,0,0,5,0,5,Sicilia,ITG1
2021-01-11,PF/BT,190303.0,RIA11 - COMUNITA` DELLA SPERANZA,SIC,80-89,25,17,0,0,0,0,42,42,0,42,Sicilia,ITG1
2021-01-11,PF/BT,190303.0,RIA11 - COMUNITA` DELLA SPERANZA,SIC,90+,2,2,0,0,0,0,4,4,0,4,Sicilia,ITG1
2021-01-11,PF/BT,190306.0,RIA11 - ASS. CASA FAM.ROSETTA ONILUS,SIC,16-19,0,1,0,0,1,0,0,1,0,1,Sicilia,ITG1
2021-01-11,PF/BT,190306.0,RIA11 - ASS. CASA FAM.ROSETTA ONILUS,SIC,20-29,10,9,0,16,3,0,0,19,0,19,Sicilia,ITG1
2021-01-11,PF/BT,190306.0,RIA11 - ASS. CASA FAM.ROSETTA ONILUS,SIC,30-39,13,13,0,19,7,0,0,26,0,26,Sicilia,ITG1
2021-01-11,PF/BT,190306.0,RIA11 - ASS. CASA FAM.ROSETTA ONILUS,SIC,40-49,20,23,0,28,15,0,0,43,0,43,Sicilia,ITG1
2021-01-11,PF/BT,190306.0,RIA11 - ASS. CASA FAM.ROSETTA ONILUS,SIC,50-59,28,36,0,40,24,0,0,64,0,64,Sicilia,ITG1
2021-01-11,PF/BT,190306.0,RIA11 - ASS. CASA FAM.ROSETTA ONILUS,SIC,60-69,11,11,0,13,9,0,0,22,0,22,Sicilia,ITG1
2021-01-11,PF/BT,190306.0,RIA11 - ASS. CASA FAM.ROSETTA ONILUS,SIC,70-79,2,1,0,2,1,0,0,3,0,3,Sicilia,ITG1
2021-01-11,PF/BT,190309.0,HSP11 - P.O. VITTORIO EMANUELE (ex AO),SIC,20-29,8,4,0,10,0,0,2,12,0,12,Sicilia,ITG1
2021-01-11,PF/BT,190309.0,HSP11 - P.O. VITTORIO EMANUELE (ex AO),SIC,30-39,6,2,0,7,0,0,1,8,0,8,Sicilia,ITG1
2021-01-11,PF/BT,190309.0,HSP11 - P.O. VITTORIO EMANUELE (ex AO),SIC,40-49,10,6,0,14,0,0,2,16,0,16,Sicilia,ITG1
2021-01-11,PF/BT,190309.0,HSP11 - P.O. VITTORIO EMANUELE (ex AO),SIC,50-59,15,14,0,23,0,0,6,29,0,29,Sicilia,ITG1
2021-01-11,PF/BT,190309.0,HSP11 - P.O. VITTORIO EMANUELE (ex AO),SIC,60-69,15,8,0,18,0,0,5,23,0,23,Sicilia,ITG1
2021-01-11,PF/BT,190309.0,HSP11 - P.O. VITTORIO EMANUELE (ex AO),SIC,70-79,1,1,0,2,0,0,0,2,0,2,Sicilia,ITG1
2021-01-11,PF/BT,190312.0,HSP11 - P.O. S. Marta e S. Venera Acireale,SIC,16-19,1,0,0,0,1,0,0,1,0,1,Sicilia,ITG1
2021-01-11,PF/BT,190312.0,HSP11 - P.O. S. Marta e S. Venera Acireale,SIC,20-29,1,2,0,2,1,0,0,3,0,3,Sicilia,ITG1
2021-01-11,PF/BT,190312.0,HSP11 - P.O. S. Marta e S. Venera Acireale,SIC,30-39,4,3,0,4,3,0,0,7,0,7,Sicilia,ITG1
2021-01-11,PF/BT,190312.0,HSP11 - P.O. S. Marta e S. Venera Acireale,SIC,40-49,1,10,0,5,6,0,0,11,0,11,Sicilia,ITG1
2021-01-11,PF/BT,190312.0,HSP11 - P.O. S. Marta e S. Venera Acireale,SIC,50-59,10,12,0,15,7,0,0,22,0,22,Sicilia,ITG1
2021-01-11,PF/BT,190312.0,HSP11 - P.O. S. Marta e S. Venera Acireale,SIC,60-69,9,6,0,11,4,0,0,15,0,15,Sicilia,ITG1
2021-01-11,PF/BT,190312.0,HSP11 - P.O. S. Marta e S. Venera Acireale,SIC,70-79,1,0,0,1,0,0,0,1,0,1,Sicilia,ITG1
2021-01-11,PF/BT,190313.0,RIA11 - IST.RIAB.VILLAG. SAN GIUSEPPE,SIC,20-29,4,3,0,5,0,0,2,7,0,7,Sicilia,ITG1
2021-01-11,PF/BT,190313.0,RIA11 - IST.RIAB.VILLAG. SAN GIUSEPPE,SIC,30-39,7,14,0,13,3,0,5,21,0,21,Sicilia,ITG1
2021-01-11,PF/BT,190313.0,RIA11 - IST.RIAB.VILLAG. SAN GIUSEPPE,SIC,40-49,6,11,0,13,1,0,3,17,0,17,Sicilia,ITG1
2021-01-11,PF/BT,190313.0,RIA11 - IST.RIAB.VILLAG. SAN GIUSEPPE,SIC,50-59,11,19,0,19,1,0,10,30,0,30,Sicilia,ITG1
2021-01-11,PF/BT,190313.0,RIA11 - IST.RIAB.VILLAG. SAN GIUSEPPE,SIC,60-69,4,9,0,9,0,0,4,13,0,13,Sicilia,ITG1
2021-01-11,PF/BT,190313.0,RIA11 - IST.RIAB.VILLAG. SAN GIUSEPPE,SIC,70-79,1,1,0,0,0,0,2,2,0,2,Sicilia,ITG1
2021-01-11,PF/BT,190314.0,RIA11 - ASS.J.F.KENNEDY ACIREALE,SIC,20-29,3,2,0,5,0,0,0,5,0,5,Sicilia,ITG1
2021-01-11,PF/BT,190314.0,RIA11 - ASS.J.F.KENNEDY ACIREALE,SIC,30-39,4,3,0,7,0,0,0,7,0,7,Sicilia,ITG1
2021-01-11,PF/BT,190314.0,RIA11 - ASS.J.F.KENNEDY ACIREALE,SIC,40-49,8,5,0,10,0,3,0,13,0,13,Sicilia,ITG1
2021-01-11,PF/BT,190314.0,RIA11 - ASS.J.F.KENNEDY ACIREALE,SIC,50-59,8,9,0,13,0,4,0,17,0,17,Sicilia,ITG1
2021-01-11,PF/BT,190314.0,RIA11 - ASS.J.F.KENNEDY ACIREALE,SIC,60-69,2,1,0,3,0,0,0,3,0,3,Sicilia,ITG1
2021-01-11,PF/BT,190314.0,RIA11 - ASS.J.F.KENNEDY ACIREALE,SIC,70-79,2,1,0,3,0,0,0,3,0,3,Sicilia,ITG1
2021-01-11,PF/BT,190316.0,RIA11 - ASS.J.F.KENNEDY - C.RIAB.ONLUS,SIC,16-19,0,2,0,2,0,0,0,2,0,2,Sicilia,ITG1
2021-01-11,PF/BT,190316.0,RIA11 - ASS.J.F.KENNEDY - C.RIAB.ONLUS,SIC,20-29,2,6,0,8,0,0,0,8,0,8,Sicilia,ITG1
2021-01-11,PF/BT,190316.0,RIA11 - ASS.J.F.KENNEDY - C.RIAB.ONLUS,SIC,30-39,6,9,0,14,1,0,0,15,0,15,Sicilia,ITG1
2021-01-11,PF/BT,190316.0,RIA11 - ASS.J.F.KENNEDY - C.RIAB.ONLUS,SIC,40-49,4,15,0,15,4,0,0,19,0,19,Sicilia,ITG1
2021-01-11,PF/BT,190316.0,RIA11 - ASS.J.F.KENNEDY - C.RIAB.ONLUS,SIC,50-59,8,19,0,21,6,0,0,27,0,27,Sicilia,ITG1
2021-01-11,PF/BT,190316.0,RIA11 - ASS.J.F.KENNEDY - C.RIAB.ONLUS,SIC,60-69,11,12,0,19,4,0,0,23,0,23,Sicilia,ITG1
2021-01-11,PF/BT,190316.0,RIA11 - ASS.J.F.KENNEDY - C.RIAB.ONLUS,SIC,70-79,1,0,0,1,0,0,0,1,0,1,Sicilia,ITG1
2021-01-11,PF/BT,190316.0,RIA11 - ASS.J.F.KENNEDY - C.RIAB.ONLUS,SIC,80-89,0,1,0,1,0,0,0,1,0,1,Sicilia,ITG1
2021-01-11,PF/BT,190317.0,HSP11 - P.O. Gravina e S. Pietro Caltagirone,SIC,20-29,6,0,0,3,3,0,0,6,0,6,Sicilia,ITG1
2021-01-11,PF/BT,190317.0,HSP11 - P.O. Gravina e S. Pietro Caltagirone,SIC,30-39,4,6,0,4,6,0,0,10,0,10,Sicilia,ITG1
2021-01-11,PF/BT,190317.0,HSP11 - P.O. Gravina e S. Pietro Caltagirone,SIC,40-49,11,10,0,8,13,0,0,21,0,21,Sicilia,ITG1
2021-01-11,PF/BT,190317.0,HSP11 - P.O. Gravina e S. Pietro Caltagirone,SIC,50-59,11,12,0,16,7,0,0,23,0,23,Sicilia,ITG1
2021-01-11,PF/BT,190317.0,HSP11 - P.O. Gravina e S. Pietro Caltagirone,SIC,60-69,7,9,0,12,4,0,0,16,0,16,Sicilia,ITG1
2021-01-11,PF/BT,190317.0,HSP11 - P.O. Gravina e S. Pietro Caltagirone,SIC,70-79,2,0,0,2,0,0,0,2,0,2,Sicilia,ITG1
2021-01-11,PF/BT,190318.0,RIA11 - ASS.ISTITUTO REGINA VIRGINUM,SIC,20-29,5,1,0,4,1,0,1,6,0,6,Sicilia,ITG1
2021-01-11,PF/BT,190318.0,RIA11 - ASS.ISTITUTO REGINA VIRGINUM,SIC,30-39,5,7,0,11,0,0,1,12,0,12,Sicilia,ITG1
2021-01-11,PF/BT,190318.0,RIA11 - ASS.ISTITUTO REGINA VIRGINUM,SIC,40-49,2,1,0,3,0,0,0,3,0,3,Sicilia,ITG1
2021-01-11,PF/BT,190318.0,RIA11 - ASS.ISTITUTO REGINA VIRGINUM,SIC,50-59,8,2,0,9,0,0,1,10,0,10,Sicilia,ITG1
2021-01-11,PF/BT,190318.0,RIA11 - ASS.ISTITUTO REGINA VIRGINUM,SIC,60-69,2,3,0,5,0,0,0,5,0,5,Sicilia,ITG1
2021-01-11,PF/BT,190319.0,HSP11 - P. O. UMBERTO I,SIC,20-29,0,1,0,1,0,0,0,1,0,1,Sicilia,ITG1
2021-01-11,PF/BT,190319.0,HSP11 - P. O. UMBERTO I,SIC,30-39,2,3,0,4,1,0,0,5,0,5,Sicilia,ITG1
2021-01-11,PF/BT,190319.0,HSP11 - P. O. UMBERTO I,SIC,40-49,4,0,0,4,0,0,0,4,0,4,Sicilia,ITG1
2021-01-11,PF/BT,190319.0,HSP11 - P. O. UMBERTO I,SIC,50-59,6,7,0,12,1,0,0,13,0,13,Sicilia,ITG1
2021-01-11,PF/BT,190319.0,HSP11 - P. O. UMBERTO I,SIC,60-69,6,6,0,11,1,0,0,12,0,12,Sicilia,ITG1
2021-01-11,PF/BT,190326.0,HSP11 - P.O. S. VINCENZO TAORMINA,SIC,30-39,1,1,0,1,1,0,0,2,0,2,Sicilia,ITG1
2021-01-11,PF/BT,190326.0,HSP11 - P.O. S. VINCENZO TAORMINA,SIC,40-49,3,1,0,2,2,0,0,4,0,4,Sicilia,ITG1
2021-01-11,PF/BT,190326.0,HSP11 - P.O. S. VINCENZO TAORMINA,SIC,50-59,3,1,0,1,3,0,0,4,0,4,Sicilia,ITG1
2021-01-11,PF/BT,190326.0,HSP11 - P.O. S. VINCENZO TAORMINA,SIC,60-69,2,0,0,2,0,0,0,2,0,2,Sicilia,ITG1
2021-01-11,PF/BT,190328.0,HSP11 - P.O. BARONE-ROMEO PATTI,SIC,20-29,2,1,0,1,2,0,0,3,0,3,Sicilia,ITG1
2021-01-11,PF/BT,190328.0,HSP11 - P.O. BARONE-ROMEO PATTI,SIC,30-39,7,7,0,10,3,0,1,14,0,14,Sicilia,ITG1
2021-01-11,PF/BT,190328.0,HSP11 - P.O. BARONE-ROMEO PATTI,SIC,40-49,14,13,0,17,9,0,1,27,0,27,Sicilia,ITG1
2021-01-11,PF/BT,190328.0,HSP11 - P.O. BARONE-ROMEO PATTI,SIC,50-59,15,22,0,29,8,0,0,37,0,37,Sicilia,ITG1
2021-01-11,PF/BT,190328.0,HSP11 - P.O. BARONE-ROMEO PATTI,SIC,60-69,22,16,0,32,4,0,2,38,0,38,Sicilia,ITG1
2021-01-11,PF/BT,190328.0,HSP11 - P.O. BARONE-ROMEO PATTI,SIC,70-79,1,0,0,1,0,0,0,1,0,1,Sicilia,ITG1
2021-01-11,PF/BT,190333.0,HSP11 - P.O. MADONNA DELLALTO - PETR. SOTTANA,SIC,16-19,1,0,0,1,0,0,0,1,0,1,Sicilia,ITG1
2021-01-11,PF/BT,190333.0,HSP11 - P.O. MADONNA DELLALTO - PETR. SOTTANA,SIC,20-29,3,4,0,5,2,0,0,7,0,7,Sicilia,ITG1
2021-01-11,PF/BT,190333.0,HSP11 - P.O. MADONNA DELLALTO - PETR. SOTTANA,SIC,30-39,1,6,0,6,1,0,0,7,0,7,Sicilia,ITG1
2021-01-11,PF/BT,190333.0,HSP11 - P.O. MADONNA DELLALTO - PETR. SOTTANA,SIC,40-49,1,8,0,6,2,0,1,9,0,9,Sicilia,ITG1
2021-01-11,PF/BT,190333.0,HSP11 - P.O. MADONNA DELLALTO - PETR. SOTTANA,SIC,50-59,4,14,0,14,1,2,1,18,0,18,Sicilia,ITG1
2021-01-11,PF/BT,190333.0,HSP11 - P.O. MADONNA DELLALTO - PETR. SOTTANA,SIC,60-69,3,0,0,1,0,2,0,3,0,3,Sicilia,ITG1
2021-01-11,PF/BT,190333.0,HSP11 - P.O. MADONNA DELLALTO - PETR. SOTTANA,SIC,70-79,6,9,0,3,1,11,0,15,0,15,Sicilia,ITG1
2021-01-11,PF/BT,190333.0,HSP11 - P.O. MADONNA DELLALTO - PETR. SOTTANA,SIC,80-89,7,21,0,0,0,28,0,28,0,28,Sicilia,ITG1
2021-01-11,PF/BT,190333.0,HSP11 - P.O. MADONNA DELLALTO - PETR. SOTTANA,SIC,90+,5,15,0,0,0,20,0,20,0,20,Sicilia,ITG1
2021-01-11,PF/BT,190334.0,HSP11 - P.O. S. CIMINO TERMINI IMERESE,SIC,16-19,0,1,0,0,1,0,0,1,0,1,Sicilia,ITG1
2021-01-11,PF/BT,190334.0,HSP11 - P.O. S. CIMINO TERMINI IMERESE,SIC,20-29,0,1,0,1,0,0,0,1,0,1,Sicilia,ITG1
2021-01-11,PF/BT,190334.0,HSP11 - P.O. S. CIMINO TERMINI IMERESE,SIC,30-39,3,3,0,6,0,0,0,6,0,6,Sicilia,ITG1
2021-01-11,PF/BT,190334.0,HSP11 - P.O. S. CIMINO TERMINI IMERESE,SIC,40-49,20,4,0,23,1,0,0,24,0,24,Sicilia,ITG1
2021-01-11,PF/BT,190334.0,HSP11 - P.O. S. CIMINO TERMINI IMERESE,SIC,50-59,9,5,0,12,2,0,0,14,0,14,Sicilia,ITG1
2021-01-11,PF/BT,190334.0,HSP11 - P.O. S. CIMINO TERMINI IMERESE,SIC,60-69,16,3,0,18,1,0,0,19,0,19,Sicilia,ITG1
2021-01-11,PF/BT,190334.0,HSP11 - P.O. S. CIMINO TERMINI IMERESE,SIC,70-79,3,2,0,5,0,0,0,5,0,5,Sicilia,ITG1
2021-01-11,PF/BT,190334.0,HSP11 - P.O. S. CIMINO TERMINI IMERESE,SIC,80-89,2,0,0,2,0,0,0,2,0,2,Sicilia,ITG1
2021-01-11,PF/BT,190335.0,HSP11 - P.O. G. F. INGRASSIA,SIC,20-29,0,1,0,1,0,0,0,1,0,1,Sicilia,ITG1
2021-01-11,PF/BT,190335.0,HSP11 - P.O. G. F. INGRASSIA,SIC,30-39,5,5,0,10,0,0,0,10,0,10,Sicilia,ITG1
2021-01-11,PF/BT,190335.0,HSP11 - P.O. G. F. INGRASSIA,SIC,40-49,1,1,0,2,0,0,0,2,0,2,Sicilia,ITG1
2021-01-11,PF/BT,190335.0,HSP11 - P.O. G. F. INGRASSIA,SIC,50-59,3,3,0,6,0,0,0,6,0,6,Sicilia,ITG1
2021-01-11,PF/BT,190335.0,HSP11 - P.O. G. F. INGRASSIA,SIC,60-69,7,2,0,9,0,0,0,9,0,9,Sicilia,ITG1
2021-01-11,PF/BT,190335.0,HSP11 - P.O. G. F. INGRASSIA,SIC,70-79,2,1,0,3,0,0,0,3,0,3,Sicilia,ITG1
2021-01-11,PF/BT,190335.0,HSP11 - P.O. G. F. INGRASSIA,SIC,80-89,0,1,0,1,0,0,0,1,0,1,Sicilia,ITG1
2021-01-11,PF/BT,190337.0,HSP11 - P.O. VILLA DELLE GINESTRE,SIC,20-29,11,6,0,11,1,0,5,17,0,17,Sicilia,ITG1
2021-01-11,PF/BT,190337.0,HSP11 - P.O. VILLA DELLE GINESTRE,SIC,30-39,19,16,0,25,6,0,4,35,0,35,Sicilia,ITG1
2021-01-11,PF/BT,190337.0,HSP11 - P.O. VILLA DELLE GINESTRE,SIC,40-49,24,36,0,40,9,2,9,60,0,60,Sicilia,ITG1
2021-01-11,PF/BT,190337.0,HSP11 - P.O. VILLA DELLE GINESTRE,SIC,50-59,42,36,0,42,25,1,10,78,0,78,Sicilia,ITG1
2021-01-11,PF/BT,190337.0,HSP11 - P.O. VILLA DELLE GINESTRE,SIC,60-69,36,23,0,42,15,2,0,59,0,59,Sicilia,ITG1
2021-01-11,PF/BT,190337.0,HSP11 - P.O. VILLA DELLE GINESTRE,SIC,70-79,16,5,0,18,1,2,0,21,0,21,Sicilia,ITG1
2021-01-11,PF/BT,190337.0,HSP11 - P.O. VILLA DELLE GINESTRE,SIC,80-89,3,4,0,1,0,6,0,7,0,7,Sicilia,ITG1
2021-01-11,PF/BT,190337.0,HSP11 - P.O. VILLA DELLE GINESTRE,SIC,90+,1,3,0,0,0,4,0,4,0,4,Sicilia,ITG1
2021-01-11,PF/BT,190338.0,HSP11 - OSPEDALE Giovanni Paolo II° M.P. A.,SIC,20-29,3,4,0,6,1,0,0,7,0,7,Sicilia,ITG1
2021-01-11,PF/BT,190338.0,HSP11 - OSPEDALE Giovanni Paolo II° M.P. A.,SIC,30-39,8,12,0,15,5,0,0,20,0,20,Sicilia,ITG1
2021-01-11,PF/BT,190338.0,HSP11 - OSPEDALE Giovanni Paolo II° M.P. A.,SIC,40-49,10,17,0,22,5,0,0,27,0,27,Sicilia,ITG1
2021-01-11,PF/BT,190338.0,HSP11 - OSPEDALE Giovanni Paolo II° M.P. A.,SIC,50-59,8,21,0,24,5,0,0,29,0,29,Sicilia,ITG1
2021-01-11,PF/BT,190338.0,HSP11 - OSPEDALE Giovanni Paolo II° M.P. A.,SIC,60-69,1,12,0,9,4,0,0,13,0,13,Sicilia,ITG1
2021-01-11,PF/BT,190339.0,HSP11 - OSPEDALE REGINA MARGHERITA  COMISO,SIC,30-39,0,1,0,1,0,0,0,1,0,1,Sicilia,ITG1
2021-01-11,PF/BT,190339.0,HSP11 - OSPEDALE REGINA MARGHERITA  COMISO,SIC,40-49,3,3,0,6,0,0,0,6,0,6,Sicilia,ITG1
2021-01-11,PF/BT,190339.0,HSP11 - OSPEDALE REGINA MARGHERITA  COMISO,SIC,50-59,1,4,0,5,0,0,0,5,0,5,Sicilia,ITG1
2021-01-11,PF/BT,190339.0,HSP11 - OSPEDALE REGINA MARGHERITA  COMISO,SIC,60-69,0,3,0,3,0,0,0,3,0,3,Sicilia,ITG1
2021-01-11,PF/BT,190340.0,HSP11 - OSPEDALE MAGGIORE MODICA,SIC,20-29,0,7,0,6,1,0,0,7,0,7,Sicilia,ITG1
2021-01-11,PF/BT,190340.0,HSP11 - OSPEDALE MAGGIORE MODICA,SIC,30-39,5,10,0,5,9,0,1,15,0,15,Sicilia,ITG1
2021-01-11,PF/BT,190340.0,HSP11 - OSPEDALE MAGGIORE MODICA,SIC,40-49,12,15,0,11,16,0,0,27,0,27,Sicilia,ITG1
2021-01-11,PF/BT,190340.0,HSP11 - OSPEDALE MAGGIORE MODICA,SIC,50-59,8,29,0,13,23,0,1,37,0,37,Sicilia,ITG1
2021-01-11,PF/BT,190340.0,HSP11 - OSPEDALE MAGGIORE MODICA,SIC,60-69,12,8,0,16,4,0,0,20,0,20,Sicilia,ITG1
2021-01-11,PF/BT,190340.0,HSP11 - OSPEDALE MAGGIORE MODICA,SIC,70-79,1,0,0,0,1,0,0,1,0,1,Sicilia,ITG1
2021-01-11,PF/BT,190345.0,HSP11 - P.O. UMBERTO I (EX A.O.),SIC,20-29,1,1,0,2,0,0,0,2,0,2,Sicilia,ITG1
2021-01-11,PF/BT,190345.0,HSP11 - P.O. UMBERTO I (EX A.O.),SIC,30-39,6,7,0,13,0,0,0,13,0,13,Sicilia,ITG1
2021-01-11,PF/BT,190345.0,HSP11 - P.O. UMBERTO I (EX A.O.),SIC,40-49,3,12,0,15,0,0,0,15,0,15,Sicilia,ITG1
2021-01-11,PF/BT,190345.0,HSP11 - P.O. UMBERTO I (EX A.O.),SIC,50-59,9,19,0,28,0,0,0,28,0,28,Sicilia,ITG1
2021-01-11,PF/BT,190345.0,HSP11 - P.O. UMBERTO I (EX A.O.),SIC,60-69,16,18,0,34,0,0,0,34,0,34,Sicilia,ITG1
2021-01-11,PF/BT,190346.0,HSP11 - P.O. MUSCATELLO AUGUSTA,SIC,30-39,2,1,0,3,0,0,0,3,0,3,Sicilia,ITG1
2021-01-11,PF/BT,190346.0,HSP11 - P.O. MUSCATELLO AUGUSTA,SIC,40-49,0,3,0,3,0,0,0,3,0,3,Sicilia,ITG1
2021-01-11,PF/BT,190346.0,HSP11 - P.O. MUSCATELLO AUGUSTA,SIC,50-59,3,2,0,5,0,0,0,5,0,5,Sicilia,ITG1
2021-01-11,PF/BT,190346.0,HSP11 - P.O. MUSCATELLO AUGUSTA,SIC,60-69,0,1,0,1,0,0,0,1,0,1,Sicilia,ITG1
2021-01-11,PF/BT,190349.0,HSP11 - P.O. SAN VITO E SANTO SPIRITO -ALCAMO,SIC,20-29,1,0,0,1,0,0,0,1,0,1,Sicilia,ITG1
2021-01-11,PF/BT,190349.0,HSP11 - P.O. SAN VITO E SANTO SPIRITO -ALCAMO,SIC,30-39,3,4,0,6,0,0,1,7,0,7,Sicilia,ITG1
2021-01-11,PF/BT,190349.0,HSP11 - P.O. SAN VITO E SANTO SPIRITO -ALCAMO,SIC,40-49,1,2,0,2,0,0,1,3,0,3,Sicilia,ITG1
2021-01-11,PF/BT,190349.0,HSP11 - P.O. SAN VITO E SANTO SPIRITO -ALCAMO,SIC,50-59,3,7,0,6,0,0,4,10,0,10,Sicilia,ITG1
2021-01-11,PF/BT,190349.0,HSP11 - P.O. SAN VITO E SANTO SPIRITO -ALCAMO,SIC,60-69,4,2,0,3,0,1,2,6,0,6,Sicilia,ITG1
2021-01-11,PF/BT,190349.0,HSP11 - P.O. SAN VITO E SANTO SPIRITO -ALCAMO,SIC,70-79,0,2,0,0,0,2,0,2,0,2,Sicilia,ITG1
2021-01-11,PF/BT,190349.0,HSP11 - P.O. SAN VITO E SANTO SPIRITO -ALCAMO,SIC,80-89,0,5,0,0,0,5,0,5,0,5,Sicilia,ITG1
2021-01-11,PF/BT,190349.0,HSP11 - P.O. SAN VITO E SANTO SPIRITO -ALCAMO,SIC,90+,0,8,0,0,0,8,0,8,0,8,Sicilia,ITG1
2021-01-11,PF/BT,190350.0,HSP11 - P.O. B. NAGAR - PANTELLERIA,SIC,20-29,1,1,0,2,0,0,0,2,0,2,Sicilia,ITG1
2021-01-11,PF/BT,190350.0,HSP11 - P.O. B. NAGAR - PANTELLERIA,SIC,30-39,3,3,0,4,1,0,1,6,0,6,Sicilia,ITG1
2021-01-11,PF/BT,190350.0,HSP11 - P.O. B. NAGAR - PANTELLERIA,SIC,40-49,3,2,0,4,1,0,0,5,0,5,Sicilia,ITG1
2021-01-11,PF/BT,190350.0,HSP11 - P.O. B. NAGAR - PANTELLERIA,SIC,50-59,7,10,0,14,0,0,3,17,0,17,Sicilia,ITG1
2021-01-11,PF/BT,190350.0,HSP11 - P.O. B. NAGAR - PANTELLERIA,SIC,60-69,9,3,0,11,0,0,1,12,0,12,Sicilia,ITG1
2021-01-11,PF/BT,190351.0,HSP11 - P.O. S. ANTONIO ABATE  - TRAPANI,SIC,20-29,1,5,0,5,1,0,0,6,0,6,Sicilia,ITG1
2021-01-11,PF/BT,190351.0,HSP11 - P.O. S. ANTONIO ABATE  - TRAPANI,SIC,30-39,4,5,0,9,0,0,0,9,0,9,Sicilia,ITG1
2021-01-11,PF/BT,190351.0,HSP11 - P.O. S. ANTONIO ABATE  - TRAPANI,SIC,40-49,13,10,0,18,5,0,0,23,0,23,Sicilia,ITG1
2021-01-11,PF/BT,190351.0,HSP11 - P.O. S. ANTONIO ABATE  - TRAPANI,SIC,50-59,10,33,0,30,13,0,0,43,0,43,Sicilia,ITG1
2021-01-11,PF/BT,190351.0,HSP11 - P.O. S. ANTONIO ABATE  - TRAPANI,SIC,60-69,16,10,0,23,3,0,0,26,0,26,Sicilia,ITG1
2021-01-11,PF/BT,190351.0,HSP11 - P.O. S. ANTONIO ABATE  - TRAPANI,SIC,70-79,1,0,0,1,0,0,0,1,0,1,Sicilia,ITG1
2021-01-11,PF/BT,190352.0,HSP11 - P.O. V.EMANUELE II CASTELVETRANO,SIC,20-29,3,7,0,6,1,0,3,10,0,10,Sicilia,ITG1
2021-01-11,PF/BT,190352.0,HSP11 - P.O. V.EMANUELE II CASTELVETRANO,SIC,30-39,2,7,0,2,1,0,6,9,0,9,Sicilia,ITG1
2021-01-11,PF/BT,190352.0,HSP11 - P.O. V.EMANUELE II CASTELVETRANO,SIC,40-49,12,17,0,11,9,0,9,29,0,29,Sicilia,ITG1
2021-01-11,PF/BT,190352.0,HSP11 - P.O. V.EMANUELE II CASTELVETRANO,SIC,50-59,3,17,0,12,2,0,6,20,0,20,Sicilia,ITG1
2021-01-11,PF/BT,190352.0,HSP11 - P.O. V.EMANUELE II CASTELVETRANO,SIC,60-69,6,3,0,4,1,0,4,9,0,9,Sicilia,ITG1
2021-01-11,PF/BT,190352.0,HSP11 - P.O. V.EMANUELE II CASTELVETRANO,SIC,70-79,1,0,0,0,0,0,1,1,0,1,Sicilia,ITG1
2021-01-11,PF/BT,190353.0,HSP11 - P.O.PAOLO BORSELLINO - MARSALA,SIC,20-29,1,6,0,7,0,0,0,7,0,7,Sicilia,ITG1
2021-01-11,PF/BT,190353.0,HSP11 - P.O.PAOLO BORSELLINO - MARSALA,SIC,30-39,5,13,0,18,0,0,0,18,0,18,Sicilia,ITG1
2021-01-11,PF/BT,190353.0,HSP11 - P.O.PAOLO BORSELLINO - MARSALA,SIC,40-49,6,15,0,21,0,0,0,21,0,21,Sicilia,ITG1
2021-01-11,PF/BT,190353.0,HSP11 - P.O.PAOLO BORSELLINO - MARSALA,SIC,50-59,14,21,0,35,0,0,0,35,0,35,Sicilia,ITG1
2021-01-11,PF/BT,190353.0,HSP11 - P.O.PAOLO BORSELLINO - MARSALA,SIC,60-69,8,7,0,15,0,0,0,15,0,15,Sicilia,ITG1
2021-01-11,PF/BT,190353.0,HSP11 - P.O.PAOLO BORSELLINO - MARSALA,SIC,70-79,3,2,0,5,0,0,0,5,0,5,Sicilia,ITG1
2021-01-11,PF/BT,190353.0,HSP11 - P.O.PAOLO BORSELLINO - MARSALA,SIC,80-89,1,0,0,1,0,0,0,1,0,1,Sicilia,ITG1
2021-01-11,PF/BT,190354.0,HSP11 - P.O.ABELE AJELLO-MAZARA D.VALLO,SIC,20-29,0,2,0,2,0,0,0,2,0,2,Sicilia,ITG1
2021-01-11,PF/BT,190354.0,HSP11 - P.O.ABELE AJELLO-MAZARA D.VALLO,SIC,30-39,5,7,0,9,3,0,0,12,0,12,Sicilia,ITG1
2021-01-11,PF/BT,190354.0,HSP11 - P.O.ABELE AJELLO-MAZARA D.VALLO,SIC,40-49,3,12,0,13,2,0,0,15,0,15,Sicilia,ITG1
2021-01-11,PF/BT,190354.0,HSP11 - P.O.ABELE AJELLO-MAZARA D.VALLO,SIC,50-59,6,12,0,15,3,0,0,18,0,18,Sicilia,ITG1
2021-01-11,PF/BT,190354.0,HSP11 - P.O.ABELE AJELLO-MAZARA D.VALLO,SIC,60-69,6,7,0,10,3,0,0,13,0,13,Sicilia,ITG1
2021-01-11,PF/BT,190355.0,HSP11 - P.O. VITTORIO EMANUELE III - SALEMI,SIC,20-29,0,2,0,2,0,0,0,2,0,2,Sicilia,ITG1
2021-01-11,PF/BT,190355.0,HSP11 - P.O. VITTORIO EMANUELE III - SALEMI,SIC,30-39,3,5,0,6,2,0,0,8,0,8,Sicilia,ITG1
2021-01-11,PF/BT,190355.0,HSP11 - P.O. VITTORIO EMANUELE III - SALEMI,SIC,40-49,1,4,0,3,2,0,0,5,0,5,Sicilia,ITG1
2021-01-11,PF/BT,190355.0,HSP11 - P.O. VITTORIO EMANUELE III - SALEMI,SIC,50-59,4,4,0,6,2,0,0,8,0,8,Sicilia,ITG1
2021-01-11,PF/BT,190355.0,HSP11 - P.O. VITTORIO EMANUELE III - SALEMI,SIC,60-69,0,1,0,0,1,0,0,1,0,1,Sicilia,ITG1
2021-01-11,PF/BT,190512.0,HSP11 - CASA DI CURA MADONNA DEL ROSARIO,SIC,20-29,0,2,0,1,1,0,0,2,0,2,Sicilia,ITG1
2021-01-11,PF/BT,190512.0,HSP11 - CASA DI CURA MADONNA DEL ROSARIO,SIC,40-49,0,1,0,1,0,0,0,1,0,1,Sicilia,ITG1
2021-01-11,PF/BT,190512.0,HSP11 - CASA DI CURA MADONNA DEL ROSARIO,SIC,50-59,2,1,0,3,0,0,0,3,0,3,Sicilia,ITG1
2021-01-11,PF/BT,190513.0,HSP11 - CASA DI CURA G.B. MORGAGNI S.R.L.,SIC,20-29,3,10,0,3,4,0,6,13,0,13,Sicilia,ITG1
2021-01-11,PF/BT,190513.0,HSP11 - CASA DI CURA G.B. MORGAGNI S.R.L.,SIC,30-39,3,7,0,4,2,0,4,10,0,10,Sicilia,ITG1
2021-01-11,PF/BT,190513.0,HSP11 - CASA DI CURA G.B. MORGAGNI S.R.L.,SIC,40-49,4,8,0,6,0,0,6,12,0,12,Sicilia,ITG1
2021-01-11,PF/BT,190513.0,HSP11 - CASA DI CURA G.B. MORGAGNI S.R.L.,SIC,50-59,3,9,0,0,1,0,11,12,0,12,Sicilia,ITG1
2021-01-11,PF/BT,190513.0,HSP11 - CASA DI CURA G.B. MORGAGNI S.R.L.,SIC,60-69,4,3,0,4,0,0,3,7,0,7,Sicilia,ITG1
2021-01-11,PF/BT,190513.0,HSP11 - CASA DI CURA G.B. MORGAGNI S.R.L.,SIC,70-79,3,0,0,3,0,0,0,3,0,3,Sicilia,ITG1
2021-01-11,PF/BT,190513.0,HSP11 - CASA DI CURA G.B. MORGAGNI S.R.L.,SIC,80-89,1,1,0,0,0,0,2,2,0,2,Sicilia,ITG1
2021-01-11,PF/BT,190513.0,HSP11 - CASA DI CURA G.B. MORGAGNI S.R.L.,SIC,90+,1,0,0,1,0,0,0,1,0,1,Sicilia,ITG1
2021-01-11,PF/BT,190519.0,HSP11 - HUMANITAS ISTITUTO CLINICO CATANESE,SIC,20-29,5,7,0,8,4,0,0,12,0,12,Sicilia,ITG1
2021-01-11,PF/BT,190519.0,HSP11 - HUMANITAS ISTITUTO CLINICO CATANESE,SIC,30-39,16,10,0,19,7,0,0,26,0,26,Sicilia,ITG1
2021-01-11,PF/BT,190519.0,HSP11 - HUMANITAS ISTITUTO CLINICO CATANESE,SIC,40-49,7,5,0,6,6,0,0,12,0,12,Sicilia,ITG1
2021-01-11,PF/BT,190519.0,HSP11 - HUMANITAS ISTITUTO CLINICO CATANESE,SIC,50-59,8,10,0,13,5,0,0,18,0,18,Sicilia,ITG1
2021-01-11,PF/BT,190519.0,HSP11 - HUMANITAS ISTITUTO CLINICO CATANESE,SIC,60-69,0,2,0,1,1,0,0,2,0,2,Sicilia,ITG1
2021-01-11,PF/BT,190524.0,HSP11 - I.O.M.I. F.SCALABRINO GANZIRRI,SIC,20-29,8,7,0,13,2,0,0,15,0,15,Sicilia,ITG1
2021-01-11,PF/BT,190524.0,HSP11 - I.O.M.I. F.SCALABRINO GANZIRRI,SIC,30-39,11,7,0,13,5,0,0,18,0,18,Sicilia,ITG1
2021-01-11,PF/BT,190524.0,HSP11 - I.O.M.I. F.SCALABRINO GANZIRRI,SIC,40-49,22,10,0,24,8,0,0,32,0,32,Sicilia,ITG1
2021-01-11,PF/BT,190524.0,HSP11 - I.O.M.I. F.SCALABRINO GANZIRRI,SIC,50-59,17,10,0,21,6,0,0,27,0,27,Sicilia,ITG1
2021-01-11,PF/BT,190524.0,HSP11 - I.O.M.I. F.SCALABRINO GANZIRRI,SIC,60-69,9,10,0,17,2,0,0,19,0,19,Sicilia,ITG1
2021-01-11,PF/BT,190524.0,HSP11 - I.O.M.I. F.SCALABRINO GANZIRRI,SIC,70-79,1,1,0,1,1,0,0,2,0,2,Sicilia,ITG1
2021-01-11,PF/BT,190524.0,HSP11 - I.O.M.I. F.SCALABRINO GANZIRRI,SIC,80-89,1,0,0,0,1,0,0,1,0,1,Sicilia,ITG1
2021-01-11,PF/BT,190536.0,HSP11 - CASA DI CURA TRIOLO ZANCLA S.P.A.,SIC,20-29,0,1,0,1,0,0,0,1,0,1,Sicilia,ITG1
2021-01-11,PF/BT,190536.0,HSP11 - CASA DI CURA TRIOLO ZANCLA S.P.A.,SIC,30-39,2,0,0,2,0,0,0,2,0,2,Sicilia,ITG1
2021-01-11,PF/BT,190536.0,HSP11 - CASA DI CURA TRIOLO ZANCLA S.P.A.,SIC,40-49,3,5,0,4,4,0,0,8,0,8,Sicilia,ITG1
2021-01-11,PF/BT,190536.0,HSP11 - CASA DI CURA TRIOLO ZANCLA S.P.A.,SIC,50-59,2,2,0,2,2,0,0,4,0,4,Sicilia,ITG1
2021-01-11,PF/BT,190536.0,HSP11 - CASA DI CURA TRIOLO ZANCLA S.P.A.,SIC,60-69,1,1,0,0,2,0,0,2,0,2,Sicilia,ITG1
2021-01-11,PF/BT,190536.0,HSP11 - CASA DI CURA TRIOLO ZANCLA S.P.A.,SIC,70-79,1,0,0,1,0,0,0,1,0,1,Sicilia,ITG1
2021-01-11,PF/BT,190537.0,HSP11 - CASA DI CURA SERENA S.P.A.,SIC,20-29,3,2,0,5,0,0,0,5,0,5,Sicilia,ITG1
2021-01-11,PF/BT,190537.0,HSP11 - CASA DI CURA SERENA S.P.A.,SIC,30-39,1,5,0,6,0,0,0,6,0,6,Sicilia,ITG1
2021-01-11,PF/BT,190537.0,HSP11 - CASA DI CURA SERENA S.P.A.,SIC,40-49,5,8,0,12,1,0,0,13,0,13,Sicilia,ITG1
2021-01-11,PF/BT,190537.0,HSP11 - CASA DI CURA SERENA S.P.A.,SIC,50-59,5,7,0,11,1,0,0,12,0,12,Sicilia,ITG1
2021-01-11,PF/BT,190537.0,HSP11 - CASA DI CURA SERENA S.P.A.,SIC,60-69,2,3,0,5,0,0,0,5,0,5,Sicilia,ITG1
2021-01-11,PF/BT,190538.0,HSP11 - CASA DI CURA NOTO PASQUALINO S.R.L.,SIC,20-29,0,1,0,1,0,0,0,1,0,1,Sicilia,ITG1
2021-01-11,PF/BT,190538.0,HSP11 - CASA DI CURA NOTO PASQUALINO S.R.L.,SIC,30-39,1,1,0,1,1,0,0,2,0,2,Sicilia,ITG1
2021-01-11,PF/BT,190538.0,HSP11 - CASA DI CURA NOTO PASQUALINO S.R.L.,SIC,40-49,4,3,0,6,0,0,1,7,0,7,Sicilia,ITG1
2021-01-11,PF/BT,190538.0,HSP11 - CASA DI CURA NOTO PASQUALINO S.R.L.,SIC,50-59,5,5,0,8,2,0,0,10,0,10,Sicilia,ITG1
2021-01-11,PF/BT,190538.0,HSP11 - CASA DI CURA NOTO PASQUALINO S.R.L.,SIC,60-69,0,2,0,2,0,0,0,2,0,2,Sicilia,ITG1
2021-01-11,PF/BT,190538.0,HSP11 - CASA DI CURA NOTO PASQUALINO S.R.L.,SIC,70-79,2,0,0,1,1,0,0,2,0,2,Sicilia,ITG1
2021-01-11,PF/BT,190539.0,HSP11 - NUOVA CASA DI CURA D`ANNA PIA ASS. SRL,SIC,20-29,0,2,0,2,0,0,0,2,0,2,Sicilia,ITG1
2021-01-11,PF/BT,190539.0,HSP11 - NUOVA CASA DI CURA D`ANNA PIA ASS. SRL,SIC,30-39,4,1,0,5,0,0,0,5,0,5,Sicilia,ITG1
2021-01-11,PF/BT,190539.0,HSP11 - NUOVA CASA DI CURA D`ANNA PIA ASS. SRL,SIC,40-49,3,4,0,5,2,0,0,7,0,7,Sicilia,ITG1
2021-01-11,PF/BT,190539.0,HSP11 - NUOVA CASA DI CURA D`ANNA PIA ASS. SRL,SIC,50-59,5,6,0,9,2,0,0,11,0,11,Sicilia,ITG1
2021-01-11,PF/BT,190539.0,HSP11 - NUOVA CASA DI CURA D`ANNA PIA ASS. SRL,SIC,60-69,3,1,0,4,0,0,0,4,0,4,Sicilia,ITG1
2021-01-11,PF/BT,190539.0,HSP11 - NUOVA CASA DI CURA D`ANNA PIA ASS. SRL,SIC,70-79,1,0,0,0,1,0,0,1,0,1,Sicilia,ITG1
2021-01-11,PF/BT,190540.0,HSP11 - NUOVA CASA DI CURA DEMMA srl,SIC,20-29,0,2,0,2,0,0,0,2,0,2,Sicilia,ITG1
2021-01-11,PF/BT,190540.0,HSP11 - NUOVA CASA DI CURA DEMMA srl,SIC,30-39,0,1,0,1,0,0,0,1,0,1,Sicilia,ITG1
2021-01-11,PF/BT,190540.0,HSP11 - NUOVA CASA DI CURA DEMMA srl,SIC,40-49,0,1,0,0,1,0,0,1,0,1,Sicilia,ITG1
2021-01-11,PF/BT,190540.0,HSP11 - NUOVA CASA DI CURA DEMMA srl,SIC,50-59,1,1,0,1,1,0,0,2,0,2,Sicilia,ITG1
2021-01-11,PF/BT,190541.0,HSP11 - CASA DI CURA MACCHIARELLA S.P.A.,SIC,20-29,4,2,0,4,2,0,0,6,0,6,Sicilia,ITG1
2021-01-11,PF/BT,190541.0,HSP11 - CASA DI CURA MACCHIARELLA S.P.A.,SIC,30-39,2,5,0,5,2,0,0,7,0,7,Sicilia,ITG1
2021-01-11,PF/BT,190541.0,HSP11 - CASA DI CURA MACCHIARELLA S.P.A.,SIC,40-49,1,6,0,7,0,0,0,7,0,7,Sicilia,ITG1
2021-01-11,PF/BT,190541.0,HSP11 - CASA DI CURA MACCHIARELLA S.P.A.,SIC,50-59,3,4,0,6,1,0,0,7,0,7,Sicilia,ITG1
2021-01-11,PF/BT,190541.0,HSP11 - CASA DI CURA MACCHIARELLA S.P.A.,SIC,60-69,2,1,0,3,0,0,0,3,0,3,Sicilia,ITG1
2021-01-11,PF/BT,190542.0,HSP11 - CASA DI CURA TORINA,SIC,20-29,1,1,0,2,0,0,0,2,0,2,Sicilia,ITG1
2021-01-11,PF/BT,190542.0,HSP11 - CASA DI CURA TORINA,SIC,60-69,1,0,0,1,0,0,0,1,0,1,Sicilia,ITG1
2021-01-11,PF/BT,190542.0,HSP11 - CASA DI CURA TORINA,SIC,70-79,2,1,0,3,0,0,0,3,0,3,Sicilia,ITG1
2021-01-11,PF/BT,190551.0,HSP11 - CASA DI CURA LA MADDALENA S.P.A.,SIC,20-29,3,3,0,6,0,0,0,6,0,6,Sicilia,ITG1
2021-01-11,PF/BT,190551.0,HSP11 - CASA DI CURA LA MADDALENA S.P.A.,SIC,30-39,2,1,0,3,0,0,0,3,0,3,Sicilia,ITG1
2021-01-11,PF/BT,190551.0,HSP11 - CASA DI CURA LA MADDALENA S.P.A.,SIC,40-49,1,8,0,9,0,0,0,9,0,9,Sicilia,ITG1
2021-01-11,PF/BT,190551.0,HSP11 - CASA DI CURA LA MADDALENA S.P.A.,SIC,50-59,2,1,0,3,0,0,0,3,0,3,Sicilia,ITG1
2021-01-11,PF/BT,190551.0,HSP11 - CASA DI CURA LA MADDALENA S.P.A.,SIC,60-69,2,1,0,3,0,0,0,3,0,3,Sicilia,ITG1
2021-01-11,PF/BT,190554.0,HSP11 - ISTITUTO ONCOLOGICO DEL MEDITERRANEO SPA,SIC,30-39,1,0,0,0,0,0,1,1,0,1,Sicilia,ITG1
2021-01-11,PF/BT,190554.0,HSP11 - ISTITUTO ONCOLOGICO DEL MEDITERRANEO SPA,SIC,40-49,0,2,0,1,0,0,1,2,0,2,Sicilia,ITG1
2021-01-11,PF/BT,190554.0,HSP11 - ISTITUTO ONCOLOGICO DEL MEDITERRANEO SPA,SIC,50-59,0,1,0,0,0,0,1,1,0,1,Sicilia,ITG1
2021-01-11,PF/BT,190554.0,HSP11 - ISTITUTO ONCOLOGICO DEL MEDITERRANEO SPA,SIC,60-69,1,1,0,0,0,0,2,2,0,2,Sicilia,ITG1
2021-01-11,PF/BT,190710.0,HSP11 - CASA DI CURA PROF.E.FALCIDIA SrL,SIC,20-29,0,2,0,0,2,0,0,2,0,2,Sicilia,ITG1
2021-01-11,PF/BT,190710.0,HSP11 - CASA DI CURA PROF.E.FALCIDIA SrL,SIC,40-49,0,1,0,1,0,0,0,1,0,1,Sicilia,ITG1
2021-01-11,PF/BT,190710.0,HSP11 - CASA DI CURA PROF.E.FALCIDIA SrL,SIC,50-59,1,0,0,1,0,0,0,1,0,1,Sicilia,ITG1
2021-01-11,PF/BT,190710.0,HSP11 - CASA DI CURA PROF.E.FALCIDIA SrL,SIC,60-69,0,2,0,1,1,0,0,2,0,2,Sicilia,ITG1
2021-01-11,PF/BT,190725.0,HSP11 - PRIVATE HOSPITAL ARGENTO srl,SIC,20-29,1,2,0,0,3,0,0,3,0,3,Sicilia,ITG1
2021-01-11,PF/BT,190725.0,HSP11 - PRIVATE HOSPITAL ARGENTO srl,SIC,40-49,0,1,0,1,0,0,0,1,0,1,Sicilia,ITG1
2021-01-11,PF/BT,190725.0,HSP11 - PRIVATE HOSPITAL ARGENTO srl,SIC,50-59,3,0,0,0,3,0,0,3,0,3,Sicilia,ITG1
2021-01-11,PF/BT,190725.0,HSP11 - PRIVATE HOSPITAL ARGENTO srl,SIC,60-69,0,2,0,0,2,0,0,2,0,2,Sicilia,ITG1
2021-01-11,PF/BT,190725.0,HSP11 - PRIVATE HOSPITAL ARGENTO srl,SIC,70-79,3,0,0,3,0,0,0,3,0,3,Sicilia,ITG1
2021-01-11,PF/BT,190921.0,HSP11 - A.O. per lEmergenza Cannizzaro,SIC,20-29,1,3,0,4,0,0,0,4,0,4,Sicilia,ITG1
2021-01-11,PF/BT,190921.0,HSP11 - A.O. per lEmergenza Cannizzaro,SIC,30-39,3,3,0,6,0,0,0,6,0,6,Sicilia,ITG1
2021-01-11,PF/BT,190921.0,HSP11 - A.O. per lEmergenza Cannizzaro,SIC,40-49,6,9,0,14,1,0,0,15,0,15,Sicilia,ITG1
2021-01-11,PF/BT,190921.0,HSP11 - A.O. per lEmergenza Cannizzaro,SIC,50-59,16,21,0,21,16,0,0,37,0,37,Sicilia,ITG1
2021-01-11,PF/BT,190921.0,HSP11 - A.O. per lEmergenza Cannizzaro,SIC,60-69,7,7,0,9,5,0,0,14,0,14,Sicilia,ITG1
2021-01-11,PF/BT,190921.0,HSP11 - A.O. per lEmergenza Cannizzaro,SIC,70-79,1,1,0,2,0,0,0,2,0,2,Sicilia,ITG1
2021-01-11,PF/BT,19092201.0,HSP11 - OSPEDALE GARIBALDI - CENTRO,SIC,20-29,4,2,0,6,0,0,0,6,0,6,Sicilia,ITG1
2021-01-11,PF/BT,19092201.0,HSP11 - OSPEDALE GARIBALDI - CENTRO,SIC,30-39,1,3,0,4,0,0,0,4,0,4,Sicilia,ITG1
2021-01-11,PF/BT,19092201.0,HSP11 - OSPEDALE GARIBALDI - CENTRO,SIC,40-49,3,2,0,5,0,0,0,5,0,5,Sicilia,ITG1
2021-01-11,PF/BT,19092201.0,HSP11 - OSPEDALE GARIBALDI - CENTRO,SIC,50-59,7,3,0,6,4,0,0,10,0,10,Sicilia,ITG1
2021-01-11,PF/BT,19092201.0,HSP11 - OSPEDALE GARIBALDI - CENTRO,SIC,60-69,2,2,0,3,1,0,0,4,0,4,Sicilia,ITG1
2021-01-11,PF/BT,19092204.0,HSP11 - NUOVO OSPEDALE GARIBALDI - NESIMA,SIC,16-19,0,1,0,0,1,0,0,1,0,1,Sicilia,ITG1
2021-01-11,PF/BT,19092204.0,HSP11 - NUOVO OSPEDALE GARIBALDI - NESIMA,SIC,20-29,0,2,0,2,0,0,0,2,0,2,Sicilia,ITG1
2021-01-11,PF/BT,19092204.0,HSP11 - NUOVO OSPEDALE GARIBALDI - NESIMA,SIC,30-39,3,6,0,5,4,0,0,9,0,9,Sicilia,ITG1
2021-01-11,PF/BT,19092204.0,HSP11 - NUOVO OSPEDALE GARIBALDI - NESIMA,SIC,40-49,8,7,0,11,4,0,0,15,0,15,Sicilia,ITG1
2021-01-11,PF/BT,19092204.0,HSP11 - NUOVO OSPEDALE GARIBALDI - NESIMA,SIC,50-59,9,14,0,17,5,0,1,23,0,23,Sicilia,ITG1
2021-01-11,PF/BT,19092204.0,HSP11 - NUOVO OSPEDALE GARIBALDI - NESIMA,SIC,60-69,5,6,0,9,2,0,0,11,0,11,Sicilia,ITG1
2021-01-11,PF/BT,19092204.0,HSP11 - NUOVO OSPEDALE GARIBALDI - NESIMA,SIC,70-79,1,0,0,1,0,0,0,1,0,1,Sicilia,ITG1
2021-01-11,PF/BT,19092301.0,HSP11 - PRESIDIO OSPEDALIERO GASPARE RODOLICO,SIC,16-19,7,7,0,14,0,0,0,14,0,14,Sicilia,ITG1
2021-01-11,PF/BT,19092301.0,HSP11 - PRESIDIO OSPEDALIERO GASPARE RODOLICO,SIC,20-29,84,97,0,181,0,0,0,181,0,181,Sicilia,ITG1
2021-01-11,PF/BT,19092301.0,HSP11 - PRESIDIO OSPEDALIERO GASPARE RODOLICO,SIC,30-39,9,10,0,19,0,0,0,19,0,19,Sicilia,ITG1
2021-01-11,PF/BT,19092301.0,HSP11 - PRESIDIO OSPEDALIERO GASPARE RODOLICO,SIC,40-49,6,10,0,16,0,0,0,16,0,16,Sicilia,ITG1
2021-01-11,PF/BT,19092301.0,HSP11 - PRESIDIO OSPEDALIERO GASPARE RODOLICO,SIC,50-59,12,7,0,19,0,0,0,19,0,19,Sicilia,ITG1
2021-01-11,PF/BT,19092301.0,HSP11 - PRESIDIO OSPEDALIERO GASPARE RODOLICO,SIC,60-69,7,8,0,15,0,0,0,15,0,15,Sicilia,ITG1
2021-01-11,PF/BT,19092304.0,HSP11 - PRESIDIO OSPEDALIERO S.MARCO,SIC,16-19,9,14,0,19,4,0,0,23,0,23,Sicilia,ITG1
2021-01-11,PF/BT,19092304.0,HSP11 - PRESIDIO OSPEDALIERO S.MARCO,SIC,20-29,63,91,0,145,9,0,0,154,0,154,Sicilia,ITG1
2021-01-11,PF/BT,19092304.0,HSP11 - PRESIDIO OSPEDALIERO S.MARCO,SIC,30-39,13,14,0,24,3,0,0,27,0,27,Sicilia,ITG1
2021-01-11,PF/BT,19092304.0,HSP11 - PRESIDIO OSPEDALIERO S.MARCO,SIC,40-49,12,13,0,19,6,0,0,25,0,25,Sicilia,ITG1
2021-01-11,PF/BT,19092304.0,HSP11 - PRESIDIO OSPEDALIERO S.MARCO,SIC,50-59,13,18,0,28,3,0,0,31,0,31,Sicilia,ITG1
2021-01-11,PF/BT,19092304.0,HSP11 - PRESIDIO OSPEDALIERO S.MARCO,SIC,60-69,7,14,0,20,1,0,0,21,0,21,Sicilia,ITG1
2021-01-11,PF/BT,190924.0,HSP11 - Azienda Ospedaliera Papardo,SIC,20-29,1,3,0,1,0,0,3,4,0,4,Sicilia,ITG1
2021-01-11,PF/BT,190924.0,HSP11 - Azienda Ospedaliera Papardo,SIC,30-39,2,8,0,7,0,0,3,10,0,10,Sicilia,ITG1
2021-01-11,PF/BT,190924.0,HSP11 - Azienda Ospedaliera Papardo,SIC,40-49,7,17,0,14,0,0,10,24,0,24,Sicilia,ITG1
2021-01-11,PF/BT,190924.0,HSP11 - Azienda Ospedaliera Papardo,SIC,50-59,20,21,0,23,0,0,18,41,0,41,Sicilia,ITG1
2021-01-11,PF/BT,190924.0,HSP11 - Azienda Ospedaliera Papardo,SIC,60-69,11,11,0,18,0,0,4,22,0,22,Sicilia,ITG1
2021-01-11,PF/BT,190924.0,HSP11 - Azienda Ospedaliera Papardo,SIC,70-79,1,0,0,0,0,0,1,1,0,1,Sicilia,ITG1
2021-01-11,PF/BT,19092501.0,HSP11 - COVID HOSPITAL,SIC,20-29,15,23,0,37,0,0,1,38,0,38,Sicilia,ITG1
2021-01-11,PF/BT,19092501.0,HSP11 - COVID HOSPITAL,SIC,30-39,22,22,0,44,0,0,0,44,0,44,Sicilia,ITG1
2021-01-11,PF/BT,19092501.0,HSP11 - COVID HOSPITAL,SIC,40-49,9,14,0,23,0,0,0,23,0,23,Sicilia,ITG1
2021-01-11,PF/BT,19092501.0,HSP11 - COVID HOSPITAL,SIC,50-59,14,22,0,36,0,0,0,36,0,36,Sicilia,ITG1
2021-01-11,PF/BT,19092501.0,HSP11 - COVID HOSPITAL,SIC,60-69,5,17,0,22,0,0,0,22,0,22,Sicilia,ITG1
2021-01-11,PF/BT,19092601.0,HSP11 - P.O. Villa Sofia,SIC,20-29,2,6,0,8,0,0,0,8,0,8,Sicilia,ITG1
2021-01-11,PF/BT,19092601.0,HSP11 - P.O. Villa Sofia,SIC,30-39,8,11,0,19,0,0,0,19,0,19,Sicilia,ITG1
2021-01-11,PF/BT,19092601.0,HSP11 - P.O. Villa Sofia,SIC,40-49,12,11,0,23,0,0,0,23,0,23,Sicilia,ITG1
2021-01-11,PF/BT,19092601.0,HSP11 - P.O. Villa Sofia,SIC,50-59,15,33,0,48,0,0,0,48,0,48,Sicilia,ITG1
2021-01-11,PF/BT,19092601.0,HSP11 - P.O. Villa Sofia,SIC,60-69,15,13,0,28,0,0,0,28,0,28,Sicilia,ITG1
2021-01-11,PF/BT,19092601.0,HSP11 - P.O. Villa Sofia,SIC,70-79,1,0,0,1,0,0,0,1,0,1,Sicilia,ITG1
2021-01-11,PF/BT,19092701.0,HSP11 - Ospedale Civico,SIC,20-29,2,2,0,3,1,0,0,4,0,4,Sicilia,ITG1
2021-01-11,PF/BT,19092701.0,HSP11 - Ospedale Civico,SIC,30-39,15,4,0,11,8,0,0,19,0,19,Sicilia,ITG1
2021-01-11,PF/BT,19092701.0,HSP11 - Ospedale Civico,SIC,40-49,21,13,0,22,12,0,0,34,0,34,Sicilia,ITG1
2021-01-11,PF/BT,19092701.0,HSP11 - Ospedale Civico,SIC,50-59,33,43,0,62,14,0,0,76,0,76,Sicilia,ITG1
2021-01-11,PF/BT,19092701.0,HSP11 - Ospedale Civico,SIC,60-69,19,16,0,28,7,0,0,35,0,35,Sicilia,ITG1
2021-01-11,PF/BT,19092702.0,HSP11 - Ospedale dei Bambini G. Di Cristina,SIC,20-29,1,1,0,1,1,0,0,2,0,2,Sicilia,ITG1
2021-01-11,PF/BT,19092702.0,HSP11 - Ospedale dei Bambini G. Di Cristina,SIC,30-39,5,3,0,4,4,0,0,8,0,8,Sicilia,ITG1
2021-01-11,PF/BT,19092702.0,HSP11 - Ospedale dei Bambini G. Di Cristina,SIC,40-49,13,16,0,11,18,0,0,29,0,29,Sicilia,ITG1
2021-01-11,PF/BT,19092702.0,HSP11 - Ospedale dei Bambini G. Di Cristina,SIC,50-59,18,33,0,24,27,0,0,51,0,51,Sicilia,ITG1
2021-01-11,PF/BT,19092702.0,HSP11 - Ospedale dei Bambini G. Di Cristina,SIC,60-69,5,19,0,14,10,0,0,24,0,24,Sicilia,ITG1
2021-01-11,PF/BT,190928.0,HSP11 - AZ.OSP.UNIV.P.GIACCONE,SIC,20-29,13,36,0,45,4,0,0,49,0,49,Sicilia,ITG1
2021-01-11,PF/BT,190928.0,HSP11 - AZ.OSP.UNIV.P.GIACCONE,SIC,30-39,21,32,0,47,4,0,2,53,0,53,Sicilia,ITG1
2021-01-11,PF/BT,190928.0,HSP11 - AZ.OSP.UNIV.P.GIACCONE,SIC,40-49,17,25,0,31,11,0,0,42,0,42,Sicilia,ITG1
2021-01-11,PF/BT,190928.0,HSP11 - AZ.OSP.UNIV.P.GIACCONE,SIC,50-59,40,42,0,64,16,0,2,82,0,82,Sicilia,ITG1
2021-01-11,PF/BT,190928.0,HSP11 - AZ.OSP.UNIV.P.GIACCONE,SIC,60-69,22,20,0,30,12,0,0,42,0,42,Sicilia,ITG1
2021-01-11,PF/BT,190928.0,HSP11 - AZ.OSP.UNIV.P.GIACCONE,SIC,70-79,2,2,0,4,0,0,0,4,0,4,Sicilia,ITG1
2021-01-11,PF/BT,190928.0,HSP11 - AZ.OSP.UNIV.P.GIACCONE,SIC,80-89,1,0,0,0,0,0,1,1,0,1,Sicilia,ITG1
2021-01-11,PF/BT,190929.0,STS11 - IRCCS Ismett,SIC,20-29,2,2,0,4,0,0,0,4,0,4,Sicilia,ITG1
2021-01-11,PF/BT,190929.0,STS11 - IRCCS Ismett,SIC,30-39,1,2,0,3,0,0,0,3,0,3,Sicilia,ITG1
2021-01-11,PF/BT,190929.0,STS11 - IRCCS Ismett,SIC,40-49,6,2,0,2,6,0,0,8,0,8,Sicilia,ITG1
2021-01-11,PF/BT,190929.0,STS11 - IRCCS Ismett,SIC,50-59,2,1,0,2,1,0,0,3,0,3,Sicilia,ITG1
2021-01-11,PF/BT,190950.0,HSP11 - ASSOCIAZIONE OASI MARIA SS,SIC,20-29,3,4,0,5,0,0,2,7,0,7,Sicilia,ITG1
2021-01-11,PF/BT,190950.0,HSP11 - ASSOCIAZIONE OASI MARIA SS,SIC,30-39,9,12,0,14,0,0,7,21,0,21,Sicilia,ITG1
2021-01-11,PF/BT,190950.0,HSP11 - ASSOCIAZIONE OASI MARIA SS,SIC,40-49,15,26,0,22,0,0,19,41,0,41,Sicilia,ITG1
2021-01-11,PF/BT,190950.0,HSP11 - ASSOCIAZIONE OASI MARIA SS,SIC,50-59,17,25,0,24,0,0,18,42,0,42,Sicilia,ITG1
2021-01-11,PF/BT,190950.0,HSP11 - ASSOCIAZIONE OASI MARIA SS,SIC,60-69,4,17,0,9,0,0,12,21,0,21,Sicilia,ITG1
2021-01-11,PF/BT,19096001.0,HSP11 - IRCCS Centro Neurolesi,SIC,20-29,2,1,0,2,0,0,1,3,0,3,Sicilia,ITG1
2021-01-11,PF/BT,19096001.0,HSP11 - IRCCS Centro Neurolesi,SIC,30-39,4,4,0,6,1,0,1,8,0,8,Sicilia,ITG1
2021-01-11,PF/BT,19096001.0,HSP11 - IRCCS Centro Neurolesi,SIC,40-49,7,6,0,9,2,0,2,13,0,13,Sicilia,ITG1
2021-01-11,PF/BT,19096001.0,HSP11 - IRCCS Centro Neurolesi,SIC,50-59,6,5,0,9,0,0,2,11,0,11,Sicilia,ITG1
2021-01-11,PF/BT,19096001.0,HSP11 - IRCCS Centro Neurolesi,SIC,60-69,28,16,0,44,0,0,0,44,0,44,Sicilia,ITG1
2021-01-11,PF/BT,19096001.0,HSP11 - IRCCS Centro Neurolesi,SIC,70-79,4,1,0,5,0,0,0,5,0,5,Sicilia,ITG1
2021-01-11,PF/BT,19096002.0,HSP11 - PRESIDIO OSPEDALIERO PIEMONTE,SIC,20-29,0,3,0,2,0,0,1,3,0,3,Sicilia,ITG1
2021-01-11,PF/BT,19096002.0,HSP11 - PRESIDIO OSPEDALIERO PIEMONTE,SIC,30-39,2,4,0,5,0,0,1,6,0,6,Sicilia,ITG1
2021-01-11,PF/BT,19096002.0,HSP11 - PRESIDIO OSPEDALIERO PIEMONTE,SIC,40-49,1,7,0,6,0,0,2,8,0,8,Sicilia,ITG1
2021-01-11,PF/BT,19096002.0,HSP11 - PRESIDIO OSPEDALIERO PIEMONTE,SIC,50-59,7,2,0,4,0,0,5,9,0,9,Sicilia,ITG1
2021-01-11,PF/BT,19096002.0,HSP11 - PRESIDIO OSPEDALIERO PIEMONTE,SIC,60-69,2,2,0,2,0,0,2,4,0,4,Sicilia,ITG1
2021-01-11,PF/BT,600123.0,STS11 - POLIAMBULATORIO,SIC,40-49,1,0,0,1,0,0,0,1,0,1,Sicilia,ITG1
2021-01-11,PF/BT,600123.0,STS11 - POLIAMBULATORIO,SIC,50-59,1,1,0,2,0,0,0,2,0,2,Sicilia,ITG1
2021-01-11,PF/BT,600123.0,STS11 - POLIAMBULATORIO,SIC,70-79,2,1,0,0,0,0,3,3,0,3,Sicilia,ITG1
2021-01-11,PF/BT,600123.0,STS11 - POLIAMBULATORIO,SIC,80-89,16,14,0,0,0,0,30,30,0,30,Sicilia,ITG1
2021-01-11,PF/BT,600123.0,STS11 - POLIAMBULATORIO,SIC,90+,5,1,0,0,0,0,6,6,0,6,Sicilia,ITG1
2021-01-11,PF/BT,608400.0,STS11 - POLIAMBULATORIO  San Luigi,SIC,20-29,1,4,0,2,3,0,0,5,0,5,Sicilia,ITG1
2021-01-11,PF/BT,608400.0,STS11 - POLIAMBULATORIO  San Luigi,SIC,30-39,11,10,0,14,7,0,0,21,0,21,Sicilia,ITG1
2021-01-11,PF/BT,608400.0,STS11 - POLIAMBULATORIO  San Luigi,SIC,40-49,4,9,0,7,6,0,0,13,0,13,Sicilia,ITG1
2021-01-11,PF/BT,608400.0,STS11 - POLIAMBULATORIO  San Luigi,SIC,50-59,5,11,0,9,7,0,0,16,0,16,Sicilia,ITG1
2021-01-11,PF/BT,608400.0,STS11 - POLIAMBULATORIO  San Luigi,SIC,60-69,7,6,0,9,4,0,0,13,0,13,Sicilia,ITG1
2021-01-11,PF/BT,608400.0,STS11 - POLIAMBULATORIO  San Luigi,SIC,70-79,3,1,0,4,0,0,0,4,0,4,Sicilia,ITG1
2021-01-11,PF/BT,800941.0,STS11 - CTA VILLA SAN GIORGIO srl,SIC,30-39,0,1,0,1,0,0,0,1,0,1,Sicilia,ITG1
2021-01-11,PF/BT,800941.0,STS11 - CTA VILLA SAN GIORGIO srl,SIC,40-49,1,0,0,0,0,1,0,1,0,1,Sicilia,ITG1
2021-01-11,PF/BT,800941.0,STS11 - CTA VILLA SAN GIORGIO srl,SIC,60-69,0,2,0,0,0,2,0,2,0,2,Sicilia,ITG1
2021-01-11,PF/BT,800941.0,STS11 - CTA VILLA SAN GIORGIO srl,SIC,70-79,1,5,0,1,0,5,0,6,0,6,Sicilia,ITG1
2021-01-11,PF/BT,800941.0,STS11 - CTA VILLA SAN GIORGIO srl,SIC,80-89,6,15,0,0,0,21,0,21,0,21,Sicilia,ITG1
2021-01-11,PF/BT,800941.0,STS11 - CTA VILLA SAN GIORGIO srl,SIC,90+,3,8,0,0,0,11,0,11,0,11,Sicilia,ITG1
2021-01-11,PF/BT,808200.0,STS11 - CTA VILLA ERMINIA,SIC,30-39,2,4,0,2,1,0,3,6,0,6,Sicilia,ITG1
2021-01-11,PF/BT,808200.0,STS11 - CTA VILLA ERMINIA,SIC,40-49,7,1,0,1,0,0,7,8,0,8,Sicilia,ITG1
2021-01-11,PF/BT,808200.0,STS11 - CTA VILLA ERMINIA,SIC,50-59,14,5,0,5,2,0,12,19,0,19,Sicilia,ITG1
2021-01-11,PF/BT,808200.0,STS11 - CTA VILLA ERMINIA,SIC,60-69,8,5,0,3,4,0,6,13,0,13,Sicilia,ITG1
2021-01-11,PF/BT,808200.0,STS11 - CTA VILLA ERMINIA,SIC,70-79,2,0,0,0,1,0,1,2,0,2,Sicilia,ITG1
2021-01-11,PF/BT,810600.0,STS11 - COMUN. TERAP. ASSISTITA SALUS,SIC,30-39,1,0,0,0,0,1,0,1,0,1,Sicilia,ITG1
2021-01-11,PF/BT,810600.0,STS11 - COMUN. TERAP. ASSISTITA SALUS,SIC,40-49,0,2,0,1,0,1,0,2,0,2,Sicilia,ITG1
2021-01-11,PF/BT,810600.0,STS11 - COMUN. TERAP. ASSISTITA SALUS,SIC,60-69,2,1,0,1,0,2,0,3,0,3,Sicilia,ITG1
2021-01-11,PF/BT,810600.0,STS11 - COMUN. TERAP. ASSISTITA SALUS,SIC,70-79,1,0,0,0,0,1,0,1,0,1,Sicilia,ITG1
2021-01-11,PF/BT,810600.0,STS11 - COMUN. TERAP. ASSISTITA SALUS,SIC,80-89,0,2,0,0,0,2,0,2,0,2,Sicilia,ITG1
2021-01-11,PF/BT,810600.0,STS11 - COMUN. TERAP. ASSISTITA SALUS,SIC,90+,2,0,0,0,0,2,0,2,0,2,Sicilia,ITG1
2021-01-11,PF/BT,831200.0,STS11 - VILLA LISA SRL,SIC,20-29,1,0,0,1,0,0,0,1,0,1,Sicilia,ITG1
2021-01-11,PF/BT,831200.0,STS11 - VILLA LISA SRL,SIC,30-39,3,0,0,3,0,0,0,3,0,3,Sicilia,ITG1
2021-01-11,PF/BT,831200.0,STS11 - VILLA LISA SRL,SIC,40-49,1,1,0,2,0,0,0,2,0,2,Sicilia,ITG1
2021-01-11,PF/BT,831200.0,STS11 - VILLA LISA SRL,SIC,50-59,1,0,0,1,0,0,0,1,0,1,Sicilia,ITG1
2021-01-11,PF/BT,831200.0,STS11 - VILLA LISA SRL,SIC,60-69,1,1,0,2,0,0,0,2,0,2,Sicilia,ITG1
2021-01-11,PF/BT,834500.0,STS11 - RSA SANTA ROSA srl,SIC,40-49,0,1,0,1,0,0,0,1,0,1,Sicilia,ITG1
2021-01-11,PF/BT,834500.0,STS11 - RSA SANTA ROSA srl,SIC,50-59,0,1,0,1,0,0,0,1,0,1,Sicilia,ITG1
2021-01-11,PF/BT,834500.0,STS11 - RSA SANTA ROSA srl,SIC,60-69,1,0,0,1,0,0,0,1,0,1,Sicilia,ITG1
2021-01-11,PF/BT,834500.0,STS11 - RSA SANTA ROSA srl,SIC,70-79,2,3,0,0,0,5,0,5,0,5,Sicilia,ITG1
2021-01-11,PF/BT,834500.0,STS11 - RSA SANTA ROSA srl,SIC,80-89,3,11,0,0,0,14,0,14,0,14,Sicilia,ITG1
2021-01-11,PF/BT,834500.0,STS11 - RSA SANTA ROSA srl,SIC,90+,1,4,0,0,0,5,0,5,0,5,Sicilia,ITG1
2021-01-12,PF/BT,1902027.0,STRUTTURE PRIVATE NON CODIFICATE NSIS,SIC,20-29,3,2,0,5,0,0,0,5,0,5,Sicilia,ITG1
2021-01-12,PF/BT,1902027.0,STRUTTURE PRIVATE NON CODIFICATE NSIS,SIC,40-49,0,6,0,3,2,1,0,6,0,6,Sicilia,ITG1
2021-01-12,PF/BT,1902027.0,STRUTTURE PRIVATE NON CODIFICATE NSIS,SIC,50-59,1,4,0,4,0,1,0,5,0,5,Sicilia,ITG1
2021-01-12,PF/BT,1902027.0,STRUTTURE PRIVATE NON CODIFICATE NSIS,SIC,60-69,0,2,0,0,0,2,0,2,0,2,Sicilia,ITG1
2021-01-12,PF/BT,1902027.0,STRUTTURE PRIVATE NON CODIFICATE NSIS,SIC,70-79,4,5,0,0,0,9,0,9,0,9,Sicilia,ITG1
2021-01-12,PF/BT,1902027.0,STRUTTURE PRIVATE NON CODIFICATE NSIS,SIC,80-89,5,16,0,0,0,21,0,21,0,21,Sicilia,ITG1
2021-01-12,PF/BT,1902027.0,STRUTTURE PRIVATE NON CODIFICATE NSIS,SIC,90+,3,10,0,0,0,13,0,13,0,13,Sicilia,ITG1
2021-01-12,PF/BT,1902047.0,STRUTTURE PRIVATE NON CODIFICATE NSIS,SIC,20-29,3,0,0,3,0,0,0,3,0,3,Sicilia,ITG1
2021-01-12,PF/BT,1902047.0,STRUTTURE PRIVATE NON CODIFICATE NSIS,SIC,30-39,1,5,0,6,0,0,0,6,0,6,Sicilia,ITG1
2021-01-12,PF/BT,1902047.0,STRUTTURE PRIVATE NON CODIFICATE NSIS,SIC,40-49,4,9,0,11,0,1,1,13,0,13,Sicilia,ITG1
2021-01-12,PF/BT,1902047.0,STRUTTURE PRIVATE NON CODIFICATE NSIS,SIC,50-59,4,13,0,15,0,1,1,17,0,17,Sicilia,ITG1
2021-01-12,PF/BT,1902047.0,STRUTTURE PRIVATE NON CODIFICATE NSIS,SIC,60-69,7,10,0,13,0,4,0,17,0,17,Sicilia,ITG1
2021-01-12,PF/BT,1902047.0,STRUTTURE PRIVATE NON CODIFICATE NSIS,SIC,70-79,1,6,0,0,0,6,1,7,0,7,Sicilia,ITG1
2021-01-12,PF/BT,1902047.0,STRUTTURE PRIVATE NON CODIFICATE NSIS,SIC,80-89,5,15,0,1,0,18,1,20,0,20,Sicilia,ITG1
2021-01-12,PF/BT,1902047.0,STRUTTURE PRIVATE NON CODIFICATE NSIS,SIC,90+,2,11,0,0,0,13,0,13,0,13,Sicilia,ITG1
2021-01-12,PF/BT,190205.0,CITTADELLA DELLA SALUTE,SIC,20-29,2,0,0,0,1,0,1,2,0,2,Sicilia,ITG1
2021-01-12,PF/BT,190205.0,CITTADELLA DELLA SALUTE,SIC,30-39,3,2,0,1,3,0,1,5,0,5,Sicilia,ITG1
2021-01-12,PF/BT,190205.0,CITTADELLA DELLA SALUTE,SIC,40-49,11,3,0,2,9,0,3,14,0,14,Sicilia,ITG1
2021-01-12,PF/BT,190205.0,CITTADELLA DELLA SALUTE,SIC,50-59,18,5,0,8,8,0,7,23,0,23,Sicilia,ITG1
2021-01-12,PF/BT,190205.0,CITTADELLA DELLA SALUTE,SIC,60-69,8,1,0,5,4,0,0,9,0,9,Sicilia,ITG1
2021-01-12,PF/BT,1902057.0,STRUTTURE PRIVATE NON CODIFICATE NSIS,SIC,30-39,1,2,0,3,0,0,0,3,0,3,Sicilia,ITG1
2021-01-12,PF/BT,1902057.0,STRUTTURE PRIVATE NON CODIFICATE NSIS,SIC,40-49,2,2,0,3,1,0,0,4,0,4,Sicilia,ITG1
2021-01-12,PF/BT,1902057.0,STRUTTURE PRIVATE NON CODIFICATE NSIS,SIC,50-59,3,3,0,6,0,0,0,6,0,6,Sicilia,ITG1
2021-01-12,PF/BT,1902057.0,STRUTTURE PRIVATE NON CODIFICATE NSIS,SIC,70-79,0,1,0,0,0,1,0,1,0,1,Sicilia,ITG1
2021-01-12,PF/BT,1902057.0,STRUTTURE PRIVATE NON CODIFICATE NSIS,SIC,80-89,1,1,0,0,0,2,0,2,0,2,Sicilia,ITG1
2021-01-12,PF/BT,1902072.0,AMBULATORI VACCINALI NON CODIFICATI NSIS,SIC,20-29,0,2,0,2,0,0,0,2,0,2,Sicilia,ITG1
2021-01-12,PF/BT,1902072.0,AMBULATORI VACCINALI NON CODIFICATI NSIS,SIC,30-39,2,6,0,7,0,0,1,8,0,8,Sicilia,ITG1
2021-01-12,PF/BT,1902072.0,AMBULATORI VACCINALI NON CODIFICATI NSIS,SIC,40-49,5,11,0,8,8,0,0,16,0,16,Sicilia,ITG1
2021-01-12,PF/BT,1902072.0,AMBULATORI VACCINALI NON CODIFICATI NSIS,SIC,50-59,6,17,0,18,4,1,0,23,0,23,Sicilia,ITG1
2021-01-12,PF/BT,1902072.0,AMBULATORI VACCINALI NON CODIFICATI NSIS,SIC,60-69,7,5,0,6,3,2,1,12,0,12,Sicilia,ITG1
2021-01-12,PF/BT,1902072.0,AMBULATORI VACCINALI NON CODIFICATI NSIS,SIC,70-79,5,4,0,3,0,6,0,9,0,9,Sicilia,ITG1
2021-01-12,PF/BT,1902072.0,AMBULATORI VACCINALI NON CODIFICATI NSIS,SIC,80-89,4,7,0,0,0,11,0,11,0,11,Sicilia,ITG1
2021-01-12,PF/BT,1902072.0,AMBULATORI VACCINALI NON CODIFICATI NSIS,SIC,90+,4,4,0,0,0,8,0,8,0,8,Sicilia,ITG1
2021-01-12,PF/BT,1902077.0,STRUTTURE PRIVATE NON CODIFICATE NSIS,SIC,20-29,1,1,0,2,0,0,0,2,0,2,Sicilia,ITG1
2021-01-12,PF/BT,1902077.0,STRUTTURE PRIVATE NON CODIFICATE NSIS,SIC,30-39,1,2,0,3,0,0,0,3,0,3,Sicilia,ITG1
2021-01-12,PF/BT,1902077.0,STRUTTURE PRIVATE NON CODIFICATE NSIS,SIC,40-49,1,5,0,5,0,1,0,6,0,6,Sicilia,ITG1
2021-01-12,PF/BT,1902077.0,STRUTTURE PRIVATE NON CODIFICATE NSIS,SIC,50-59,4,7,0,10,0,1,0,11,0,11,Sicilia,ITG1
2021-01-12,PF/BT,1902077.0,STRUTTURE PRIVATE NON CODIFICATE NSIS,SIC,60-69,1,3,0,2,0,1,1,4,0,4,Sicilia,ITG1
2021-01-12,PF/BT,1902077.0,STRUTTURE PRIVATE NON CODIFICATE NSIS,SIC,70-79,3,2,0,1,0,4,0,5,0,5,Sicilia,ITG1
2021-01-12,PF/BT,1902077.0,STRUTTURE PRIVATE NON CODIFICATE NSIS,SIC,80-89,6,14,0,0,0,18,2,20,0,20,Sicilia,ITG1
2021-01-12,PF/BT,1902077.0,STRUTTURE PRIVATE NON CODIFICATE NSIS,SIC,90+,2,9,0,0,0,10,1,11,0,11,Sicilia,ITG1
2021-01-12,PF/BT,190302.0,RIA11 - C.DELLA SPERANZA DON ANGELO G.,SIC,20-29,0,1,0,0,0,0,1,1,0,1,Sicilia,ITG1
2021-01-12,PF/BT,190302.0,RIA11 - C.DELLA SPERANZA DON ANGELO G.,SIC,30-39,0,1,0,0,0,0,1,1,0,1,Sicilia,ITG1
2021-01-12,PF/BT,190302.0,RIA11 - C.DELLA SPERANZA DON ANGELO G.,SIC,40-49,6,1,0,0,0,0,7,7,0,7,Sicilia,ITG1
2021-01-12,PF/BT,190302.0,RIA11 - C.DELLA SPERANZA DON ANGELO G.,SIC,50-59,1,3,0,1,0,0,3,4,0,4,Sicilia,ITG1
2021-01-12,PF/BT,190302.0,RIA11 - C.DELLA SPERANZA DON ANGELO G.,SIC,60-69,7,1,0,0,0,0,8,8,0,8,Sicilia,ITG1
2021-01-12,PF/BT,190302.0,RIA11 - C.DELLA SPERANZA DON ANGELO G.,SIC,70-79,2,0,0,0,0,0,2,2,0,2,Sicilia,ITG1
2021-01-12,PF/BT,190302.0,RIA11 - C.DELLA SPERANZA DON ANGELO G.,SIC,80-89,1,0,0,0,0,0,1,1,0,1,Sicilia,ITG1
2021-01-12,PF/BT,190306.0,RIA11 - ASS. CASA FAM.ROSETTA ONILUS,SIC,16-19,0,1,0,1,0,0,0,1,0,1,Sicilia,ITG1
2021-01-12,PF/BT,190306.0,RIA11 - ASS. CASA FAM.ROSETTA ONILUS,SIC,20-29,16,4,0,16,4,0,0,20,0,20,Sicilia,ITG1
2021-01-12,PF/BT,190306.0,RIA11 - ASS. CASA FAM.ROSETTA ONILUS,SIC,30-39,11,5,0,15,1,0,0,16,0,16,Sicilia,ITG1
2021-01-12,PF/BT,190306.0,RIA11 - ASS. CASA FAM.ROSETTA ONILUS,SIC,40-49,15,10,0,17,7,0,1,25,0,25,Sicilia,ITG1
2021-01-12,PF/BT,190306.0,RIA11 - ASS. CASA FAM.ROSETTA ONILUS,SIC,50-59,18,13,0,22,9,0,0,31,0,31,Sicilia,ITG1
2021-01-12,PF/BT,190306.0,RIA11 - ASS. CASA FAM.ROSETTA ONILUS,SIC,60-69,14,6,0,19,0,0,1,20,0,20,Sicilia,ITG1
2021-01-12,PF/BT,190306.0,RIA11 - ASS. CASA FAM.ROSETTA ONILUS,SIC,70-79,3,0,0,1,1,1,0,3,0,3,Sicilia,ITG1
2021-01-12,PF/BT,190309.0,HSP11 - P.O. VITTORIO EMANUELE (ex AO),SIC,16-19,0,1,0,1,0,0,0,1,0,1,Sicilia,ITG1
2021-01-12,PF/BT,190309.0,HSP11 - P.O. VITTORIO EMANUELE (ex AO),SIC,20-29,7,6,0,5,0,0,8,13,0,13,Sicilia,ITG1
2021-01-12,PF/BT,190309.0,HSP11 - P.O. VITTORIO EMANUELE (ex AO),SIC,30-39,6,3,0,5,0,0,4,9,0,9,Sicilia,ITG1
2021-01-12,PF/BT,190309.0,HSP11 - P.O. VITTORIO EMANUELE (ex AO),SIC,40-49,6,13,0,13,0,0,6,19,0,19,Sicilia,ITG1
2021-01-12,PF/BT,190309.0,HSP11 - P.O. VITTORIO EMANUELE (ex AO),SIC,50-59,5,14,0,12,0,0,7,19,0,19,Sicilia,ITG1
2021-01-12,PF/BT,190309.0,HSP11 - P.O. VITTORIO EMANUELE (ex AO),SIC,60-69,12,4,0,10,0,0,6,16,0,16,Sicilia,ITG1
2021-01-12,PF/BT,190312.0,HSP11 - P.O. S. Marta e S. Venera Acireale,SIC,20-29,5,6,0,10,1,0,0,11,0,11,Sicilia,ITG1
2021-01-12,PF/BT,190312.0,HSP11 - P.O. S. Marta e S. Venera Acireale,SIC,30-39,16,12,0,22,6,0,0,28,0,28,Sicilia,ITG1
2021-01-12,PF/BT,190312.0,HSP11 - P.O. S. Marta e S. Venera Acireale,SIC,40-49,10,17,0,17,10,0,0,27,0,27,Sicilia,ITG1
2021-01-12,PF/BT,190312.0,HSP11 - P.O. S. Marta e S. Venera Acireale,SIC,50-59,8,22,0,22,8,0,0,30,0,30,Sicilia,ITG1
2021-01-12,PF/BT,190312.0,HSP11 - P.O. S. Marta e S. Venera Acireale,SIC,60-69,14,7,0,17,4,0,0,21,0,21,Sicilia,ITG1
2021-01-12,PF/BT,190312.0,HSP11 - P.O. S. Marta e S. Venera Acireale,SIC,70-79,1,1,0,0,2,0,0,2,0,2,Sicilia,ITG1
2021-01-12,PF/BT,190312.0,HSP11 - P.O. S. Marta e S. Venera Acireale,SIC,80-89,0,1,0,0,1,0,0,1,0,1,Sicilia,ITG1
2021-01-12,PF/BT,190313.0,RIA11 - IST.RIAB.VILLAG. SAN GIUSEPPE,SIC,20-29,3,2,0,4,0,0,1,5,0,5,Sicilia,ITG1
2021-01-12,PF/BT,190313.0,RIA11 - IST.RIAB.VILLAG. SAN GIUSEPPE,SIC,30-39,5,7,0,10,0,0,2,12,0,12,Sicilia,ITG1
2021-01-12,PF/BT,190313.0,RIA11 - IST.RIAB.VILLAG. SAN GIUSEPPE,SIC,40-49,4,3,0,6,0,0,1,7,0,7,Sicilia,ITG1
2021-01-12,PF/BT,190313.0,RIA11 - IST.RIAB.VILLAG. SAN GIUSEPPE,SIC,50-59,9,10,0,16,0,0,3,19,0,19,Sicilia,ITG1
2021-01-12,PF/BT,190313.0,RIA11 - IST.RIAB.VILLAG. SAN GIUSEPPE,SIC,60-69,9,7,0,13,0,0,3,16,0,16,Sicilia,ITG1
2021-01-12,PF/BT,190313.0,RIA11 - IST.RIAB.VILLAG. SAN GIUSEPPE,SIC,70-79,1,0,0,1,0,0,0,1,0,1,Sicilia,ITG1
2021-01-12,PF/BT,190314.0,RIA11 - ASS.J.F.KENNEDY ACIREALE,SIC,20-29,1,1,0,2,0,0,0,2,0,2,Sicilia,ITG1
2021-01-12,PF/BT,190314.0,RIA11 - ASS.J.F.KENNEDY ACIREALE,SIC,30-39,4,7,0,11,0,0,0,11,0,11,Sicilia,ITG1
2021-01-12,PF/BT,190314.0,RIA11 - ASS.J.F.KENNEDY ACIREALE,SIC,40-49,4,4,0,8,0,0,0,8,0,8,Sicilia,ITG1
2021-01-12,PF/BT,190314.0,RIA11 - ASS.J.F.KENNEDY ACIREALE,SIC,50-59,6,6,0,12,0,0,0,12,0,12,Sicilia,ITG1
2021-01-12,PF/BT,190314.0,RIA11 - ASS.J.F.KENNEDY ACIREALE,SIC,60-69,7,5,0,12,0,0,0,12,0,12,Sicilia,ITG1
2021-01-12,PF/BT,190314.0,RIA11 - ASS.J.F.KENNEDY ACIREALE,SIC,70-79,2,1,0,3,0,0,0,3,0,3,Sicilia,ITG1
2021-01-12,PF/BT,190316.0,RIA11 - ASS.J.F.KENNEDY - C.RIAB.ONLUS,SIC,16-19,0,1,0,1,0,0,0,1,0,1,Sicilia,ITG1
2021-01-12,PF/BT,190316.0,RIA11 - ASS.J.F.KENNEDY - C.RIAB.ONLUS,SIC,20-29,1,4,0,5,0,0,0,5,0,5,Sicilia,ITG1
2021-01-12,PF/BT,190316.0,RIA11 - ASS.J.F.KENNEDY - C.RIAB.ONLUS,SIC,30-39,4,2,0,6,0,0,0,6,0,6,Sicilia,ITG1
2021-01-12,PF/BT,190316.0,RIA11 - ASS.J.F.KENNEDY - C.RIAB.ONLUS,SIC,40-49,4,12,0,15,1,0,0,16,0,16,Sicilia,ITG1
2021-01-12,PF/BT,190316.0,RIA11 - ASS.J.F.KENNEDY - C.RIAB.ONLUS,SIC,50-59,3,7,0,9,1,0,0,10,0,10,Sicilia,ITG1
2021-01-12,PF/BT,190316.0,RIA11 - ASS.J.F.KENNEDY - C.RIAB.ONLUS,SIC,60-69,8,8,0,16,0,0,0,16,0,16,Sicilia,ITG1
2021-01-12,PF/BT,190317.0,HSP11 - P.O. Gravina e S. Pietro Caltagirone,SIC,20-29,4,4,0,5,3,0,0,8,0,8,Sicilia,ITG1
2021-01-12,PF/BT,190317.0,HSP11 - P.O. Gravina e S. Pietro Caltagirone,SIC,30-39,4,12,0,14,2,0,0,16,0,16,Sicilia,ITG1
2021-01-12,PF/BT,190317.0,HSP11 - P.O. Gravina e S. Pietro Caltagirone,SIC,40-49,6,6,0,9,3,0,0,12,0,12,Sicilia,ITG1
2021-01-12,PF/BT,190317.0,HSP11 - P.O. Gravina e S. Pietro Caltagirone,SIC,50-59,10,14,0,17,7,0,0,24,0,24,Sicilia,ITG1
2021-01-12,PF/BT,190317.0,HSP11 - P.O. Gravina e S. Pietro Caltagirone,SIC,60-69,8,14,0,16,6,0,0,22,0,22,Sicilia,ITG1
2021-01-12,PF/BT,190317.0,HSP11 - P.O. Gravina e S. Pietro Caltagirone,SIC,70-79,1,0,0,1,0,0,0,1,0,1,Sicilia,ITG1
2021-01-12,PF/BT,190317.0,HSP11 - P.O. Gravina e S. Pietro Caltagirone,SIC,80-89,0,1,0,1,0,0,0,1,0,1,Sicilia,ITG1
2021-01-12,PF/BT,190318.0,RIA11 - ASS.ISTITUTO REGINA VIRGINUM,SIC,20-29,0,1,0,0,1,0,0,1,0,1,Sicilia,ITG1
2021-01-12,PF/BT,190318.0,RIA11 - ASS.ISTITUTO REGINA VIRGINUM,SIC,30-39,1,1,0,1,1,0,0,2,0,2,Sicilia,ITG1
2021-01-12,PF/BT,190318.0,RIA11 - ASS.ISTITUTO REGINA VIRGINUM,SIC,40-49,4,0,0,4,0,0,0,4,0,4,Sicilia,ITG1
2021-01-12,PF/BT,190318.0,RIA11 - ASS.ISTITUTO REGINA VIRGINUM,SIC,50-59,3,2,0,5,0,0,0,5,0,5,Sicilia,ITG1
2021-01-12,PF/BT,190318.0,RIA11 - ASS.ISTITUTO REGINA VIRGINUM,SIC,60-69,2,2,0,4,0,0,0,4,0,4,Sicilia,ITG1
2021-01-12,PF/BT,190318.0,RIA11 - ASS.ISTITUTO REGINA VIRGINUM,SIC,70-79,2,0,0,2,0,0,0,2,0,2,Sicilia,ITG1
2021-01-12,PF/BT,190319.0,HSP11 - P. O. UMBERTO I,SIC,20-29,1,2,0,1,1,0,1,3,0,3,Sicilia,ITG1
2021-01-12,PF/BT,190319.0,HSP11 - P. O. UMBERTO I,SIC,30-39,3,6,0,5,0,0,4,9,0,9,Sicilia,ITG1
2021-01-12,PF/BT,190319.0,HSP11 - P. O. UMBERTO I,SIC,40-49,4,2,0,2,2,0,2,6,0,6,Sicilia,ITG1
2021-01-12,PF/BT,190319.0,HSP11 - P. O. UMBERTO I,SIC,50-59,3,7,0,10,0,0,0,10,0,10,Sicilia,ITG1
2021-01-12,PF/BT,190319.0,HSP11 - P. O. UMBERTO I,SIC,60-69,2,4,0,4,1,0,1,6,0,6,Sicilia,ITG1
2021-01-12,PF/BT,190319.0,HSP11 - P. O. UMBERTO I,SIC,70-79,1,0,0,1,0,0,0,1,0,1,Sicilia,ITG1
2021-01-12,PF/BT,190326.0,HSP11 - P.O. S. VINCENZO TAORMINA,SIC,20-29,1,2,0,1,2,0,0,3,0,3,Sicilia,ITG1
2021-01-12,PF/BT,190326.0,HSP11 - P.O. S. VINCENZO TAORMINA,SIC,30-39,6,9,0,13,2,0,0,15,0,15,Sicilia,ITG1
2021-01-12,PF/BT,190326.0,HSP11 - P.O. S. VINCENZO TAORMINA,SIC,40-49,12,17,0,23,6,0,0,29,0,29,Sicilia,ITG1
2021-01-12,PF/BT,190326.0,HSP11 - P.O. S. VINCENZO TAORMINA,SIC,50-59,22,28,0,38,12,0,0,50,0,50,Sicilia,ITG1
2021-01-12,PF/BT,190326.0,HSP11 - P.O. S. VINCENZO TAORMINA,SIC,60-69,9,14,0,18,5,0,0,23,0,23,Sicilia,ITG1
2021-01-12,PF/BT,190328.0,HSP11 - P.O. BARONE-ROMEO PATTI,SIC,30-39,0,1,0,1,0,0,0,1,0,1,Sicilia,ITG1
2021-01-12,PF/BT,190330.0,HSP11 - P.O. DEI BIANCHI CORLEONE,SIC,20-29,0,3,0,2,1,0,0,3,0,3,Sicilia,ITG1
2021-01-12,PF/BT,190330.0,HSP11 - P.O. DEI BIANCHI CORLEONE,SIC,30-39,1,2,0,2,1,0,0,3,0,3,Sicilia,ITG1
2021-01-12,PF/BT,190330.0,HSP11 - P.O. DEI BIANCHI CORLEONE,SIC,40-49,6,4,0,8,2,0,0,10,0,10,Sicilia,ITG1
2021-01-12,PF/BT,190330.0,HSP11 - P.O. DEI BIANCHI CORLEONE,SIC,50-59,3,2,0,2,3,0,0,5,0,5,Sicilia,ITG1
2021-01-12,PF/BT,190330.0,HSP11 - P.O. DEI BIANCHI CORLEONE,SIC,60-69,5,6,0,6,3,0,2,11,0,11,Sicilia,ITG1
2021-01-12,PF/BT,190330.0,HSP11 - P.O. DEI BIANCHI CORLEONE,SIC,70-79,4,0,0,2,2,0,0,4,0,4,Sicilia,ITG1
2021-01-12,PF/BT,190332.0,HSP11 - P.O. CIVICO PARTINICO,SIC,20-29,6,3,0,9,0,0,0,9,0,9,Sicilia,ITG1
2021-01-12,PF/BT,190332.0,HSP11 - P.O. CIVICO PARTINICO,SIC,30-39,6,5,0,11,0,0,0,11,0,11,Sicilia,ITG1
2021-01-12,PF/BT,190332.0,HSP11 - P.O. CIVICO PARTINICO,SIC,40-49,10,6,0,14,2,0,0,16,0,16,Sicilia,ITG1
2021-01-12,PF/BT,190332.0,HSP11 - P.O. CIVICO PARTINICO,SIC,50-59,10,11,0,16,5,0,0,21,0,21,Sicilia,ITG1
2021-01-12,PF/BT,190332.0,HSP11 - P.O. CIVICO PARTINICO,SIC,60-69,14,5,0,18,1,0,0,19,0,19,Sicilia,ITG1
2021-01-12,PF/BT,190332.0,HSP11 - P.O. CIVICO PARTINICO,SIC,70-79,8,2,0,10,0,0,0,10,0,10,Sicilia,ITG1
2021-01-12,PF/BT,190332.0,HSP11 - P.O. CIVICO PARTINICO,SIC,80-89,2,0,0,2,0,0,0,2,0,2,Sicilia,ITG1
2021-01-12,PF/BT,190332.0,HSP11 - P.O. CIVICO PARTINICO,SIC,90+,1,0,0,1,0,0,0,1,0,1,Sicilia,ITG1
2021-01-12,PF/BT,190333.0,HSP11 - P.O. MADONNA DELLALTO - PETR. SOTTANA,SIC,16-19,2,2,0,0,0,0,4,4,0,4,Sicilia,ITG1
2021-01-12,PF/BT,190333.0,HSP11 - P.O. MADONNA DELLALTO - PETR. SOTTANA,SIC,20-29,3,0,0,0,0,0,3,3,0,3,Sicilia,ITG1
2021-01-12,PF/BT,190333.0,HSP11 - P.O. MADONNA DELLALTO - PETR. SOTTANA,SIC,30-39,5,5,0,2,3,0,5,10,0,10,Sicilia,ITG1
2021-01-12,PF/BT,190333.0,HSP11 - P.O. MADONNA DELLALTO - PETR. SOTTANA,SIC,40-49,7,4,0,7,1,0,3,11,0,11,Sicilia,ITG1
2021-01-12,PF/BT,190333.0,HSP11 - P.O. MADONNA DELLALTO - PETR. SOTTANA,SIC,50-59,2,2,0,3,0,0,1,4,0,4,Sicilia,ITG1
2021-01-12,PF/BT,190333.0,HSP11 - P.O. MADONNA DELLALTO - PETR. SOTTANA,SIC,60-69,3,3,0,3,0,1,2,6,0,6,Sicilia,ITG1
2021-01-12,PF/BT,190333.0,HSP11 - P.O. MADONNA DELLALTO - PETR. SOTTANA,SIC,70-79,3,2,0,1,0,1,3,5,0,5,Sicilia,ITG1
2021-01-12,PF/BT,190333.0,HSP11 - P.O. MADONNA DELLALTO - PETR. SOTTANA,SIC,80-89,2,2,0,1,0,1,2,4,0,4,Sicilia,ITG1
2021-01-12,PF/BT,190333.0,HSP11 - P.O. MADONNA DELLALTO - PETR. SOTTANA,SIC,90+,1,0,0,0,0,1,0,1,0,1,Sicilia,ITG1
2021-01-12,PF/BT,190334.0,HSP11 - P.O. S. CIMINO TERMINI IMERESE,SIC,20-29,3,4,0,7,0,0,0,7,0,7,Sicilia,ITG1
2021-01-12,PF/BT,190334.0,HSP11 - P.O. S. CIMINO TERMINI IMERESE,SIC,30-39,4,3,0,6,1,0,0,7,0,7,Sicilia,ITG1
2021-01-12,PF/BT,190334.0,HSP11 - P.O. S. CIMINO TERMINI IMERESE,SIC,40-49,14,9,0,22,1,0,0,23,0,23,Sicilia,ITG1
2021-01-12,PF/BT,190334.0,HSP11 - P.O. S. CIMINO TERMINI IMERESE,SIC,50-59,17,7,0,22,2,0,0,24,0,24,Sicilia,ITG1
2021-01-12,PF/BT,190334.0,HSP11 - P.O. S. CIMINO TERMINI IMERESE,SIC,60-69,7,8,0,14,1,0,0,15,0,15,Sicilia,ITG1
2021-01-12,PF/BT,190334.0,HSP11 - P.O. S. CIMINO TERMINI IMERESE,SIC,70-79,8,0,0,8,0,0,0,8,0,8,Sicilia,ITG1
2021-01-12,PF/BT,190335.0,HSP11 - P.O. G. F. INGRASSIA,SIC,20-29,1,3,0,4,0,0,0,4,0,4,Sicilia,ITG1
2021-01-12,PF/BT,190335.0,HSP11 - P.O. G. F. INGRASSIA,SIC,30-39,4,3,0,7,0,0,0,7,0,7,Sicilia,ITG1
2021-01-12,PF/BT,190335.0,HSP11 - P.O. G. F. INGRASSIA,SIC,40-49,2,2,0,4,0,0,0,4,0,4,Sicilia,ITG1
2021-01-12,PF/BT,190335.0,HSP11 - P.O. G. F. INGRASSIA,SIC,50-59,6,3,0,9,0,0,0,9,0,9,Sicilia,ITG1
2021-01-12,PF/BT,190335.0,HSP11 - P.O. G. F. INGRASSIA,SIC,60-69,8,6,0,10,2,0,2,14,0,14,Sicilia,ITG1
2021-01-12,PF/BT,190335.0,HSP11 - P.O. G. F. INGRASSIA,SIC,70-79,3,1,0,4,0,0,0,4,0,4,Sicilia,ITG1
2021-01-12,PF/BT,190337.0,HSP11 - P.O. VILLA DELLE GINESTRE,SIC,20-29,4,7,0,7,3,0,1,11,0,11,Sicilia,ITG1
2021-01-12,PF/BT,190337.0,HSP11 - P.O. VILLA DELLE GINESTRE,SIC,30-39,10,10,0,6,11,0,3,20,0,20,Sicilia,ITG1
2021-01-12,PF/BT,190337.0,HSP11 - P.O. VILLA DELLE GINESTRE,SIC,40-49,15,28,0,25,13,0,5,43,0,43,Sicilia,ITG1
2021-01-12,PF/BT,190337.0,HSP11 - P.O. VILLA DELLE GINESTRE,SIC,50-59,22,26,0,20,24,0,4,48,0,48,Sicilia,ITG1
2021-01-12,PF/BT,190337.0,HSP11 - P.O. VILLA DELLE GINESTRE,SIC,60-69,33,29,0,46,16,0,0,62,0,62,Sicilia,ITG1
2021-01-12,PF/BT,190337.0,HSP11 - P.O. VILLA DELLE GINESTRE,SIC,70-79,14,3,0,17,0,0,0,17,0,17,Sicilia,ITG1
2021-01-12,PF/BT,190337.0,HSP11 - P.O. VILLA DELLE GINESTRE,SIC,80-89,1,0,0,1,0,0,0,1,0,1,Sicilia,ITG1
2021-01-12,PF/BT,190338.0,HSP11 - OSPEDALE Giovanni Paolo II° M.P. A.,SIC,20-29,0,1,0,0,1,0,0,1,0,1,Sicilia,ITG1
2021-01-12,PF/BT,190338.0,HSP11 - OSPEDALE Giovanni Paolo II° M.P. A.,SIC,30-39,5,5,0,3,7,0,0,10,0,10,Sicilia,ITG1
2021-01-12,PF/BT,190338.0,HSP11 - OSPEDALE Giovanni Paolo II° M.P. A.,SIC,40-49,7,24,0,9,22,0,0,31,0,31,Sicilia,ITG1
2021-01-12,PF/BT,190338.0,HSP11 - OSPEDALE Giovanni Paolo II° M.P. A.,SIC,50-59,3,19,0,7,13,0,2,22,0,22,Sicilia,ITG1
2021-01-12,PF/BT,190338.0,HSP11 - OSPEDALE Giovanni Paolo II° M.P. A.,SIC,60-69,2,6,0,4,4,0,0,8,0,8,Sicilia,ITG1
2021-01-12,PF/BT,190339.0,HSP11 - OSPEDALE REGINA MARGHERITA  COMISO,SIC,20-29,0,1,0,0,0,1,0,1,0,1,Sicilia,ITG1
2021-01-12,PF/BT,190339.0,HSP11 - OSPEDALE REGINA MARGHERITA  COMISO,SIC,30-39,1,1,0,2,0,0,0,2,0,2,Sicilia,ITG1
2021-01-12,PF/BT,190339.0,HSP11 - OSPEDALE REGINA MARGHERITA  COMISO,SIC,40-49,2,1,0,3,0,0,0,3,0,3,Sicilia,ITG1
2021-01-12,PF/BT,190339.0,HSP11 - OSPEDALE REGINA MARGHERITA  COMISO,SIC,50-59,6,8,0,14,0,0,0,14,0,14,Sicilia,ITG1
2021-01-12,PF/BT,190339.0,HSP11 - OSPEDALE REGINA MARGHERITA  COMISO,SIC,60-69,11,13,0,24,0,0,0,24,0,24,Sicilia,ITG1
2021-01-12,PF/BT,190339.0,HSP11 - OSPEDALE REGINA MARGHERITA  COMISO,SIC,90+,1,0,0,0,0,1,0,1,0,1,Sicilia,ITG1
2021-01-12,PF/BT,190343.0,HSP11 - P.O. DI MARIA AVOLA,SIC,30-39,1,1,0,2,0,0,0,2,0,2,Sicilia,ITG1
2021-01-12,PF/BT,190343.0,HSP11 - P.O. DI MARIA AVOLA,SIC,40-49,5,9,0,11,3,0,0,14,0,14,Sicilia,ITG1
2021-01-12,PF/BT,190343.0,HSP11 - P.O. DI MARIA AVOLA,SIC,50-59,11,16,0,17,10,0,0,27,0,27,Sicilia,ITG1
2021-01-12,PF/BT,190343.0,HSP11 - P.O. DI MARIA AVOLA,SIC,60-69,7,4,0,9,2,0,0,11,0,11,Sicilia,ITG1
2021-01-12,PF/BT,190345.0,HSP11 - P.O. UMBERTO I (EX A.O.),SIC,20-29,2,2,0,0,0,0,4,4,0,4,Sicilia,ITG1
2021-01-12,PF/BT,190345.0,HSP11 - P.O. UMBERTO I (EX A.O.),SIC,30-39,6,5,0,4,0,0,7,11,0,11,Sicilia,ITG1
2021-01-12,PF/BT,190345.0,HSP11 - P.O. UMBERTO I (EX A.O.),SIC,40-49,11,2,0,2,0,0,11,13,0,13,Sicilia,ITG1
2021-01-12,PF/BT,190345.0,HSP11 - P.O. UMBERTO I (EX A.O.),SIC,50-59,10,9,0,12,0,0,7,19,0,19,Sicilia,ITG1
2021-01-12,PF/BT,190345.0,HSP11 - P.O. UMBERTO I (EX A.O.),SIC,60-69,40,15,0,38,0,0,17,55,0,55,Sicilia,ITG1
2021-01-12,PF/BT,190345.0,HSP11 - P.O. UMBERTO I (EX A.O.),SIC,70-79,3,0,0,2,0,0,1,3,0,3,Sicilia,ITG1
2021-01-12,PF/BT,190349.0,HSP11 - P.O. SAN VITO E SANTO SPIRITO -ALCAMO,SIC,20-29,2,3,0,4,1,0,0,5,0,5,Sicilia,ITG1
2021-01-12,PF/BT,190349.0,HSP11 - P.O. SAN VITO E SANTO SPIRITO -ALCAMO,SIC,30-39,5,2,0,6,1,0,0,7,0,7,Sicilia,ITG1
2021-01-12,PF/BT,190349.0,HSP11 - P.O. SAN VITO E SANTO SPIRITO -ALCAMO,SIC,40-49,3,12,0,9,3,0,3,15,0,15,Sicilia,ITG1
2021-01-12,PF/BT,190349.0,HSP11 - P.O. SAN VITO E SANTO SPIRITO -ALCAMO,SIC,50-59,3,17,0,12,5,0,3,20,0,20,Sicilia,ITG1
2021-01-12,PF/BT,190349.0,HSP11 - P.O. SAN VITO E SANTO SPIRITO -ALCAMO,SIC,60-69,3,9,0,5,5,0,2,12,0,12,Sicilia,ITG1
2021-01-12,PF/BT,190349.0,HSP11 - P.O. SAN VITO E SANTO SPIRITO -ALCAMO,SIC,70-79,0,1,0,0,0,1,0,1,0,1,Sicilia,ITG1
2021-01-12,PF/BT,190349.0,HSP11 - P.O. SAN VITO E SANTO SPIRITO -ALCAMO,SIC,80-89,0,5,0,0,0,5,0,5,0,5,Sicilia,ITG1
2021-01-12,PF/BT,190349.0,HSP11 - P.O. SAN VITO E SANTO SPIRITO -ALCAMO,SIC,90+,0,4,0,0,0,4,0,4,0,4,Sicilia,ITG1
2021-01-12,PF/BT,190351.0,HSP11 - P.O. S. ANTONIO ABATE  - TRAPANI,SIC,16-19,0,1,0,1,0,0,0,1,0,1,Sicilia,ITG1
2021-01-12,PF/BT,190351.0,HSP11 - P.O. S. ANTONIO ABATE  - TRAPANI,SIC,20-29,14,3,0,17,0,0,0,17,0,17,Sicilia,ITG1
2021-01-12,PF/BT,190351.0,HSP11 - P.O. S. ANTONIO ABATE  - TRAPANI,SIC,30-39,10,12,0,14,8,0,0,22,0,22,Sicilia,ITG1
2021-01-12,PF/BT,190351.0,HSP11 - P.O. S. ANTONIO ABATE  - TRAPANI,SIC,40-49,17,13,0,19,11,0,0,30,0,30,Sicilia,ITG1
2021-01-12,PF/BT,190351.0,HSP11 - P.O. S. ANTONIO ABATE  - TRAPANI,SIC,50-59,16,22,0,18,20,0,0,38,0,38,Sicilia,ITG1
2021-01-12,PF/BT,190351.0,HSP11 - P.O. S. ANTONIO ABATE  - TRAPANI,SIC,60-69,14,20,0,23,11,0,0,34,0,34,Sicilia,ITG1
2021-01-12,PF/BT,190351.0,HSP11 - P.O. S. ANTONIO ABATE  - TRAPANI,SIC,70-79,2,0,0,2,0,0,0,2,0,2,Sicilia,ITG1
2021-01-12,PF/BT,190352.0,HSP11 - P.O. V.EMANUELE II CASTELVETRANO,SIC,20-29,2,7,0,5,4,0,0,9,0,9,Sicilia,ITG1
2021-01-12,PF/BT,190352.0,HSP11 - P.O. V.EMANUELE II CASTELVETRANO,SIC,30-39,4,11,0,8,6,0,1,15,0,15,Sicilia,ITG1
2021-01-12,PF/BT,190352.0,HSP11 - P.O. V.EMANUELE II CASTELVETRANO,SIC,40-49,3,19,0,12,7,0,3,22,0,22,Sicilia,ITG1
2021-01-12,PF/BT,190352.0,HSP11 - P.O. V.EMANUELE II CASTELVETRANO,SIC,50-59,8,19,0,11,11,0,5,27,0,27,Sicilia,ITG1
2021-01-12,PF/BT,190352.0,HSP11 - P.O. V.EMANUELE II CASTELVETRANO,SIC,60-69,3,2,0,2,2,0,1,5,0,5,Sicilia,ITG1
2021-01-12,PF/BT,190352.0,HSP11 - P.O. V.EMANUELE II CASTELVETRANO,SIC,70-79,0,1,0,1,0,0,0,1,0,1,Sicilia,ITG1
2021-01-12,PF/BT,190352.0,HSP11 - P.O. V.EMANUELE II CASTELVETRANO,SIC,80-89,1,3,0,0,0,0,4,4,0,4,Sicilia,ITG1
2021-01-12,PF/BT,190352.0,HSP11 - P.O. V.EMANUELE II CASTELVETRANO,SIC,90+,0,1,0,0,0,0,1,1,0,1,Sicilia,ITG1
2021-01-12,PF/BT,190353.0,HSP11 - P.O.PAOLO BORSELLINO - MARSALA,SIC,20-29,0,1,0,1,0,0,0,1,0,1,Sicilia,ITG1
2021-01-12,PF/BT,190353.0,HSP11 - P.O.PAOLO BORSELLINO - MARSALA,SIC,30-39,9,4,0,8,3,0,2,13,0,13,Sicilia,ITG1
2021-01-12,PF/BT,190353.0,HSP11 - P.O.PAOLO BORSELLINO - MARSALA,SIC,40-49,4,8,0,7,5,0,0,12,0,12,Sicilia,ITG1
2021-01-12,PF/BT,190353.0,HSP11 - P.O.PAOLO BORSELLINO - MARSALA,SIC,50-59,5,10,0,8,7,0,0,15,0,15,Sicilia,ITG1
2021-01-12,PF/BT,190353.0,HSP11 - P.O.PAOLO BORSELLINO - MARSALA,SIC,60-69,6,5,0,4,7,0,0,11,0,11,Sicilia,ITG1
2021-01-12,PF/BT,190353.0,HSP11 - P.O.PAOLO BORSELLINO - MARSALA,SIC,70-79,2,0,0,2,0,0,0,2,0,2,Sicilia,ITG1
2021-01-12,PF/BT,190354.0,HSP11 - P.O.ABELE AJELLO-MAZARA D.VALLO,SIC,20-29,1,5,0,6,0,0,0,6,0,6,Sicilia,ITG1
2021-01-12,PF/BT,190354.0,HSP11 - P.O.ABELE AJELLO-MAZARA D.VALLO,SIC,30-39,3,6,0,8,1,0,0,9,0,9,Sicilia,ITG1
2021-01-12,PF/BT,190354.0,HSP11 - P.O.ABELE AJELLO-MAZARA D.VALLO,SIC,40-49,5,10,0,12,3,0,0,15,0,15,Sicilia,ITG1
2021-01-12,PF/BT,190354.0,HSP11 - P.O.ABELE AJELLO-MAZARA D.VALLO,SIC,50-59,7,13,0,14,6,0,0,20,0,20,Sicilia,ITG1
2021-01-12,PF/BT,190354.0,HSP11 - P.O.ABELE AJELLO-MAZARA D.VALLO,SIC,60-69,4,5,0,4,5,0,0,9,0,9,Sicilia,ITG1
2021-01-12,PF/BT,190354.0,HSP11 - P.O.ABELE AJELLO-MAZARA D.VALLO,SIC,70-79,1,0,0,1,0,0,0,1,0,1,Sicilia,ITG1
2021-01-12,PF/BT,190355.0,HSP11 - P.O. VITTORIO EMANUELE III - SALEMI,SIC,20-29,2,6,0,8,0,0,0,8,0,8,Sicilia,ITG1
2021-01-12,PF/BT,190355.0,HSP11 - P.O. VITTORIO EMANUELE III - SALEMI,SIC,30-39,3,4,0,7,0,0,0,7,0,7,Sicilia,ITG1
2021-01-12,PF/BT,190355.0,HSP11 - P.O. VITTORIO EMANUELE III - SALEMI,SIC,40-49,5,6,0,9,2,0,0,11,0,11,Sicilia,ITG1
2021-01-12,PF/BT,190355.0,HSP11 - P.O. VITTORIO EMANUELE III - SALEMI,SIC,50-59,6,5,0,7,4,0,0,11,0,11,Sicilia,ITG1
2021-01-12,PF/BT,190355.0,HSP11 - P.O. VITTORIO EMANUELE III - SALEMI,SIC,60-69,1,4,0,5,0,0,0,5,0,5,Sicilia,ITG1
2021-01-12,PF/BT,190355.0,HSP11 - P.O. VITTORIO EMANUELE III - SALEMI,SIC,70-79,1,0,0,0,0,0,1,1,0,1,Sicilia,ITG1
2021-01-12,PF/BT,190355.0,HSP11 - P.O. VITTORIO EMANUELE III - SALEMI,SIC,80-89,6,2,0,0,0,0,8,8,0,8,Sicilia,ITG1
2021-01-12,PF/BT,190355.0,HSP11 - P.O. VITTORIO EMANUELE III - SALEMI,SIC,90+,6,3,0,0,0,0,9,9,0,9,Sicilia,ITG1
2021-01-12,PF/BT,190513.0,HSP11 - CASA DI CURA G.B. MORGAGNI S.R.L.,SIC,20-29,0,1,0,0,0,0,1,1,0,1,Sicilia,ITG1
2021-01-12,PF/BT,190513.0,HSP11 - CASA DI CURA G.B. MORGAGNI S.R.L.,SIC,30-39,3,1,0,1,2,0,1,4,0,4,Sicilia,ITG1
2021-01-12,PF/BT,190513.0,HSP11 - CASA DI CURA G.B. MORGAGNI S.R.L.,SIC,40-49,0,5,0,1,1,0,3,5,0,5,Sicilia,ITG1
2021-01-12,PF/BT,190513.0,HSP11 - CASA DI CURA G.B. MORGAGNI S.R.L.,SIC,50-59,1,3,0,3,0,0,1,4,0,4,Sicilia,ITG1
2021-01-12,PF/BT,190513.0,HSP11 - CASA DI CURA G.B. MORGAGNI S.R.L.,SIC,60-69,2,1,0,1,0,0,2,3,0,3,Sicilia,ITG1
2021-01-12,PF/BT,190513.0,HSP11 - CASA DI CURA G.B. MORGAGNI S.R.L.,SIC,70-79,1,0,0,1,0,0,0,1,0,1,Sicilia,ITG1
2021-01-12,PF/BT,190516.0,HSP11 - MATER DEI DI G.NESI & C. S.P.A,SIC,20-29,1,2,0,2,1,0,0,3,0,3,Sicilia,ITG1
2021-01-12,PF/BT,190516.0,HSP11 - MATER DEI DI G.NESI & C. S.P.A,SIC,30-39,5,2,0,7,0,0,0,7,0,7,Sicilia,ITG1
2021-01-12,PF/BT,190516.0,HSP11 - MATER DEI DI G.NESI & C. S.P.A,SIC,40-49,4,2,0,3,3,0,0,6,0,6,Sicilia,ITG1
2021-01-12,PF/BT,190516.0,HSP11 - MATER DEI DI G.NESI & C. S.P.A,SIC,50-59,3,4,0,4,1,0,2,7,0,7,Sicilia,ITG1
2021-01-12,PF/BT,190516.0,HSP11 - MATER DEI DI G.NESI & C. S.P.A,SIC,60-69,6,4,0,9,1,0,0,10,0,10,Sicilia,ITG1
2021-01-12,PF/BT,190516.0,HSP11 - MATER DEI DI G.NESI & C. S.P.A,SIC,70-79,2,1,0,2,0,0,1,3,0,3,Sicilia,ITG1
2021-01-12,PF/BT,190524.0,HSP11 - I.O.M.I. F.SCALABRINO GANZIRRI,SIC,20-29,0,1,0,1,0,0,0,1,0,1,Sicilia,ITG1
2021-01-12,PF/BT,190524.0,HSP11 - I.O.M.I. F.SCALABRINO GANZIRRI,SIC,30-39,1,3,0,4,0,0,0,4,0,4,Sicilia,ITG1
2021-01-12,PF/BT,190524.0,HSP11 - I.O.M.I. F.SCALABRINO GANZIRRI,SIC,40-49,0,2,0,2,0,0,0,2,0,2,Sicilia,ITG1
2021-01-12,PF/BT,190524.0,HSP11 - I.O.M.I. F.SCALABRINO GANZIRRI,SIC,50-59,3,1,0,4,0,0,0,4,0,4,Sicilia,ITG1
2021-01-12,PF/BT,190524.0,HSP11 - I.O.M.I. F.SCALABRINO GANZIRRI,SIC,60-69,3,1,0,3,1,0,0,4,0,4,Sicilia,ITG1
2021-01-12,PF/BT,190524.0,HSP11 - I.O.M.I. F.SCALABRINO GANZIRRI,SIC,70-79,1,1,0,1,1,0,0,2,0,2,Sicilia,ITG1
2021-01-12,PF/BT,190524.0,HSP11 - I.O.M.I. F.SCALABRINO GANZIRRI,SIC,80-89,0,1,0,0,1,0,0,1,0,1,Sicilia,ITG1
2021-01-12,PF/BT,190526.0,HSP11 - CASA DI CURA CRISTO RE,SIC,20-29,3,9,0,12,0,0,0,12,0,12,Sicilia,ITG1
2021-01-12,PF/BT,190526.0,HSP11 - CASA DI CURA CRISTO RE,SIC,30-39,13,7,0,20,0,0,0,20,0,20,Sicilia,ITG1
2021-01-12,PF/BT,190526.0,HSP11 - CASA DI CURA CRISTO RE,SIC,40-49,12,4,0,16,0,0,0,16,0,16,Sicilia,ITG1
2021-01-12,PF/BT,190526.0,HSP11 - CASA DI CURA CRISTO RE,SIC,50-59,14,5,0,18,1,0,0,19,0,19,Sicilia,ITG1
2021-01-12,PF/BT,190526.0,HSP11 - CASA DI CURA CRISTO RE,SIC,60-69,10,2,0,11,1,0,0,12,0,12,Sicilia,ITG1
2021-01-12,PF/BT,190526.0,HSP11 - CASA DI CURA CRISTO RE,SIC,70-79,4,0,0,4,0,0,0,4,0,4,Sicilia,ITG1
2021-01-12,PF/BT,190526.0,HSP11 - CASA DI CURA CRISTO RE,SIC,90+,1,0,0,1,0,0,0,1,0,1,Sicilia,ITG1
2021-01-12,PF/BT,190537.0,HSP11 - CASA DI CURA SERENA S.P.A.,SIC,20-29,1,5,0,6,0,0,0,6,0,6,Sicilia,ITG1
2021-01-12,PF/BT,190537.0,HSP11 - CASA DI CURA SERENA S.P.A.,SIC,30-39,1,4,0,5,0,0,0,5,0,5,Sicilia,ITG1
2021-01-12,PF/BT,190537.0,HSP11 - CASA DI CURA SERENA S.P.A.,SIC,40-49,4,2,0,6,0,0,0,6,0,6,Sicilia,ITG1
2021-01-12,PF/BT,190537.0,HSP11 - CASA DI CURA SERENA S.P.A.,SIC,50-59,3,9,0,9,3,0,0,12,0,12,Sicilia,ITG1
2021-01-12,PF/BT,190537.0,HSP11 - CASA DI CURA SERENA S.P.A.,SIC,70-79,1,0,0,1,0,0,0,1,0,1,Sicilia,ITG1
2021-01-12,PF/BT,190540.0,HSP11 - NUOVA CASA DI CURA DEMMA srl,SIC,30-39,0,1,0,0,1,0,0,1,0,1,Sicilia,ITG1
2021-01-12,PF/BT,190540.0,HSP11 - NUOVA CASA DI CURA DEMMA srl,SIC,50-59,0,4,0,1,3,0,0,4,0,4,Sicilia,ITG1
2021-01-12,PF/BT,190540.0,HSP11 - NUOVA CASA DI CURA DEMMA srl,SIC,60-69,0,1,0,1,0,0,0,1,0,1,Sicilia,ITG1
2021-01-12,PF/BT,190543.0,HSP11 - CASA DI CURA VILLA MARGHERITA,SIC,20-29,2,0,0,2,0,0,0,2,0,2,Sicilia,ITG1
2021-01-12,PF/BT,190543.0,HSP11 - CASA DI CURA VILLA MARGHERITA,SIC,30-39,1,0,0,1,0,0,0,1,0,1,Sicilia,ITG1
2021-01-12,PF/BT,190543.0,HSP11 - CASA DI CURA VILLA MARGHERITA,SIC,40-49,1,1,0,0,0,0,2,2,0,2,Sicilia,ITG1
2021-01-12,PF/BT,190543.0,HSP11 - CASA DI CURA VILLA MARGHERITA,SIC,50-59,0,1,0,0,0,0,1,1,0,1,Sicilia,ITG1
2021-01-12,PF/BT,190553.0,HSP11 - CASA DI CURA RIABILITATIVA VILLA SOFIA,SIC,20-29,0,6,0,6,0,0,0,6,0,6,Sicilia,ITG1
2021-01-12,PF/BT,190553.0,HSP11 - CASA DI CURA RIABILITATIVA VILLA SOFIA,SIC,30-39,7,4,0,11,0,0,0,11,0,11,Sicilia,ITG1
2021-01-12,PF/BT,190553.0,HSP11 - CASA DI CURA RIABILITATIVA VILLA SOFIA,SIC,40-49,9,10,0,17,2,0,0,19,0,19,Sicilia,ITG1
2021-01-12,PF/BT,190553.0,HSP11 - CASA DI CURA RIABILITATIVA VILLA SOFIA,SIC,50-59,3,10,0,12,1,0,0,13,0,13,Sicilia,ITG1
2021-01-12,PF/BT,190553.0,HSP11 - CASA DI CURA RIABILITATIVA VILLA SOFIA,SIC,60-69,4,3,0,6,1,0,0,7,0,7,Sicilia,ITG1
2021-01-12,PF/BT,190553.0,HSP11 - CASA DI CURA RIABILITATIVA VILLA SOFIA,SIC,70-79,3,0,0,2,1,0,0,3,0,3,Sicilia,ITG1
2021-01-12,PF/BT,190553.0,HSP11 - CASA DI CURA RIABILITATIVA VILLA SOFIA,SIC,80-89,1,0,0,1,0,0,0,1,0,1,Sicilia,ITG1
2021-01-12,PF/BT,190555.0,HSP11 - CASA DI CURA MONS. G. CALACIURA Cenacolo,SIC,20-29,3,3,0,5,1,0,0,6,0,6,Sicilia,ITG1
2021-01-12,PF/BT,190555.0,HSP11 - CASA DI CURA MONS. G. CALACIURA Cenacolo,SIC,30-39,8,6,0,11,3,0,0,14,0,14,Sicilia,ITG1
2021-01-12,PF/BT,190555.0,HSP11 - CASA DI CURA MONS. G. CALACIURA Cenacolo,SIC,40-49,2,6,0,6,2,0,0,8,0,8,Sicilia,ITG1
2021-01-12,PF/BT,190555.0,HSP11 - CASA DI CURA MONS. G. CALACIURA Cenacolo,SIC,50-59,5,2,0,4,3,0,0,7,0,7,Sicilia,ITG1
2021-01-12,PF/BT,190555.0,HSP11 - CASA DI CURA MONS. G. CALACIURA Cenacolo,SIC,70-79,1,0,0,1,0,0,0,1,0,1,Sicilia,ITG1
2021-01-12,PF/BT,190710.0,HSP11 - CASA DI CURA PROF.E.FALCIDIA SrL,SIC,40-49,0,1,0,0,1,0,0,1,0,1,Sicilia,ITG1
2021-01-12,PF/BT,190710.0,HSP11 - CASA DI CURA PROF.E.FALCIDIA SrL,SIC,50-59,2,0,0,0,2,0,0,2,0,2,Sicilia,ITG1
2021-01-12,PF/BT,190710.0,HSP11 - CASA DI CURA PROF.E.FALCIDIA SrL,SIC,60-69,1,2,0,0,3,0,0,3,0,3,Sicilia,ITG1
2021-01-12,PF/BT,190718.0,HSP11 - CASA DI CURA LATTERI VALSAVA S.R.L.,SIC,20-29,3,2,0,5,0,0,0,5,0,5,Sicilia,ITG1
2021-01-12,PF/BT,190718.0,HSP11 - CASA DI CURA LATTERI VALSAVA S.R.L.,SIC,30-39,4,2,0,6,0,0,0,6,0,6,Sicilia,ITG1
2021-01-12,PF/BT,190718.0,HSP11 - CASA DI CURA LATTERI VALSAVA S.R.L.,SIC,40-49,2,2,0,3,1,0,0,4,0,4,Sicilia,ITG1
2021-01-12,PF/BT,190718.0,HSP11 - CASA DI CURA LATTERI VALSAVA S.R.L.,SIC,50-59,10,4,0,11,3,0,0,14,0,14,Sicilia,ITG1
2021-01-12,PF/BT,190718.0,HSP11 - CASA DI CURA LATTERI VALSAVA S.R.L.,SIC,60-69,2,3,0,4,1,0,0,5,0,5,Sicilia,ITG1
2021-01-12,PF/BT,190718.0,HSP11 - CASA DI CURA LATTERI VALSAVA S.R.L.,SIC,70-79,0,1,0,1,0,0,0,1,0,1,Sicilia,ITG1
2021-01-12,PF/BT,190723.0,HSP11 - CASA DI CURA VALSALVA  SRL,SIC,20-29,2,8,0,10,0,0,0,10,0,10,Sicilia,ITG1
2021-01-12,PF/BT,190723.0,HSP11 - CASA DI CURA VALSALVA  SRL,SIC,30-39,1,1,0,2,0,0,0,2,0,2,Sicilia,ITG1
2021-01-12,PF/BT,190723.0,HSP11 - CASA DI CURA VALSALVA  SRL,SIC,40-49,0,5,0,4,1,0,0,5,0,5,Sicilia,ITG1
2021-01-12,PF/BT,190723.0,HSP11 - CASA DI CURA VALSALVA  SRL,SIC,50-59,2,8,0,9,1,0,0,10,0,10,Sicilia,ITG1
2021-01-12,PF/BT,190723.0,HSP11 - CASA DI CURA VALSALVA  SRL,SIC,60-69,7,2,0,8,1,0,0,9,0,9,Sicilia,ITG1
2021-01-12,PF/BT,190723.0,HSP11 - CASA DI CURA VALSALVA  SRL,SIC,70-79,4,0,0,4,0,0,0,4,0,4,Sicilia,ITG1
2021-01-12,PF/BT,190723.0,HSP11 - CASA DI CURA VALSALVA  SRL,SIC,80-89,2,0,0,2,0,0,0,2,0,2,Sicilia,ITG1
2021-01-12,PF/BT,190724.0,HSP11 - ISCAS MORGAGNI NORD SRL,SIC,20-29,1,1,0,2,0,0,0,2,0,2,Sicilia,ITG1
2021-01-12,PF/BT,190724.0,HSP11 - ISCAS MORGAGNI NORD SRL,SIC,30-39,1,3,0,2,2,0,0,4,0,4,Sicilia,ITG1
2021-01-12,PF/BT,190724.0,HSP11 - ISCAS MORGAGNI NORD SRL,SIC,40-49,2,3,0,4,1,0,0,5,0,5,Sicilia,ITG1
2021-01-12,PF/BT,190724.0,HSP11 - ISCAS MORGAGNI NORD SRL,SIC,50-59,2,2,0,2,2,0,0,4,0,4,Sicilia,ITG1
2021-01-12,PF/BT,190724.0,HSP11 - ISCAS MORGAGNI NORD SRL,SIC,60-69,3,0,0,1,2,0,0,3,0,3,Sicilia,ITG1
2021-01-12,PF/BT,190921.0,HSP11 - A.O. per lEmergenza Cannizzaro,SIC,20-29,4,1,0,0,5,0,0,5,0,5,Sicilia,ITG1
2021-01-12,PF/BT,190921.0,HSP11 - A.O. per lEmergenza Cannizzaro,SIC,30-39,10,2,0,1,11,0,0,12,0,12,Sicilia,ITG1
2021-01-12,PF/BT,190921.0,HSP11 - A.O. per lEmergenza Cannizzaro,SIC,40-49,19,9,0,13,15,0,0,28,0,28,Sicilia,ITG1
2021-01-12,PF/BT,190921.0,HSP11 - A.O. per lEmergenza Cannizzaro,SIC,50-59,12,15,0,10,17,0,0,27,0,27,Sicilia,ITG1
2021-01-12,PF/BT,190921.0,HSP11 - A.O. per lEmergenza Cannizzaro,SIC,60-69,11,4,0,4,11,0,0,15,0,15,Sicilia,ITG1
2021-01-12,PF/BT,190921.0,HSP11 - A.O. per lEmergenza Cannizzaro,SIC,70-79,0,3,0,0,3,0,0,3,0,3,Sicilia,ITG1
2021-01-12,PF/BT,19092201.0,HSP11 - OSPEDALE GARIBALDI - CENTRO,SIC,20-29,0,1,0,1,0,0,0,1,0,1,Sicilia,ITG1
2021-01-12,PF/BT,19092201.0,HSP11 - OSPEDALE GARIBALDI - CENTRO,SIC,30-39,0,3,0,2,1,0,0,3,0,3,Sicilia,ITG1
2021-01-12,PF/BT,19092201.0,HSP11 - OSPEDALE GARIBALDI - CENTRO,SIC,40-49,2,4,0,2,4,0,0,6,0,6,Sicilia,ITG1
2021-01-12,PF/BT,19092201.0,HSP11 - OSPEDALE GARIBALDI - CENTRO,SIC,50-59,2,6,0,4,4,0,0,8,0,8,Sicilia,ITG1
2021-01-12,PF/BT,19092201.0,HSP11 - OSPEDALE GARIBALDI - CENTRO,SIC,60-69,2,4,0,3,3,0,0,6,0,6,Sicilia,ITG1
2021-01-12,PF/BT,19092204.0,HSP11 - NUOVO OSPEDALE GARIBALDI - NESIMA,SIC,20-29,1,0,0,0,1,0,0,1,0,1,Sicilia,ITG1
2021-01-12,PF/BT,19092204.0,HSP11 - NUOVO OSPEDALE GARIBALDI - NESIMA,SIC,30-39,1,3,0,2,2,0,0,4,0,4,Sicilia,ITG1
2021-01-12,PF/BT,19092204.0,HSP11 - NUOVO OSPEDALE GARIBALDI - NESIMA,SIC,40-49,2,2,0,2,2,0,0,4,0,4,Sicilia,ITG1
2021-01-12,PF/BT,19092204.0,HSP11 - NUOVO OSPEDALE GARIBALDI - NESIMA,SIC,50-59,3,7,0,7,3,0,0,10,0,10,Sicilia,ITG1
2021-01-12,PF/BT,19092204.0,HSP11 - NUOVO OSPEDALE GARIBALDI - NESIMA,SIC,60-69,1,4,0,5,0,0,0,5,0,5,Sicilia,ITG1
2021-01-12,PF/BT,19092301.0,HSP11 - PRESIDIO OSPEDALIERO GASPARE RODOLICO,SIC,16-19,4,3,0,7,0,0,0,7,0,7,Sicilia,ITG1
2021-01-12,PF/BT,19092301.0,HSP11 - PRESIDIO OSPEDALIERO GASPARE RODOLICO,SIC,20-29,98,109,0,207,0,0,0,207,0,207,Sicilia,ITG1
2021-01-12,PF/BT,19092301.0,HSP11 - PRESIDIO OSPEDALIERO GASPARE RODOLICO,SIC,30-39,6,7,0,13,0,0,0,13,0,13,Sicilia,ITG1
2021-01-12,PF/BT,19092301.0,HSP11 - PRESIDIO OSPEDALIERO GASPARE RODOLICO,SIC,40-49,3,6,0,9,0,0,0,9,0,9,Sicilia,ITG1
2021-01-12,PF/BT,19092301.0,HSP11 - PRESIDIO OSPEDALIERO GASPARE RODOLICO,SIC,50-59,7,16,0,23,0,0,0,23,0,23,Sicilia,ITG1
2021-01-12,PF/BT,19092301.0,HSP11 - PRESIDIO OSPEDALIERO GASPARE RODOLICO,SIC,60-69,5,5,0,10,0,0,0,10,0,10,Sicilia,ITG1
2021-01-12,PF/BT,19092304.0,HSP11 - PRESIDIO OSPEDALIERO S.MARCO,SIC,16-19,3,2,0,5,0,0,0,5,0,5,Sicilia,ITG1
2021-01-12,PF/BT,19092304.0,HSP11 - PRESIDIO OSPEDALIERO S.MARCO,SIC,20-29,15,21,0,33,3,0,0,36,0,36,Sicilia,ITG1
2021-01-12,PF/BT,19092304.0,HSP11 - PRESIDIO OSPEDALIERO S.MARCO,SIC,30-39,3,3,0,5,1,0,0,6,0,6,Sicilia,ITG1
2021-01-12,PF/BT,19092304.0,HSP11 - PRESIDIO OSPEDALIERO S.MARCO,SIC,40-49,9,2,0,9,2,0,0,11,0,11,Sicilia,ITG1
2021-01-12,PF/BT,19092304.0,HSP11 - PRESIDIO OSPEDALIERO S.MARCO,SIC,50-59,9,8,0,13,4,0,0,17,0,17,Sicilia,ITG1
2021-01-12,PF/BT,19092304.0,HSP11 - PRESIDIO OSPEDALIERO S.MARCO,SIC,60-69,0,2,0,2,0,0,0,2,0,2,Sicilia,ITG1
2021-01-12,PF/BT,190924.0,HSP11 - Azienda Ospedaliera Papardo,SIC,20-29,0,2,0,1,0,0,1,2,0,2,Sicilia,ITG1
2021-01-12,PF/BT,190924.0,HSP11 - Azienda Ospedaliera Papardo,SIC,30-39,5,2,0,4,0,0,3,7,0,7,Sicilia,ITG1
2021-01-12,PF/BT,190924.0,HSP11 - Azienda Ospedaliera Papardo,SIC,40-49,3,5,0,6,0,0,2,8,0,8,Sicilia,ITG1
2021-01-12,PF/BT,190924.0,HSP11 - Azienda Ospedaliera Papardo,SIC,50-59,11,11,0,16,0,0,6,22,0,22,Sicilia,ITG1
2021-01-12,PF/BT,190924.0,HSP11 - Azienda Ospedaliera Papardo,SIC,60-69,6,8,0,10,0,0,4,14,0,14,Sicilia,ITG1
2021-01-12,PF/BT,190924.0,HSP11 - Azienda Ospedaliera Papardo,SIC,70-79,1,0,0,1,0,0,0,1,0,1,Sicilia,ITG1
2021-01-12,PF/BT,19092501.0,HSP11 - COVID HOSPITAL,SIC,20-29,10,12,0,22,0,0,0,22,0,22,Sicilia,ITG1
2021-01-12,PF/BT,19092501.0,HSP11 - COVID HOSPITAL,SIC,30-39,26,26,0,4,48,0,0,52,0,52,Sicilia,ITG1
2021-01-12,PF/BT,19092501.0,HSP11 - COVID HOSPITAL,SIC,40-49,32,23,0,2,53,0,0,55,0,55,Sicilia,ITG1
2021-01-12,PF/BT,19092501.0,HSP11 - COVID HOSPITAL,SIC,50-59,46,32,0,0,78,0,0,78,0,78,Sicilia,ITG1
2021-01-12,PF/BT,19092501.0,HSP11 - COVID HOSPITAL,SIC,60-69,23,29,0,1,51,0,0,52,0,52,Sicilia,ITG1
2021-01-12,PF/BT,19092601.0,HSP11 - P.O. Villa Sofia,SIC,20-29,5,1,0,6,0,0,0,6,0,6,Sicilia,ITG1
2021-01-12,PF/BT,19092601.0,HSP11 - P.O. Villa Sofia,SIC,30-39,12,11,0,23,0,0,0,23,0,23,Sicilia,ITG1
2021-01-12,PF/BT,19092601.0,HSP11 - P.O. Villa Sofia,SIC,40-49,31,9,0,40,0,0,0,40,0,40,Sicilia,ITG1
2021-01-12,PF/BT,19092601.0,HSP11 - P.O. Villa Sofia,SIC,50-59,51,31,0,82,0,0,0,82,0,82,Sicilia,ITG1
2021-01-12,PF/BT,19092601.0,HSP11 - P.O. Villa Sofia,SIC,60-69,21,6,0,27,0,0,0,27,0,27,Sicilia,ITG1
2021-01-12,PF/BT,19092701.0,HSP11 - Ospedale Civico,SIC,20-29,10,4,0,4,10,0,0,14,0,14,Sicilia,ITG1
2021-01-12,PF/BT,19092701.0,HSP11 - Ospedale Civico,SIC,30-39,12,6,0,10,8,0,0,18,0,18,Sicilia,ITG1
2021-01-12,PF/BT,19092701.0,HSP11 - Ospedale Civico,SIC,40-49,28,16,0,15,29,0,0,44,0,44,Sicilia,ITG1
2021-01-12,PF/BT,19092701.0,HSP11 - Ospedale Civico,SIC,50-59,31,29,0,28,32,0,0,60,0,60,Sicilia,ITG1
2021-01-12,PF/BT,19092701.0,HSP11 - Ospedale Civico,SIC,60-69,17,9,0,17,9,0,0,26,0,26,Sicilia,ITG1
2021-01-12,PF/BT,19092702.0,HSP11 - Ospedale dei Bambini G. Di Cristina,SIC,20-29,0,2,0,0,2,0,0,2,0,2,Sicilia,ITG1
2021-01-12,PF/BT,19092702.0,HSP11 - Ospedale dei Bambini G. Di Cristina,SIC,30-39,6,3,0,2,7,0,0,9,0,9,Sicilia,ITG1
2021-01-12,PF/BT,19092702.0,HSP11 - Ospedale dei Bambini G. Di Cristina,SIC,40-49,13,1,0,1,13,0,0,14,0,14,Sicilia,ITG1
2021-01-12,PF/BT,19092702.0,HSP11 - Ospedale dei Bambini G. Di Cristina,SIC,50-59,25,10,0,7,28,0,0,35,0,35,Sicilia,ITG1
2021-01-12,PF/BT,19092702.0,HSP11 - Ospedale dei Bambini G. Di Cristina,SIC,60-69,4,2,0,1,5,0,0,6,0,6,Sicilia,ITG1
2021-01-12,PF/BT,190928.0,HSP11 - AZ.OSP.UNIV.P.GIACCONE,SIC,20-29,12,17,0,24,1,0,4,29,0,29,Sicilia,ITG1
2021-01-12,PF/BT,190928.0,HSP11 - AZ.OSP.UNIV.P.GIACCONE,SIC,30-39,21,20,0,29,10,0,2,41,0,41,Sicilia,ITG1
2021-01-12,PF/BT,190928.0,HSP11 - AZ.OSP.UNIV.P.GIACCONE,SIC,40-49,22,20,0,29,9,0,4,42,0,42,Sicilia,ITG1
2021-01-12,PF/BT,190928.0,HSP11 - AZ.OSP.UNIV.P.GIACCONE,SIC,50-59,35,36,0,48,11,0,12,71,0,71,Sicilia,ITG1
2021-01-12,PF/BT,190928.0,HSP11 - AZ.OSP.UNIV.P.GIACCONE,SIC,60-69,24,21,0,38,4,0,3,45,0,45,Sicilia,ITG1
2021-01-12,PF/BT,190928.0,HSP11 - AZ.OSP.UNIV.P.GIACCONE,SIC,70-79,5,2,0,6,1,0,0,7,0,7,Sicilia,ITG1
2021-01-12,PF/BT,190928.0,HSP11 - AZ.OSP.UNIV.P.GIACCONE,SIC,80-89,2,0,0,2,0,0,0,2,0,2,Sicilia,ITG1
2021-01-12,PF/BT,190929.0,STS11 - IRCCS Ismett,SIC,30-39,2,1,0,2,1,0,0,3,0,3,Sicilia,ITG1
2021-01-12,PF/BT,190929.0,STS11 - IRCCS Ismett,SIC,40-49,2,2,0,2,2,0,0,4,0,4,Sicilia,ITG1
2021-01-12,PF/BT,190929.0,STS11 - IRCCS Ismett,SIC,50-59,3,1,0,2,2,0,0,4,0,4,Sicilia,ITG1
2021-01-12,PF/BT,190929.0,STS11 - IRCCS Ismett,SIC,60-69,1,0,0,0,1,0,0,1,0,1,Sicilia,ITG1
2021-01-12,PF/BT,608200.0,STS11 - POLIAMBULATORIO San Giorgio,SIC,20-29,3,4,0,7,0,0,0,7,0,7,Sicilia,ITG1
2021-01-12,PF/BT,608200.0,STS11 - POLIAMBULATORIO San Giorgio,SIC,30-39,5,2,0,7,0,0,0,7,0,7,Sicilia,ITG1
2021-01-12,PF/BT,608200.0,STS11 - POLIAMBULATORIO San Giorgio,SIC,40-49,0,2,0,0,2,0,0,2,0,2,Sicilia,ITG1
2021-01-12,PF/BT,608200.0,STS11 - POLIAMBULATORIO San Giorgio,SIC,50-59,3,5,0,5,3,0,0,8,0,8,Sicilia,ITG1
2021-01-12,PF/BT,608200.0,STS11 - POLIAMBULATORIO San Giorgio,SIC,60-69,1,1,0,1,1,0,0,2,0,2,Sicilia,ITG1
2021-01-12,PF/BT,608200.0,STS11 - POLIAMBULATORIO San Giorgio,SIC,70-79,3,0,0,3,0,0,0,3,0,3,Sicilia,ITG1
2021-01-12,PF/BT,608200.0,STS11 - POLIAMBULATORIO San Giorgio,SIC,80-89,1,0,0,1,0,0,0,1,0,1,Sicilia,ITG1
2021-01-12,PF/BT,608400.0,STS11 - POLIAMBULATORIO  San Luigi,SIC,20-29,2,0,0,0,2,0,0,2,0,2,Sicilia,ITG1
2021-01-12,PF/BT,608400.0,STS11 - POLIAMBULATORIO  San Luigi,SIC,30-39,6,5,0,5,6,0,0,11,0,11,Sicilia,ITG1
2021-01-12,PF/BT,608400.0,STS11 - POLIAMBULATORIO  San Luigi,SIC,40-49,8,11,0,10,9,0,0,19,0,19,Sicilia,ITG1
2021-01-12,PF/BT,608400.0,STS11 - POLIAMBULATORIO  San Luigi,SIC,50-59,5,18,0,18,5,0,0,23,0,23,Sicilia,ITG1
2021-01-12,PF/BT,608400.0,STS11 - POLIAMBULATORIO  San Luigi,SIC,60-69,14,8,0,12,10,0,0,22,0,22,Sicilia,ITG1
2021-01-12,PF/BT,608400.0,STS11 - POLIAMBULATORIO  San Luigi,SIC,70-79,1,0,0,1,0,0,0,1,0,1,Sicilia,ITG1
2021-01-12,PF/BT,808101.0,STS11 - CTA VILLA MAJOR SRL,SIC,20-29,5,2,0,2,0,0,5,7,0,7,Sicilia,ITG1
2021-01-12,PF/BT,808101.0,STS11 - CTA VILLA MAJOR SRL,SIC,30-39,5,1,0,2,0,0,4,6,0,6,Sicilia,ITG1
2021-01-12,PF/BT,808101.0,STS11 - CTA VILLA MAJOR SRL,SIC,40-49,12,5,0,6,2,0,9,17,0,17,Sicilia,ITG1
2021-01-12,PF/BT,808101.0,STS11 - CTA VILLA MAJOR SRL,SIC,50-59,9,6,0,5,1,0,9,15,0,15,Sicilia,ITG1
2021-01-12,PF/BT,808101.0,STS11 - CTA VILLA MAJOR SRL,SIC,60-69,3,4,0,4,0,0,3,7,0,7,Sicilia,ITG1
2021-01-12,PF/BT,808101.0,STS11 - CTA VILLA MAJOR SRL,SIC,70-79,0,2,0,0,0,0,2,2,0,2,Sicilia,ITG1
2021-01-12,PF/BT,820100.0,STS11 - VILLA LETIZIA COOP.SOCIALE,SIC,30-39,0,1,0,1,0,0,0,1,0,1,Sicilia,ITG1
2021-01-12,PF/BT,820100.0,STS11 - VILLA LETIZIA COOP.SOCIALE,SIC,50-59,0,1,0,1,0,0,0,1,0,1,Sicilia,ITG1
2021-01-12,PF/BT,826800.0,STS11 - RSA RESIDENZA SERENA srl,SIC,20-29,1,1,0,2,0,0,0,2,0,2,Sicilia,ITG1
2021-01-12,PF/BT,826800.0,STS11 - RSA RESIDENZA SERENA srl,SIC,30-39,2,0,0,2,0,0,0,2,0,2,Sicilia,ITG1
2021-01-12,PF/BT,826800.0,STS11 - RSA RESIDENZA SERENA srl,SIC,40-49,0,1,0,1,0,0,0,1,0,1,Sicilia,ITG1
2021-01-12,PF/BT,826800.0,STS11 - RSA RESIDENZA SERENA srl,SIC,50-59,2,1,0,1,0,2,0,3,0,3,Sicilia,ITG1
2021-01-12,PF/BT,826800.0,STS11 - RSA RESIDENZA SERENA srl,SIC,60-69,1,2,0,1,0,2,0,3,0,3,Sicilia,ITG1
2021-01-12,PF/BT,826800.0,STS11 - RSA RESIDENZA SERENA srl,SIC,70-79,3,1,0,0,0,4,0,4,0,4,Sicilia,ITG1
2021-01-12,PF/BT,826800.0,STS11 - RSA RESIDENZA SERENA srl,SIC,80-89,1,5,0,0,0,6,0,6,0,6,Sicilia,ITG1
2021-01-12,PF/BT,826800.0,STS11 - RSA RESIDENZA SERENA srl,SIC,90+,1,1,0,0,0,2,0,2,0,2,Sicilia,ITG1
2021-01-12,PF/BT,831200.0,STS11 - VILLA LISA SRL,SIC,20-29,1,1,0,1,1,0,0,2,0,2,Sicilia,ITG1
2021-01-12,PF/BT,831200.0,STS11 - VILLA LISA SRL,SIC,30-39,1,0,0,1,0,0,0,1,0,1,Sicilia,ITG1
2021-01-12,PF/BT,831200.0,STS11 - VILLA LISA SRL,SIC,40-49,3,2,0,5,0,0,0,5,0,5,Sicilia,ITG1
2021-01-12,PF/BT,831200.0,STS11 - VILLA LISA SRL,SIC,50-59,1,1,0,2,0,0,0,2,0,2,Sicilia,ITG1
2021-01-12,PF/BT,832700.0,STS11 - RSA MARIA REGINA,SIC,30-39,1,1,0,1,1,0,0,2,0,2,Sicilia,ITG1
2021-01-12,PF/BT,832700.0,STS11 - RSA MARIA REGINA,SIC,50-59,0,1,0,1,0,0,0,1,0,1,Sicilia,ITG1
2021-01-12,PF/BT,832700.0,STS11 - RSA MARIA REGINA,SIC,60-69,1,0,0,0,0,1,0,1,0,1,Sicilia,ITG1
2021-01-12,PF/BT,832700.0,STS11 - RSA MARIA REGINA,SIC,80-89,1,4,0,0,0,5,0,5,0,5,Sicilia,ITG1
2021-01-13,PF/BT,1902012.0,AMBULATORI VACCINALI NON CODIFICATI NSIS,SIC,20-29,1,4,0,5,0,0,0,5,0,5,Sicilia,ITG1
2021-01-13,PF/BT,1902012.0,AMBULATORI VACCINALI NON CODIFICATI NSIS,SIC,30-39,4,13,0,15,2,0,0,17,0,17,Sicilia,ITG1
2021-01-13,PF/BT,1902012.0,AMBULATORI VACCINALI NON CODIFICATI NSIS,SIC,40-49,7,20,0,23,3,1,0,27,0,27,Sicilia,ITG1
2021-01-13,PF/BT,1902012.0,AMBULATORI VACCINALI NON CODIFICATI NSIS,SIC,50-59,5,16,0,12,2,7,0,21,0,21,Sicilia,ITG1
2021-01-13,PF/BT,1902012.0,AMBULATORI VACCINALI NON CODIFICATI NSIS,SIC,60-69,3,12,0,8,0,7,0,15,0,15,Sicilia,ITG1
2021-01-13,PF/BT,1902012.0,AMBULATORI VACCINALI NON CODIFICATI NSIS,SIC,70-79,2,17,0,4,0,14,1,19,0,19,Sicilia,ITG1
2021-01-13,PF/BT,1902012.0,AMBULATORI VACCINALI NON CODIFICATI NSIS,SIC,80-89,9,44,0,1,0,52,0,53,0,53,Sicilia,ITG1
2021-01-13,PF/BT,1902012.0,AMBULATORI VACCINALI NON CODIFICATI NSIS,SIC,90+,5,36,0,1,0,40,0,41,0,41,Sicilia,ITG1
2021-01-13,PF/BT,1902027.0,STRUTTURE PRIVATE NON CODIFICATE NSIS,SIC,30-39,1,1,0,2,0,0,0,2,0,2,Sicilia,ITG1
2021-01-13,PF/BT,1902027.0,STRUTTURE PRIVATE NON CODIFICATE NSIS,SIC,40-49,0,1,0,1,0,0,0,1,0,1,Sicilia,ITG1
2021-01-13,PF/BT,1902027.0,STRUTTURE PRIVATE NON CODIFICATE NSIS,SIC,50-59,0,1,0,0,0,1,0,1,0,1,Sicilia,ITG1
2021-01-13,PF/BT,1902027.0,STRUTTURE PRIVATE NON CODIFICATE NSIS,SIC,60-69,0,2,0,0,0,2,0,2,0,2,Sicilia,ITG1
2021-01-13,PF/BT,1902027.0,STRUTTURE PRIVATE NON CODIFICATE NSIS,SIC,70-79,0,1,0,0,0,1,0,1,0,1,Sicilia,ITG1
2021-01-13,PF/BT,1902027.0,STRUTTURE PRIVATE NON CODIFICATE NSIS,SIC,80-89,2,6,0,0,0,8,0,8,0,8,Sicilia,ITG1
2021-01-13,PF/BT,1902027.0,STRUTTURE PRIVATE NON CODIFICATE NSIS,SIC,90+,0,4,0,0,0,4,0,4,0,4,Sicilia,ITG1
2021-01-13,PF/BT,1902037.0,STRUTTURE PRIVATE NON CODIFICATE NSIS,SIC,30-39,1,0,0,1,0,0,0,1,0,1,Sicilia,ITG1
2021-01-13,PF/BT,1902057.0,STRUTTURE PRIVATE NON CODIFICATE NSIS,SIC,20-29,2,0,0,2,0,0,0,2,0,2,Sicilia,ITG1
2021-01-13,PF/BT,1902057.0,STRUTTURE PRIVATE NON CODIFICATE NSIS,SIC,30-39,3,2,0,4,1,0,0,5,0,5,Sicilia,ITG1
2021-01-13,PF/BT,1902057.0,STRUTTURE PRIVATE NON CODIFICATE NSIS,SIC,40-49,12,3,0,7,8,0,0,15,0,15,Sicilia,ITG1
2021-01-13,PF/BT,1902057.0,STRUTTURE PRIVATE NON CODIFICATE NSIS,SIC,50-59,18,5,0,14,9,0,0,23,0,23,Sicilia,ITG1
2021-01-13,PF/BT,1902057.0,STRUTTURE PRIVATE NON CODIFICATE NSIS,SIC,60-69,8,1,0,7,1,0,1,9,0,9,Sicilia,ITG1
2021-01-13,PF/BT,1902072.0,AMBULATORI VACCINALI NON CODIFICATI NSIS,SIC,20-29,1,3,0,1,0,0,3,4,0,4,Sicilia,ITG1
2021-01-13,PF/BT,1902072.0,AMBULATORI VACCINALI NON CODIFICATI NSIS,SIC,30-39,3,7,0,0,1,0,9,10,0,10,Sicilia,ITG1
2021-01-13,PF/BT,1902072.0,AMBULATORI VACCINALI NON CODIFICATI NSIS,SIC,40-49,4,8,0,2,1,0,9,12,0,12,Sicilia,ITG1
2021-01-13,PF/BT,1902072.0,AMBULATORI VACCINALI NON CODIFICATI NSIS,SIC,50-59,12,17,0,12,6,0,11,29,0,29,Sicilia,ITG1
2021-01-13,PF/BT,1902072.0,AMBULATORI VACCINALI NON CODIFICATI NSIS,SIC,60-69,15,10,0,7,4,0,14,25,0,25,Sicilia,ITG1
2021-01-13,PF/BT,1902072.0,AMBULATORI VACCINALI NON CODIFICATI NSIS,SIC,70-79,4,0,0,2,0,0,2,4,0,4,Sicilia,ITG1
2021-01-13,PF/BT,1902072.0,AMBULATORI VACCINALI NON CODIFICATI NSIS,SIC,80-89,0,1,0,0,0,1,0,1,0,1,Sicilia,ITG1
2021-01-13,PF/BT,1902077.0,STRUTTURE PRIVATE NON CODIFICATE NSIS,SIC,20-29,4,1,0,5,0,0,0,5,0,5,Sicilia,ITG1
2021-01-13,PF/BT,1902077.0,STRUTTURE PRIVATE NON CODIFICATE NSIS,SIC,30-39,2,4,0,5,1,0,0,6,0,6,Sicilia,ITG1
2021-01-13,PF/BT,1902077.0,STRUTTURE PRIVATE NON CODIFICATE NSIS,SIC,40-49,1,6,0,6,0,1,0,7,0,7,Sicilia,ITG1
2021-01-13,PF/BT,1902077.0,STRUTTURE PRIVATE NON CODIFICATE NSIS,SIC,50-59,4,6,0,6,0,3,1,10,0,10,Sicilia,ITG1
2021-01-13,PF/BT,1902077.0,STRUTTURE PRIVATE NON CODIFICATE NSIS,SIC,60-69,5,8,0,5,0,7,1,13,0,13,Sicilia,ITG1
2021-01-13,PF/BT,1902077.0,STRUTTURE PRIVATE NON CODIFICATE NSIS,SIC,70-79,6,7,0,0,0,11,2,13,0,13,Sicilia,ITG1
2021-01-13,PF/BT,1902077.0,STRUTTURE PRIVATE NON CODIFICATE NSIS,SIC,80-89,8,28,0,2,0,32,2,36,0,36,Sicilia,ITG1
2021-01-13,PF/BT,1902077.0,STRUTTURE PRIVATE NON CODIFICATE NSIS,SIC,90+,4,21,0,0,0,24,1,25,0,25,Sicilia,ITG1
2021-01-13,PF/BT,1902082.0,AMBULATORI VACCINALI NON CODIFICATI NSIS,SIC,20-29,0,1,0,1,0,0,0,1,0,1,Sicilia,ITG1
2021-01-13,PF/BT,1902082.0,AMBULATORI VACCINALI NON CODIFICATI NSIS,SIC,30-39,0,3,0,3,0,0,0,3,0,3,Sicilia,ITG1
2021-01-13,PF/BT,1902082.0,AMBULATORI VACCINALI NON CODIFICATI NSIS,SIC,40-49,0,12,0,12,0,0,0,12,0,12,Sicilia,ITG1
2021-01-13,PF/BT,1902082.0,AMBULATORI VACCINALI NON CODIFICATI NSIS,SIC,50-59,0,2,0,2,0,0,0,2,0,2,Sicilia,ITG1
2021-01-13,PF/BT,1902082.0,AMBULATORI VACCINALI NON CODIFICATI NSIS,SIC,70-79,1,4,0,0,0,5,0,5,0,5,Sicilia,ITG1
2021-01-13,PF/BT,1902082.0,AMBULATORI VACCINALI NON CODIFICATI NSIS,SIC,80-89,3,11,0,0,0,14,0,14,0,14,Sicilia,ITG1
2021-01-13,PF/BT,1902082.0,AMBULATORI VACCINALI NON CODIFICATI NSIS,SIC,90+,2,9,0,0,0,11,0,11,0,11,Sicilia,ITG1
2021-01-13,PF/BT,190301.0,RIA11 - A.I.A.S.SEZ.DI AGRIGENTO ONLUS,SIC,20-29,11,7,0,12,2,0,4,18,0,18,Sicilia,ITG1
2021-01-13,PF/BT,190301.0,RIA11 - A.I.A.S.SEZ.DI AGRIGENTO ONLUS,SIC,30-39,15,9,0,20,1,0,3,24,0,24,Sicilia,ITG1
2021-01-13,PF/BT,190301.0,RIA11 - A.I.A.S.SEZ.DI AGRIGENTO ONLUS,SIC,40-49,9,13,0,19,1,0,2,22,0,22,Sicilia,ITG1
2021-01-13,PF/BT,190301.0,RIA11 - A.I.A.S.SEZ.DI AGRIGENTO ONLUS,SIC,50-59,20,19,0,25,4,0,10,39,0,39,Sicilia,ITG1
2021-01-13,PF/BT,190301.0,RIA11 - A.I.A.S.SEZ.DI AGRIGENTO ONLUS,SIC,60-69,10,3,0,11,1,0,1,13,0,13,Sicilia,ITG1
2021-01-13,PF/BT,190301.0,RIA11 - A.I.A.S.SEZ.DI AGRIGENTO ONLUS,SIC,70-79,3,0,0,3,0,0,0,3,0,3,Sicilia,ITG1
2021-01-13,PF/BT,190302.0,RIA11 - C.DELLA SPERANZA DON ANGELO G.,SIC,20-29,3,3,0,0,0,0,6,6,0,6,Sicilia,ITG1
2021-01-13,PF/BT,190302.0,RIA11 - C.DELLA SPERANZA DON ANGELO G.,SIC,30-39,7,15,0,0,0,0,22,22,0,22,Sicilia,ITG1
2021-01-13,PF/BT,190302.0,RIA11 - C.DELLA SPERANZA DON ANGELO G.,SIC,40-49,8,14,0,0,0,0,22,22,0,22,Sicilia,ITG1
2021-01-13,PF/BT,190302.0,RIA11 - C.DELLA SPERANZA DON ANGELO G.,SIC,50-59,3,5,0,2,0,0,6,8,0,8,Sicilia,ITG1
2021-01-13,PF/BT,190302.0,RIA11 - C.DELLA SPERANZA DON ANGELO G.,SIC,60-69,7,1,0,1,0,0,7,8,0,8,Sicilia,ITG1
2021-01-13,PF/BT,190302.0,RIA11 - C.DELLA SPERANZA DON ANGELO G.,SIC,70-79,3,1,0,0,0,0,4,4,0,4,Sicilia,ITG1
2021-01-13,PF/BT,190302.0,RIA11 - C.DELLA SPERANZA DON ANGELO G.,SIC,80-89,2,0,0,0,0,0,2,2,0,2,Sicilia,ITG1
2021-01-13,PF/BT,190303.0,RIA11 - COMUNITA` DELLA SPERANZA,SIC,20-29,5,3,0,7,0,0,1,8,0,8,Sicilia,ITG1
2021-01-13,PF/BT,190303.0,RIA11 - COMUNITA` DELLA SPERANZA,SIC,30-39,2,2,0,2,1,0,1,4,0,4,Sicilia,ITG1
2021-01-13,PF/BT,190303.0,RIA11 - COMUNITA` DELLA SPERANZA,SIC,40-49,4,7,0,8,3,0,0,11,0,11,Sicilia,ITG1
2021-01-13,PF/BT,190303.0,RIA11 - COMUNITA` DELLA SPERANZA,SIC,50-59,2,7,0,5,2,0,2,9,0,9,Sicilia,ITG1
2021-01-13,PF/BT,190303.0,RIA11 - COMUNITA` DELLA SPERANZA,SIC,60-69,13,5,0,16,1,0,1,18,0,18,Sicilia,ITG1
2021-01-13,PF/BT,190303.0,RIA11 - COMUNITA` DELLA SPERANZA,SIC,70-79,17,4,0,19,0,0,2,21,0,21,Sicilia,ITG1
2021-01-13,PF/BT,190303.0,RIA11 - COMUNITA` DELLA SPERANZA,SIC,80-89,8,3,0,0,0,0,11,11,0,11,Sicilia,ITG1
2021-01-13,PF/BT,190303.0,RIA11 - COMUNITA` DELLA SPERANZA,SIC,90+,2,0,0,1,0,0,1,2,0,2,Sicilia,ITG1
2021-01-13,PF/BT,190306.0,RIA11 - ASS. CASA FAM.ROSETTA ONILUS,SIC,16-19,1,0,0,0,1,0,0,1,0,1,Sicilia,ITG1
2021-01-13,PF/BT,190306.0,RIA11 - ASS. CASA FAM.ROSETTA ONILUS,SIC,20-29,9,9,0,13,4,0,1,18,0,18,Sicilia,ITG1
2021-01-13,PF/BT,190306.0,RIA11 - ASS. CASA FAM.ROSETTA ONILUS,SIC,30-39,11,13,0,17,4,0,3,24,0,24,Sicilia,ITG1
2021-01-13,PF/BT,190306.0,RIA11 - ASS. CASA FAM.ROSETTA ONILUS,SIC,40-49,13,14,0,18,9,0,0,27,0,27,Sicilia,ITG1
2021-01-13,PF/BT,190306.0,RIA11 - ASS. CASA FAM.ROSETTA ONILUS,SIC,50-59,20,19,0,23,15,0,1,39,0,39,Sicilia,ITG1
2021-01-13,PF/BT,190306.0,RIA11 - ASS. CASA FAM.ROSETTA ONILUS,SIC,60-69,16,10,0,18,6,0,2,26,0,26,Sicilia,ITG1
2021-01-13,PF/BT,190306.0,RIA11 - ASS. CASA FAM.ROSETTA ONILUS,SIC,70-79,4,2,0,2,4,0,0,6,0,6,Sicilia,ITG1
2021-01-13,PF/BT,190306.0,RIA11 - ASS. CASA FAM.ROSETTA ONILUS,SIC,80-89,2,2,0,1,1,0,2,4,0,4,Sicilia,ITG1
2021-01-13,PF/BT,190309.0,HSP11 - P.O. VITTORIO EMANUELE (ex AO),SIC,16-19,1,0,0,0,0,0,1,1,0,1,Sicilia,ITG1
2021-01-13,PF/BT,190309.0,HSP11 - P.O. VITTORIO EMANUELE (ex AO),SIC,20-29,3,11,0,7,0,0,7,14,0,14,Sicilia,ITG1
2021-01-13,PF/BT,190309.0,HSP11 - P.O. VITTORIO EMANUELE (ex AO),SIC,30-39,6,10,0,14,0,0,2,16,0,16,Sicilia,ITG1
2021-01-13,PF/BT,190309.0,HSP11 - P.O. VITTORIO EMANUELE (ex AO),SIC,40-49,12,10,0,14,0,0,8,22,0,22,Sicilia,ITG1
2021-01-13,PF/BT,190309.0,HSP11 - P.O. VITTORIO EMANUELE (ex AO),SIC,50-59,16,9,0,18,0,0,7,25,0,25,Sicilia,ITG1
2021-01-13,PF/BT,190309.0,HSP11 - P.O. VITTORIO EMANUELE (ex AO),SIC,60-69,14,8,0,16,0,0,6,22,0,22,Sicilia,ITG1
2021-01-13,PF/BT,190309.0,HSP11 - P.O. VITTORIO EMANUELE (ex AO),SIC,70-79,8,0,0,8,0,0,0,8,0,8,Sicilia,ITG1
2021-01-13,PF/BT,190312.0,HSP11 - P.O. S. Marta e S. Venera Acireale,SIC,20-29,3,2,0,2,3,0,0,5,0,5,Sicilia,ITG1
2021-01-13,PF/BT,190312.0,HSP11 - P.O. S. Marta e S. Venera Acireale,SIC,30-39,7,10,0,15,2,0,0,17,0,17,Sicilia,ITG1
2021-01-13,PF/BT,190312.0,HSP11 - P.O. S. Marta e S. Venera Acireale,SIC,40-49,5,27,0,26,6,0,0,32,0,32,Sicilia,ITG1
2021-01-13,PF/BT,190312.0,HSP11 - P.O. S. Marta e S. Venera Acireale,SIC,50-59,16,17,0,28,5,0,0,33,0,33,Sicilia,ITG1
2021-01-13,PF/BT,190312.0,HSP11 - P.O. S. Marta e S. Venera Acireale,SIC,60-69,11,16,0,22,5,0,0,27,0,27,Sicilia,ITG1
2021-01-13,PF/BT,190313.0,RIA11 - IST.RIAB.VILLAG. SAN GIUSEPPE,SIC,16-19,0,1,0,0,0,0,1,1,0,1,Sicilia,ITG1
2021-01-13,PF/BT,190313.0,RIA11 - IST.RIAB.VILLAG. SAN GIUSEPPE,SIC,20-29,4,8,0,10,0,0,2,12,0,12,Sicilia,ITG1
2021-01-13,PF/BT,190313.0,RIA11 - IST.RIAB.VILLAG. SAN GIUSEPPE,SIC,30-39,7,10,0,14,0,0,3,17,0,17,Sicilia,ITG1
2021-01-13,PF/BT,190313.0,RIA11 - IST.RIAB.VILLAG. SAN GIUSEPPE,SIC,40-49,5,15,0,15,0,0,5,20,0,20,Sicilia,ITG1
2021-01-13,PF/BT,190313.0,RIA11 - IST.RIAB.VILLAG. SAN GIUSEPPE,SIC,50-59,7,24,0,24,0,0,7,31,0,31,Sicilia,ITG1
2021-01-13,PF/BT,190313.0,RIA11 - IST.RIAB.VILLAG. SAN GIUSEPPE,SIC,60-69,22,13,0,28,0,0,7,35,0,35,Sicilia,ITG1
2021-01-13,PF/BT,190313.0,RIA11 - IST.RIAB.VILLAG. SAN GIUSEPPE,SIC,70-79,1,2,0,2,0,0,1,3,0,3,Sicilia,ITG1
2021-01-13,PF/BT,190313.0,RIA11 - IST.RIAB.VILLAG. SAN GIUSEPPE,SIC,80-89,1,0,0,1,0,0,0,1,0,1,Sicilia,ITG1
2021-01-13,PF/BT,190314.0,RIA11 - ASS.J.F.KENNEDY ACIREALE,SIC,20-29,3,3,0,3,0,3,0,6,0,6,Sicilia,ITG1
2021-01-13,PF/BT,190314.0,RIA11 - ASS.J.F.KENNEDY ACIREALE,SIC,30-39,11,2,0,3,0,10,0,13,0,13,Sicilia,ITG1
2021-01-13,PF/BT,190314.0,RIA11 - ASS.J.F.KENNEDY ACIREALE,SIC,40-49,13,5,0,12,0,6,0,18,0,18,Sicilia,ITG1
2021-01-13,PF/BT,190314.0,RIA11 - ASS.J.F.KENNEDY ACIREALE,SIC,50-59,12,8,0,15,0,5,0,20,0,20,Sicilia,ITG1
2021-01-13,PF/BT,190314.0,RIA11 - ASS.J.F.KENNEDY ACIREALE,SIC,60-69,5,2,0,6,0,1,0,7,0,7,Sicilia,ITG1
2021-01-13,PF/BT,190314.0,RIA11 - ASS.J.F.KENNEDY ACIREALE,SIC,70-79,1,1,0,1,0,1,0,2,0,2,Sicilia,ITG1
2021-01-13,PF/BT,190316.0,RIA11 - ASS.J.F.KENNEDY - C.RIAB.ONLUS,SIC,16-19,1,0,0,0,1,0,0,1,0,1,Sicilia,ITG1
2021-01-13,PF/BT,190316.0,RIA11 - ASS.J.F.KENNEDY - C.RIAB.ONLUS,SIC,20-29,1,6,0,6,1,0,0,7,0,7,Sicilia,ITG1
2021-01-13,PF/BT,190316.0,RIA11 - ASS.J.F.KENNEDY - C.RIAB.ONLUS,SIC,30-39,5,6,0,11,0,0,0,11,0,11,Sicilia,ITG1
2021-01-13,PF/BT,190316.0,RIA11 - ASS.J.F.KENNEDY - C.RIAB.ONLUS,SIC,40-49,6,14,0,19,1,0,0,20,0,20,Sicilia,ITG1
2021-01-13,PF/BT,190316.0,RIA11 - ASS.J.F.KENNEDY - C.RIAB.ONLUS,SIC,50-59,5,15,0,14,6,0,0,20,0,20,Sicilia,ITG1
2021-01-13,PF/BT,190316.0,RIA11 - ASS.J.F.KENNEDY - C.RIAB.ONLUS,SIC,60-69,5,8,0,9,4,0,0,13,0,13,Sicilia,ITG1
2021-01-13,PF/BT,190316.0,RIA11 - ASS.J.F.KENNEDY - C.RIAB.ONLUS,SIC,70-79,2,1,0,3,0,0,0,3,0,3,Sicilia,ITG1
2021-01-13,PF/BT,190316.0,RIA11 - ASS.J.F.KENNEDY - C.RIAB.ONLUS,SIC,80-89,0,2,0,1,1,0,0,2,0,2,Sicilia,ITG1
2021-01-13,PF/BT,190316.0,RIA11 - ASS.J.F.KENNEDY - C.RIAB.ONLUS,SIC,90+,0,1,0,0,1,0,0,1,0,1,Sicilia,ITG1
2021-01-13,PF/BT,190317.0,HSP11 - P.O. Gravina e S. Pietro Caltagirone,SIC,20-29,3,0,0,2,1,0,0,3,0,3,Sicilia,ITG1
2021-01-13,PF/BT,190317.0,HSP11 - P.O. Gravina e S. Pietro Caltagirone,SIC,30-39,5,5,0,5,5,0,0,10,0,10,Sicilia,ITG1
2021-01-13,PF/BT,190317.0,HSP11 - P.O. Gravina e S. Pietro Caltagirone,SIC,40-49,9,5,0,11,3,0,0,14,0,14,Sicilia,ITG1
2021-01-13,PF/BT,190317.0,HSP11 - P.O. Gravina e S. Pietro Caltagirone,SIC,50-59,4,14,0,14,4,0,0,18,0,18,Sicilia,ITG1
2021-01-13,PF/BT,190317.0,HSP11 - P.O. Gravina e S. Pietro Caltagirone,SIC,60-69,8,6,0,9,5,0,0,14,0,14,Sicilia,ITG1
2021-01-13,PF/BT,190317.0,HSP11 - P.O. Gravina e S. Pietro Caltagirone,SIC,80-89,0,1,0,1,0,0,0,1,0,1,Sicilia,ITG1
2021-01-13,PF/BT,190319.0,HSP11 - P. O. UMBERTO I,SIC,20-29,2,1,0,0,0,0,3,3,0,3,Sicilia,ITG1
2021-01-13,PF/BT,190319.0,HSP11 - P. O. UMBERTO I,SIC,30-39,3,4,0,5,0,0,2,7,0,7,Sicilia,ITG1
2021-01-13,PF/BT,190319.0,HSP11 - P. O. UMBERTO I,SIC,40-49,10,8,0,9,3,0,6,18,0,18,Sicilia,ITG1
2021-01-13,PF/BT,190319.0,HSP11 - P. O. UMBERTO I,SIC,50-59,8,6,0,9,2,0,3,14,0,14,Sicilia,ITG1
2021-01-13,PF/BT,190319.0,HSP11 - P. O. UMBERTO I,SIC,60-69,9,8,0,12,2,0,3,17,0,17,Sicilia,ITG1
2021-01-13,PF/BT,190325.0,HSP11 - P.O. G. FOGLIANI MILAZZO,SIC,30-39,4,5,0,9,0,0,0,9,0,9,Sicilia,ITG1
2021-01-13,PF/BT,190325.0,HSP11 - P.O. G. FOGLIANI MILAZZO,SIC,40-49,3,8,0,10,1,0,0,11,0,11,Sicilia,ITG1
2021-01-13,PF/BT,190325.0,HSP11 - P.O. G. FOGLIANI MILAZZO,SIC,50-59,12,25,0,36,1,0,0,37,0,37,Sicilia,ITG1
2021-01-13,PF/BT,190325.0,HSP11 - P.O. G. FOGLIANI MILAZZO,SIC,60-69,11,14,0,21,4,0,0,25,0,25,Sicilia,ITG1
2021-01-13,PF/BT,190328.0,HSP11 - P.O. BARONE-ROMEO PATTI,SIC,20-29,1,0,0,0,0,0,1,1,0,1,Sicilia,ITG1
2021-01-13,PF/BT,190328.0,HSP11 - P.O. BARONE-ROMEO PATTI,SIC,30-39,1,4,0,4,0,0,1,5,0,5,Sicilia,ITG1
2021-01-13,PF/BT,190328.0,HSP11 - P.O. BARONE-ROMEO PATTI,SIC,40-49,2,2,0,0,0,0,4,4,0,4,Sicilia,ITG1
2021-01-13,PF/BT,190328.0,HSP11 - P.O. BARONE-ROMEO PATTI,SIC,50-59,7,2,0,4,1,0,4,9,0,9,Sicilia,ITG1
2021-01-13,PF/BT,190328.0,HSP11 - P.O. BARONE-ROMEO PATTI,SIC,60-69,6,2,0,6,1,0,1,8,0,8,Sicilia,ITG1
2021-01-13,PF/BT,190328.0,HSP11 - P.O. BARONE-ROMEO PATTI,SIC,70-79,1,0,0,1,0,0,0,1,0,1,Sicilia,ITG1
2021-01-13,PF/BT,190328.0,HSP11 - P.O. BARONE-ROMEO PATTI,SIC,80-89,1,1,0,0,0,0,2,2,0,2,Sicilia,ITG1
2021-01-13,PF/BT,190330.0,HSP11 - P.O. DEI BIANCHI CORLEONE,SIC,20-29,1,4,0,5,0,0,0,5,0,5,Sicilia,ITG1
2021-01-13,PF/BT,190330.0,HSP11 - P.O. DEI BIANCHI CORLEONE,SIC,30-39,3,3,0,6,0,0,0,6,0,6,Sicilia,ITG1
2021-01-13,PF/BT,190330.0,HSP11 - P.O. DEI BIANCHI CORLEONE,SIC,40-49,12,7,0,15,3,0,1,19,0,19,Sicilia,ITG1
2021-01-13,PF/BT,190330.0,HSP11 - P.O. DEI BIANCHI CORLEONE,SIC,50-59,8,6,0,12,1,0,1,14,0,14,Sicilia,ITG1
2021-01-13,PF/BT,190330.0,HSP11 - P.O. DEI BIANCHI CORLEONE,SIC,60-69,3,4,0,7,0,0,0,7,0,7,Sicilia,ITG1
2021-01-13,PF/BT,190330.0,HSP11 - P.O. DEI BIANCHI CORLEONE,SIC,70-79,1,2,0,1,0,0,2,3,0,3,Sicilia,ITG1
2021-01-13,PF/BT,190332.0,HSP11 - P.O. CIVICO PARTINICO,SIC,20-29,2,1,0,2,1,0,0,3,0,3,Sicilia,ITG1
2021-01-13,PF/BT,190332.0,HSP11 - P.O. CIVICO PARTINICO,SIC,30-39,4,1,0,4,0,1,0,5,0,5,Sicilia,ITG1
2021-01-13,PF/BT,190332.0,HSP11 - P.O. CIVICO PARTINICO,SIC,40-49,11,3,0,5,6,3,0,14,0,14,Sicilia,ITG1
2021-01-13,PF/BT,190332.0,HSP11 - P.O. CIVICO PARTINICO,SIC,50-59,5,11,0,13,1,2,0,16,0,16,Sicilia,ITG1
2021-01-13,PF/BT,190332.0,HSP11 - P.O. CIVICO PARTINICO,SIC,60-69,10,5,0,10,1,4,0,15,0,15,Sicilia,ITG1
2021-01-13,PF/BT,190332.0,HSP11 - P.O. CIVICO PARTINICO,SIC,70-79,6,0,0,5,0,1,0,6,0,6,Sicilia,ITG1
2021-01-13,PF/BT,190333.0,HSP11 - P.O. MADONNA DELLALTO - PETR. SOTTANA,SIC,20-29,1,0,0,1,0,0,0,1,0,1,Sicilia,ITG1
2021-01-13,PF/BT,190333.0,HSP11 - P.O. MADONNA DELLALTO - PETR. SOTTANA,SIC,30-39,2,7,0,8,1,0,0,9,0,9,Sicilia,ITG1
2021-01-13,PF/BT,190333.0,HSP11 - P.O. MADONNA DELLALTO - PETR. SOTTANA,SIC,40-49,0,6,0,6,0,0,0,6,0,6,Sicilia,ITG1
2021-01-13,PF/BT,190333.0,HSP11 - P.O. MADONNA DELLALTO - PETR. SOTTANA,SIC,50-59,1,10,0,7,0,2,2,11,0,11,Sicilia,ITG1
2021-01-13,PF/BT,190333.0,HSP11 - P.O. MADONNA DELLALTO - PETR. SOTTANA,SIC,60-69,1,6,0,6,1,0,0,7,0,7,Sicilia,ITG1
2021-01-13,PF/BT,190333.0,HSP11 - P.O. MADONNA DELLALTO - PETR. SOTTANA,SIC,70-79,3,3,0,0,0,4,2,6,0,6,Sicilia,ITG1
2021-01-13,PF/BT,190333.0,HSP11 - P.O. MADONNA DELLALTO - PETR. SOTTANA,SIC,80-89,2,6,0,0,0,6,2,8,0,8,Sicilia,ITG1
2021-01-13,PF/BT,190333.0,HSP11 - P.O. MADONNA DELLALTO - PETR. SOTTANA,SIC,90+,0,6,0,0,0,6,0,6,0,6,Sicilia,ITG1
2021-01-13,PF/BT,190334.0,HSP11 - P.O. S. CIMINO TERMINI IMERESE,SIC,20-29,0,5,0,5,0,0,0,5,0,5,Sicilia,ITG1
2021-01-13,PF/BT,190334.0,HSP11 - P.O. S. CIMINO TERMINI IMERESE,SIC,30-39,3,8,0,10,1,0,0,11,0,11,Sicilia,ITG1
2021-01-13,PF/BT,190334.0,HSP11 - P.O. S. CIMINO TERMINI IMERESE,SIC,40-49,6,6,0,11,1,0,0,12,0,12,Sicilia,ITG1
2021-01-13,PF/BT,190334.0,HSP11 - P.O. S. CIMINO TERMINI IMERESE,SIC,50-59,13,8,0,19,2,0,0,21,0,21,Sicilia,ITG1
2021-01-13,PF/BT,190334.0,HSP11 - P.O. S. CIMINO TERMINI IMERESE,SIC,60-69,8,7,0,15,0,0,0,15,0,15,Sicilia,ITG1
2021-01-13,PF/BT,190334.0,HSP11 - P.O. S. CIMINO TERMINI IMERESE,SIC,70-79,5,2,0,7,0,0,0,7,0,7,Sicilia,ITG1
2021-01-13,PF/BT,190334.0,HSP11 - P.O. S. CIMINO TERMINI IMERESE,SIC,80-89,1,0,0,1,0,0,0,1,0,1,Sicilia,ITG1
2021-01-13,PF/BT,190335.0,HSP11 - P.O. G. F. INGRASSIA,SIC,20-29,2,0,0,2,0,0,0,2,0,2,Sicilia,ITG1
2021-01-13,PF/BT,190335.0,HSP11 - P.O. G. F. INGRASSIA,SIC,30-39,2,1,0,3,0,0,0,3,0,3,Sicilia,ITG1
2021-01-13,PF/BT,190335.0,HSP11 - P.O. G. F. INGRASSIA,SIC,40-49,5,1,0,6,0,0,0,6,0,6,Sicilia,ITG1
2021-01-13,PF/BT,190335.0,HSP11 - P.O. G. F. INGRASSIA,SIC,50-59,10,12,0,15,7,0,0,22,0,22,Sicilia,ITG1
2021-01-13,PF/BT,190335.0,HSP11 - P.O. G. F. INGRASSIA,SIC,60-69,6,1,0,6,1,0,0,7,0,7,Sicilia,ITG1
2021-01-13,PF/BT,190335.0,HSP11 - P.O. G. F. INGRASSIA,SIC,70-79,2,0,0,2,0,0,0,2,0,2,Sicilia,ITG1
2021-01-13,PF/BT,190337.0,HSP11 - P.O. VILLA DELLE GINESTRE,SIC,20-29,9,6,0,10,5,0,0,15,0,15,Sicilia,ITG1
2021-01-13,PF/BT,190337.0,HSP11 - P.O. VILLA DELLE GINESTRE,SIC,30-39,11,9,0,14,6,0,0,20,0,20,Sicilia,ITG1
2021-01-13,PF/BT,190337.0,HSP11 - P.O. VILLA DELLE GINESTRE,SIC,40-49,19,14,0,21,10,0,2,33,0,33,Sicilia,ITG1
2021-01-13,PF/BT,190337.0,HSP11 - P.O. VILLA DELLE GINESTRE,SIC,50-59,23,27,0,22,28,0,0,50,0,50,Sicilia,ITG1
2021-01-13,PF/BT,190337.0,HSP11 - P.O. VILLA DELLE GINESTRE,SIC,60-69,40,28,0,58,10,0,0,68,0,68,Sicilia,ITG1
2021-01-13,PF/BT,190337.0,HSP11 - P.O. VILLA DELLE GINESTRE,SIC,70-79,10,0,0,10,0,0,0,10,0,10,Sicilia,ITG1
2021-01-13,PF/BT,190341.0,HSP11 - OSPEDALE BUSACCA SCICLI,SIC,40-49,0,2,0,0,2,0,0,2,0,2,Sicilia,ITG1
2021-01-13,PF/BT,190341.0,HSP11 - OSPEDALE BUSACCA SCICLI,SIC,70-79,1,0,0,0,0,1,0,1,0,1,Sicilia,ITG1
2021-01-13,PF/BT,190343.0,HSP11 - P.O. DI MARIA AVOLA,SIC,20-29,2,0,0,0,2,0,0,2,0,2,Sicilia,ITG1
2021-01-13,PF/BT,190343.0,HSP11 - P.O. DI MARIA AVOLA,SIC,30-39,1,2,0,3,0,0,0,3,0,3,Sicilia,ITG1
2021-01-13,PF/BT,190343.0,HSP11 - P.O. DI MARIA AVOLA,SIC,40-49,8,0,0,4,3,0,1,8,0,8,Sicilia,ITG1
2021-01-13,PF/BT,190343.0,HSP11 - P.O. DI MARIA AVOLA,SIC,50-59,23,12,0,21,12,0,2,35,0,35,Sicilia,ITG1
2021-01-13,PF/BT,190343.0,HSP11 - P.O. DI MARIA AVOLA,SIC,60-69,26,8,0,25,8,0,1,34,0,34,Sicilia,ITG1
2021-01-13,PF/BT,190345.0,HSP11 - P.O. UMBERTO I (EX A.O.),SIC,20-29,2,1,0,0,2,0,1,3,0,3,Sicilia,ITG1
2021-01-13,PF/BT,190345.0,HSP11 - P.O. UMBERTO I (EX A.O.),SIC,30-39,7,10,0,8,5,0,4,17,0,17,Sicilia,ITG1
2021-01-13,PF/BT,190345.0,HSP11 - P.O. UMBERTO I (EX A.O.),SIC,40-49,28,15,0,18,17,0,8,43,0,43,Sicilia,ITG1
2021-01-13,PF/BT,190345.0,HSP11 - P.O. UMBERTO I (EX A.O.),SIC,50-59,26,30,0,29,24,0,3,56,0,56,Sicilia,ITG1
2021-01-13,PF/BT,190345.0,HSP11 - P.O. UMBERTO I (EX A.O.),SIC,60-69,52,12,0,39,13,1,11,64,0,64,Sicilia,ITG1
2021-01-13,PF/BT,190345.0,HSP11 - P.O. UMBERTO I (EX A.O.),SIC,70-79,2,0,0,1,0,0,1,2,0,2,Sicilia,ITG1
2021-01-13,PF/BT,190346.0,HSP11 - P.O. MUSCATELLO AUGUSTA,SIC,20-29,1,0,0,0,0,0,1,1,0,1,Sicilia,ITG1
2021-01-13,PF/BT,190346.0,HSP11 - P.O. MUSCATELLO AUGUSTA,SIC,30-39,5,0,0,2,0,0,3,5,0,5,Sicilia,ITG1
2021-01-13,PF/BT,190346.0,HSP11 - P.O. MUSCATELLO AUGUSTA,SIC,40-49,5,3,0,7,0,0,1,8,0,8,Sicilia,ITG1
2021-01-13,PF/BT,190346.0,HSP11 - P.O. MUSCATELLO AUGUSTA,SIC,50-59,10,4,0,11,0,0,3,14,0,14,Sicilia,ITG1
2021-01-13,PF/BT,190346.0,HSP11 - P.O. MUSCATELLO AUGUSTA,SIC,60-69,11,3,0,13,0,0,1,14,0,14,Sicilia,ITG1
2021-01-13,PF/BT,190347.0,HSP11 - OSPEDALE GENERALE DI ZONA,SIC,20-29,1,0,0,1,0,0,0,1,0,1,Sicilia,ITG1
2021-01-13,PF/BT,190347.0,HSP11 - OSPEDALE GENERALE DI ZONA,SIC,40-49,1,0,0,1,0,0,0,1,0,1,Sicilia,ITG1
2021-01-13,PF/BT,190347.0,HSP11 - OSPEDALE GENERALE DI ZONA,SIC,50-59,5,6,0,11,0,0,0,11,0,11,Sicilia,ITG1
2021-01-13,PF/BT,190347.0,HSP11 - OSPEDALE GENERALE DI ZONA,SIC,60-69,13,4,0,17,0,0,0,17,0,17,Sicilia,ITG1
2021-01-13,PF/BT,190349.0,HSP11 - P.O. SAN VITO E SANTO SPIRITO -ALCAMO,SIC,20-29,2,2,0,1,0,0,3,4,0,4,Sicilia,ITG1
2021-01-13,PF/BT,190349.0,HSP11 - P.O. SAN VITO E SANTO SPIRITO -ALCAMO,SIC,30-39,1,1,0,0,1,0,1,2,0,2,Sicilia,ITG1
2021-01-13,PF/BT,190349.0,HSP11 - P.O. SAN VITO E SANTO SPIRITO -ALCAMO,SIC,40-49,4,10,0,6,4,0,4,14,0,14,Sicilia,ITG1
2021-01-13,PF/BT,190349.0,HSP11 - P.O. SAN VITO E SANTO SPIRITO -ALCAMO,SIC,50-59,0,7,0,4,1,0,2,7,0,7,Sicilia,ITG1
2021-01-13,PF/BT,190349.0,HSP11 - P.O. SAN VITO E SANTO SPIRITO -ALCAMO,SIC,60-69,3,1,0,1,1,2,0,4,0,4,Sicilia,ITG1
2021-01-13,PF/BT,190349.0,HSP11 - P.O. SAN VITO E SANTO SPIRITO -ALCAMO,SIC,70-79,1,3,0,0,1,3,0,4,0,4,Sicilia,ITG1
2021-01-13,PF/BT,190349.0,HSP11 - P.O. SAN VITO E SANTO SPIRITO -ALCAMO,SIC,80-89,7,7,0,0,0,14,0,14,0,14,Sicilia,ITG1
2021-01-13,PF/BT,190349.0,HSP11 - P.O. SAN VITO E SANTO SPIRITO -ALCAMO,SIC,90+,2,9,0,0,0,11,0,11,0,11,Sicilia,ITG1
2021-01-13,PF/BT,190351.0,HSP11 - P.O. S. ANTONIO ABATE  - TRAPANI,SIC,16-19,1,1,0,2,0,0,0,2,0,2,Sicilia,ITG1
2021-01-13,PF/BT,190351.0,HSP11 - P.O. S. ANTONIO ABATE  - TRAPANI,SIC,20-29,9,11,0,16,4,0,0,20,0,20,Sicilia,ITG1
2021-01-13,PF/BT,190351.0,HSP11 - P.O. S. ANTONIO ABATE  - TRAPANI,SIC,30-39,4,9,0,10,3,0,0,13,0,13,Sicilia,ITG1
2021-01-13,PF/BT,190351.0,HSP11 - P.O. S. ANTONIO ABATE  - TRAPANI,SIC,40-49,10,21,0,20,11,0,0,31,0,31,Sicilia,ITG1
2021-01-13,PF/BT,190351.0,HSP11 - P.O. S. ANTONIO ABATE  - TRAPANI,SIC,50-59,23,21,0,20,24,0,0,44,0,44,Sicilia,ITG1
2021-01-13,PF/BT,190351.0,HSP11 - P.O. S. ANTONIO ABATE  - TRAPANI,SIC,60-69,13,8,0,11,10,0,0,21,0,21,Sicilia,ITG1
2021-01-13,PF/BT,190351.0,HSP11 - P.O. S. ANTONIO ABATE  - TRAPANI,SIC,70-79,5,1,0,2,4,0,0,6,0,6,Sicilia,ITG1
2021-01-13,PF/BT,190351.0,HSP11 - P.O. S. ANTONIO ABATE  - TRAPANI,SIC,80-89,1,0,0,0,1,0,0,1,0,1,Sicilia,ITG1
2021-01-13,PF/BT,190352.0,HSP11 - P.O. V.EMANUELE II CASTELVETRANO,SIC,20-29,2,4,0,2,4,0,0,6,0,6,Sicilia,ITG1
2021-01-13,PF/BT,190352.0,HSP11 - P.O. V.EMANUELE II CASTELVETRANO,SIC,30-39,3,13,0,11,5,0,0,16,0,16,Sicilia,ITG1
2021-01-13,PF/BT,190352.0,HSP11 - P.O. V.EMANUELE II CASTELVETRANO,SIC,40-49,3,9,0,6,6,0,0,12,0,12,Sicilia,ITG1
2021-01-13,PF/BT,190352.0,HSP11 - P.O. V.EMANUELE II CASTELVETRANO,SIC,50-59,6,9,0,8,7,0,0,15,0,15,Sicilia,ITG1
2021-01-13,PF/BT,190352.0,HSP11 - P.O. V.EMANUELE II CASTELVETRANO,SIC,60-69,10,6,0,9,7,0,0,16,0,16,Sicilia,ITG1
2021-01-13,PF/BT,190352.0,HSP11 - P.O. V.EMANUELE II CASTELVETRANO,SIC,70-79,0,1,0,0,1,0,0,1,0,1,Sicilia,ITG1
2021-01-13,PF/BT,190353.0,HSP11 - P.O.PAOLO BORSELLINO - MARSALA,SIC,20-29,1,3,0,2,2,0,0,4,0,4,Sicilia,ITG1
2021-01-13,PF/BT,190353.0,HSP11 - P.O.PAOLO BORSELLINO - MARSALA,SIC,30-39,9,12,0,15,6,0,0,21,0,21,Sicilia,ITG1
2021-01-13,PF/BT,190353.0,HSP11 - P.O.PAOLO BORSELLINO - MARSALA,SIC,40-49,6,12,0,7,11,0,0,18,0,18,Sicilia,ITG1
2021-01-13,PF/BT,190353.0,HSP11 - P.O.PAOLO BORSELLINO - MARSALA,SIC,50-59,5,10,0,7,8,0,0,15,0,15,Sicilia,ITG1
2021-01-13,PF/BT,190353.0,HSP11 - P.O.PAOLO BORSELLINO - MARSALA,SIC,60-69,2,4,0,4,2,0,0,6,0,6,Sicilia,ITG1
2021-01-13,PF/BT,190355.0,HSP11 - P.O. VITTORIO EMANUELE III - SALEMI,SIC,20-29,3,3,0,5,1,0,0,6,0,6,Sicilia,ITG1
2021-01-13,PF/BT,190355.0,HSP11 - P.O. VITTORIO EMANUELE III - SALEMI,SIC,30-39,1,5,0,4,2,0,0,6,0,6,Sicilia,ITG1
2021-01-13,PF/BT,190355.0,HSP11 - P.O. VITTORIO EMANUELE III - SALEMI,SIC,40-49,2,4,0,4,2,0,0,6,0,6,Sicilia,ITG1
2021-01-13,PF/BT,190355.0,HSP11 - P.O. VITTORIO EMANUELE III - SALEMI,SIC,50-59,1,0,0,1,0,0,0,1,0,1,Sicilia,ITG1
2021-01-13,PF/BT,190355.0,HSP11 - P.O. VITTORIO EMANUELE III - SALEMI,SIC,60-69,3,1,0,4,0,0,0,4,0,4,Sicilia,ITG1
2021-01-13,PF/BT,190355.0,HSP11 - P.O. VITTORIO EMANUELE III - SALEMI,SIC,70-79,1,0,0,0,1,0,0,1,0,1,Sicilia,ITG1
2021-01-13,PF/BT,190506.0,HSP11 - SO.GE.SA.SPA.C.DI.C.S.BARBARA,SIC,20-29,4,4,0,7,1,0,0,8,0,8,Sicilia,ITG1
2021-01-13,PF/BT,190506.0,HSP11 - SO.GE.SA.SPA.C.DI.C.S.BARBARA,SIC,30-39,9,6,0,14,1,0,0,15,0,15,Sicilia,ITG1
2021-01-13,PF/BT,190506.0,HSP11 - SO.GE.SA.SPA.C.DI.C.S.BARBARA,SIC,40-49,4,6,0,9,1,0,0,10,0,10,Sicilia,ITG1
2021-01-13,PF/BT,190506.0,HSP11 - SO.GE.SA.SPA.C.DI.C.S.BARBARA,SIC,50-59,18,7,0,25,0,0,0,25,0,25,Sicilia,ITG1
2021-01-13,PF/BT,190506.0,HSP11 - SO.GE.SA.SPA.C.DI.C.S.BARBARA,SIC,60-69,4,3,0,7,0,0,0,7,0,7,Sicilia,ITG1
2021-01-13,PF/BT,190506.0,HSP11 - SO.GE.SA.SPA.C.DI.C.S.BARBARA,SIC,70-79,1,0,0,1,0,0,0,1,0,1,Sicilia,ITG1
2021-01-13,PF/BT,190506.0,HSP11 - SO.GE.SA.SPA.C.DI.C.S.BARBARA,SIC,80-89,1,2,0,0,0,3,0,3,0,3,Sicilia,ITG1
2021-01-13,PF/BT,190513.0,HSP11 - CASA DI CURA G.B. MORGAGNI S.R.L.,SIC,16-19,0,1,0,0,0,0,1,1,0,1,Sicilia,ITG1
2021-01-13,PF/BT,190513.0,HSP11 - CASA DI CURA G.B. MORGAGNI S.R.L.,SIC,20-29,0,2,0,2,0,0,0,2,0,2,Sicilia,ITG1
2021-01-13,PF/BT,190513.0,HSP11 - CASA DI CURA G.B. MORGAGNI S.R.L.,SIC,30-39,0,3,0,2,0,0,1,3,0,3,Sicilia,ITG1
2021-01-13,PF/BT,190513.0,HSP11 - CASA DI CURA G.B. MORGAGNI S.R.L.,SIC,40-49,1,2,0,1,2,0,0,3,0,3,Sicilia,ITG1
2021-01-13,PF/BT,190513.0,HSP11 - CASA DI CURA G.B. MORGAGNI S.R.L.,SIC,50-59,1,2,0,3,0,0,0,3,0,3,Sicilia,ITG1
2021-01-13,PF/BT,190513.0,HSP11 - CASA DI CURA G.B. MORGAGNI S.R.L.,SIC,60-69,3,2,0,3,0,0,2,5,0,5,Sicilia,ITG1
2021-01-13,PF/BT,190513.0,HSP11 - CASA DI CURA G.B. MORGAGNI S.R.L.,SIC,70-79,1,0,0,1,0,0,0,1,0,1,Sicilia,ITG1
2021-01-13,PF/BT,190524.0,HSP11 - I.O.M.I. F.SCALABRINO GANZIRRI,SIC,20-29,10,6,0,12,4,0,0,16,0,16,Sicilia,ITG1
2021-01-13,PF/BT,190524.0,HSP11 - I.O.M.I. F.SCALABRINO GANZIRRI,SIC,30-39,18,10,0,22,6,0,0,28,0,28,Sicilia,ITG1
2021-01-13,PF/BT,190524.0,HSP11 - I.O.M.I. F.SCALABRINO GANZIRRI,SIC,40-49,19,5,0,12,12,0,0,24,0,24,Sicilia,ITG1
2021-01-13,PF/BT,190524.0,HSP11 - I.O.M.I. F.SCALABRINO GANZIRRI,SIC,50-59,25,14,0,31,8,0,0,39,0,39,Sicilia,ITG1
2021-01-13,PF/BT,190524.0,HSP11 - I.O.M.I. F.SCALABRINO GANZIRRI,SIC,60-69,22,9,0,24,7,0,0,31,0,31,Sicilia,ITG1
2021-01-13,PF/BT,190553.0,HSP11 - CASA DI CURA RIABILITATIVA VILLA SOFIA,SIC,20-29,2,8,0,10,0,0,0,10,0,10,Sicilia,ITG1
2021-01-13,PF/BT,190553.0,HSP11 - CASA DI CURA RIABILITATIVA VILLA SOFIA,SIC,30-39,1,6,0,7,0,0,0,7,0,7,Sicilia,ITG1
2021-01-13,PF/BT,190553.0,HSP11 - CASA DI CURA RIABILITATIVA VILLA SOFIA,SIC,40-49,2,3,0,4,1,0,0,5,0,5,Sicilia,ITG1
2021-01-13,PF/BT,190553.0,HSP11 - CASA DI CURA RIABILITATIVA VILLA SOFIA,SIC,50-59,2,4,0,6,0,0,0,6,0,6,Sicilia,ITG1
2021-01-13,PF/BT,190553.0,HSP11 - CASA DI CURA RIABILITATIVA VILLA SOFIA,SIC,60-69,1,1,0,1,1,0,0,2,0,2,Sicilia,ITG1
2021-01-13,PF/BT,190723.0,HSP11 - CASA DI CURA VALSALVA  SRL,SIC,50-59,3,0,0,1,1,0,1,3,0,3,Sicilia,ITG1
2021-01-13,PF/BT,190723.0,HSP11 - CASA DI CURA VALSALVA  SRL,SIC,60-69,1,0,0,1,0,0,0,1,0,1,Sicilia,ITG1
2021-01-13,PF/BT,190723.0,HSP11 - CASA DI CURA VALSALVA  SRL,SIC,70-79,1,0,0,1,0,0,0,1,0,1,Sicilia,ITG1
2021-01-13,PF/BT,190728.0,HSP11 - CLINICA SANTAGATA Tigano srl,SIC,20-29,5,3,0,8,0,0,0,8,0,8,Sicilia,ITG1
2021-01-13,PF/BT,190728.0,HSP11 - CLINICA SANTAGATA Tigano srl,SIC,30-39,5,6,0,11,0,0,0,11,0,11,Sicilia,ITG1
2021-01-13,PF/BT,190728.0,HSP11 - CLINICA SANTAGATA Tigano srl,SIC,40-49,4,10,0,10,4,0,0,14,0,14,Sicilia,ITG1
2021-01-13,PF/BT,190728.0,HSP11 - CLINICA SANTAGATA Tigano srl,SIC,50-59,3,8,0,10,1,0,0,11,0,11,Sicilia,ITG1
2021-01-13,PF/BT,190728.0,HSP11 - CLINICA SANTAGATA Tigano srl,SIC,60-69,0,3,0,2,1,0,0,3,0,3,Sicilia,ITG1
2021-01-13,PF/BT,190728.0,HSP11 - CLINICA SANTAGATA Tigano srl,SIC,70-79,1,0,0,1,0,0,0,1,0,1,Sicilia,ITG1
2021-01-13,PF/BT,190921.0,HSP11 - A.O. per lEmergenza Cannizzaro,SIC,20-29,3,1,0,2,2,0,0,4,0,4,Sicilia,ITG1
2021-01-13,PF/BT,190921.0,HSP11 - A.O. per lEmergenza Cannizzaro,SIC,30-39,9,2,0,7,4,0,0,11,0,11,Sicilia,ITG1
2021-01-13,PF/BT,190921.0,HSP11 - A.O. per lEmergenza Cannizzaro,SIC,40-49,12,3,0,4,11,0,0,15,0,15,Sicilia,ITG1
2021-01-13,PF/BT,190921.0,HSP11 - A.O. per lEmergenza Cannizzaro,SIC,50-59,15,5,0,7,13,0,0,20,0,20,Sicilia,ITG1
2021-01-13,PF/BT,190921.0,HSP11 - A.O. per lEmergenza Cannizzaro,SIC,60-69,1,3,0,0,4,0,0,4,0,4,Sicilia,ITG1
2021-01-13,PF/BT,19092201.0,HSP11 - OSPEDALE GARIBALDI - CENTRO,SIC,20-29,2,1,0,1,0,0,2,3,0,3,Sicilia,ITG1
2021-01-13,PF/BT,19092201.0,HSP11 - OSPEDALE GARIBALDI - CENTRO,SIC,30-39,5,6,0,0,2,0,9,11,0,11,Sicilia,ITG1
2021-01-13,PF/BT,19092201.0,HSP11 - OSPEDALE GARIBALDI - CENTRO,SIC,40-49,5,12,0,2,3,0,12,17,0,17,Sicilia,ITG1
2021-01-13,PF/BT,19092201.0,HSP11 - OSPEDALE GARIBALDI - CENTRO,SIC,50-59,11,10,0,3,3,0,15,21,0,21,Sicilia,ITG1
2021-01-13,PF/BT,19092201.0,HSP11 - OSPEDALE GARIBALDI - CENTRO,SIC,60-69,11,9,0,2,7,0,11,20,0,20,Sicilia,ITG1
2021-01-13,PF/BT,19092204.0,HSP11 - NUOVO OSPEDALE GARIBALDI - NESIMA,SIC,20-29,0,2,0,1,1,0,0,2,0,2,Sicilia,ITG1
2021-01-13,PF/BT,19092204.0,HSP11 - NUOVO OSPEDALE GARIBALDI - NESIMA,SIC,30-39,12,5,0,3,14,0,0,17,0,17,Sicilia,ITG1
2021-01-13,PF/BT,19092204.0,HSP11 - NUOVO OSPEDALE GARIBALDI - NESIMA,SIC,40-49,9,5,0,1,13,0,0,14,0,14,Sicilia,ITG1
2021-01-13,PF/BT,19092204.0,HSP11 - NUOVO OSPEDALE GARIBALDI - NESIMA,SIC,50-59,7,7,0,3,11,0,0,14,0,14,Sicilia,ITG1
2021-01-13,PF/BT,19092204.0,HSP11 - NUOVO OSPEDALE GARIBALDI - NESIMA,SIC,60-69,4,2,0,3,3,0,0,6,0,6,Sicilia,ITG1
2021-01-13,PF/BT,19092301.0,HSP11 - PRESIDIO OSPEDALIERO GASPARE RODOLICO,SIC,16-19,8,19,0,27,0,0,0,27,0,27,Sicilia,ITG1
2021-01-13,PF/BT,19092301.0,HSP11 - PRESIDIO OSPEDALIERO GASPARE RODOLICO,SIC,20-29,65,109,0,174,0,0,0,174,0,174,Sicilia,ITG1
2021-01-13,PF/BT,19092301.0,HSP11 - PRESIDIO OSPEDALIERO GASPARE RODOLICO,SIC,30-39,7,12,0,19,0,0,0,19,0,19,Sicilia,ITG1
2021-01-13,PF/BT,19092301.0,HSP11 - PRESIDIO OSPEDALIERO GASPARE RODOLICO,SIC,40-49,4,6,0,10,0,0,0,10,0,10,Sicilia,ITG1
2021-01-13,PF/BT,19092301.0,HSP11 - PRESIDIO OSPEDALIERO GASPARE RODOLICO,SIC,50-59,2,8,0,10,0,0,0,10,0,10,Sicilia,ITG1
2021-01-13,PF/BT,19092301.0,HSP11 - PRESIDIO OSPEDALIERO GASPARE RODOLICO,SIC,60-69,3,3,0,6,0,0,0,6,0,6,Sicilia,ITG1
2021-01-13,PF/BT,19092304.0,HSP11 - PRESIDIO OSPEDALIERO S.MARCO,SIC,16-19,11,18,0,29,0,0,0,29,0,29,Sicilia,ITG1
2021-01-13,PF/BT,19092304.0,HSP11 - PRESIDIO OSPEDALIERO S.MARCO,SIC,20-29,57,82,0,137,2,0,0,139,0,139,Sicilia,ITG1
2021-01-13,PF/BT,19092304.0,HSP11 - PRESIDIO OSPEDALIERO S.MARCO,SIC,30-39,3,3,0,6,0,0,0,6,0,6,Sicilia,ITG1
2021-01-13,PF/BT,19092304.0,HSP11 - PRESIDIO OSPEDALIERO S.MARCO,SIC,40-49,3,8,0,9,2,0,0,11,0,11,Sicilia,ITG1
2021-01-13,PF/BT,19092304.0,HSP11 - PRESIDIO OSPEDALIERO S.MARCO,SIC,50-59,3,8,0,11,0,0,0,11,0,11,Sicilia,ITG1
2021-01-13,PF/BT,19092304.0,HSP11 - PRESIDIO OSPEDALIERO S.MARCO,SIC,60-69,4,3,0,7,0,0,0,7,0,7,Sicilia,ITG1
2021-01-13,PF/BT,19092501.0,HSP11 - COVID HOSPITAL,SIC,20-29,23,17,0,40,0,0,0,40,0,40,Sicilia,ITG1
2021-01-13,PF/BT,19092501.0,HSP11 - COVID HOSPITAL,SIC,30-39,26,24,0,50,0,0,0,50,0,50,Sicilia,ITG1
2021-01-13,PF/BT,19092501.0,HSP11 - COVID HOSPITAL,SIC,40-49,10,16,0,26,0,0,0,26,0,26,Sicilia,ITG1
2021-01-13,PF/BT,19092501.0,HSP11 - COVID HOSPITAL,SIC,50-59,10,12,0,22,0,0,0,22,0,22,Sicilia,ITG1
2021-01-13,PF/BT,19092501.0,HSP11 - COVID HOSPITAL,SIC,60-69,5,9,0,14,0,0,0,14,0,14,Sicilia,ITG1
2021-01-13,PF/BT,19092601.0,HSP11 - P.O. Villa Sofia,SIC,20-29,10,1,0,2,4,0,5,11,0,11,Sicilia,ITG1
2021-01-13,PF/BT,19092601.0,HSP11 - P.O. Villa Sofia,SIC,30-39,19,13,0,9,9,0,14,32,0,32,Sicilia,ITG1
2021-01-13,PF/BT,19092601.0,HSP11 - P.O. Villa Sofia,SIC,40-49,32,22,0,9,21,0,24,54,0,54,Sicilia,ITG1
2021-01-13,PF/BT,19092601.0,HSP11 - P.O. Villa Sofia,SIC,50-59,19,17,0,7,18,0,11,36,0,36,Sicilia,ITG1
2021-01-13,PF/BT,19092601.0,HSP11 - P.O. Villa Sofia,SIC,60-69,10,13,0,10,7,0,6,23,0,23,Sicilia,ITG1
2021-01-13,PF/BT,19092701.0,HSP11 - Ospedale Civico,SIC,20-29,13,5,0,2,16,0,0,18,0,18,Sicilia,ITG1
2021-01-13,PF/BT,19092701.0,HSP11 - Ospedale Civico,SIC,30-39,18,6,0,5,19,0,0,24,0,24,Sicilia,ITG1
2021-01-13,PF/BT,19092701.0,HSP11 - Ospedale Civico,SIC,40-49,30,12,0,5,37,0,0,42,0,42,Sicilia,ITG1
2021-01-13,PF/BT,19092701.0,HSP11 - Ospedale Civico,SIC,50-59,17,10,0,8,19,0,0,27,0,27,Sicilia,ITG1
2021-01-13,PF/BT,19092701.0,HSP11 - Ospedale Civico,SIC,60-69,9,5,0,10,4,0,0,14,0,14,Sicilia,ITG1
2021-01-13,PF/BT,19092701.0,HSP11 - Ospedale Civico,SIC,70-79,1,0,0,1,0,0,0,1,0,1,Sicilia,ITG1
2021-01-13,PF/BT,19092702.0,HSP11 - Ospedale dei Bambini G. Di Cristina,SIC,40-49,0,1,0,1,0,0,0,1,0,1,Sicilia,ITG1
2021-01-13,PF/BT,19092702.0,HSP11 - Ospedale dei Bambini G. Di Cristina,SIC,50-59,1,0,0,0,1,0,0,1,0,1,Sicilia,ITG1
2021-01-13,PF/BT,19092702.0,HSP11 - Ospedale dei Bambini G. Di Cristina,SIC,60-69,3,0,0,0,3,0,0,3,0,3,Sicilia,ITG1
2021-01-13,PF/BT,190928.0,HSP11 - AZ.OSP.UNIV.P.GIACCONE,SIC,20-29,10,10,0,17,3,0,0,20,0,20,Sicilia,ITG1
2021-01-13,PF/BT,190928.0,HSP11 - AZ.OSP.UNIV.P.GIACCONE,SIC,30-39,7,12,0,10,9,0,0,19,0,19,Sicilia,ITG1
2021-01-13,PF/BT,190928.0,HSP11 - AZ.OSP.UNIV.P.GIACCONE,SIC,40-49,12,21,0,15,15,0,3,33,0,33,Sicilia,ITG1
2021-01-13,PF/BT,190928.0,HSP11 - AZ.OSP.UNIV.P.GIACCONE,SIC,50-59,23,25,0,24,20,0,4,48,0,48,Sicilia,ITG1
2021-01-13,PF/BT,190928.0,HSP11 - AZ.OSP.UNIV.P.GIACCONE,SIC,60-69,15,17,0,19,10,0,3,32,0,32,Sicilia,ITG1
2021-01-13,PF/BT,190928.0,HSP11 - AZ.OSP.UNIV.P.GIACCONE,SIC,70-79,3,0,0,3,0,0,0,3,0,3,Sicilia,ITG1
2021-01-13,PF/BT,190929.0,STS11 - IRCCS Ismett,SIC,20-29,1,1,0,2,0,0,0,2,0,2,Sicilia,ITG1
2021-01-13,PF/BT,190929.0,STS11 - IRCCS Ismett,SIC,40-49,1,4,0,4,1,0,0,5,0,5,Sicilia,ITG1
2021-01-13,PF/BT,190929.0,STS11 - IRCCS Ismett,SIC,50-59,3,1,0,3,1,0,0,4,0,4,Sicilia,ITG1
2021-01-13,PF/BT,190929.0,STS11 - IRCCS Ismett,SIC,60-69,1,0,0,0,1,0,0,1,0,1,Sicilia,ITG1
2021-01-13,PF/BT,190950.0,HSP11 - ASSOCIAZIONE OASI MARIA SS,SIC,16-19,3,1,0,0,0,0,4,4,0,4,Sicilia,ITG1
2021-01-13,PF/BT,190950.0,HSP11 - ASSOCIAZIONE OASI MARIA SS,SIC,20-29,12,7,0,5,0,0,14,19,0,19,Sicilia,ITG1
2021-01-13,PF/BT,190950.0,HSP11 - ASSOCIAZIONE OASI MARIA SS,SIC,30-39,5,8,0,4,0,0,9,13,0,13,Sicilia,ITG1
2021-01-13,PF/BT,190950.0,HSP11 - ASSOCIAZIONE OASI MARIA SS,SIC,40-49,8,14,0,11,0,0,11,22,0,22,Sicilia,ITG1
2021-01-13,PF/BT,190950.0,HSP11 - ASSOCIAZIONE OASI MARIA SS,SIC,50-59,3,16,0,12,0,0,7,19,0,19,Sicilia,ITG1
2021-01-13,PF/BT,190950.0,HSP11 - ASSOCIAZIONE OASI MARIA SS,SIC,60-69,1,6,0,3,0,0,4,7,0,7,Sicilia,ITG1
2021-01-13,PF/BT,190950.0,HSP11 - ASSOCIAZIONE OASI MARIA SS,SIC,70-79,0,4,0,0,0,0,4,4,0,4,Sicilia,ITG1
2021-01-13,PF/BT,190950.0,HSP11 - ASSOCIAZIONE OASI MARIA SS,SIC,80-89,0,1,0,0,0,0,1,1,0,1,Sicilia,ITG1
2021-01-13,PF/BT,19096002.0,HSP11 - PRESIDIO OSPEDALIERO PIEMONTE,SIC,20-29,1,2,0,2,0,0,1,3,0,3,Sicilia,ITG1
2021-01-13,PF/BT,19096002.0,HSP11 - PRESIDIO OSPEDALIERO PIEMONTE,SIC,30-39,4,3,0,3,0,0,4,7,0,7,Sicilia,ITG1
2021-01-13,PF/BT,19096002.0,HSP11 - PRESIDIO OSPEDALIERO PIEMONTE,SIC,40-49,5,1,0,3,0,0,3,6,0,6,Sicilia,ITG1
2021-01-13,PF/BT,19096002.0,HSP11 - PRESIDIO OSPEDALIERO PIEMONTE,SIC,50-59,6,1,0,2,0,0,5,7,0,7,Sicilia,ITG1
2021-01-13,PF/BT,19096002.0,HSP11 - PRESIDIO OSPEDALIERO PIEMONTE,SIC,60-69,1,0,0,1,0,0,0,1,0,1,Sicilia,ITG1
2021-01-13,PF/BT,600123.0,STS11 - POLIAMBULATORIO,SIC,20-29,6,3,0,5,2,0,2,9,0,9,Sicilia,ITG1
2021-01-13,PF/BT,600123.0,STS11 - POLIAMBULATORIO,SIC,30-39,9,6,0,6,4,0,5,15,0,15,Sicilia,ITG1
2021-01-13,PF/BT,600123.0,STS11 - POLIAMBULATORIO,SIC,40-49,8,12,0,12,5,0,3,20,0,20,Sicilia,ITG1
2021-01-13,PF/BT,600123.0,STS11 - POLIAMBULATORIO,SIC,50-59,10,10,0,8,11,0,1,20,0,20,Sicilia,ITG1
2021-01-13,PF/BT,600123.0,STS11 - POLIAMBULATORIO,SIC,60-69,3,10,0,9,3,0,1,13,0,13,Sicilia,ITG1
2021-01-13,PF/BT,600123.0,STS11 - POLIAMBULATORIO,SIC,70-79,3,1,0,3,0,0,1,4,0,4,Sicilia,ITG1
2021-01-13,PF/BT,608200.0,STS11 - POLIAMBULATORIO San Giorgio,SIC,20-29,2,2,0,4,0,0,0,4,0,4,Sicilia,ITG1
2021-01-13,PF/BT,608200.0,STS11 - POLIAMBULATORIO San Giorgio,SIC,30-39,5,5,1,9,1,0,0,10,0,10,Sicilia,ITG1
2021-01-13,PF/BT,608200.0,STS11 - POLIAMBULATORIO San Giorgio,SIC,40-49,9,9,0,13,5,0,0,18,0,18,Sicilia,ITG1
2021-01-13,PF/BT,608200.0,STS11 - POLIAMBULATORIO San Giorgio,SIC,50-59,11,14,0,22,3,0,0,25,0,25,Sicilia,ITG1
2021-01-13,PF/BT,608200.0,STS11 - POLIAMBULATORIO San Giorgio,SIC,60-69,7,3,0,6,4,0,0,10,0,10,Sicilia,ITG1
2021-01-13,PF/BT,608200.0,STS11 - POLIAMBULATORIO San Giorgio,SIC,70-79,4,0,0,3,1,0,0,4,0,4,Sicilia,ITG1
2021-01-13,PF/BT,608200.0,STS11 - POLIAMBULATORIO San Giorgio,SIC,80-89,0,1,0,1,0,0,0,1,0,1,Sicilia,ITG1
2021-01-13,PF/BT,608400.0,STS11 - POLIAMBULATORIO  San Luigi,SIC,20-29,2,1,0,3,0,0,0,3,0,3,Sicilia,ITG1
2021-01-13,PF/BT,608400.0,STS11 - POLIAMBULATORIO  San Luigi,SIC,30-39,4,6,0,7,3,0,0,10,0,10,Sicilia,ITG1
2021-01-13,PF/BT,608400.0,STS11 - POLIAMBULATORIO  San Luigi,SIC,40-49,6,7,0,9,4,0,0,13,0,13,Sicilia,ITG1
2021-01-13,PF/BT,608400.0,STS11 - POLIAMBULATORIO  San Luigi,SIC,50-59,3,17,0,12,8,0,0,20,0,20,Sicilia,ITG1
2021-01-13,PF/BT,608400.0,STS11 - POLIAMBULATORIO  San Luigi,SIC,60-69,19,10,0,20,9,0,0,29,0,29,Sicilia,ITG1
2021-01-13,PF/BT,608400.0,STS11 - POLIAMBULATORIO  San Luigi,SIC,70-79,2,1,0,3,0,0,0,3,0,3,Sicilia,ITG1
2021-01-13,PF/BT,805900.0,STS11 - RSA VILLA AGATA SOC. COOP. PAPA GIOVANNI,SIC,20-29,3,5,0,8,0,0,0,8,0,8,Sicilia,ITG1
2021-01-13,PF/BT,805900.0,STS11 - RSA VILLA AGATA SOC. COOP. PAPA GIOVANNI,SIC,30-39,3,4,0,6,0,1,0,7,0,7,Sicilia,ITG1
2021-01-13,PF/BT,805900.0,STS11 - RSA VILLA AGATA SOC. COOP. PAPA GIOVANNI,SIC,40-49,4,5,0,9,0,0,0,9,0,9,Sicilia,ITG1
2021-01-13,PF/BT,805900.0,STS11 - RSA VILLA AGATA SOC. COOP. PAPA GIOVANNI,SIC,50-59,0,6,0,5,0,1,0,6,0,6,Sicilia,ITG1
2021-01-13,PF/BT,805900.0,STS11 - RSA VILLA AGATA SOC. COOP. PAPA GIOVANNI,SIC,60-69,5,0,0,3,0,2,0,5,0,5,Sicilia,ITG1
2021-01-13,PF/BT,805900.0,STS11 - RSA VILLA AGATA SOC. COOP. PAPA GIOVANNI,SIC,70-79,0,3,0,0,0,3,0,3,0,3,Sicilia,ITG1
2021-01-13,PF/BT,805900.0,STS11 - RSA VILLA AGATA SOC. COOP. PAPA GIOVANNI,SIC,80-89,0,1,0,0,0,1,0,1,0,1,Sicilia,ITG1
2021-01-13,PF/BT,805900.0,STS11 - RSA VILLA AGATA SOC. COOP. PAPA GIOVANNI,SIC,90+,1,1,0,0,0,2,0,2,0,2,Sicilia,ITG1
2021-01-13,PF/BT,808000.0,STS11 - CTA HELIOS,SIC,20-29,2,1,0,2,0,0,1,3,0,3,Sicilia,ITG1
2021-01-13,PF/BT,808000.0,STS11 - CTA HELIOS,SIC,30-39,6,3,0,9,0,0,0,9,0,9,Sicilia,ITG1
2021-01-13,PF/BT,808000.0,STS11 - CTA HELIOS,SIC,40-49,1,1,0,1,1,0,0,2,0,2,Sicilia,ITG1
2021-01-13,PF/BT,808000.0,STS11 - CTA HELIOS,SIC,50-59,4,7,0,7,1,3,0,11,0,11,Sicilia,ITG1
2021-01-13,PF/BT,808000.0,STS11 - CTA HELIOS,SIC,70-79,0,1,0,0,0,1,0,1,0,1,Sicilia,ITG1
2021-01-13,PF/BT,808000.0,STS11 - CTA HELIOS,SIC,80-89,3,5,0,0,0,8,0,8,0,8,Sicilia,ITG1
2021-01-13,PF/BT,808000.0,STS11 - CTA HELIOS,SIC,90+,1,1,0,0,0,2,0,2,0,2,Sicilia,ITG1
2021-01-13,PF/BT,808300.0,STS11 - CTA VILLA CHIARA,SIC,20-29,4,0,0,1,0,0,3,4,0,4,Sicilia,ITG1
2021-01-13,PF/BT,808300.0,STS11 - CTA VILLA CHIARA,SIC,30-39,6,2,0,4,0,0,4,8,0,8,Sicilia,ITG1
2021-01-13,PF/BT,808300.0,STS11 - CTA VILLA CHIARA,SIC,40-49,10,3,0,5,2,0,6,13,0,13,Sicilia,ITG1
2021-01-13,PF/BT,808300.0,STS11 - CTA VILLA CHIARA,SIC,50-59,11,9,0,11,0,0,9,20,0,20,Sicilia,ITG1
2021-01-13,PF/BT,808300.0,STS11 - CTA VILLA CHIARA,SIC,60-69,2,4,0,1,2,0,3,6,0,6,Sicilia,ITG1
2021-01-13,PF/BT,808300.0,STS11 - CTA VILLA CHIARA,SIC,70-79,2,1,0,0,0,0,3,3,0,3,Sicilia,ITG1
2021-01-13,PF/BT,818000.0,STS11 - R.S.A. BUON PASTORE ONLUS,SIC,16-19,1,1,0,2,0,0,0,2,0,2,Sicilia,ITG1
2021-01-13,PF/BT,818000.0,STS11 - R.S.A. BUON PASTORE ONLUS,SIC,20-29,7,6,0,12,1,0,0,13,0,13,Sicilia,ITG1
2021-01-13,PF/BT,818000.0,STS11 - R.S.A. BUON PASTORE ONLUS,SIC,30-39,5,7,0,8,1,0,3,12,0,12,Sicilia,ITG1
2021-01-13,PF/BT,818000.0,STS11 - R.S.A. BUON PASTORE ONLUS,SIC,40-49,6,9,0,11,0,1,3,15,0,15,Sicilia,ITG1
2021-01-13,PF/BT,818000.0,STS11 - R.S.A. BUON PASTORE ONLUS,SIC,50-59,3,7,0,7,0,1,2,10,0,10,Sicilia,ITG1
2021-01-13,PF/BT,818000.0,STS11 - R.S.A. BUON PASTORE ONLUS,SIC,60-69,2,2,0,4,0,0,0,4,0,4,Sicilia,ITG1
2021-01-13,PF/BT,818000.0,STS11 - R.S.A. BUON PASTORE ONLUS,SIC,70-79,0,3,0,1,0,2,0,3,0,3,Sicilia,ITG1
2021-01-13,PF/BT,818000.0,STS11 - R.S.A. BUON PASTORE ONLUS,SIC,80-89,0,9,0,0,0,9,0,9,0,9,Sicilia,ITG1
2021-01-13,PF/BT,818000.0,STS11 - R.S.A. BUON PASTORE ONLUS,SIC,90+,0,7,0,0,0,7,0,7,0,7,Sicilia,ITG1
2021-01-13,PF/BT,820300.0,STS11 - CASA DI CURA MORANA RESIDENZA SANITARIA ASSISTITA,SIC,40-49,0,1,0,0,0,1,0,1,0,1,Sicilia,ITG1
2021-01-13,PF/BT,820300.0,STS11 - CASA DI CURA MORANA RESIDENZA SANITARIA ASSISTITA,SIC,60-69,0,2,0,0,0,2,0,2,0,2,Sicilia,ITG1
2021-01-13,PF/BT,820300.0,STS11 - CASA DI CURA MORANA RESIDENZA SANITARIA ASSISTITA,SIC,70-79,1,5,0,0,0,6,0,6,0,6,Sicilia,ITG1
2021-01-13,PF/BT,820300.0,STS11 - CASA DI CURA MORANA RESIDENZA SANITARIA ASSISTITA,SIC,80-89,2,9,0,0,0,11,0,11,0,11,Sicilia,ITG1
2021-01-13,PF/BT,820300.0,STS11 - CASA DI CURA MORANA RESIDENZA SANITARIA ASSISTITA,SIC,90+,2,4,0,0,0,6,0,6,0,6,Sicilia,ITG1
2021-01-13,PF/BT,827100.0,STS11 - RSA KORUS srl,SIC,20-29,1,2,0,3,0,0,0,3,0,3,Sicilia,ITG1
2021-01-13,PF/BT,827100.0,STS11 - RSA KORUS srl,SIC,30-39,1,2,0,3,0,0,0,3,0,3,Sicilia,ITG1
2021-01-13,PF/BT,827100.0,STS11 - RSA KORUS srl,SIC,40-49,4,3,0,7,0,0,0,7,0,7,Sicilia,ITG1
2021-01-13,PF/BT,827100.0,STS11 - RSA KORUS srl,SIC,50-59,4,6,0,8,1,1,0,10,0,10,Sicilia,ITG1
2021-01-13,PF/BT,827100.0,STS11 - RSA KORUS srl,SIC,60-69,2,1,0,1,0,2,0,3,0,3,Sicilia,ITG1
2021-01-13,PF/BT,827100.0,STS11 - RSA KORUS srl,SIC,80-89,0,3,0,0,0,3,0,3,0,3,Sicilia,ITG1
2021-01-14,Moderna,1902037.0,STRUTTURE PRIVATE NON CODIFICATE NSIS,SIC,40-49,1,0,0,1,0,0,0,1,0,1,Sicilia,ITG1
2021-01-14,Moderna,1902037.0,STRUTTURE PRIVATE NON CODIFICATE NSIS,SIC,60-69,1,0,0,0,0,1,0,1,0,1,Sicilia,ITG1
2021-01-14,Moderna,1902037.0,STRUTTURE PRIVATE NON CODIFICATE NSIS,SIC,70-79,1,3,0,0,0,4,0,4,0,4,Sicilia,ITG1
2021-01-14,Moderna,1902037.0,STRUTTURE PRIVATE NON CODIFICATE NSIS,SIC,80-89,4,5,0,0,0,9,0,9,0,9,Sicilia,ITG1
2021-01-14,Moderna,1902037.0,STRUTTURE PRIVATE NON CODIFICATE NSIS,SIC,90+,0,5,0,0,0,5,0,5,0,5,Sicilia,ITG1
2021-01-14,Moderna,190345.0,HSP11 - P.O. UMBERTO I (EX A.O.),SIC,20-29,1,0,0,1,0,0,0,1,0,1,Sicilia,ITG1
2021-01-14,Moderna,190345.0,HSP11 - P.O. UMBERTO I (EX A.O.),SIC,30-39,6,3,0,9,0,0,0,9,0,9,Sicilia,ITG1
2021-01-14,Moderna,190345.0,HSP11 - P.O. UMBERTO I (EX A.O.),SIC,40-49,2,2,0,3,1,0,0,4,0,4,Sicilia,ITG1
2021-01-14,Moderna,190345.0,HSP11 - P.O. UMBERTO I (EX A.O.),SIC,50-59,7,17,0,24,0,0,0,24,0,24,Sicilia,ITG1
2021-01-14,Moderna,190345.0,HSP11 - P.O. UMBERTO I (EX A.O.),SIC,60-69,12,10,0,21,1,0,0,22,0,22,Sicilia,ITG1
2021-01-14,PF/BT,1902012.0,AMBULATORI VACCINALI NON CODIFICATI NSIS,SIC,20-29,1,6,0,7,0,0,0,7,0,7,Sicilia,ITG1
2021-01-14,PF/BT,1902012.0,AMBULATORI VACCINALI NON CODIFICATI NSIS,SIC,30-39,8,3,0,10,0,1,0,11,0,11,Sicilia,ITG1
2021-01-14,PF/BT,1902012.0,AMBULATORI VACCINALI NON CODIFICATI NSIS,SIC,40-49,8,14,0,21,0,1,0,22,0,22,Sicilia,ITG1
2021-01-14,PF/BT,1902012.0,AMBULATORI VACCINALI NON CODIFICATI NSIS,SIC,50-59,10,13,0,19,0,4,0,23,0,23,Sicilia,ITG1
2021-01-14,PF/BT,1902012.0,AMBULATORI VACCINALI NON CODIFICATI NSIS,SIC,60-69,7,6,0,5,0,8,0,13,0,13,Sicilia,ITG1
2021-01-14,PF/BT,1902012.0,AMBULATORI VACCINALI NON CODIFICATI NSIS,SIC,70-79,1,4,0,0,0,5,0,5,0,5,Sicilia,ITG1
2021-01-14,PF/BT,1902012.0,AMBULATORI VACCINALI NON CODIFICATI NSIS,SIC,80-89,6,8,0,1,0,13,0,14,0,14,Sicilia,ITG1
2021-01-14,PF/BT,1902012.0,AMBULATORI VACCINALI NON CODIFICATI NSIS,SIC,90+,3,4,0,0,0,7,0,7,0,7,Sicilia,ITG1
2021-01-14,PF/BT,1902027.0,STRUTTURE PRIVATE NON CODIFICATE NSIS,SIC,20-29,0,1,0,1,0,0,0,1,0,1,Sicilia,ITG1
2021-01-14,PF/BT,1902027.0,STRUTTURE PRIVATE NON CODIFICATE NSIS,SIC,30-39,2,2,0,3,1,0,0,4,0,4,Sicilia,ITG1
2021-01-14,PF/BT,1902027.0,STRUTTURE PRIVATE NON CODIFICATE NSIS,SIC,40-49,4,2,0,2,2,2,0,6,0,6,Sicilia,ITG1
2021-01-14,PF/BT,1902027.0,STRUTTURE PRIVATE NON CODIFICATE NSIS,SIC,50-59,3,6,0,5,1,3,0,9,0,9,Sicilia,ITG1
2021-01-14,PF/BT,1902027.0,STRUTTURE PRIVATE NON CODIFICATE NSIS,SIC,60-69,1,2,0,0,0,3,0,3,0,3,Sicilia,ITG1
2021-01-14,PF/BT,1902027.0,STRUTTURE PRIVATE NON CODIFICATE NSIS,SIC,70-79,6,0,0,1,0,5,0,6,0,6,Sicilia,ITG1
2021-01-14,PF/BT,1902027.0,STRUTTURE PRIVATE NON CODIFICATE NSIS,SIC,80-89,4,6,0,0,0,10,0,10,0,10,Sicilia,ITG1
2021-01-14,PF/BT,1902027.0,STRUTTURE PRIVATE NON CODIFICATE NSIS,SIC,90+,3,2,0,0,0,5,0,5,0,5,Sicilia,ITG1
2021-01-14,PF/BT,1902037.0,STRUTTURE PRIVATE NON CODIFICATE NSIS,SIC,20-29,1,1,0,2,0,0,0,2,0,2,Sicilia,ITG1
2021-01-14,PF/BT,1902037.0,STRUTTURE PRIVATE NON CODIFICATE NSIS,SIC,30-39,0,1,0,1,0,0,0,1,0,1,Sicilia,ITG1
2021-01-14,PF/BT,190205.0,CENTRO VACCINALE BARCELLONA P.G.,SIC,20-29,2,5,0,7,0,0,0,7,0,7,Sicilia,ITG1
2021-01-14,PF/BT,190205.0,CENTRO VACCINALE BARCELLONA P.G.,SIC,30-39,7,7,0,14,0,0,0,14,0,14,Sicilia,ITG1
2021-01-14,PF/BT,190205.0,CENTRO VACCINALE BARCELLONA P.G.,SIC,40-49,3,1,0,4,0,0,0,4,0,4,Sicilia,ITG1
2021-01-14,PF/BT,190205.0,CENTRO VACCINALE BARCELLONA P.G.,SIC,50-59,2,3,0,5,0,0,0,5,0,5,Sicilia,ITG1
2021-01-14,PF/BT,190205.0,CENTRO VACCINALE BARCELLONA P.G.,SIC,60-69,3,1,0,4,0,0,0,4,0,4,Sicilia,ITG1
2021-01-14,PF/BT,190205.0,CENTRO VACCINALE BARCELLONA P.G.,SIC,70-79,2,0,0,2,0,0,0,2,0,2,Sicilia,ITG1
2021-01-14,PF/BT,1902077.0,STRUTTURE PRIVATE NON CODIFICATE NSIS,SIC,40-49,1,2,0,2,0,1,0,3,0,3,Sicilia,ITG1
2021-01-14,PF/BT,1902077.0,STRUTTURE PRIVATE NON CODIFICATE NSIS,SIC,50-59,0,1,0,0,0,1,0,1,0,1,Sicilia,ITG1
2021-01-14,PF/BT,1902077.0,STRUTTURE PRIVATE NON CODIFICATE NSIS,SIC,60-69,2,0,0,0,0,2,0,2,0,2,Sicilia,ITG1
2021-01-14,PF/BT,1902077.0,STRUTTURE PRIVATE NON CODIFICATE NSIS,SIC,70-79,5,3,0,0,0,7,1,8,0,8,Sicilia,ITG1
2021-01-14,PF/BT,1902077.0,STRUTTURE PRIVATE NON CODIFICATE NSIS,SIC,80-89,6,10,0,0,0,16,0,16,0,16,Sicilia,ITG1
2021-01-14,PF/BT,1902077.0,STRUTTURE PRIVATE NON CODIFICATE NSIS,SIC,90+,3,3,0,0,0,6,0,6,0,6,Sicilia,ITG1
2021-01-14,PF/BT,1902087.0,STRUTTURE PRIVATE NON CODIFICATE NSIS,SIC,30-39,0,2,0,2,0,0,0,2,0,2,Sicilia,ITG1
2021-01-14,PF/BT,1902087.0,STRUTTURE PRIVATE NON CODIFICATE NSIS,SIC,40-49,0,5,0,4,0,1,0,5,0,5,Sicilia,ITG1
2021-01-14,PF/BT,1902087.0,STRUTTURE PRIVATE NON CODIFICATE NSIS,SIC,50-59,3,6,0,8,0,1,0,9,0,9,Sicilia,ITG1
2021-01-14,PF/BT,1902087.0,STRUTTURE PRIVATE NON CODIFICATE NSIS,SIC,60-69,1,1,0,1,0,1,0,2,0,2,Sicilia,ITG1
2021-01-14,PF/BT,1902087.0,STRUTTURE PRIVATE NON CODIFICATE NSIS,SIC,70-79,0,3,0,0,0,3,0,3,0,3,Sicilia,ITG1
2021-01-14,PF/BT,1902087.0,STRUTTURE PRIVATE NON CODIFICATE NSIS,SIC,80-89,5,11,0,0,0,16,0,16,0,16,Sicilia,ITG1
2021-01-14,PF/BT,1902087.0,STRUTTURE PRIVATE NON CODIFICATE NSIS,SIC,90+,0,6,0,0,0,6,0,6,0,6,Sicilia,ITG1
2021-01-14,PF/BT,190301.0,RIA11 - A.I.A.S.SEZ.DI AGRIGENTO ONLUS,SIC,20-29,7,6,0,10,2,0,1,13,0,13,Sicilia,ITG1
2021-01-14,PF/BT,190301.0,RIA11 - A.I.A.S.SEZ.DI AGRIGENTO ONLUS,SIC,30-39,8,8,0,14,2,0,0,16,0,16,Sicilia,ITG1
2021-01-14,PF/BT,190301.0,RIA11 - A.I.A.S.SEZ.DI AGRIGENTO ONLUS,SIC,40-49,15,20,0,28,5,0,2,35,0,35,Sicilia,ITG1
2021-01-14,PF/BT,190301.0,RIA11 - A.I.A.S.SEZ.DI AGRIGENTO ONLUS,SIC,50-59,24,24,0,30,8,0,10,48,0,48,Sicilia,ITG1
2021-01-14,PF/BT,190301.0,RIA11 - A.I.A.S.SEZ.DI AGRIGENTO ONLUS,SIC,60-69,17,17,0,28,2,0,4,34,0,34,Sicilia,ITG1
2021-01-14,PF/BT,190301.0,RIA11 - A.I.A.S.SEZ.DI AGRIGENTO ONLUS,SIC,70-79,2,1,0,2,0,0,1,3,0,3,Sicilia,ITG1
2021-01-14,PF/BT,190302.0,RIA11 - C.DELLA SPERANZA DON ANGELO G.,SIC,20-29,6,6,0,0,0,0,12,12,0,12,Sicilia,ITG1
2021-01-14,PF/BT,190302.0,RIA11 - C.DELLA SPERANZA DON ANGELO G.,SIC,30-39,4,14,0,1,0,0,17,18,0,18,Sicilia,ITG1
2021-01-14,PF/BT,190302.0,RIA11 - C.DELLA SPERANZA DON ANGELO G.,SIC,40-49,4,13,0,0,0,0,17,17,0,17,Sicilia,ITG1
2021-01-14,PF/BT,190302.0,RIA11 - C.DELLA SPERANZA DON ANGELO G.,SIC,50-59,7,9,0,1,0,0,15,16,0,16,Sicilia,ITG1
2021-01-14,PF/BT,190302.0,RIA11 - C.DELLA SPERANZA DON ANGELO G.,SIC,60-69,9,5,0,0,0,0,14,14,0,14,Sicilia,ITG1
2021-01-14,PF/BT,190302.0,RIA11 - C.DELLA SPERANZA DON ANGELO G.,SIC,70-79,6,0,0,0,0,0,6,6,0,6,Sicilia,ITG1
2021-01-14,PF/BT,190302.0,RIA11 - C.DELLA SPERANZA DON ANGELO G.,SIC,80-89,0,1,0,0,0,0,1,1,0,1,Sicilia,ITG1
2021-01-14,PF/BT,190303.0,RIA11 - COMUNITA` DELLA SPERANZA,SIC,16-19,0,1,0,1,0,0,0,1,0,1,Sicilia,ITG1
2021-01-14,PF/BT,190303.0,RIA11 - COMUNITA` DELLA SPERANZA,SIC,20-29,4,4,0,5,3,0,0,8,0,8,Sicilia,ITG1
2021-01-14,PF/BT,190303.0,RIA11 - COMUNITA` DELLA SPERANZA,SIC,30-39,8,8,0,11,5,0,0,16,0,16,Sicilia,ITG1
2021-01-14,PF/BT,190303.0,RIA11 - COMUNITA` DELLA SPERANZA,SIC,40-49,4,6,0,3,7,0,0,10,0,10,Sicilia,ITG1
2021-01-14,PF/BT,190303.0,RIA11 - COMUNITA` DELLA SPERANZA,SIC,50-59,3,9,0,9,3,0,0,12,0,12,Sicilia,ITG1
2021-01-14,PF/BT,190303.0,RIA11 - COMUNITA` DELLA SPERANZA,SIC,60-69,12,2,0,11,3,0,0,14,0,14,Sicilia,ITG1
2021-01-14,PF/BT,190303.0,RIA11 - COMUNITA` DELLA SPERANZA,SIC,70-79,2,0,0,2,0,0,0,2,0,2,Sicilia,ITG1
2021-01-14,PF/BT,190303.0,RIA11 - COMUNITA` DELLA SPERANZA,SIC,80-89,2,1,0,0,0,0,3,3,0,3,Sicilia,ITG1
2021-01-14,PF/BT,190304.0,HSP11 - P.O.  F.LLI PARLAPIANO - RIBERA,SIC,20-29,14,17,0,10,4,0,17,31,0,31,Sicilia,ITG1
2021-01-14,PF/BT,190304.0,HSP11 - P.O.  F.LLI PARLAPIANO - RIBERA,SIC,30-39,13,17,0,21,9,0,0,30,0,30,Sicilia,ITG1
2021-01-14,PF/BT,190304.0,HSP11 - P.O.  F.LLI PARLAPIANO - RIBERA,SIC,40-49,13,15,0,18,10,0,0,28,0,28,Sicilia,ITG1
2021-01-14,PF/BT,190304.0,HSP11 - P.O.  F.LLI PARLAPIANO - RIBERA,SIC,50-59,10,21,0,25,6,0,0,31,0,31,Sicilia,ITG1
2021-01-14,PF/BT,190304.0,HSP11 - P.O.  F.LLI PARLAPIANO - RIBERA,SIC,60-69,8,14,0,16,6,0,0,22,0,22,Sicilia,ITG1
2021-01-14,PF/BT,190304.0,HSP11 - P.O.  F.LLI PARLAPIANO - RIBERA,SIC,70-79,2,2,0,3,1,0,0,4,0,4,Sicilia,ITG1
2021-01-14,PF/BT,190304.0,HSP11 - P.O.  F.LLI PARLAPIANO - RIBERA,SIC,80-89,2,1,0,1,0,2,0,3,0,3,Sicilia,ITG1
2021-01-14,PF/BT,190304.0,HSP11 - P.O.  F.LLI PARLAPIANO - RIBERA,SIC,90+,1,0,0,0,0,1,0,1,0,1,Sicilia,ITG1
2021-01-14,PF/BT,190306.0,RIA11 - ASS. CASA FAM.ROSETTA ONILUS,SIC,20-29,9,14,0,22,0,0,1,23,0,23,Sicilia,ITG1
2021-01-14,PF/BT,190306.0,RIA11 - ASS. CASA FAM.ROSETTA ONILUS,SIC,30-39,15,21,0,34,2,0,0,36,0,36,Sicilia,ITG1
2021-01-14,PF/BT,190306.0,RIA11 - ASS. CASA FAM.ROSETTA ONILUS,SIC,40-49,17,25,0,40,2,0,0,42,0,42,Sicilia,ITG1
2021-01-14,PF/BT,190306.0,RIA11 - ASS. CASA FAM.ROSETTA ONILUS,SIC,50-59,16,21,0,29,8,0,0,37,0,37,Sicilia,ITG1
2021-01-14,PF/BT,190306.0,RIA11 - ASS. CASA FAM.ROSETTA ONILUS,SIC,60-69,17,19,0,31,4,0,1,36,0,36,Sicilia,ITG1
2021-01-14,PF/BT,190306.0,RIA11 - ASS. CASA FAM.ROSETTA ONILUS,SIC,70-79,5,2,0,7,0,0,0,7,0,7,Sicilia,ITG1
2021-01-14,PF/BT,190306.0,RIA11 - ASS. CASA FAM.ROSETTA ONILUS,SIC,90+,1,0,0,1,0,0,0,1,0,1,Sicilia,ITG1
2021-01-14,PF/BT,190309.0,HSP11 - P.O. VITTORIO EMANUELE (ex AO),SIC,20-29,7,2,0,8,0,0,1,9,0,9,Sicilia,ITG1
2021-01-14,PF/BT,190309.0,HSP11 - P.O. VITTORIO EMANUELE (ex AO),SIC,30-39,3,3,0,6,0,0,0,6,0,6,Sicilia,ITG1
2021-01-14,PF/BT,190309.0,HSP11 - P.O. VITTORIO EMANUELE (ex AO),SIC,40-49,4,4,0,7,0,0,1,8,0,8,Sicilia,ITG1
2021-01-14,PF/BT,190309.0,HSP11 - P.O. VITTORIO EMANUELE (ex AO),SIC,50-59,9,9,0,17,0,0,1,18,0,18,Sicilia,ITG1
2021-01-14,PF/BT,190309.0,HSP11 - P.O. VITTORIO EMANUELE (ex AO),SIC,60-69,4,6,0,9,0,0,1,10,0,10,Sicilia,ITG1
2021-01-14,PF/BT,190309.0,HSP11 - P.O. VITTORIO EMANUELE (ex AO),SIC,70-79,3,0,0,3,0,0,0,3,0,3,Sicilia,ITG1
2021-01-14,PF/BT,190312.0,HSP11 - P.O. S. Marta e S. Venera Acireale,SIC,20-29,3,1,0,3,1,0,0,4,0,4,Sicilia,ITG1
2021-01-14,PF/BT,190312.0,HSP11 - P.O. S. Marta e S. Venera Acireale,SIC,30-39,4,6,0,8,2,0,0,10,0,10,Sicilia,ITG1
2021-01-14,PF/BT,190312.0,HSP11 - P.O. S. Marta e S. Venera Acireale,SIC,40-49,10,16,0,20,6,0,0,26,0,26,Sicilia,ITG1
2021-01-14,PF/BT,190312.0,HSP11 - P.O. S. Marta e S. Venera Acireale,SIC,50-59,15,18,0,22,11,0,0,33,0,33,Sicilia,ITG1
2021-01-14,PF/BT,190312.0,HSP11 - P.O. S. Marta e S. Venera Acireale,SIC,60-69,7,13,0,17,3,0,0,20,0,20,Sicilia,ITG1
2021-01-14,PF/BT,190312.0,HSP11 - P.O. S. Marta e S. Venera Acireale,SIC,70-79,1,0,0,0,1,0,0,1,0,1,Sicilia,ITG1
2021-01-14,PF/BT,190312.0,HSP11 - P.O. S. Marta e S. Venera Acireale,SIC,80-89,2,0,0,0,2,0,0,2,0,2,Sicilia,ITG1
2021-01-14,PF/BT,190313.0,RIA11 - IST.RIAB.VILLAG. SAN GIUSEPPE,SIC,16-19,0,2,0,0,1,0,1,2,0,2,Sicilia,ITG1
2021-01-14,PF/BT,190313.0,RIA11 - IST.RIAB.VILLAG. SAN GIUSEPPE,SIC,20-29,4,12,0,8,8,0,0,16,0,16,Sicilia,ITG1
2021-01-14,PF/BT,190313.0,RIA11 - IST.RIAB.VILLAG. SAN GIUSEPPE,SIC,30-39,19,8,0,19,8,0,0,27,0,27,Sicilia,ITG1
2021-01-14,PF/BT,190313.0,RIA11 - IST.RIAB.VILLAG. SAN GIUSEPPE,SIC,40-49,12,20,0,27,5,0,0,32,0,32,Sicilia,ITG1
2021-01-14,PF/BT,190313.0,RIA11 - IST.RIAB.VILLAG. SAN GIUSEPPE,SIC,50-59,15,18,0,25,7,0,1,33,0,33,Sicilia,ITG1
2021-01-14,PF/BT,190313.0,RIA11 - IST.RIAB.VILLAG. SAN GIUSEPPE,SIC,60-69,8,10,0,15,3,0,0,18,0,18,Sicilia,ITG1
2021-01-14,PF/BT,190313.0,RIA11 - IST.RIAB.VILLAG. SAN GIUSEPPE,SIC,70-79,3,0,0,3,0,0,0,3,0,3,Sicilia,ITG1
2021-01-14,PF/BT,190314.0,RIA11 - ASS.J.F.KENNEDY ACIREALE,SIC,20-29,4,4,0,8,0,0,0,8,0,8,Sicilia,ITG1
2021-01-14,PF/BT,190314.0,RIA11 - ASS.J.F.KENNEDY ACIREALE,SIC,30-39,9,8,0,17,0,0,0,17,0,17,Sicilia,ITG1
2021-01-14,PF/BT,190314.0,RIA11 - ASS.J.F.KENNEDY ACIREALE,SIC,40-49,5,6,0,11,0,0,0,11,0,11,Sicilia,ITG1
2021-01-14,PF/BT,190314.0,RIA11 - ASS.J.F.KENNEDY ACIREALE,SIC,50-59,3,6,0,9,0,0,0,9,0,9,Sicilia,ITG1
2021-01-14,PF/BT,190314.0,RIA11 - ASS.J.F.KENNEDY ACIREALE,SIC,60-69,10,4,0,14,0,0,0,14,0,14,Sicilia,ITG1
2021-01-14,PF/BT,190314.0,RIA11 - ASS.J.F.KENNEDY ACIREALE,SIC,70-79,1,0,0,1,0,0,0,1,0,1,Sicilia,ITG1
2021-01-14,PF/BT,190316.0,RIA11 - ASS.J.F.KENNEDY - C.RIAB.ONLUS,SIC,16-19,2,1,0,1,2,0,0,3,0,3,Sicilia,ITG1
2021-01-14,PF/BT,190316.0,RIA11 - ASS.J.F.KENNEDY - C.RIAB.ONLUS,SIC,20-29,6,7,0,6,7,0,0,13,0,13,Sicilia,ITG1
2021-01-14,PF/BT,190316.0,RIA11 - ASS.J.F.KENNEDY - C.RIAB.ONLUS,SIC,30-39,6,13,0,16,3,0,0,19,0,19,Sicilia,ITG1
2021-01-14,PF/BT,190316.0,RIA11 - ASS.J.F.KENNEDY - C.RIAB.ONLUS,SIC,40-49,2,17,0,14,5,0,0,19,0,19,Sicilia,ITG1
2021-01-14,PF/BT,190316.0,RIA11 - ASS.J.F.KENNEDY - C.RIAB.ONLUS,SIC,50-59,5,16,0,15,6,0,0,21,0,21,Sicilia,ITG1
2021-01-14,PF/BT,190316.0,RIA11 - ASS.J.F.KENNEDY - C.RIAB.ONLUS,SIC,60-69,2,5,0,5,2,0,0,7,0,7,Sicilia,ITG1
2021-01-14,PF/BT,190316.0,RIA11 - ASS.J.F.KENNEDY - C.RIAB.ONLUS,SIC,70-79,3,3,0,3,3,0,0,6,0,6,Sicilia,ITG1
2021-01-14,PF/BT,190316.0,RIA11 - ASS.J.F.KENNEDY - C.RIAB.ONLUS,SIC,80-89,0,2,0,2,0,0,0,2,0,2,Sicilia,ITG1
2021-01-14,PF/BT,190317.0,HSP11 - P.O. Gravina e S. Pietro Caltagirone,SIC,20-29,2,3,0,4,1,0,0,5,0,5,Sicilia,ITG1
2021-01-14,PF/BT,190317.0,HSP11 - P.O. Gravina e S. Pietro Caltagirone,SIC,30-39,2,1,0,1,2,0,0,3,0,3,Sicilia,ITG1
2021-01-14,PF/BT,190317.0,HSP11 - P.O. Gravina e S. Pietro Caltagirone,SIC,40-49,7,9,0,10,6,0,0,16,0,16,Sicilia,ITG1
2021-01-14,PF/BT,190317.0,HSP11 - P.O. Gravina e S. Pietro Caltagirone,SIC,50-59,8,2,0,4,6,0,0,10,0,10,Sicilia,ITG1
2021-01-14,PF/BT,190317.0,HSP11 - P.O. Gravina e S. Pietro Caltagirone,SIC,60-69,3,8,0,5,6,0,0,11,0,11,Sicilia,ITG1
2021-01-14,PF/BT,190317.0,HSP11 - P.O. Gravina e S. Pietro Caltagirone,SIC,70-79,2,0,0,1,1,0,0,2,0,2,Sicilia,ITG1
2021-01-14,PF/BT,190317.0,HSP11 - P.O. Gravina e S. Pietro Caltagirone,SIC,80-89,1,0,0,0,1,0,0,1,0,1,Sicilia,ITG1
2021-01-14,PF/BT,190318.0,RIA11 - ASS.ISTITUTO REGINA VIRGINUM,SIC,20-29,2,4,0,2,4,0,0,6,0,6,Sicilia,ITG1
2021-01-14,PF/BT,190318.0,RIA11 - ASS.ISTITUTO REGINA VIRGINUM,SIC,30-39,5,6,0,6,4,0,1,11,0,11,Sicilia,ITG1
2021-01-14,PF/BT,190318.0,RIA11 - ASS.ISTITUTO REGINA VIRGINUM,SIC,40-49,3,6,0,5,4,0,0,9,0,9,Sicilia,ITG1
2021-01-14,PF/BT,190318.0,RIA11 - ASS.ISTITUTO REGINA VIRGINUM,SIC,50-59,3,9,0,9,2,0,1,12,0,12,Sicilia,ITG1
2021-01-14,PF/BT,190318.0,RIA11 - ASS.ISTITUTO REGINA VIRGINUM,SIC,60-69,6,3,0,4,5,0,0,9,0,9,Sicilia,ITG1
2021-01-14,PF/BT,190318.0,RIA11 - ASS.ISTITUTO REGINA VIRGINUM,SIC,70-79,1,0,0,0,1,0,0,1,0,1,Sicilia,ITG1
2021-01-14,PF/BT,190319.0,HSP11 - P. O. UMBERTO I,SIC,20-29,1,3,0,4,0,0,0,4,0,4,Sicilia,ITG1
2021-01-14,PF/BT,190319.0,HSP11 - P. O. UMBERTO I,SIC,30-39,4,4,0,8,0,0,0,8,0,8,Sicilia,ITG1
2021-01-14,PF/BT,190319.0,HSP11 - P. O. UMBERTO I,SIC,40-49,6,10,0,12,4,0,0,16,0,16,Sicilia,ITG1
2021-01-14,PF/BT,190319.0,HSP11 - P. O. UMBERTO I,SIC,50-59,4,7,0,10,1,0,0,11,0,11,Sicilia,ITG1
2021-01-14,PF/BT,190319.0,HSP11 - P. O. UMBERTO I,SIC,60-69,10,5,0,11,4,0,0,15,0,15,Sicilia,ITG1
2021-01-14,PF/BT,190325.0,HSP11 - P.O. G. FOGLIANI MILAZZO,SIC,30-39,4,3,0,6,1,0,0,7,0,7,Sicilia,ITG1
2021-01-14,PF/BT,190325.0,HSP11 - P.O. G. FOGLIANI MILAZZO,SIC,40-49,8,17,0,22,3,0,0,25,0,25,Sicilia,ITG1
2021-01-14,PF/BT,190325.0,HSP11 - P.O. G. FOGLIANI MILAZZO,SIC,50-59,17,20,0,30,7,0,0,37,0,37,Sicilia,ITG1
2021-01-14,PF/BT,190325.0,HSP11 - P.O. G. FOGLIANI MILAZZO,SIC,60-69,7,8,0,13,2,0,0,15,0,15,Sicilia,ITG1
2021-01-14,PF/BT,190326.0,HSP11 - P.O. S. VINCENZO TAORMINA,SIC,30-39,2,0,0,2,0,0,0,2,0,2,Sicilia,ITG1
2021-01-14,PF/BT,190326.0,HSP11 - P.O. S. VINCENZO TAORMINA,SIC,50-59,1,1,0,0,2,0,0,2,0,2,Sicilia,ITG1
2021-01-14,PF/BT,190326.0,HSP11 - P.O. S. VINCENZO TAORMINA,SIC,60-69,1,1,0,2,0,0,0,2,0,2,Sicilia,ITG1
2021-01-14,PF/BT,190328.0,P.O. Barone Romeo Patti,SIC,20-29,0,1,0,0,1,0,0,1,0,1,Sicilia,ITG1
2021-01-14,PF/BT,190328.0,P.O. Barone Romeo Patti,SIC,30-39,1,0,0,0,0,0,1,1,0,1,Sicilia,ITG1
2021-01-14,PF/BT,190328.0,P.O. Barone Romeo Patti,SIC,40-49,2,3,0,0,5,0,0,5,0,5,Sicilia,ITG1
2021-01-14,PF/BT,190328.0,P.O. Barone Romeo Patti,SIC,50-59,4,1,0,1,3,0,1,5,0,5,Sicilia,ITG1
2021-01-14,PF/BT,190328.0,P.O. Barone Romeo Patti,SIC,60-69,4,2,0,2,3,0,1,6,0,6,Sicilia,ITG1
2021-01-14,PF/BT,190329.0,HSP11 - STABILIMENTO OSPED. S. AGATA MILITELLO,SIC,20-29,2,5,0,6,0,0,1,7,0,7,Sicilia,ITG1
2021-01-14,PF/BT,190329.0,HSP11 - STABILIMENTO OSPED. S. AGATA MILITELLO,SIC,30-39,2,3,0,4,0,0,1,5,0,5,Sicilia,ITG1
2021-01-14,PF/BT,190329.0,HSP11 - STABILIMENTO OSPED. S. AGATA MILITELLO,SIC,40-49,7,13,0,11,0,0,9,20,0,20,Sicilia,ITG1
2021-01-14,PF/BT,190329.0,HSP11 - STABILIMENTO OSPED. S. AGATA MILITELLO,SIC,50-59,16,19,0,22,3,0,10,35,0,35,Sicilia,ITG1
2021-01-14,PF/BT,190329.0,HSP11 - STABILIMENTO OSPED. S. AGATA MILITELLO,SIC,60-69,16,15,0,22,4,0,5,31,0,31,Sicilia,ITG1
2021-01-14,PF/BT,190329.0,HSP11 - STABILIMENTO OSPED. S. AGATA MILITELLO,SIC,70-79,3,0,0,3,0,0,0,3,0,3,Sicilia,ITG1
2021-01-14,PF/BT,190329.0,HSP11 - STABILIMENTO OSPED. S. AGATA MILITELLO,SIC,80-89,1,0,0,1,0,0,0,1,0,1,Sicilia,ITG1
2021-01-14,PF/BT,190330.0,HSP11 - P.O. DEI BIANCHI CORLEONE,SIC,20-29,3,8,0,7,1,0,3,11,0,11,Sicilia,ITG1
2021-01-14,PF/BT,190330.0,HSP11 - P.O. DEI BIANCHI CORLEONE,SIC,30-39,3,5,0,5,3,0,0,8,0,8,Sicilia,ITG1
2021-01-14,PF/BT,190330.0,HSP11 - P.O. DEI BIANCHI CORLEONE,SIC,40-49,4,9,0,9,4,0,0,13,0,13,Sicilia,ITG1
2021-01-14,PF/BT,190330.0,HSP11 - P.O. DEI BIANCHI CORLEONE,SIC,50-59,12,6,0,12,5,0,1,18,0,18,Sicilia,ITG1
2021-01-14,PF/BT,190330.0,HSP11 - P.O. DEI BIANCHI CORLEONE,SIC,60-69,2,1,0,2,1,0,0,3,0,3,Sicilia,ITG1
2021-01-14,PF/BT,190330.0,HSP11 - P.O. DEI BIANCHI CORLEONE,SIC,70-79,1,0,0,0,0,0,1,1,0,1,Sicilia,ITG1
2021-01-14,PF/BT,190332.0,HSP11 - P.O. CIVICO PARTINICO,SIC,20-29,3,1,0,4,0,0,0,4,0,4,Sicilia,ITG1
2021-01-14,PF/BT,190332.0,HSP11 - P.O. CIVICO PARTINICO,SIC,30-39,3,0,0,2,1,0,0,3,0,3,Sicilia,ITG1
2021-01-14,PF/BT,190332.0,HSP11 - P.O. CIVICO PARTINICO,SIC,40-49,2,4,0,6,0,0,0,6,0,6,Sicilia,ITG1
2021-01-14,PF/BT,190332.0,HSP11 - P.O. CIVICO PARTINICO,SIC,50-59,4,8,0,10,2,0,0,12,0,12,Sicilia,ITG1
2021-01-14,PF/BT,190332.0,HSP11 - P.O. CIVICO PARTINICO,SIC,60-69,7,2,0,6,3,0,0,9,0,9,Sicilia,ITG1
2021-01-14,PF/BT,190332.0,HSP11 - P.O. CIVICO PARTINICO,SIC,70-79,1,1,0,2,0,0,0,2,0,2,Sicilia,ITG1
2021-01-14,PF/BT,190333.0,HSP11 - P.O. MADONNA DELLALTO - PETR. SOTTANA,SIC,20-29,1,2,0,1,2,0,0,3,0,3,Sicilia,ITG1
2021-01-14,PF/BT,190333.0,HSP11 - P.O. MADONNA DELLALTO - PETR. SOTTANA,SIC,30-39,1,0,0,0,1,0,0,1,0,1,Sicilia,ITG1
2021-01-14,PF/BT,190333.0,HSP11 - P.O. MADONNA DELLALTO - PETR. SOTTANA,SIC,40-49,2,0,0,0,0,0,2,2,0,2,Sicilia,ITG1
2021-01-14,PF/BT,190333.0,HSP11 - P.O. MADONNA DELLALTO - PETR. SOTTANA,SIC,50-59,0,3,0,2,0,0,1,3,0,3,Sicilia,ITG1
2021-01-14,PF/BT,190333.0,HSP11 - P.O. MADONNA DELLALTO - PETR. SOTTANA,SIC,70-79,1,7,0,0,0,1,7,8,0,8,Sicilia,ITG1
2021-01-14,PF/BT,190333.0,HSP11 - P.O. MADONNA DELLALTO - PETR. SOTTANA,SIC,80-89,43,27,0,0,0,0,70,70,0,70,Sicilia,ITG1
2021-01-14,PF/BT,190333.0,HSP11 - P.O. MADONNA DELLALTO - PETR. SOTTANA,SIC,90+,2,1,0,0,0,0,3,3,0,3,Sicilia,ITG1
2021-01-14,PF/BT,190334.0,HSP11 - P.O. S. CIMINO TERMINI IMERESE,SIC,20-29,1,6,0,7,0,0,0,7,0,7,Sicilia,ITG1
2021-01-14,PF/BT,190334.0,HSP11 - P.O. S. CIMINO TERMINI IMERESE,SIC,30-39,6,3,0,9,0,0,0,9,0,9,Sicilia,ITG1
2021-01-14,PF/BT,190334.0,HSP11 - P.O. S. CIMINO TERMINI IMERESE,SIC,40-49,6,9,0,12,3,0,0,15,0,15,Sicilia,ITG1
2021-01-14,PF/BT,190334.0,HSP11 - P.O. S. CIMINO TERMINI IMERESE,SIC,50-59,9,2,0,10,1,0,0,11,0,11,Sicilia,ITG1
2021-01-14,PF/BT,190334.0,HSP11 - P.O. S. CIMINO TERMINI IMERESE,SIC,60-69,12,2,0,14,0,0,0,14,0,14,Sicilia,ITG1
2021-01-14,PF/BT,190334.0,HSP11 - P.O. S. CIMINO TERMINI IMERESE,SIC,70-79,3,1,0,4,0,0,0,4,0,4,Sicilia,ITG1
2021-01-14,PF/BT,190335.0,HSP11 - P.O. G. F. INGRASSIA,SIC,30-39,4,1,0,5,0,0,0,5,0,5,Sicilia,ITG1
2021-01-14,PF/BT,190335.0,HSP11 - P.O. G. F. INGRASSIA,SIC,40-49,3,2,0,4,1,0,0,5,0,5,Sicilia,ITG1
2021-01-14,PF/BT,190335.0,HSP11 - P.O. G. F. INGRASSIA,SIC,50-59,7,1,0,8,0,0,0,8,0,8,Sicilia,ITG1
2021-01-14,PF/BT,190335.0,HSP11 - P.O. G. F. INGRASSIA,SIC,60-69,3,4,0,7,0,0,0,7,0,7,Sicilia,ITG1
2021-01-14,PF/BT,190335.0,HSP11 - P.O. G. F. INGRASSIA,SIC,70-79,4,1,0,4,1,0,0,5,0,5,Sicilia,ITG1
2021-01-14,PF/BT,190337.0,HSP11 - P.O. VILLA DELLE GINESTRE,SIC,20-29,4,5,0,6,0,0,3,9,0,9,Sicilia,ITG1
2021-01-14,PF/BT,190337.0,HSP11 - P.O. VILLA DELLE GINESTRE,SIC,30-39,17,16,0,18,6,0,9,33,0,33,Sicilia,ITG1
2021-01-14,PF/BT,190337.0,HSP11 - P.O. VILLA DELLE GINESTRE,SIC,40-49,23,16,0,16,15,0,8,39,0,39,Sicilia,ITG1
2021-01-14,PF/BT,190337.0,HSP11 - P.O. VILLA DELLE GINESTRE,SIC,50-59,23,26,0,25,17,0,7,49,0,49,Sicilia,ITG1
2021-01-14,PF/BT,190337.0,HSP11 - P.O. VILLA DELLE GINESTRE,SIC,60-69,40,22,0,54,5,0,3,62,0,62,Sicilia,ITG1
2021-01-14,PF/BT,190337.0,HSP11 - P.O. VILLA DELLE GINESTRE,SIC,70-79,11,5,0,16,0,0,0,16,0,16,Sicilia,ITG1
2021-01-14,PF/BT,190337.0,HSP11 - P.O. VILLA DELLE GINESTRE,SIC,80-89,2,0,0,1,1,0,0,2,0,2,Sicilia,ITG1
2021-01-14,PF/BT,190337.0,HSP11 - P.O. VILLA DELLE GINESTRE,SIC,90+,1,0,0,1,0,0,0,1,0,1,Sicilia,ITG1
2021-01-14,PF/BT,190343.0,HSP11 - P.O. DI MARIA AVOLA,SIC,30-39,1,0,0,0,1,0,0,1,0,1,Sicilia,ITG1
2021-01-14,PF/BT,190343.0,HSP11 - P.O. DI MARIA AVOLA,SIC,40-49,7,1,0,7,1,0,0,8,0,8,Sicilia,ITG1
2021-01-14,PF/BT,190343.0,HSP11 - P.O. DI MARIA AVOLA,SIC,50-59,1,0,0,0,1,0,0,1,0,1,Sicilia,ITG1
2021-01-14,PF/BT,190343.0,HSP11 - P.O. DI MARIA AVOLA,SIC,60-69,2,0,0,1,1,0,0,2,0,2,Sicilia,ITG1
2021-01-14,PF/BT,190345.0,HSP11 - P.O. UMBERTO I (EX A.O.),SIC,20-29,4,4,0,2,0,0,6,8,0,8,Sicilia,ITG1
2021-01-14,PF/BT,190345.0,HSP11 - P.O. UMBERTO I (EX A.O.),SIC,30-39,13,6,0,7,1,0,11,19,0,19,Sicilia,ITG1
2021-01-14,PF/BT,190345.0,HSP11 - P.O. UMBERTO I (EX A.O.),SIC,40-49,15,11,0,4,3,0,19,26,0,26,Sicilia,ITG1
2021-01-14,PF/BT,190345.0,HSP11 - P.O. UMBERTO I (EX A.O.),SIC,50-59,16,14,0,19,6,0,5,30,0,30,Sicilia,ITG1
2021-01-14,PF/BT,190345.0,HSP11 - P.O. UMBERTO I (EX A.O.),SIC,60-69,42,13,0,29,7,0,19,55,0,55,Sicilia,ITG1
2021-01-14,PF/BT,190345.0,HSP11 - P.O. UMBERTO I (EX A.O.),SIC,70-79,6,0,0,1,0,0,5,6,0,6,Sicilia,ITG1
2021-01-14,PF/BT,190346.0,HSP11 - P.O. MUSCATELLO AUGUSTA,SIC,20-29,3,0,0,0,0,0,3,3,0,3,Sicilia,ITG1
2021-01-14,PF/BT,190346.0,HSP11 - P.O. MUSCATELLO AUGUSTA,SIC,30-39,1,1,0,2,0,0,0,2,0,2,Sicilia,ITG1
2021-01-14,PF/BT,190346.0,HSP11 - P.O. MUSCATELLO AUGUSTA,SIC,40-49,2,3,0,3,1,0,1,5,0,5,Sicilia,ITG1
2021-01-14,PF/BT,190346.0,HSP11 - P.O. MUSCATELLO AUGUSTA,SIC,50-59,1,6,0,4,2,0,1,7,0,7,Sicilia,ITG1
2021-01-14,PF/BT,190346.0,HSP11 - P.O. MUSCATELLO AUGUSTA,SIC,60-69,14,4,0,16,0,0,2,18,0,18,Sicilia,ITG1
2021-01-14,PF/BT,190346.0,HSP11 - P.O. MUSCATELLO AUGUSTA,SIC,70-79,1,0,0,1,0,0,0,1,0,1,Sicilia,ITG1
2021-01-14,PF/BT,190349.0,HSP11 - P.O. SAN VITO E SANTO SPIRITO -ALCAMO,SIC,16-19,2,0,0,1,1,0,0,2,0,2,Sicilia,ITG1
2021-01-14,PF/BT,190349.0,HSP11 - P.O. SAN VITO E SANTO SPIRITO -ALCAMO,SIC,20-29,3,5,0,4,3,1,0,8,0,8,Sicilia,ITG1
2021-01-14,PF/BT,190349.0,HSP11 - P.O. SAN VITO E SANTO SPIRITO -ALCAMO,SIC,30-39,2,9,0,9,2,0,0,11,0,11,Sicilia,ITG1
2021-01-14,PF/BT,190349.0,HSP11 - P.O. SAN VITO E SANTO SPIRITO -ALCAMO,SIC,40-49,3,10,0,6,7,0,0,13,0,13,Sicilia,ITG1
2021-01-14,PF/BT,190349.0,HSP11 - P.O. SAN VITO E SANTO SPIRITO -ALCAMO,SIC,50-59,3,14,0,10,7,0,0,17,0,17,Sicilia,ITG1
2021-01-14,PF/BT,190349.0,HSP11 - P.O. SAN VITO E SANTO SPIRITO -ALCAMO,SIC,60-69,3,3,0,3,3,0,0,6,0,6,Sicilia,ITG1
2021-01-14,PF/BT,190349.0,HSP11 - P.O. SAN VITO E SANTO SPIRITO -ALCAMO,SIC,70-79,1,1,0,2,0,0,0,2,0,2,Sicilia,ITG1
2021-01-14,PF/BT,190349.0,HSP11 - P.O. SAN VITO E SANTO SPIRITO -ALCAMO,SIC,80-89,0,3,0,0,0,3,0,3,0,3,Sicilia,ITG1
2021-01-14,PF/BT,190349.0,HSP11 - P.O. SAN VITO E SANTO SPIRITO -ALCAMO,SIC,90+,0,5,0,0,0,5,0,5,0,5,Sicilia,ITG1
2021-01-14,PF/BT,190351.0,HSP11 - P.O. S. ANTONIO ABATE  - TRAPANI,SIC,20-29,1,3,0,4,0,0,0,4,0,4,Sicilia,ITG1
2021-01-14,PF/BT,190351.0,HSP11 - P.O. S. ANTONIO ABATE  - TRAPANI,SIC,30-39,2,5,0,6,1,0,0,7,0,7,Sicilia,ITG1
2021-01-14,PF/BT,190351.0,HSP11 - P.O. S. ANTONIO ABATE  - TRAPANI,SIC,40-49,8,12,0,20,0,0,0,20,0,20,Sicilia,ITG1
2021-01-14,PF/BT,190351.0,HSP11 - P.O. S. ANTONIO ABATE  - TRAPANI,SIC,50-59,8,18,0,19,7,0,0,26,0,26,Sicilia,ITG1
2021-01-14,PF/BT,190351.0,HSP11 - P.O. S. ANTONIO ABATE  - TRAPANI,SIC,60-69,3,5,0,8,0,0,0,8,0,8,Sicilia,ITG1
2021-01-14,PF/BT,190351.0,HSP11 - P.O. S. ANTONIO ABATE  - TRAPANI,SIC,70-79,1,0,0,1,0,0,0,1,0,1,Sicilia,ITG1
2021-01-14,PF/BT,190352.0,HSP11 - P.O. V.EMANUELE II CASTELVETRANO,SIC,20-29,2,2,0,3,0,0,1,4,0,4,Sicilia,ITG1
2021-01-14,PF/BT,190352.0,HSP11 - P.O. V.EMANUELE II CASTELVETRANO,SIC,30-39,6,5,0,8,1,0,2,11,0,11,Sicilia,ITG1
2021-01-14,PF/BT,190352.0,HSP11 - P.O. V.EMANUELE II CASTELVETRANO,SIC,40-49,7,12,0,10,4,0,5,19,0,19,Sicilia,ITG1
2021-01-14,PF/BT,190352.0,HSP11 - P.O. V.EMANUELE II CASTELVETRANO,SIC,50-59,4,8,0,8,0,0,4,12,0,12,Sicilia,ITG1
2021-01-14,PF/BT,190352.0,HSP11 - P.O. V.EMANUELE II CASTELVETRANO,SIC,60-69,4,4,0,3,4,0,1,8,0,8,Sicilia,ITG1
2021-01-14,PF/BT,190353.0,HSP11 - P.O.PAOLO BORSELLINO - MARSALA,SIC,20-29,0,2,0,2,0,0,0,2,0,2,Sicilia,ITG1
2021-01-14,PF/BT,190353.0,HSP11 - P.O.PAOLO BORSELLINO - MARSALA,SIC,30-39,0,1,0,1,0,0,0,1,0,1,Sicilia,ITG1
2021-01-14,PF/BT,190353.0,HSP11 - P.O.PAOLO BORSELLINO - MARSALA,SIC,40-49,5,3,0,5,3,0,0,8,0,8,Sicilia,ITG1
2021-01-14,PF/BT,190353.0,HSP11 - P.O.PAOLO BORSELLINO - MARSALA,SIC,50-59,1,3,0,2,2,0,0,4,0,4,Sicilia,ITG1
2021-01-14,PF/BT,190353.0,HSP11 - P.O.PAOLO BORSELLINO - MARSALA,SIC,60-69,1,1,0,1,1,0,0,2,0,2,Sicilia,ITG1
2021-01-14,PF/BT,190353.0,HSP11 - P.O.PAOLO BORSELLINO - MARSALA,SIC,70-79,1,1,0,1,1,0,0,2,0,2,Sicilia,ITG1
2021-01-14,PF/BT,190353.0,HSP11 - P.O.PAOLO BORSELLINO - MARSALA,SIC,80-89,0,2,0,0,0,2,0,2,0,2,Sicilia,ITG1
2021-01-14,PF/BT,190353.0,HSP11 - P.O.PAOLO BORSELLINO - MARSALA,SIC,90+,0,2,0,0,0,2,0,2,0,2,Sicilia,ITG1
2021-01-14,PF/BT,190354.0,HSP11 - P.O.ABELE AJELLO-MAZARA D.VALLO,SIC,20-29,2,1,0,2,1,0,0,3,0,3,Sicilia,ITG1
2021-01-14,PF/BT,190354.0,HSP11 - P.O.ABELE AJELLO-MAZARA D.VALLO,SIC,30-39,1,5,0,6,0,0,0,6,0,6,Sicilia,ITG1
2021-01-14,PF/BT,190354.0,HSP11 - P.O.ABELE AJELLO-MAZARA D.VALLO,SIC,40-49,1,3,0,3,1,0,0,4,0,4,Sicilia,ITG1
2021-01-14,PF/BT,190354.0,HSP11 - P.O.ABELE AJELLO-MAZARA D.VALLO,SIC,50-59,3,1,0,3,1,0,0,4,0,4,Sicilia,ITG1
2021-01-14,PF/BT,190354.0,HSP11 - P.O.ABELE AJELLO-MAZARA D.VALLO,SIC,70-79,1,0,0,1,0,0,0,1,0,1,Sicilia,ITG1
2021-01-14,PF/BT,190355.0,HSP11 - P.O. VITTORIO EMANUELE III - SALEMI,SIC,20-29,0,3,0,1,0,0,2,3,0,3,Sicilia,ITG1
2021-01-14,PF/BT,190355.0,HSP11 - P.O. VITTORIO EMANUELE III - SALEMI,SIC,30-39,3,10,0,8,2,0,3,13,0,13,Sicilia,ITG1
2021-01-14,PF/BT,190355.0,HSP11 - P.O. VITTORIO EMANUELE III - SALEMI,SIC,40-49,0,5,0,5,0,0,0,5,0,5,Sicilia,ITG1
2021-01-14,PF/BT,190355.0,HSP11 - P.O. VITTORIO EMANUELE III - SALEMI,SIC,50-59,4,8,0,7,2,0,3,12,0,12,Sicilia,ITG1
2021-01-14,PF/BT,190355.0,HSP11 - P.O. VITTORIO EMANUELE III - SALEMI,SIC,60-69,1,0,0,0,0,0,1,1,0,1,Sicilia,ITG1
2021-01-14,PF/BT,190355.0,HSP11 - P.O. VITTORIO EMANUELE III - SALEMI,SIC,70-79,1,1,0,2,0,0,0,2,0,2,Sicilia,ITG1
2021-01-14,PF/BT,190399.0,RIA11 - C.E.P.A.I.D. ONLUS,SIC,70-79,0,2,0,0,0,2,0,2,0,2,Sicilia,ITG1
2021-01-14,PF/BT,190399.0,RIA11 - C.E.P.A.I.D. ONLUS,SIC,80-89,1,2,0,0,0,3,0,3,0,3,Sicilia,ITG1
2021-01-14,PF/BT,190399.0,RIA11 - C.E.P.A.I.D. ONLUS,SIC,90+,1,1,0,0,0,2,0,2,0,2,Sicilia,ITG1
2021-01-14,PF/BT,190513.0,HSP11 - CASA DI CURA G.B. MORGAGNI S.R.L.,SIC,20-29,0,2,0,1,0,0,1,2,0,2,Sicilia,ITG1
2021-01-14,PF/BT,190513.0,HSP11 - CASA DI CURA G.B. MORGAGNI S.R.L.,SIC,30-39,1,0,0,1,0,0,0,1,0,1,Sicilia,ITG1
2021-01-14,PF/BT,190513.0,HSP11 - CASA DI CURA G.B. MORGAGNI S.R.L.,SIC,50-59,0,1,0,1,0,0,0,1,0,1,Sicilia,ITG1
2021-01-14,PF/BT,190513.0,HSP11 - CASA DI CURA G.B. MORGAGNI S.R.L.,SIC,60-69,0,2,0,2,0,0,0,2,0,2,Sicilia,ITG1
2021-01-14,PF/BT,190524.0,HSP11 - I.O.M.I. F.SCALABRINO GANZIRRI,SIC,16-19,1,0,0,0,1,0,0,1,0,1,Sicilia,ITG1
2021-01-14,PF/BT,190524.0,HSP11 - I.O.M.I. F.SCALABRINO GANZIRRI,SIC,30-39,2,1,0,1,2,0,0,3,0,3,Sicilia,ITG1
2021-01-14,PF/BT,190524.0,HSP11 - I.O.M.I. F.SCALABRINO GANZIRRI,SIC,50-59,4,2,0,2,4,0,0,6,0,6,Sicilia,ITG1
2021-01-14,PF/BT,190524.0,HSP11 - I.O.M.I. F.SCALABRINO GANZIRRI,SIC,60-69,1,0,0,0,1,0,0,1,0,1,Sicilia,ITG1
2021-01-14,PF/BT,190524.0,HSP11 - I.O.M.I. F.SCALABRINO GANZIRRI,SIC,70-79,1,0,0,0,1,0,0,1,0,1,Sicilia,ITG1
2021-01-14,PF/BT,190533.0,HSP11 - CASA DI CURA CANDELA SPA,SIC,20-29,4,3,0,6,1,0,0,7,0,7,Sicilia,ITG1
2021-01-14,PF/BT,190533.0,HSP11 - CASA DI CURA CANDELA SPA,SIC,30-39,8,5,0,5,8,0,0,13,0,13,Sicilia,ITG1
2021-01-14,PF/BT,190533.0,HSP11 - CASA DI CURA CANDELA SPA,SIC,40-49,7,10,0,11,5,0,1,17,0,17,Sicilia,ITG1
2021-01-14,PF/BT,190533.0,HSP11 - CASA DI CURA CANDELA SPA,SIC,50-59,15,11,0,13,13,0,0,26,0,26,Sicilia,ITG1
2021-01-14,PF/BT,190533.0,HSP11 - CASA DI CURA CANDELA SPA,SIC,60-69,6,4,0,5,4,0,1,10,0,10,Sicilia,ITG1
2021-01-14,PF/BT,190533.0,HSP11 - CASA DI CURA CANDELA SPA,SIC,70-79,5,0,0,2,0,0,3,5,0,5,Sicilia,ITG1
2021-01-14,PF/BT,190534.0,HSP11 - CASA DI CURE ORESTANO S.R.L.,SIC,20-29,4,3,0,6,1,0,0,7,0,7,Sicilia,ITG1
2021-01-14,PF/BT,190534.0,HSP11 - CASA DI CURE ORESTANO S.R.L.,SIC,30-39,2,0,0,0,2,0,0,2,0,2,Sicilia,ITG1
2021-01-14,PF/BT,190534.0,HSP11 - CASA DI CURE ORESTANO S.R.L.,SIC,40-49,13,5,0,3,15,0,0,18,0,18,Sicilia,ITG1
2021-01-14,PF/BT,190534.0,HSP11 - CASA DI CURE ORESTANO S.R.L.,SIC,50-59,6,6,0,6,6,0,0,12,0,12,Sicilia,ITG1
2021-01-14,PF/BT,190534.0,HSP11 - CASA DI CURE ORESTANO S.R.L.,SIC,60-69,5,3,0,4,4,0,0,8,0,8,Sicilia,ITG1
2021-01-14,PF/BT,190534.0,HSP11 - CASA DI CURE ORESTANO S.R.L.,SIC,70-79,3,0,0,2,1,0,0,3,0,3,Sicilia,ITG1
2021-01-14,PF/BT,190534.0,HSP11 - CASA DI CURE ORESTANO S.R.L.,SIC,80-89,1,0,0,1,0,0,0,1,0,1,Sicilia,ITG1
2021-01-14,PF/BT,190536.0,HSP11 - CASA DI CURA TRIOLO ZANCLA S.P.A.,SIC,30-39,0,2,0,0,0,0,2,2,0,2,Sicilia,ITG1
2021-01-14,PF/BT,190536.0,HSP11 - CASA DI CURA TRIOLO ZANCLA S.P.A.,SIC,40-49,2,4,0,2,2,0,2,6,0,6,Sicilia,ITG1
2021-01-14,PF/BT,190536.0,HSP11 - CASA DI CURA TRIOLO ZANCLA S.P.A.,SIC,50-59,2,2,0,1,0,0,3,4,0,4,Sicilia,ITG1
2021-01-14,PF/BT,190538.0,CASA DI CURA NOTO PASQUALINO S.R.L.,SIC,20-29,2,2,0,1,3,0,0,4,0,4,Sicilia,ITG1
2021-01-14,PF/BT,190538.0,CASA DI CURA NOTO PASQUALINO S.R.L.,SIC,30-39,6,4,0,1,9,0,0,10,0,10,Sicilia,ITG1
2021-01-14,PF/BT,190538.0,CASA DI CURA NOTO PASQUALINO S.R.L.,SIC,40-49,5,4,0,1,8,0,0,9,0,9,Sicilia,ITG1
2021-01-14,PF/BT,190538.0,CASA DI CURA NOTO PASQUALINO S.R.L.,SIC,50-59,7,10,0,7,10,0,0,17,0,17,Sicilia,ITG1
2021-01-14,PF/BT,190538.0,CASA DI CURA NOTO PASQUALINO S.R.L.,SIC,60-69,0,2,0,1,1,0,0,2,0,2,Sicilia,ITG1
2021-01-14,PF/BT,190540.0,HSP11 - NUOVA CASA DI CURA DEMMA srl,SIC,20-29,4,0,0,2,2,0,0,4,0,4,Sicilia,ITG1
2021-01-14,PF/BT,190540.0,HSP11 - NUOVA CASA DI CURA DEMMA srl,SIC,30-39,2,0,0,0,2,0,0,2,0,2,Sicilia,ITG1
2021-01-14,PF/BT,190540.0,HSP11 - NUOVA CASA DI CURA DEMMA srl,SIC,40-49,2,3,0,2,3,0,0,5,0,5,Sicilia,ITG1
2021-01-14,PF/BT,190540.0,HSP11 - NUOVA CASA DI CURA DEMMA srl,SIC,50-59,2,6,0,1,7,0,0,8,0,8,Sicilia,ITG1
2021-01-14,PF/BT,190540.0,HSP11 - NUOVA CASA DI CURA DEMMA srl,SIC,60-69,1,4,0,2,3,0,0,5,0,5,Sicilia,ITG1
2021-01-14,PF/BT,190541.0,HSP11 - CASA DI CURA MACCHIARELLA S.P.A.,SIC,20-29,1,1,0,2,0,0,0,2,0,2,Sicilia,ITG1
2021-01-14,PF/BT,190541.0,HSP11 - CASA DI CURA MACCHIARELLA S.P.A.,SIC,30-39,5,1,0,5,1,0,0,6,0,6,Sicilia,ITG1
2021-01-14,PF/BT,190541.0,HSP11 - CASA DI CURA MACCHIARELLA S.P.A.,SIC,40-49,6,9,0,14,1,0,0,15,0,15,Sicilia,ITG1
2021-01-14,PF/BT,190541.0,HSP11 - CASA DI CURA MACCHIARELLA S.P.A.,SIC,50-59,5,6,0,9,2,0,0,11,0,11,Sicilia,ITG1
2021-01-14,PF/BT,190541.0,HSP11 - CASA DI CURA MACCHIARELLA S.P.A.,SIC,60-69,4,4,0,4,4,0,0,8,0,8,Sicilia,ITG1
2021-01-14,PF/BT,190545.0,HSP11 - CASA DI CURE COSENTINO DI KAROL  S.R.L.,SIC,20-29,2,4,0,2,4,0,0,6,0,6,Sicilia,ITG1
2021-01-14,PF/BT,190545.0,HSP11 - CASA DI CURE COSENTINO DI KAROL  S.R.L.,SIC,30-39,9,3,0,2,10,0,0,12,0,12,Sicilia,ITG1
2021-01-14,PF/BT,190545.0,HSP11 - CASA DI CURE COSENTINO DI KAROL  S.R.L.,SIC,40-49,14,9,0,7,16,0,0,23,0,23,Sicilia,ITG1
2021-01-14,PF/BT,190545.0,HSP11 - CASA DI CURE COSENTINO DI KAROL  S.R.L.,SIC,50-59,7,3,0,2,8,0,0,10,0,10,Sicilia,ITG1
2021-01-14,PF/BT,190545.0,HSP11 - CASA DI CURE COSENTINO DI KAROL  S.R.L.,SIC,60-69,5,4,0,7,2,0,0,9,0,9,Sicilia,ITG1
2021-01-14,PF/BT,190555.0,HSP11 - CASA DI CURA MONS. G. CALACIURA Cenacolo,SIC,20-29,1,4,0,4,0,0,1,5,0,5,Sicilia,ITG1
2021-01-14,PF/BT,190555.0,HSP11 - CASA DI CURA MONS. G. CALACIURA Cenacolo,SIC,30-39,2,2,0,3,1,0,0,4,0,4,Sicilia,ITG1
2021-01-14,PF/BT,190555.0,HSP11 - CASA DI CURA MONS. G. CALACIURA Cenacolo,SIC,40-49,1,4,0,3,2,0,0,5,0,5,Sicilia,ITG1
2021-01-14,PF/BT,190555.0,HSP11 - CASA DI CURA MONS. G. CALACIURA Cenacolo,SIC,50-59,0,5,0,3,1,0,1,5,0,5,Sicilia,ITG1
2021-01-14,PF/BT,190555.0,HSP11 - CASA DI CURA MONS. G. CALACIURA Cenacolo,SIC,60-69,5,0,0,5,0,0,0,5,0,5,Sicilia,ITG1
2021-01-14,PF/BT,190602.0,HSP11 - CENTRO ANDROS S.R.L.,SIC,30-39,3,8,0,7,4,0,0,11,0,11,Sicilia,ITG1
2021-01-14,PF/BT,190602.0,HSP11 - CENTRO ANDROS S.R.L.,SIC,40-49,1,6,0,4,3,0,0,7,0,7,Sicilia,ITG1
2021-01-14,PF/BT,190602.0,HSP11 - CENTRO ANDROS S.R.L.,SIC,50-59,3,7,0,4,6,0,0,10,0,10,Sicilia,ITG1
2021-01-14,PF/BT,190602.0,HSP11 - CENTRO ANDROS S.R.L.,SIC,60-69,2,3,0,4,1,0,0,5,0,5,Sicilia,ITG1
2021-01-14,PF/BT,190602.0,HSP11 - CENTRO ANDROS S.R.L.,SIC,70-79,2,0,0,2,0,0,0,2,0,2,Sicilia,ITG1
2021-01-14,PF/BT,190602.0,HSP11 - CENTRO ANDROS S.R.L.,SIC,80-89,0,1,0,0,1,0,0,1,0,1,Sicilia,ITG1
2021-01-14,PF/BT,190710.0,HSP11 - CASA DI CURA PROF.E.FALCIDIA SrL,SIC,40-49,0,1,0,0,1,0,0,1,0,1,Sicilia,ITG1
2021-01-14,PF/BT,190710.0,HSP11 - CASA DI CURA PROF.E.FALCIDIA SrL,SIC,50-59,2,0,0,1,1,0,0,2,0,2,Sicilia,ITG1
2021-01-14,PF/BT,190710.0,HSP11 - CASA DI CURA PROF.E.FALCIDIA SrL,SIC,60-69,0,1,0,1,0,0,0,1,0,1,Sicilia,ITG1
2021-01-14,PF/BT,190710.0,HSP11 - CASA DI CURA PROF.E.FALCIDIA SrL,SIC,70-79,2,0,0,2,0,0,0,2,0,2,Sicilia,ITG1
2021-01-14,PF/BT,190720.0,HSP11 - CASA DI CURA MARIA ELEONORA HOSPITAL srl,SIC,20-29,0,1,0,0,1,0,0,1,0,1,Sicilia,ITG1
2021-01-14,PF/BT,190720.0,HSP11 - CASA DI CURA MARIA ELEONORA HOSPITAL srl,SIC,40-49,1,1,0,0,2,0,0,2,0,2,Sicilia,ITG1
2021-01-14,PF/BT,190720.0,HSP11 - CASA DI CURA MARIA ELEONORA HOSPITAL srl,SIC,50-59,0,2,0,0,2,0,0,2,0,2,Sicilia,ITG1
2021-01-14,PF/BT,190720.0,HSP11 - CASA DI CURA MARIA ELEONORA HOSPITAL srl,SIC,60-69,1,0,0,1,0,0,0,1,0,1,Sicilia,ITG1
2021-01-14,PF/BT,190921.0,HSP11 - A.O. per lEmergenza Cannizzaro,SIC,20-29,5,0,0,4,1,0,0,5,0,5,Sicilia,ITG1
2021-01-14,PF/BT,190921.0,HSP11 - A.O. per lEmergenza Cannizzaro,SIC,30-39,5,0,0,3,2,0,0,5,0,5,Sicilia,ITG1
2021-01-14,PF/BT,190921.0,HSP11 - A.O. per lEmergenza Cannizzaro,SIC,40-49,10,5,0,9,6,0,0,15,0,15,Sicilia,ITG1
2021-01-14,PF/BT,190921.0,HSP11 - A.O. per lEmergenza Cannizzaro,SIC,50-59,12,8,0,9,11,0,0,20,0,20,Sicilia,ITG1
2021-01-14,PF/BT,190921.0,HSP11 - A.O. per lEmergenza Cannizzaro,SIC,60-69,5,4,0,3,6,0,0,9,0,9,Sicilia,ITG1
2021-01-14,PF/BT,19092201.0,HSP11 - OSPEDALE GARIBALDI - CENTRO,SIC,20-29,6,1,0,0,0,0,7,7,0,7,Sicilia,ITG1
2021-01-14,PF/BT,19092201.0,HSP11 - OSPEDALE GARIBALDI - CENTRO,SIC,30-39,17,6,0,3,1,0,19,23,0,23,Sicilia,ITG1
2021-01-14,PF/BT,19092201.0,HSP11 - OSPEDALE GARIBALDI - CENTRO,SIC,40-49,26,5,0,2,0,0,29,31,0,31,Sicilia,ITG1
2021-01-14,PF/BT,19092201.0,HSP11 - OSPEDALE GARIBALDI - CENTRO,SIC,50-59,19,4,0,2,0,0,21,23,0,23,Sicilia,ITG1
2021-01-14,PF/BT,19092201.0,HSP11 - OSPEDALE GARIBALDI - CENTRO,SIC,60-69,6,2,0,2,0,0,6,8,0,8,Sicilia,ITG1
2021-01-14,PF/BT,19092204.0,HSP11 - NUOVO OSPEDALE GARIBALDI - NESIMA,SIC,20-29,4,1,0,2,3,0,0,5,0,5,Sicilia,ITG1
2021-01-14,PF/BT,19092204.0,HSP11 - NUOVO OSPEDALE GARIBALDI - NESIMA,SIC,30-39,6,1,0,0,6,0,1,7,0,7,Sicilia,ITG1
2021-01-14,PF/BT,19092204.0,HSP11 - NUOVO OSPEDALE GARIBALDI - NESIMA,SIC,40-49,6,7,0,3,8,0,2,13,0,13,Sicilia,ITG1
2021-01-14,PF/BT,19092204.0,HSP11 - NUOVO OSPEDALE GARIBALDI - NESIMA,SIC,50-59,10,7,0,6,10,0,1,17,0,17,Sicilia,ITG1
2021-01-14,PF/BT,19092204.0,HSP11 - NUOVO OSPEDALE GARIBALDI - NESIMA,SIC,60-69,6,0,0,1,5,0,0,6,0,6,Sicilia,ITG1
2021-01-14,PF/BT,19092301.0,HSP11 - PRESIDIO OSPEDALIERO GASPARE RODOLICO,SIC,16-19,8,11,0,19,0,0,0,19,0,19,Sicilia,ITG1
2021-01-14,PF/BT,19092301.0,HSP11 - PRESIDIO OSPEDALIERO GASPARE RODOLICO,SIC,20-29,87,131,0,218,0,0,0,218,0,218,Sicilia,ITG1
2021-01-14,PF/BT,19092301.0,HSP11 - PRESIDIO OSPEDALIERO GASPARE RODOLICO,SIC,30-39,5,12,0,17,0,0,0,17,0,17,Sicilia,ITG1
2021-01-14,PF/BT,19092301.0,HSP11 - PRESIDIO OSPEDALIERO GASPARE RODOLICO,SIC,40-49,5,12,0,17,0,0,0,17,0,17,Sicilia,ITG1
2021-01-14,PF/BT,19092301.0,HSP11 - PRESIDIO OSPEDALIERO GASPARE RODOLICO,SIC,50-59,6,7,0,13,0,0,0,13,0,13,Sicilia,ITG1
2021-01-14,PF/BT,19092301.0,HSP11 - PRESIDIO OSPEDALIERO GASPARE RODOLICO,SIC,60-69,7,1,0,8,0,0,0,8,0,8,Sicilia,ITG1
2021-01-14,PF/BT,19092304.0,HSP11 - PRESIDIO OSPEDALIERO S.MARCO,SIC,16-19,12,26,0,36,2,0,0,38,0,38,Sicilia,ITG1
2021-01-14,PF/BT,19092304.0,HSP11 - PRESIDIO OSPEDALIERO S.MARCO,SIC,20-29,120,138,0,246,12,0,0,258,0,258,Sicilia,ITG1
2021-01-14,PF/BT,19092304.0,HSP11 - PRESIDIO OSPEDALIERO S.MARCO,SIC,30-39,5,13,0,15,3,0,0,18,0,18,Sicilia,ITG1
2021-01-14,PF/BT,19092304.0,HSP11 - PRESIDIO OSPEDALIERO S.MARCO,SIC,40-49,5,4,0,7,2,0,0,9,0,9,Sicilia,ITG1
2021-01-14,PF/BT,19092304.0,HSP11 - PRESIDIO OSPEDALIERO S.MARCO,SIC,50-59,1,5,0,5,1,0,0,6,0,6,Sicilia,ITG1
2021-01-14,PF/BT,19092304.0,HSP11 - PRESIDIO OSPEDALIERO S.MARCO,SIC,60-69,3,1,0,4,0,0,0,4,0,4,Sicilia,ITG1
2021-01-14,PF/BT,19092501.0,HSP11 - COVID HOSPITAL,SIC,16-19,1,0,0,0,1,0,0,1,0,1,Sicilia,ITG1
2021-01-14,PF/BT,19092501.0,HSP11 - COVID HOSPITAL,SIC,20-29,9,10,0,3,16,0,0,19,0,19,Sicilia,ITG1
2021-01-14,PF/BT,19092501.0,HSP11 - COVID HOSPITAL,SIC,30-39,19,9,0,2,26,0,0,28,0,28,Sicilia,ITG1
2021-01-14,PF/BT,19092501.0,HSP11 - COVID HOSPITAL,SIC,40-49,51,25,0,4,72,0,0,76,0,76,Sicilia,ITG1
2021-01-14,PF/BT,19092501.0,HSP11 - COVID HOSPITAL,SIC,50-59,53,40,0,6,87,0,0,93,0,93,Sicilia,ITG1
2021-01-14,PF/BT,19092501.0,HSP11 - COVID HOSPITAL,SIC,60-69,7,16,0,4,19,0,0,23,0,23,Sicilia,ITG1
2021-01-14,PF/BT,19092601.0,HSP11 - P.O. Villa Sofia,SIC,20-29,4,6,0,3,1,0,6,10,0,10,Sicilia,ITG1
2021-01-14,PF/BT,19092601.0,HSP11 - P.O. Villa Sofia,SIC,30-39,17,16,0,9,5,0,19,33,0,33,Sicilia,ITG1
2021-01-14,PF/BT,19092601.0,HSP11 - P.O. Villa Sofia,SIC,40-49,27,29,0,3,27,0,26,56,0,56,Sicilia,ITG1
2021-01-14,PF/BT,19092601.0,HSP11 - P.O. Villa Sofia,SIC,50-59,30,50,0,9,57,0,14,80,0,80,Sicilia,ITG1
2021-01-14,PF/BT,19092601.0,HSP11 - P.O. Villa Sofia,SIC,60-69,20,19,0,7,27,0,5,39,0,39,Sicilia,ITG1
2021-01-14,PF/BT,19092702.0,HSP11 - Ospedale dei Bambini G. Di Cristina,SIC,20-29,1,0,0,0,1,0,0,1,0,1,Sicilia,ITG1
2021-01-14,PF/BT,19092702.0,HSP11 - Ospedale dei Bambini G. Di Cristina,SIC,40-49,1,1,0,1,1,0,0,2,0,2,Sicilia,ITG1
2021-01-14,PF/BT,19092702.0,HSP11 - Ospedale dei Bambini G. Di Cristina,SIC,50-59,0,1,0,1,0,0,0,1,0,1,Sicilia,ITG1
2021-01-14,PF/BT,19092702.0,HSP11 - Ospedale dei Bambini G. Di Cristina,SIC,60-69,1,0,0,0,1,0,0,1,0,1,Sicilia,ITG1
2021-01-14,PF/BT,190928.0,HSP11 - AZ.OSP.UNIV.P.GIACCONE,SIC,20-29,12,10,0,16,2,0,4,22,0,22,Sicilia,ITG1
2021-01-14,PF/BT,190928.0,HSP11 - AZ.OSP.UNIV.P.GIACCONE,SIC,30-39,20,27,0,24,11,0,12,47,0,47,Sicilia,ITG1
2021-01-14,PF/BT,190928.0,HSP11 - AZ.OSP.UNIV.P.GIACCONE,SIC,40-49,28,20,0,20,16,0,12,48,0,48,Sicilia,ITG1
2021-01-14,PF/BT,190928.0,HSP11 - AZ.OSP.UNIV.P.GIACCONE,SIC,50-59,33,14,0,17,16,0,14,47,0,47,Sicilia,ITG1
2021-01-14,PF/BT,190928.0,HSP11 - AZ.OSP.UNIV.P.GIACCONE,SIC,60-69,10,10,0,8,3,0,9,20,0,20,Sicilia,ITG1
2021-01-14,PF/BT,190928.0,HSP11 - AZ.OSP.UNIV.P.GIACCONE,SIC,70-79,2,0,0,1,1,0,0,2,0,2,Sicilia,ITG1
2021-01-14,PF/BT,190929.0,STS11 - IRCCS Ismett,SIC,40-49,2,3,0,4,1,0,0,5,0,5,Sicilia,ITG1
2021-01-14,PF/BT,190929.0,STS11 - IRCCS Ismett,SIC,50-59,1,0,0,1,0,0,0,1,0,1,Sicilia,ITG1
2021-01-14,PF/BT,190950.0,HSP11 - ASSOCIAZIONE OASI MARIA SS,SIC,20-29,1,0,0,1,0,0,0,1,0,1,Sicilia,ITG1
2021-01-14,PF/BT,190950.0,HSP11 - ASSOCIAZIONE OASI MARIA SS,SIC,30-39,0,1,0,1,0,0,0,1,0,1,Sicilia,ITG1
2021-01-14,PF/BT,190950.0,HSP11 - ASSOCIAZIONE OASI MARIA SS,SIC,40-49,3,1,0,2,0,0,2,4,0,4,Sicilia,ITG1
2021-01-14,PF/BT,190950.0,HSP11 - ASSOCIAZIONE OASI MARIA SS,SIC,50-59,1,15,0,16,0,0,0,16,0,16,Sicilia,ITG1
2021-01-14,PF/BT,190950.0,HSP11 - ASSOCIAZIONE OASI MARIA SS,SIC,60-69,1,1,0,1,0,0,1,2,0,2,Sicilia,ITG1
2021-01-14,PF/BT,19096002.0,HSP11 - PRESIDIO OSPEDALIERO PIEMONTE,SIC,20-29,3,1,0,4,0,0,0,4,0,4,Sicilia,ITG1
2021-01-14,PF/BT,19096002.0,HSP11 - PRESIDIO OSPEDALIERO PIEMONTE,SIC,30-39,2,4,0,5,0,0,1,6,0,6,Sicilia,ITG1
2021-01-14,PF/BT,19096002.0,HSP11 - PRESIDIO OSPEDALIERO PIEMONTE,SIC,40-49,3,4,0,5,0,0,2,7,0,7,Sicilia,ITG1
2021-01-14,PF/BT,19096002.0,HSP11 - PRESIDIO OSPEDALIERO PIEMONTE,SIC,50-59,1,3,0,2,0,0,2,4,0,4,Sicilia,ITG1
2021-01-14,PF/BT,19096002.0,HSP11 - PRESIDIO OSPEDALIERO PIEMONTE,SIC,60-69,0,7,0,7,0,0,0,7,0,7,Sicilia,ITG1
2021-01-14,PF/BT,19096002.0,HSP11 - PRESIDIO OSPEDALIERO PIEMONTE,SIC,70-79,2,0,0,1,0,0,1,2,0,2,Sicilia,ITG1
2021-01-14,PF/BT,190970.0,HSP11 - Dipartimento Rizzoli-Sicilia,SIC,20-29,1,7,0,8,0,0,0,8,0,8,Sicilia,ITG1
2021-01-14,PF/BT,190970.0,HSP11 - Dipartimento Rizzoli-Sicilia,SIC,30-39,15,17,0,32,0,0,0,32,0,32,Sicilia,ITG1
2021-01-14,PF/BT,190970.0,HSP11 - Dipartimento Rizzoli-Sicilia,SIC,40-49,4,5,0,9,0,0,0,9,0,9,Sicilia,ITG1
2021-01-14,PF/BT,190970.0,HSP11 - Dipartimento Rizzoli-Sicilia,SIC,50-59,3,1,0,4,0,0,0,4,0,4,Sicilia,ITG1
2021-01-14,PF/BT,190970.0,HSP11 - Dipartimento Rizzoli-Sicilia,SIC,60-69,0,1,0,1,0,0,0,1,0,1,Sicilia,ITG1
2021-01-14,PF/BT,434000.0,Centro di Medicina Nucleare San Gaetano S.r.l.,SIC,30-39,3,1,0,4,0,0,0,4,0,4,Sicilia,ITG1
2021-01-14,PF/BT,434000.0,Centro di Medicina Nucleare San Gaetano S.r.l.,SIC,40-49,2,5,0,7,0,0,0,7,0,7,Sicilia,ITG1
2021-01-14,PF/BT,434000.0,Centro di Medicina Nucleare San Gaetano S.r.l.,SIC,50-59,3,0,0,3,0,0,0,3,0,3,Sicilia,ITG1
2021-01-14,PF/BT,434000.0,Centro di Medicina Nucleare San Gaetano S.r.l.,SIC,60-69,2,0,0,2,0,0,0,2,0,2,Sicilia,ITG1
2021-01-14,PF/BT,446400.0,STS11 - VILLA S. TERESA S.R.L.,SIC,30-39,5,5,0,10,0,0,0,10,0,10,Sicilia,ITG1
2021-01-14,PF/BT,446400.0,STS11 - VILLA S. TERESA S.R.L.,SIC,40-49,10,8,0,18,0,0,0,18,0,18,Sicilia,ITG1
2021-01-14,PF/BT,446400.0,STS11 - VILLA S. TERESA S.R.L.,SIC,50-59,10,1,0,10,1,0,0,11,0,11,Sicilia,ITG1
2021-01-14,PF/BT,446400.0,STS11 - VILLA S. TERESA S.R.L.,SIC,60-69,2,0,0,2,0,0,0,2,0,2,Sicilia,ITG1
2021-01-14,PF/BT,446400.0,STS11 - VILLA S. TERESA S.R.L.,SIC,70-79,1,0,0,1,0,0,0,1,0,1,Sicilia,ITG1
2021-01-14,PF/BT,600123.0,STS11 - POLIAMBULATORIO,SIC,20-29,0,3,0,1,2,0,0,3,0,3,Sicilia,ITG1
2021-01-14,PF/BT,600123.0,STS11 - POLIAMBULATORIO,SIC,30-39,4,5,0,4,5,0,0,9,0,9,Sicilia,ITG1
2021-01-14,PF/BT,600123.0,STS11 - POLIAMBULATORIO,SIC,40-49,2,7,0,6,3,0,0,9,0,9,Sicilia,ITG1
2021-01-14,PF/BT,600123.0,STS11 - POLIAMBULATORIO,SIC,50-59,2,2,0,4,0,0,0,4,0,4,Sicilia,ITG1
2021-01-14,PF/BT,600123.0,STS11 - POLIAMBULATORIO,SIC,60-69,3,3,0,4,2,0,0,6,0,6,Sicilia,ITG1
2021-01-14,PF/BT,600123.0,STS11 - POLIAMBULATORIO,SIC,70-79,2,0,0,2,0,0,0,2,0,2,Sicilia,ITG1
2021-01-14,PF/BT,608200.0,STS11 - POLIAMBULATORIO San Giorgio,SIC,20-29,7,8,0,12,3,0,0,15,0,15,Sicilia,ITG1
2021-01-14,PF/BT,608200.0,STS11 - POLIAMBULATORIO San Giorgio,SIC,30-39,5,8,0,11,2,0,0,13,0,13,Sicilia,ITG1
2021-01-14,PF/BT,608200.0,STS11 - POLIAMBULATORIO San Giorgio,SIC,40-49,4,2,0,3,3,0,0,6,0,6,Sicilia,ITG1
2021-01-14,PF/BT,608200.0,STS11 - POLIAMBULATORIO San Giorgio,SIC,50-59,10,14,0,15,9,0,0,24,0,24,Sicilia,ITG1
2021-01-14,PF/BT,608200.0,STS11 - POLIAMBULATORIO San Giorgio,SIC,60-69,4,2,0,3,3,0,0,6,0,6,Sicilia,ITG1
2021-01-14,PF/BT,608200.0,STS11 - POLIAMBULATORIO San Giorgio,SIC,70-79,2,0,0,2,0,0,0,2,0,2,Sicilia,ITG1
2021-01-14,PF/BT,608400.0,STS11 - POLIAMBULATORIO  San Luigi,SIC,20-29,4,4,0,5,3,0,0,8,0,8,Sicilia,ITG1
2021-01-14,PF/BT,608400.0,STS11 - POLIAMBULATORIO  San Luigi,SIC,30-39,7,8,0,10,5,0,0,15,0,15,Sicilia,ITG1
2021-01-14,PF/BT,608400.0,STS11 - POLIAMBULATORIO  San Luigi,SIC,40-49,8,8,0,7,9,0,0,16,0,16,Sicilia,ITG1
2021-01-14,PF/BT,608400.0,STS11 - POLIAMBULATORIO  San Luigi,SIC,50-59,4,17,0,14,7,0,0,21,0,21,Sicilia,ITG1
2021-01-14,PF/BT,608400.0,STS11 - POLIAMBULATORIO  San Luigi,SIC,60-69,8,8,0,7,9,0,0,16,0,16,Sicilia,ITG1
2021-01-14,PF/BT,608400.0,STS11 - POLIAMBULATORIO  San Luigi,SIC,70-79,2,0,0,2,0,0,0,2,0,2,Sicilia,ITG1
2021-01-14,PF/BT,800941.0,STS11 - CTA VILLA SAN GIORGIO srl,SIC,70-79,1,0,0,0,0,1,0,1,0,1,Sicilia,ITG1
2021-01-14,PF/BT,800941.0,STS11 - CTA VILLA SAN GIORGIO srl,SIC,80-89,0,3,0,0,0,3,0,3,0,3,Sicilia,ITG1
2021-01-14,PF/BT,800941.0,STS11 - CTA VILLA SAN GIORGIO srl,SIC,90+,1,1,0,0,0,2,0,2,0,2,Sicilia,ITG1
2021-01-14,PF/BT,820100.0,STS11 - VILLA LETIZIA COOP.SOCIALE,SIC,40-49,0,2,0,1,0,1,0,2,0,2,Sicilia,ITG1
2021-01-14,PF/BT,820100.0,STS11 - VILLA LETIZIA COOP.SOCIALE,SIC,50-59,2,2,0,3,0,1,0,4,0,4,Sicilia,ITG1
2021-01-14,PF/BT,820100.0,STS11 - VILLA LETIZIA COOP.SOCIALE,SIC,60-69,0,1,0,0,0,1,0,1,0,1,Sicilia,ITG1
2021-01-14,PF/BT,820100.0,STS11 - VILLA LETIZIA COOP.SOCIALE,SIC,70-79,0,2,0,1,0,1,0,2,0,2,Sicilia,ITG1
2021-01-14,PF/BT,820100.0,STS11 - VILLA LETIZIA COOP.SOCIALE,SIC,80-89,2,2,0,0,0,4,0,4,0,4,Sicilia,ITG1
2021-01-14,PF/BT,820100.0,STS11 - VILLA LETIZIA COOP.SOCIALE,SIC,90+,0,4,0,0,0,4,0,4,0,4,Sicilia,ITG1
2021-01-14,PF/BT,821101.0,STS11 - CTA VILLA S. ANTONIO SRL,SIC,20-29,2,4,0,4,0,0,2,6,0,6,Sicilia,ITG1
2021-01-14,PF/BT,821101.0,STS11 - CTA VILLA S. ANTONIO SRL,SIC,30-39,4,0,0,0,0,0,4,4,0,4,Sicilia,ITG1
2021-01-14,PF/BT,821101.0,STS11 - CTA VILLA S. ANTONIO SRL,SIC,40-49,4,5,0,1,1,0,7,9,0,9,Sicilia,ITG1
2021-01-14,PF/BT,821101.0,STS11 - CTA VILLA S. ANTONIO SRL,SIC,50-59,9,9,0,2,10,0,6,18,0,18,Sicilia,ITG1
2021-01-14,PF/BT,821101.0,STS11 - CTA VILLA S. ANTONIO SRL,SIC,60-69,11,8,0,1,6,0,12,19,0,19,Sicilia,ITG1
2021-01-14,PF/BT,821101.0,STS11 - CTA VILLA S. ANTONIO SRL,SIC,70-79,1,2,0,0,0,0,3,3,0,3,Sicilia,ITG1
2021-01-14,PF/BT,821101.0,STS11 - CTA VILLA S. ANTONIO SRL,SIC,80-89,0,1,0,0,0,0,1,1,0,1,Sicilia,ITG1
2021-01-14,PF/BT,830400.0,RSA VILLA PACIS SAN FRANCESCO,SIC,20-29,3,3,0,6,0,0,0,6,0,6,Sicilia,ITG1
2021-01-14,PF/BT,830400.0,RSA VILLA PACIS SAN FRANCESCO,SIC,30-39,3,6,0,5,4,0,0,9,0,9,Sicilia,ITG1
2021-01-14,PF/BT,830400.0,RSA VILLA PACIS SAN FRANCESCO,SIC,40-49,2,5,0,4,3,0,0,7,0,7,Sicilia,ITG1
2021-01-14,PF/BT,830400.0,RSA VILLA PACIS SAN FRANCESCO,SIC,50-59,1,3,0,3,1,0,0,4,0,4,Sicilia,ITG1
2021-01-14,PF/BT,830400.0,RSA VILLA PACIS SAN FRANCESCO,SIC,60-69,0,2,0,1,1,0,0,2,0,2,Sicilia,ITG1
2021-01-14,PF/BT,830400.0,RSA VILLA PACIS SAN FRANCESCO,SIC,70-79,1,0,0,1,0,0,0,1,0,1,Sicilia,ITG1
2021-01-15,Moderna,190345.0,HSP11 - P.O. UMBERTO I (EX A.O.),SIC,20-29,0,1,0,1,0,0,0,1,0,1,Sicilia,ITG1
2021-01-15,Moderna,190345.0,HSP11 - P.O. UMBERTO I (EX A.O.),SIC,30-39,1,4,0,1,4,0,0,5,0,5,Sicilia,ITG1
2021-01-15,Moderna,190345.0,HSP11 - P.O. UMBERTO I (EX A.O.),SIC,40-49,6,9,0,11,4,0,0,15,0,15,Sicilia,ITG1
2021-01-15,Moderna,190345.0,HSP11 - P.O. UMBERTO I (EX A.O.),SIC,50-59,9,12,0,11,10,0,0,21,0,21,Sicilia,ITG1
2021-01-15,Moderna,190345.0,HSP11 - P.O. UMBERTO I (EX A.O.),SIC,60-69,13,12,0,18,7,0,0,25,0,25,Sicilia,ITG1
2021-01-15,PF/BT,190199.0,HSP11 - OSP. BUCCHERI LA FERLA FATEBENEFRATELLI,SIC,16-19,1,0,0,1,0,0,0,1,0,1,Sicilia,ITG1
2021-01-15,PF/BT,190199.0,HSP11 - OSP. BUCCHERI LA FERLA FATEBENEFRATELLI,SIC,20-29,3,2,0,2,3,0,0,5,0,5,Sicilia,ITG1
2021-01-15,PF/BT,190199.0,HSP11 - OSP. BUCCHERI LA FERLA FATEBENEFRATELLI,SIC,30-39,3,3,0,4,2,0,0,6,0,6,Sicilia,ITG1
2021-01-15,PF/BT,190199.0,HSP11 - OSP. BUCCHERI LA FERLA FATEBENEFRATELLI,SIC,40-49,5,8,0,7,6,0,0,13,0,13,Sicilia,ITG1
2021-01-15,PF/BT,190199.0,HSP11 - OSP. BUCCHERI LA FERLA FATEBENEFRATELLI,SIC,50-59,14,11,0,16,9,0,0,25,0,25,Sicilia,ITG1
2021-01-15,PF/BT,190199.0,HSP11 - OSP. BUCCHERI LA FERLA FATEBENEFRATELLI,SIC,60-69,5,5,0,8,2,0,0,10,0,10,Sicilia,ITG1
2021-01-15,PF/BT,1902027.0,STRUTTURE PRIVATE NON CODIFICATE NSIS,SIC,20-29,2,3,0,5,0,0,0,5,0,5,Sicilia,ITG1
2021-01-15,PF/BT,1902027.0,STRUTTURE PRIVATE NON CODIFICATE NSIS,SIC,30-39,2,4,0,6,0,0,0,6,0,6,Sicilia,ITG1
2021-01-15,PF/BT,1902027.0,STRUTTURE PRIVATE NON CODIFICATE NSIS,SIC,40-49,1,4,0,5,0,0,0,5,0,5,Sicilia,ITG1
2021-01-15,PF/BT,1902027.0,STRUTTURE PRIVATE NON CODIFICATE NSIS,SIC,50-59,3,8,0,8,0,3,0,11,0,11,Sicilia,ITG1
2021-01-15,PF/BT,1902027.0,STRUTTURE PRIVATE NON CODIFICATE NSIS,SIC,60-69,6,2,0,1,0,7,0,8,0,8,Sicilia,ITG1
2021-01-15,PF/BT,1902027.0,STRUTTURE PRIVATE NON CODIFICATE NSIS,SIC,70-79,3,5,0,0,0,8,0,8,0,8,Sicilia,ITG1
2021-01-15,PF/BT,1902027.0,STRUTTURE PRIVATE NON CODIFICATE NSIS,SIC,80-89,11,22,0,0,0,33,0,33,0,33,Sicilia,ITG1
2021-01-15,PF/BT,1902027.0,STRUTTURE PRIVATE NON CODIFICATE NSIS,SIC,90+,3,5,0,0,0,8,0,8,0,8,Sicilia,ITG1
2021-01-15,PF/BT,1902047.0,STRUTTURE PRIVATE NON CODIFICATE NSIS,SIC,20-29,2,4,0,6,0,0,0,6,0,6,Sicilia,ITG1
2021-01-15,PF/BT,1902047.0,STRUTTURE PRIVATE NON CODIFICATE NSIS,SIC,30-39,4,9,0,12,0,1,0,13,0,13,Sicilia,ITG1
2021-01-15,PF/BT,1902047.0,STRUTTURE PRIVATE NON CODIFICATE NSIS,SIC,40-49,0,13,0,12,1,0,0,13,0,13,Sicilia,ITG1
2021-01-15,PF/BT,1902047.0,STRUTTURE PRIVATE NON CODIFICATE NSIS,SIC,50-59,6,21,0,24,3,0,0,27,0,27,Sicilia,ITG1
2021-01-15,PF/BT,1902047.0,STRUTTURE PRIVATE NON CODIFICATE NSIS,SIC,60-69,3,12,0,10,2,3,0,15,0,15,Sicilia,ITG1
2021-01-15,PF/BT,1902047.0,STRUTTURE PRIVATE NON CODIFICATE NSIS,SIC,70-79,8,9,0,0,0,17,0,17,0,17,Sicilia,ITG1
2021-01-15,PF/BT,1902047.0,STRUTTURE PRIVATE NON CODIFICATE NSIS,SIC,80-89,14,31,0,0,0,45,0,45,0,45,Sicilia,ITG1
2021-01-15,PF/BT,1902047.0,STRUTTURE PRIVATE NON CODIFICATE NSIS,SIC,90+,5,20,0,1,0,24,0,25,0,25,Sicilia,ITG1
2021-01-15,PF/BT,1902057.0,STRUTTURE PRIVATE NON CODIFICATE NSIS,SIC,20-29,15,18,0,33,0,0,0,33,0,33,Sicilia,ITG1
2021-01-15,PF/BT,1902057.0,STRUTTURE PRIVATE NON CODIFICATE NSIS,SIC,30-39,24,16,0,40,0,0,0,40,0,40,Sicilia,ITG1
2021-01-15,PF/BT,1902057.0,STRUTTURE PRIVATE NON CODIFICATE NSIS,SIC,40-49,23,15,0,36,2,0,0,38,0,38,Sicilia,ITG1
2021-01-15,PF/BT,1902057.0,STRUTTURE PRIVATE NON CODIFICATE NSIS,SIC,50-59,37,17,0,50,3,0,1,54,0,54,Sicilia,ITG1
2021-01-15,PF/BT,1902057.0,STRUTTURE PRIVATE NON CODIFICATE NSIS,SIC,60-69,37,23,0,57,3,0,0,60,0,60,Sicilia,ITG1
2021-01-15,PF/BT,1902057.0,STRUTTURE PRIVATE NON CODIFICATE NSIS,SIC,70-79,33,5,0,38,0,0,0,38,0,38,Sicilia,ITG1
2021-01-15,PF/BT,1902057.0,STRUTTURE PRIVATE NON CODIFICATE NSIS,SIC,80-89,2,0,0,2,0,0,0,2,0,2,Sicilia,ITG1
2021-01-15,PF/BT,1902097.0,STRUTTURE PRIVATE NON CODIFICATE NSIS,SIC,20-29,0,1,0,0,0,1,0,1,0,1,Sicilia,ITG1
2021-01-15,PF/BT,1902097.0,STRUTTURE PRIVATE NON CODIFICATE NSIS,SIC,30-39,4,0,0,1,0,3,0,4,0,4,Sicilia,ITG1
2021-01-15,PF/BT,1902097.0,STRUTTURE PRIVATE NON CODIFICATE NSIS,SIC,40-49,6,9,0,7,3,5,0,15,0,15,Sicilia,ITG1
2021-01-15,PF/BT,1902097.0,STRUTTURE PRIVATE NON CODIFICATE NSIS,SIC,50-59,7,9,0,6,3,7,0,16,0,16,Sicilia,ITG1
2021-01-15,PF/BT,1902097.0,STRUTTURE PRIVATE NON CODIFICATE NSIS,SIC,60-69,3,6,0,1,0,8,0,9,0,9,Sicilia,ITG1
2021-01-15,PF/BT,1902097.0,STRUTTURE PRIVATE NON CODIFICATE NSIS,SIC,70-79,2,2,0,0,0,4,0,4,0,4,Sicilia,ITG1
2021-01-15,PF/BT,1902097.0,STRUTTURE PRIVATE NON CODIFICATE NSIS,SIC,80-89,5,15,0,0,0,20,0,20,0,20,Sicilia,ITG1
2021-01-15,PF/BT,1902097.0,STRUTTURE PRIVATE NON CODIFICATE NSIS,SIC,90+,4,9,0,0,0,13,0,13,0,13,Sicilia,ITG1
2021-01-15,PF/BT,190306.0,RIA11 - ASS. CASA FAM.ROSETTA ONILUS,SIC,20-29,11,8,0,15,2,0,2,19,0,19,Sicilia,ITG1
2021-01-15,PF/BT,190306.0,RIA11 - ASS. CASA FAM.ROSETTA ONILUS,SIC,30-39,16,17,0,24,8,0,1,33,0,33,Sicilia,ITG1
2021-01-15,PF/BT,190306.0,RIA11 - ASS. CASA FAM.ROSETTA ONILUS,SIC,40-49,10,18,0,22,5,0,1,28,0,28,Sicilia,ITG1
2021-01-15,PF/BT,190306.0,RIA11 - ASS. CASA FAM.ROSETTA ONILUS,SIC,50-59,24,27,0,37,10,0,4,51,0,51,Sicilia,ITG1
2021-01-15,PF/BT,190306.0,RIA11 - ASS. CASA FAM.ROSETTA ONILUS,SIC,60-69,31,12,0,37,4,0,2,43,0,43,Sicilia,ITG1
2021-01-15,PF/BT,190306.0,RIA11 - ASS. CASA FAM.ROSETTA ONILUS,SIC,70-79,10,1,0,10,0,0,1,11,0,11,Sicilia,ITG1
2021-01-15,PF/BT,190309.0,HSP11 - P.O. VITTORIO EMANUELE (ex AO),SIC,16-19,1,0,0,1,0,0,0,1,0,1,Sicilia,ITG1
2021-01-15,PF/BT,190309.0,HSP11 - P.O. VITTORIO EMANUELE (ex AO),SIC,20-29,4,7,0,11,0,0,0,11,0,11,Sicilia,ITG1
2021-01-15,PF/BT,190309.0,HSP11 - P.O. VITTORIO EMANUELE (ex AO),SIC,30-39,6,6,0,12,0,0,0,12,0,12,Sicilia,ITG1
2021-01-15,PF/BT,190309.0,HSP11 - P.O. VITTORIO EMANUELE (ex AO),SIC,40-49,5,9,0,12,0,0,2,14,0,14,Sicilia,ITG1
2021-01-15,PF/BT,190309.0,HSP11 - P.O. VITTORIO EMANUELE (ex AO),SIC,50-59,5,10,0,14,0,0,1,15,0,15,Sicilia,ITG1
2021-01-15,PF/BT,190309.0,HSP11 - P.O. VITTORIO EMANUELE (ex AO),SIC,60-69,9,14,0,19,0,0,4,23,0,23,Sicilia,ITG1
2021-01-15,PF/BT,190309.0,HSP11 - P.O. VITTORIO EMANUELE (ex AO),SIC,70-79,1,0,0,1,0,0,0,1,0,1,Sicilia,ITG1
2021-01-15,PF/BT,190312.0,HSP11 - P.O. S. Marta e S. Venera Acireale,SIC,20-29,2,4,0,4,2,0,0,6,0,6,Sicilia,ITG1
2021-01-15,PF/BT,190312.0,HSP11 - P.O. S. Marta e S. Venera Acireale,SIC,30-39,8,18,0,24,2,0,0,26,0,26,Sicilia,ITG1
2021-01-15,PF/BT,190312.0,HSP11 - P.O. S. Marta e S. Venera Acireale,SIC,40-49,8,28,0,29,7,0,0,36,0,36,Sicilia,ITG1
2021-01-15,PF/BT,190312.0,HSP11 - P.O. S. Marta e S. Venera Acireale,SIC,50-59,12,38,0,34,16,0,0,50,0,50,Sicilia,ITG1
2021-01-15,PF/BT,190312.0,HSP11 - P.O. S. Marta e S. Venera Acireale,SIC,60-69,5,20,0,20,5,0,0,25,0,25,Sicilia,ITG1
2021-01-15,PF/BT,190312.0,HSP11 - P.O. S. Marta e S. Venera Acireale,SIC,70-79,0,1,0,0,1,0,0,1,0,1,Sicilia,ITG1
2021-01-15,PF/BT,190313.0,RIA11 - IST.RIAB.VILLAG. SAN GIUSEPPE,SIC,16-19,1,1,0,1,1,0,0,2,0,2,Sicilia,ITG1
2021-01-15,PF/BT,190313.0,RIA11 - IST.RIAB.VILLAG. SAN GIUSEPPE,SIC,20-29,3,10,0,9,4,0,0,13,0,13,Sicilia,ITG1
2021-01-15,PF/BT,190313.0,RIA11 - IST.RIAB.VILLAG. SAN GIUSEPPE,SIC,30-39,8,15,0,17,6,0,0,23,0,23,Sicilia,ITG1
2021-01-15,PF/BT,190313.0,RIA11 - IST.RIAB.VILLAG. SAN GIUSEPPE,SIC,40-49,9,28,0,26,11,0,0,37,0,37,Sicilia,ITG1
2021-01-15,PF/BT,190313.0,RIA11 - IST.RIAB.VILLAG. SAN GIUSEPPE,SIC,50-59,11,36,0,30,17,0,0,47,0,47,Sicilia,ITG1
2021-01-15,PF/BT,190313.0,RIA11 - IST.RIAB.VILLAG. SAN GIUSEPPE,SIC,60-69,7,9,0,8,8,0,0,16,0,16,Sicilia,ITG1
2021-01-15,PF/BT,190313.0,RIA11 - IST.RIAB.VILLAG. SAN GIUSEPPE,SIC,70-79,3,1,0,1,3,0,0,4,0,4,Sicilia,ITG1
2021-01-15,PF/BT,190313.0,RIA11 - IST.RIAB.VILLAG. SAN GIUSEPPE,SIC,80-89,1,0,0,0,1,0,0,1,0,1,Sicilia,ITG1
2021-01-15,PF/BT,190314.0,RIA11 - ASS.J.F.KENNEDY ACIREALE,SIC,20-29,5,9,0,14,0,0,0,14,0,14,Sicilia,ITG1
2021-01-15,PF/BT,190314.0,RIA11 - ASS.J.F.KENNEDY ACIREALE,SIC,30-39,5,15,0,20,0,0,0,20,0,20,Sicilia,ITG1
2021-01-15,PF/BT,190314.0,RIA11 - ASS.J.F.KENNEDY ACIREALE,SIC,40-49,10,27,0,35,1,1,0,37,0,37,Sicilia,ITG1
2021-01-15,PF/BT,190314.0,RIA11 - ASS.J.F.KENNEDY ACIREALE,SIC,50-59,11,40,0,48,1,2,0,51,0,51,Sicilia,ITG1
2021-01-15,PF/BT,190314.0,RIA11 - ASS.J.F.KENNEDY ACIREALE,SIC,60-69,5,9,0,13,0,1,0,14,0,14,Sicilia,ITG1
2021-01-15,PF/BT,190314.0,RIA11 - ASS.J.F.KENNEDY ACIREALE,SIC,70-79,1,0,0,1,0,0,0,1,0,1,Sicilia,ITG1
2021-01-15,PF/BT,190314.0,RIA11 - ASS.J.F.KENNEDY ACIREALE,SIC,80-89,0,1,0,1,0,0,0,1,0,1,Sicilia,ITG1
2021-01-15,PF/BT,190315.0,RIA11 - AIAS SEZ. ACIREALE,SIC,20-29,1,2,0,3,0,0,0,3,0,3,Sicilia,ITG1
2021-01-15,PF/BT,190315.0,RIA11 - AIAS SEZ. ACIREALE,SIC,30-39,0,3,0,3,0,0,0,3,0,3,Sicilia,ITG1
2021-01-15,PF/BT,190315.0,RIA11 - AIAS SEZ. ACIREALE,SIC,40-49,1,4,0,5,0,0,0,5,0,5,Sicilia,ITG1
2021-01-15,PF/BT,190315.0,RIA11 - AIAS SEZ. ACIREALE,SIC,50-59,0,8,0,8,0,0,0,8,0,8,Sicilia,ITG1
2021-01-15,PF/BT,190315.0,RIA11 - AIAS SEZ. ACIREALE,SIC,60-69,7,3,0,10,0,0,0,10,0,10,Sicilia,ITG1
2021-01-15,PF/BT,190316.0,RIA11 - ASS.J.F.KENNEDY - C.RIAB.ONLUS,SIC,16-19,0,1,0,1,0,0,0,1,0,1,Sicilia,ITG1
2021-01-15,PF/BT,190316.0,RIA11 - ASS.J.F.KENNEDY - C.RIAB.ONLUS,SIC,20-29,6,5,0,6,5,0,0,11,0,11,Sicilia,ITG1
2021-01-15,PF/BT,190316.0,RIA11 - ASS.J.F.KENNEDY - C.RIAB.ONLUS,SIC,30-39,5,4,0,7,2,0,0,9,0,9,Sicilia,ITG1
2021-01-15,PF/BT,190316.0,RIA11 - ASS.J.F.KENNEDY - C.RIAB.ONLUS,SIC,40-49,4,10,0,12,2,0,0,14,0,14,Sicilia,ITG1
2021-01-15,PF/BT,190316.0,RIA11 - ASS.J.F.KENNEDY - C.RIAB.ONLUS,SIC,50-59,7,14,0,14,7,0,0,21,0,21,Sicilia,ITG1
2021-01-15,PF/BT,190316.0,RIA11 - ASS.J.F.KENNEDY - C.RIAB.ONLUS,SIC,60-69,3,3,0,6,0,0,0,6,0,6,Sicilia,ITG1
2021-01-15,PF/BT,190316.0,RIA11 - ASS.J.F.KENNEDY - C.RIAB.ONLUS,SIC,70-79,3,0,0,0,3,0,0,3,0,3,Sicilia,ITG1
2021-01-15,PF/BT,190317.0,HSP11 - P.O. Gravina e S. Pietro Caltagirone,SIC,20-29,6,5,0,7,4,0,0,11,0,11,Sicilia,ITG1
2021-01-15,PF/BT,190317.0,HSP11 - P.O. Gravina e S. Pietro Caltagirone,SIC,30-39,6,15,0,6,15,0,0,21,0,21,Sicilia,ITG1
2021-01-15,PF/BT,190317.0,HSP11 - P.O. Gravina e S. Pietro Caltagirone,SIC,40-49,12,21,0,14,19,0,0,33,0,33,Sicilia,ITG1
2021-01-15,PF/BT,190317.0,HSP11 - P.O. Gravina e S. Pietro Caltagirone,SIC,50-59,6,22,0,14,12,2,0,28,0,28,Sicilia,ITG1
2021-01-15,PF/BT,190317.0,HSP11 - P.O. Gravina e S. Pietro Caltagirone,SIC,60-69,5,4,0,5,4,0,0,9,0,9,Sicilia,ITG1
2021-01-15,PF/BT,190317.0,HSP11 - P.O. Gravina e S. Pietro Caltagirone,SIC,70-79,3,1,0,2,2,0,0,4,0,4,Sicilia,ITG1
2021-01-15,PF/BT,190317.0,HSP11 - P.O. Gravina e S. Pietro Caltagirone,SIC,80-89,0,1,0,0,1,0,0,1,0,1,Sicilia,ITG1
2021-01-15,PF/BT,190319.0,HSP11 - P. O. UMBERTO I,SIC,20-29,2,3,0,0,5,0,0,5,0,5,Sicilia,ITG1
2021-01-15,PF/BT,190319.0,HSP11 - P. O. UMBERTO I,SIC,30-39,3,7,0,6,4,0,0,10,0,10,Sicilia,ITG1
2021-01-15,PF/BT,190319.0,HSP11 - P. O. UMBERTO I,SIC,40-49,6,5,0,9,2,0,0,11,0,11,Sicilia,ITG1
2021-01-15,PF/BT,190319.0,HSP11 - P. O. UMBERTO I,SIC,50-59,9,16,0,20,5,0,0,25,0,25,Sicilia,ITG1
2021-01-15,PF/BT,190319.0,HSP11 - P. O. UMBERTO I,SIC,60-69,13,8,0,18,3,0,0,21,0,21,Sicilia,ITG1
2021-01-15,PF/BT,190325.0,"P.O. ""G. Fogliani"" di Milazzo",SIC,16-19,0,2,0,0,2,0,0,2,0,2,Sicilia,ITG1
2021-01-15,PF/BT,190325.0,"P.O. ""G. Fogliani"" di Milazzo",SIC,20-29,0,4,0,0,4,0,0,4,0,4,Sicilia,ITG1
2021-01-15,PF/BT,190325.0,"P.O. ""G. Fogliani"" di Milazzo",SIC,30-39,7,6,0,1,12,0,0,13,0,13,Sicilia,ITG1
2021-01-15,PF/BT,190325.0,"P.O. ""G. Fogliani"" di Milazzo",SIC,40-49,12,7,0,3,16,0,0,19,0,19,Sicilia,ITG1
2021-01-15,PF/BT,190325.0,"P.O. ""G. Fogliani"" di Milazzo",SIC,50-59,10,14,0,5,19,0,0,24,0,24,Sicilia,ITG1
2021-01-15,PF/BT,190325.0,"P.O. ""G. Fogliani"" di Milazzo",SIC,60-69,2,5,0,0,7,0,0,7,0,7,Sicilia,ITG1
2021-01-15,PF/BT,190329.0,Presidio Ospedaliero Sant’Agata Militello via Medici,SIC,20-29,5,9,0,10,0,0,4,14,0,14,Sicilia,ITG1
2021-01-15,PF/BT,190329.0,Presidio Ospedaliero Sant’Agata Militello via Medici,SIC,30-39,3,12,0,6,1,0,8,15,0,15,Sicilia,ITG1
2021-01-15,PF/BT,190329.0,Presidio Ospedaliero Sant’Agata Militello via Medici,SIC,40-49,5,17,0,11,0,0,11,22,0,22,Sicilia,ITG1
2021-01-15,PF/BT,190329.0,Presidio Ospedaliero Sant’Agata Militello via Medici,SIC,50-59,12,17,0,22,1,0,6,29,0,29,Sicilia,ITG1
2021-01-15,PF/BT,190329.0,Presidio Ospedaliero Sant’Agata Militello via Medici,SIC,60-69,6,12,0,12,0,0,6,18,0,18,Sicilia,ITG1
2021-01-15,PF/BT,190329.0,Presidio Ospedaliero Sant’Agata Militello via Medici,SIC,70-79,3,1,0,3,0,0,1,4,0,4,Sicilia,ITG1
2021-01-15,PF/BT,190330.0,HSP11 - P.O. DEI BIANCHI CORLEONE,SIC,20-29,0,2,0,1,0,0,1,2,0,2,Sicilia,ITG1
2021-01-15,PF/BT,190330.0,HSP11 - P.O. DEI BIANCHI CORLEONE,SIC,30-39,6,0,0,5,0,0,1,6,0,6,Sicilia,ITG1
2021-01-15,PF/BT,190330.0,HSP11 - P.O. DEI BIANCHI CORLEONE,SIC,40-49,9,9,0,14,3,0,1,18,0,18,Sicilia,ITG1
2021-01-15,PF/BT,190330.0,HSP11 - P.O. DEI BIANCHI CORLEONE,SIC,50-59,2,7,0,5,2,0,2,9,0,9,Sicilia,ITG1
2021-01-15,PF/BT,190330.0,HSP11 - P.O. DEI BIANCHI CORLEONE,SIC,60-69,4,1,0,4,1,0,0,5,0,5,Sicilia,ITG1
2021-01-15,PF/BT,190330.0,HSP11 - P.O. DEI BIANCHI CORLEONE,SIC,70-79,2,0,0,1,0,0,1,2,0,2,Sicilia,ITG1
2021-01-15,PF/BT,190332.0,HSP11 - P.O. CIVICO PARTINICO,SIC,20-29,1,1,0,2,0,0,0,2,0,2,Sicilia,ITG1
2021-01-15,PF/BT,190332.0,HSP11 - P.O. CIVICO PARTINICO,SIC,30-39,3,5,0,8,0,0,0,8,0,8,Sicilia,ITG1
2021-01-15,PF/BT,190332.0,HSP11 - P.O. CIVICO PARTINICO,SIC,40-49,6,7,0,12,1,0,0,13,0,13,Sicilia,ITG1
2021-01-15,PF/BT,190332.0,HSP11 - P.O. CIVICO PARTINICO,SIC,50-59,4,3,0,5,1,0,1,7,0,7,Sicilia,ITG1
2021-01-15,PF/BT,190332.0,HSP11 - P.O. CIVICO PARTINICO,SIC,60-69,6,7,0,13,0,0,0,13,0,13,Sicilia,ITG1
2021-01-15,PF/BT,190332.0,HSP11 - P.O. CIVICO PARTINICO,SIC,70-79,8,1,0,7,0,0,2,9,0,9,Sicilia,ITG1
2021-01-15,PF/BT,190332.0,HSP11 - P.O. CIVICO PARTINICO,SIC,80-89,1,1,0,2,0,0,0,2,0,2,Sicilia,ITG1
2021-01-15,PF/BT,190334.0,HSP11 - P.O. S. CIMINO TERMINI IMERESE,SIC,20-29,3,4,0,7,0,0,0,7,0,7,Sicilia,ITG1
2021-01-15,PF/BT,190334.0,HSP11 - P.O. S. CIMINO TERMINI IMERESE,SIC,30-39,3,8,0,11,0,0,0,11,0,11,Sicilia,ITG1
2021-01-15,PF/BT,190334.0,HSP11 - P.O. S. CIMINO TERMINI IMERESE,SIC,40-49,10,7,0,14,3,0,0,17,0,17,Sicilia,ITG1
2021-01-15,PF/BT,190334.0,HSP11 - P.O. S. CIMINO TERMINI IMERESE,SIC,50-59,8,9,0,13,4,0,0,17,0,17,Sicilia,ITG1
2021-01-15,PF/BT,190334.0,HSP11 - P.O. S. CIMINO TERMINI IMERESE,SIC,60-69,7,3,0,10,0,0,0,10,0,10,Sicilia,ITG1
2021-01-15,PF/BT,190334.0,HSP11 - P.O. S. CIMINO TERMINI IMERESE,SIC,70-79,6,1,0,7,0,0,0,7,0,7,Sicilia,ITG1
2021-01-15,PF/BT,190334.0,HSP11 - P.O. S. CIMINO TERMINI IMERESE,SIC,80-89,2,1,0,3,0,0,0,3,0,3,Sicilia,ITG1
2021-01-15,PF/BT,190335.0,HSP11 - P.O. G. F. INGRASSIA,SIC,20-29,0,2,0,2,0,0,0,2,0,2,Sicilia,ITG1
2021-01-15,PF/BT,190335.0,HSP11 - P.O. G. F. INGRASSIA,SIC,30-39,3,5,0,8,0,0,0,8,0,8,Sicilia,ITG1
2021-01-15,PF/BT,190335.0,HSP11 - P.O. G. F. INGRASSIA,SIC,40-49,2,2,0,3,1,0,0,4,0,4,Sicilia,ITG1
2021-01-15,PF/BT,190335.0,HSP11 - P.O. G. F. INGRASSIA,SIC,50-59,6,8,0,10,4,0,0,14,0,14,Sicilia,ITG1
2021-01-15,PF/BT,190335.0,HSP11 - P.O. G. F. INGRASSIA,SIC,60-69,5,4,0,8,1,0,0,9,0,9,Sicilia,ITG1
2021-01-15,PF/BT,190335.0,HSP11 - P.O. G. F. INGRASSIA,SIC,70-79,5,0,0,5,0,0,0,5,0,5,Sicilia,ITG1
2021-01-15,PF/BT,190337.0,HSP11 - P.O. VILLA DELLE GINESTRE,SIC,16-19,2,0,0,1,0,0,1,2,0,2,Sicilia,ITG1
2021-01-15,PF/BT,190337.0,HSP11 - P.O. VILLA DELLE GINESTRE,SIC,20-29,8,11,0,8,3,0,8,19,0,19,Sicilia,ITG1
2021-01-15,PF/BT,190337.0,HSP11 - P.O. VILLA DELLE GINESTRE,SIC,30-39,17,18,0,18,11,0,6,35,0,35,Sicilia,ITG1
2021-01-15,PF/BT,190337.0,HSP11 - P.O. VILLA DELLE GINESTRE,SIC,40-49,19,29,0,22,14,0,12,48,0,48,Sicilia,ITG1
2021-01-15,PF/BT,190337.0,HSP11 - P.O. VILLA DELLE GINESTRE,SIC,50-59,17,24,0,18,16,0,7,41,0,41,Sicilia,ITG1
2021-01-15,PF/BT,190337.0,HSP11 - P.O. VILLA DELLE GINESTRE,SIC,60-69,26,20,0,30,10,0,6,46,0,46,Sicilia,ITG1
2021-01-15,PF/BT,190337.0,HSP11 - P.O. VILLA DELLE GINESTRE,SIC,70-79,8,5,0,12,0,0,1,13,0,13,Sicilia,ITG1
2021-01-15,PF/BT,190337.0,HSP11 - P.O. VILLA DELLE GINESTRE,SIC,80-89,1,1,0,1,0,0,1,2,0,2,Sicilia,ITG1
2021-01-15,PF/BT,190337.0,HSP11 - P.O. VILLA DELLE GINESTRE,SIC,90+,1,0,0,1,0,0,0,1,0,1,Sicilia,ITG1
2021-01-15,PF/BT,190345.0,HSP11 - P.O. UMBERTO I (EX A.O.),SIC,20-29,0,1,0,1,0,0,0,1,0,1,Sicilia,ITG1
2021-01-15,PF/BT,190345.0,HSP11 - P.O. UMBERTO I (EX A.O.),SIC,30-39,1,0,0,1,0,0,0,1,0,1,Sicilia,ITG1
2021-01-15,PF/BT,190345.0,HSP11 - P.O. UMBERTO I (EX A.O.),SIC,40-49,2,1,0,3,0,0,0,3,0,3,Sicilia,ITG1
2021-01-15,PF/BT,190345.0,HSP11 - P.O. UMBERTO I (EX A.O.),SIC,50-59,3,3,0,4,2,0,0,6,0,6,Sicilia,ITG1
2021-01-15,PF/BT,190345.0,HSP11 - P.O. UMBERTO I (EX A.O.),SIC,60-69,1,0,0,1,0,0,0,1,0,1,Sicilia,ITG1
2021-01-15,PF/BT,190353.0,HSP11 - P.O.PAOLO BORSELLINO - MARSALA,SIC,30-39,1,0,0,1,0,0,0,1,0,1,Sicilia,ITG1
2021-01-15,PF/BT,190353.0,HSP11 - P.O.PAOLO BORSELLINO - MARSALA,SIC,40-49,1,0,0,0,1,0,0,1,0,1,Sicilia,ITG1
2021-01-15,PF/BT,190353.0,HSP11 - P.O.PAOLO BORSELLINO - MARSALA,SIC,50-59,2,2,0,1,3,0,0,4,0,4,Sicilia,ITG1
2021-01-15,PF/BT,190354.0,HSP11 - P.O.ABELE AJELLO-MAZARA D.VALLO,SIC,30-39,1,0,0,0,0,1,0,1,0,1,Sicilia,ITG1
2021-01-15,PF/BT,190354.0,HSP11 - P.O.ABELE AJELLO-MAZARA D.VALLO,SIC,40-49,1,0,0,0,0,1,0,1,0,1,Sicilia,ITG1
2021-01-15,PF/BT,190354.0,HSP11 - P.O.ABELE AJELLO-MAZARA D.VALLO,SIC,60-69,1,1,0,0,0,2,0,2,0,2,Sicilia,ITG1
2021-01-15,PF/BT,190354.0,HSP11 - P.O.ABELE AJELLO-MAZARA D.VALLO,SIC,70-79,4,2,0,0,0,6,0,6,0,6,Sicilia,ITG1
2021-01-15,PF/BT,190354.0,HSP11 - P.O.ABELE AJELLO-MAZARA D.VALLO,SIC,80-89,5,21,0,0,0,26,0,26,0,26,Sicilia,ITG1
2021-01-15,PF/BT,190354.0,HSP11 - P.O.ABELE AJELLO-MAZARA D.VALLO,SIC,90+,6,16,0,0,0,22,0,22,0,22,Sicilia,ITG1
2021-01-15,PF/BT,190520.0,HSP11 - CASA CURA CENTRO CATANESE MED. E CH.,SIC,20-29,4,7,0,11,0,0,0,11,0,11,Sicilia,ITG1
2021-01-15,PF/BT,190520.0,HSP11 - CASA CURA CENTRO CATANESE MED. E CH.,SIC,30-39,2,6,0,7,1,0,0,8,0,8,Sicilia,ITG1
2021-01-15,PF/BT,190520.0,HSP11 - CASA CURA CENTRO CATANESE MED. E CH.,SIC,40-49,4,3,0,5,2,0,0,7,0,7,Sicilia,ITG1
2021-01-15,PF/BT,190520.0,HSP11 - CASA CURA CENTRO CATANESE MED. E CH.,SIC,50-59,6,9,0,11,4,0,0,15,0,15,Sicilia,ITG1
2021-01-15,PF/BT,190520.0,HSP11 - CASA CURA CENTRO CATANESE MED. E CH.,SIC,60-69,4,2,0,3,3,0,0,6,0,6,Sicilia,ITG1
2021-01-15,PF/BT,190520.0,HSP11 - CASA CURA CENTRO CATANESE MED. E CH.,SIC,70-79,1,0,0,0,1,0,0,1,0,1,Sicilia,ITG1
2021-01-15,PF/BT,190534.0,HSP11 - CASA DI CURE ORESTANO S.R.L.,SIC,30-39,1,0,0,0,1,0,0,1,0,1,Sicilia,ITG1
2021-01-15,PF/BT,190534.0,HSP11 - CASA DI CURE ORESTANO S.R.L.,SIC,40-49,1,0,0,0,1,0,0,1,0,1,Sicilia,ITG1
2021-01-15,PF/BT,190534.0,HSP11 - CASA DI CURE ORESTANO S.R.L.,SIC,50-59,2,0,0,0,2,0,0,2,0,2,Sicilia,ITG1
2021-01-15,PF/BT,190534.0,HSP11 - CASA DI CURE ORESTANO S.R.L.,SIC,60-69,0,1,0,0,1,0,0,1,0,1,Sicilia,ITG1
2021-01-15,PF/BT,190536.0,HSP11 - CASA DI CURA TRIOLO ZANCLA S.P.A.,SIC,20-29,1,0,0,0,0,0,1,1,0,1,Sicilia,ITG1
2021-01-15,PF/BT,190536.0,HSP11 - CASA DI CURA TRIOLO ZANCLA S.P.A.,SIC,30-39,1,0,0,0,0,0,1,1,0,1,Sicilia,ITG1
2021-01-15,PF/BT,190536.0,HSP11 - CASA DI CURA TRIOLO ZANCLA S.P.A.,SIC,40-49,2,1,0,2,1,0,0,3,0,3,Sicilia,ITG1
2021-01-15,PF/BT,190536.0,HSP11 - CASA DI CURA TRIOLO ZANCLA S.P.A.,SIC,50-59,3,1,0,1,0,0,3,4,0,4,Sicilia,ITG1
2021-01-15,PF/BT,190536.0,HSP11 - CASA DI CURA TRIOLO ZANCLA S.P.A.,SIC,60-69,3,0,0,1,1,0,1,3,0,3,Sicilia,ITG1
2021-01-15,PF/BT,190537.0,HSP11 - CASA DI CURA SERENA S.P.A.,SIC,16-19,1,0,0,1,0,0,0,1,0,1,Sicilia,ITG1
2021-01-15,PF/BT,190537.0,HSP11 - CASA DI CURA SERENA S.P.A.,SIC,20-29,5,2,0,3,0,0,4,7,0,7,Sicilia,ITG1
2021-01-15,PF/BT,190537.0,HSP11 - CASA DI CURA SERENA S.P.A.,SIC,30-39,4,2,0,2,2,0,2,6,0,6,Sicilia,ITG1
2021-01-15,PF/BT,190537.0,HSP11 - CASA DI CURA SERENA S.P.A.,SIC,40-49,4,4,0,2,3,0,3,8,0,8,Sicilia,ITG1
2021-01-15,PF/BT,190537.0,HSP11 - CASA DI CURA SERENA S.P.A.,SIC,50-59,10,11,0,7,9,0,5,21,0,21,Sicilia,ITG1
2021-01-15,PF/BT,190537.0,HSP11 - CASA DI CURA SERENA S.P.A.,SIC,60-69,2,2,0,2,1,0,1,4,0,4,Sicilia,ITG1
2021-01-15,PF/BT,190537.0,HSP11 - CASA DI CURA SERENA S.P.A.,SIC,70-79,1,0,0,1,0,0,0,1,0,1,Sicilia,ITG1
2021-01-15,PF/BT,190539.0,HSP11 - NUOVA CASA DI CURA D`ANNA PIA ASS. SRL,SIC,20-29,1,0,0,1,0,0,0,1,0,1,Sicilia,ITG1
2021-01-15,PF/BT,190539.0,HSP11 - NUOVA CASA DI CURA D`ANNA PIA ASS. SRL,SIC,30-39,2,1,0,2,1,0,0,3,0,3,Sicilia,ITG1
2021-01-15,PF/BT,190539.0,HSP11 - NUOVA CASA DI CURA D`ANNA PIA ASS. SRL,SIC,40-49,2,2,0,4,0,0,0,4,0,4,Sicilia,ITG1
2021-01-15,PF/BT,190539.0,HSP11 - NUOVA CASA DI CURA D`ANNA PIA ASS. SRL,SIC,50-59,1,1,0,2,0,0,0,2,0,2,Sicilia,ITG1
2021-01-15,PF/BT,190539.0,HSP11 - NUOVA CASA DI CURA D`ANNA PIA ASS. SRL,SIC,60-69,1,0,0,1,0,0,0,1,0,1,Sicilia,ITG1
2021-01-15,PF/BT,190539.0,HSP11 - NUOVA CASA DI CURA D`ANNA PIA ASS. SRL,SIC,70-79,1,0,0,1,0,0,0,1,0,1,Sicilia,ITG1
2021-01-15,PF/BT,190540.0,HSP11 - NUOVA CASA DI CURA DEMMA srl,SIC,20-29,1,0,0,0,1,0,0,1,0,1,Sicilia,ITG1
2021-01-15,PF/BT,190540.0,HSP11 - NUOVA CASA DI CURA DEMMA srl,SIC,30-39,0,1,0,1,0,0,0,1,0,1,Sicilia,ITG1
2021-01-15,PF/BT,190540.0,HSP11 - NUOVA CASA DI CURA DEMMA srl,SIC,40-49,1,0,0,0,1,0,0,1,0,1,Sicilia,ITG1
2021-01-15,PF/BT,190540.0,HSP11 - NUOVA CASA DI CURA DEMMA srl,SIC,50-59,0,1,0,0,1,0,0,1,0,1,Sicilia,ITG1
2021-01-15,PF/BT,190540.0,HSP11 - NUOVA CASA DI CURA DEMMA srl,SIC,60-69,1,1,0,2,0,0,0,2,0,2,Sicilia,ITG1
2021-01-15,PF/BT,190541.0,HSP11 - CASA DI CURA MACCHIARELLA S.P.A.,SIC,30-39,1,2,0,2,1,0,0,3,0,3,Sicilia,ITG1
2021-01-15,PF/BT,190541.0,HSP11 - CASA DI CURA MACCHIARELLA S.P.A.,SIC,40-49,2,3,0,5,0,0,0,5,0,5,Sicilia,ITG1
2021-01-15,PF/BT,190541.0,HSP11 - CASA DI CURA MACCHIARELLA S.P.A.,SIC,50-59,2,2,0,3,1,0,0,4,0,4,Sicilia,ITG1
2021-01-15,PF/BT,190541.0,HSP11 - CASA DI CURA MACCHIARELLA S.P.A.,SIC,60-69,1,1,0,1,1,0,0,2,0,2,Sicilia,ITG1
2021-01-15,PF/BT,190541.0,HSP11 - CASA DI CURA MACCHIARELLA S.P.A.,SIC,70-79,3,0,0,1,1,0,1,3,0,3,Sicilia,ITG1
2021-01-15,PF/BT,190542.0,HSP11 - CASA DI CURA TORINA,SIC,20-29,1,3,0,0,1,0,3,4,0,4,Sicilia,ITG1
2021-01-15,PF/BT,190542.0,HSP11 - CASA DI CURA TORINA,SIC,30-39,6,3,0,2,2,0,5,9,0,9,Sicilia,ITG1
2021-01-15,PF/BT,190542.0,HSP11 - CASA DI CURA TORINA,SIC,40-49,7,10,0,4,4,0,9,17,0,17,Sicilia,ITG1
2021-01-15,PF/BT,190542.0,HSP11 - CASA DI CURA TORINA,SIC,50-59,11,13,0,9,6,0,9,24,0,24,Sicilia,ITG1
2021-01-15,PF/BT,190542.0,HSP11 - CASA DI CURA TORINA,SIC,60-69,3,7,0,4,1,0,5,10,0,10,Sicilia,ITG1
2021-01-15,PF/BT,190542.0,HSP11 - CASA DI CURA TORINA,SIC,70-79,1,1,0,1,0,0,1,2,0,2,Sicilia,ITG1
2021-01-15,PF/BT,190720.0,HSP11 - CASA DI CURA MARIA ELEONORA HOSPITAL srl,SIC,20-29,5,2,0,2,5,0,0,7,0,7,Sicilia,ITG1
2021-01-15,PF/BT,190720.0,HSP11 - CASA DI CURA MARIA ELEONORA HOSPITAL srl,SIC,30-39,6,9,0,5,10,0,0,15,0,15,Sicilia,ITG1
2021-01-15,PF/BT,190720.0,HSP11 - CASA DI CURA MARIA ELEONORA HOSPITAL srl,SIC,40-49,11,16,0,10,17,0,0,27,0,27,Sicilia,ITG1
2021-01-15,PF/BT,190720.0,HSP11 - CASA DI CURA MARIA ELEONORA HOSPITAL srl,SIC,50-59,13,13,0,7,19,0,0,26,0,26,Sicilia,ITG1
2021-01-15,PF/BT,190720.0,HSP11 - CASA DI CURA MARIA ELEONORA HOSPITAL srl,SIC,60-69,1,6,0,2,5,0,0,7,0,7,Sicilia,ITG1
2021-01-15,PF/BT,190720.0,HSP11 - CASA DI CURA MARIA ELEONORA HOSPITAL srl,SIC,70-79,1,0,0,1,0,0,0,1,0,1,Sicilia,ITG1
2021-01-15,PF/BT,190720.0,HSP11 - CASA DI CURA MARIA ELEONORA HOSPITAL srl,SIC,80-89,1,0,0,1,0,0,0,1,0,1,Sicilia,ITG1
2021-01-15,PF/BT,190921.0,HSP11 - A.O. per lEmergenza Cannizzaro,SIC,20-29,5,3,0,5,3,0,0,8,0,8,Sicilia,ITG1
2021-01-15,PF/BT,190921.0,HSP11 - A.O. per lEmergenza Cannizzaro,SIC,30-39,7,0,0,5,2,0,0,7,0,7,Sicilia,ITG1
2021-01-15,PF/BT,190921.0,HSP11 - A.O. per lEmergenza Cannizzaro,SIC,40-49,7,14,0,13,8,0,0,21,0,21,Sicilia,ITG1
2021-01-15,PF/BT,190921.0,HSP11 - A.O. per lEmergenza Cannizzaro,SIC,50-59,4,5,0,5,4,0,0,9,0,9,Sicilia,ITG1
2021-01-15,PF/BT,190921.0,HSP11 - A.O. per lEmergenza Cannizzaro,SIC,60-69,3,3,0,1,5,0,0,6,0,6,Sicilia,ITG1
2021-01-15,PF/BT,190921.0,HSP11 - A.O. per lEmergenza Cannizzaro,SIC,70-79,1,2,0,0,3,0,0,3,0,3,Sicilia,ITG1
2021-01-15,PF/BT,19092201.0,HSP11 - OSPEDALE GARIBALDI - CENTRO,SIC,20-29,7,2,0,3,0,0,6,9,0,9,Sicilia,ITG1
2021-01-15,PF/BT,19092201.0,HSP11 - OSPEDALE GARIBALDI - CENTRO,SIC,30-39,12,1,0,3,0,0,10,13,0,13,Sicilia,ITG1
2021-01-15,PF/BT,19092201.0,HSP11 - OSPEDALE GARIBALDI - CENTRO,SIC,40-49,8,1,0,1,0,0,8,9,0,9,Sicilia,ITG1
2021-01-15,PF/BT,19092201.0,HSP11 - OSPEDALE GARIBALDI - CENTRO,SIC,50-59,11,7,0,6,0,0,12,18,0,18,Sicilia,ITG1
2021-01-15,PF/BT,19092201.0,HSP11 - OSPEDALE GARIBALDI - CENTRO,SIC,60-69,1,3,0,3,1,0,0,4,0,4,Sicilia,ITG1
2021-01-15,PF/BT,19092201.0,HSP11 - OSPEDALE GARIBALDI - CENTRO,SIC,70-79,1,0,0,0,0,0,1,1,0,1,Sicilia,ITG1
2021-01-15,PF/BT,19092204.0,HSP11 - NUOVO OSPEDALE GARIBALDI - NESIMA,SIC,20-29,1,1,0,0,2,0,0,2,0,2,Sicilia,ITG1
2021-01-15,PF/BT,19092204.0,HSP11 - NUOVO OSPEDALE GARIBALDI - NESIMA,SIC,30-39,16,12,0,5,21,0,2,28,0,28,Sicilia,ITG1
2021-01-15,PF/BT,19092204.0,HSP11 - NUOVO OSPEDALE GARIBALDI - NESIMA,SIC,40-49,11,10,0,5,13,0,3,21,0,21,Sicilia,ITG1
2021-01-15,PF/BT,19092204.0,HSP11 - NUOVO OSPEDALE GARIBALDI - NESIMA,SIC,50-59,10,9,0,6,12,0,1,19,0,19,Sicilia,ITG1
2021-01-15,PF/BT,19092204.0,HSP11 - NUOVO OSPEDALE GARIBALDI - NESIMA,SIC,60-69,6,8,0,4,7,0,3,14,0,14,Sicilia,ITG1
2021-01-15,PF/BT,19092301.0,HSP11 - PRESIDIO OSPEDALIERO GASPARE RODOLICO,SIC,16-19,15,16,0,31,0,0,0,31,0,31,Sicilia,ITG1
2021-01-15,PF/BT,19092301.0,HSP11 - PRESIDIO OSPEDALIERO GASPARE RODOLICO,SIC,20-29,81,106,0,187,0,0,0,187,0,187,Sicilia,ITG1
2021-01-15,PF/BT,19092301.0,HSP11 - PRESIDIO OSPEDALIERO GASPARE RODOLICO,SIC,30-39,10,6,0,16,0,0,0,16,0,16,Sicilia,ITG1
2021-01-15,PF/BT,19092301.0,HSP11 - PRESIDIO OSPEDALIERO GASPARE RODOLICO,SIC,40-49,2,8,0,10,0,0,0,10,0,10,Sicilia,ITG1
2021-01-15,PF/BT,19092301.0,HSP11 - PRESIDIO OSPEDALIERO GASPARE RODOLICO,SIC,50-59,3,8,0,11,0,0,0,11,0,11,Sicilia,ITG1
2021-01-15,PF/BT,19092301.0,HSP11 - PRESIDIO OSPEDALIERO GASPARE RODOLICO,SIC,60-69,5,3,0,8,0,0,0,8,0,8,Sicilia,ITG1
2021-01-15,PF/BT,19092301.0,HSP11 - PRESIDIO OSPEDALIERO GASPARE RODOLICO,SIC,70-79,1,0,0,1,0,0,0,1,0,1,Sicilia,ITG1
2021-01-15,PF/BT,19092304.0,HSP11 - PRESIDIO OSPEDALIERO S.MARCO,SIC,16-19,5,5,0,10,0,0,0,10,0,10,Sicilia,ITG1
2021-01-15,PF/BT,19092304.0,HSP11 - PRESIDIO OSPEDALIERO S.MARCO,SIC,20-29,97,127,0,206,18,0,0,224,0,224,Sicilia,ITG1
2021-01-15,PF/BT,19092304.0,HSP11 - PRESIDIO OSPEDALIERO S.MARCO,SIC,30-39,9,18,0,25,2,0,0,27,0,27,Sicilia,ITG1
2021-01-15,PF/BT,19092304.0,HSP11 - PRESIDIO OSPEDALIERO S.MARCO,SIC,40-49,1,3,0,4,0,0,0,4,0,4,Sicilia,ITG1
2021-01-15,PF/BT,19092304.0,HSP11 - PRESIDIO OSPEDALIERO S.MARCO,SIC,50-59,2,4,0,5,1,0,0,6,0,6,Sicilia,ITG1
2021-01-15,PF/BT,19092304.0,HSP11 - PRESIDIO OSPEDALIERO S.MARCO,SIC,60-69,5,0,0,4,1,0,0,5,0,5,Sicilia,ITG1
2021-01-15,PF/BT,19092501.0,HSP11 - COVID HOSPITAL,SIC,16-19,7,11,0,0,0,0,18,18,0,18,Sicilia,ITG1
2021-01-15,PF/BT,19092501.0,HSP11 - COVID HOSPITAL,SIC,20-29,112,139,0,18,0,0,233,251,0,251,Sicilia,ITG1
2021-01-15,PF/BT,19092501.0,HSP11 - COVID HOSPITAL,SIC,30-39,15,8,0,11,0,0,12,23,0,23,Sicilia,ITG1
2021-01-15,PF/BT,19092501.0,HSP11 - COVID HOSPITAL,SIC,40-49,18,13,0,9,0,0,22,31,0,31,Sicilia,ITG1
2021-01-15,PF/BT,19092501.0,HSP11 - COVID HOSPITAL,SIC,50-59,24,13,0,12,0,0,25,37,0,37,Sicilia,ITG1
2021-01-15,PF/BT,19092501.0,HSP11 - COVID HOSPITAL,SIC,60-69,7,7,0,1,1,0,12,14,0,14,Sicilia,ITG1
2021-01-15,PF/BT,19092501.0,HSP11 - COVID HOSPITAL,SIC,70-79,3,1,0,1,0,0,3,4,0,4,Sicilia,ITG1
2021-01-15,PF/BT,190928.0,HSP11 - AZ.OSP.UNIV.P.GIACCONE,SIC,20-29,41,34,0,37,6,0,32,75,0,75,Sicilia,ITG1
2021-01-15,PF/BT,190928.0,HSP11 - AZ.OSP.UNIV.P.GIACCONE,SIC,30-39,27,19,0,15,14,0,17,46,0,46,Sicilia,ITG1
2021-01-15,PF/BT,190928.0,HSP11 - AZ.OSP.UNIV.P.GIACCONE,SIC,40-49,38,28,0,15,27,0,24,66,0,66,Sicilia,ITG1
2021-01-15,PF/BT,190928.0,HSP11 - AZ.OSP.UNIV.P.GIACCONE,SIC,50-59,33,16,0,16,25,0,8,49,0,49,Sicilia,ITG1
2021-01-15,PF/BT,190928.0,HSP11 - AZ.OSP.UNIV.P.GIACCONE,SIC,60-69,16,8,0,14,7,0,3,24,0,24,Sicilia,ITG1
2021-01-15,PF/BT,190928.0,HSP11 - AZ.OSP.UNIV.P.GIACCONE,SIC,70-79,4,1,0,2,3,0,0,5,0,5,Sicilia,ITG1
2021-01-15,PF/BT,190950.0,HSP11 - ASSOCIAZIONE OASI MARIA SS,SIC,20-29,1,1,0,1,0,0,1,2,0,2,Sicilia,ITG1
2021-01-15,PF/BT,190950.0,HSP11 - ASSOCIAZIONE OASI MARIA SS,SIC,30-39,0,4,0,2,0,0,2,4,0,4,Sicilia,ITG1
2021-01-15,PF/BT,190950.0,HSP11 - ASSOCIAZIONE OASI MARIA SS,SIC,40-49,4,21,0,13,0,0,12,25,0,25,Sicilia,ITG1
2021-01-15,PF/BT,190950.0,HSP11 - ASSOCIAZIONE OASI MARIA SS,SIC,50-59,2,15,0,11,0,0,6,17,0,17,Sicilia,ITG1
2021-01-15,PF/BT,190950.0,HSP11 - ASSOCIAZIONE OASI MARIA SS,SIC,60-69,0,4,0,3,0,0,1,4,0,4,Sicilia,ITG1
2021-01-15,PF/BT,190950.0,HSP11 - ASSOCIAZIONE OASI MARIA SS,SIC,70-79,0,2,0,0,0,0,2,2,0,2,Sicilia,ITG1
2021-01-15,PF/BT,19096001.0,HSP11 - IRCCS Centro Neurolesi,SIC,20-29,1,1,0,2,0,0,0,2,0,2,Sicilia,ITG1
2021-01-15,PF/BT,19096001.0,HSP11 - IRCCS Centro Neurolesi,SIC,30-39,2,1,0,3,0,0,0,3,0,3,Sicilia,ITG1
2021-01-15,PF/BT,19096001.0,HSP11 - IRCCS Centro Neurolesi,SIC,50-59,2,1,0,3,0,0,0,3,0,3,Sicilia,ITG1
2021-01-15,PF/BT,19096001.0,HSP11 - IRCCS Centro Neurolesi,SIC,60-69,8,12,0,20,0,0,0,20,0,20,Sicilia,ITG1
2021-01-15,PF/BT,19096001.0,HSP11 - IRCCS Centro Neurolesi,SIC,70-79,2,0,0,2,0,0,0,2,0,2,Sicilia,ITG1
2021-01-15,PF/BT,19096002.0,HSP11 - PRESIDIO OSPEDALIERO PIEMONTE,SIC,30-39,1,1,0,1,0,0,1,2,0,2,Sicilia,ITG1
2021-01-15,PF/BT,19096002.0,HSP11 - PRESIDIO OSPEDALIERO PIEMONTE,SIC,40-49,0,2,0,2,0,0,0,2,0,2,Sicilia,ITG1
2021-01-15,PF/BT,19096002.0,HSP11 - PRESIDIO OSPEDALIERO PIEMONTE,SIC,50-59,1,0,0,1,0,0,0,1,0,1,Sicilia,ITG1
2021-01-15,PF/BT,19096002.0,HSP11 - PRESIDIO OSPEDALIERO PIEMONTE,SIC,60-69,0,1,0,1,0,0,0,1,0,1,Sicilia,ITG1
2021-01-15,PF/BT,190970.0,HSP11 - Dipartimento Rizzoli-Sicilia,SIC,20-29,0,1,0,1,0,0,0,1,0,1,Sicilia,ITG1
2021-01-15,PF/BT,190970.0,HSP11 - Dipartimento Rizzoli-Sicilia,SIC,30-39,2,4,0,6,0,0,0,6,0,6,Sicilia,ITG1
2021-01-15,PF/BT,190970.0,HSP11 - Dipartimento Rizzoli-Sicilia,SIC,40-49,3,2,0,5,0,0,0,5,0,5,Sicilia,ITG1
2021-01-15,PF/BT,190970.0,HSP11 - Dipartimento Rizzoli-Sicilia,SIC,50-59,1,1,0,2,0,0,0,2,0,2,Sicilia,ITG1
2021-01-15,PF/BT,190970.0,HSP11 - Dipartimento Rizzoli-Sicilia,SIC,60-69,0,1,0,1,0,0,0,1,0,1,Sicilia,ITG1
2021-01-15,PF/BT,434000.0,Centro di Medicina Nucleare San Gaetano S.r.l.,SIC,30-39,0,1,0,1,0,0,0,1,0,1,Sicilia,ITG1
2021-01-15,PF/BT,434000.0,Centro di Medicina Nucleare San Gaetano S.r.l.,SIC,40-49,1,0,0,1,0,0,0,1,0,1,Sicilia,ITG1
2021-01-15,PF/BT,434000.0,Centro di Medicina Nucleare San Gaetano S.r.l.,SIC,50-59,2,0,0,1,1,0,0,2,0,2,Sicilia,ITG1
2021-01-15,PF/BT,434000.0,Centro di Medicina Nucleare San Gaetano S.r.l.,SIC,70-79,1,0,0,0,1,0,0,1,0,1,Sicilia,ITG1
2021-01-15,PF/BT,434000.0,Centro di Medicina Nucleare San Gaetano S.r.l.,SIC,80-89,1,0,0,0,1,0,0,1,0,1,Sicilia,ITG1
2021-01-15,PF/BT,446400.0,STS11 - VILLA S. TERESA S.R.L.,SIC,30-39,0,1,0,0,1,0,0,1,0,1,Sicilia,ITG1
2021-01-15,PF/BT,446400.0,STS11 - VILLA S. TERESA S.R.L.,SIC,40-49,2,3,0,1,4,0,0,5,0,5,Sicilia,ITG1
2021-01-15,PF/BT,446400.0,STS11 - VILLA S. TERESA S.R.L.,SIC,50-59,2,1,0,2,1,0,0,3,0,3,Sicilia,ITG1
2021-01-15,PF/BT,600123.0,STS11 - POLIAMBULATORIO,SIC,16-19,0,1,0,0,0,0,1,1,0,1,Sicilia,ITG1
2021-01-15,PF/BT,600123.0,STS11 - POLIAMBULATORIO,SIC,20-29,1,1,0,0,0,0,2,2,0,2,Sicilia,ITG1
2021-01-15,PF/BT,600123.0,STS11 - POLIAMBULATORIO,SIC,30-39,2,2,0,0,0,0,4,4,0,4,Sicilia,ITG1
2021-01-15,PF/BT,600123.0,STS11 - POLIAMBULATORIO,SIC,40-49,1,2,0,3,0,0,0,3,0,3,Sicilia,ITG1
2021-01-15,PF/BT,600123.0,STS11 - POLIAMBULATORIO,SIC,50-59,2,2,0,1,0,0,3,4,0,4,Sicilia,ITG1
2021-01-15,PF/BT,600123.0,STS11 - POLIAMBULATORIO,SIC,60-69,7,2,0,7,0,0,2,9,0,9,Sicilia,ITG1
2021-01-15,PF/BT,600123.0,STS11 - POLIAMBULATORIO,SIC,70-79,6,1,0,6,0,0,1,7,0,7,Sicilia,ITG1
2021-01-15,PF/BT,608200.0,STS11 - POLIAMBULATORIO San Giorgio,SIC,20-29,1,9,0,10,0,0,0,10,0,10,Sicilia,ITG1
2021-01-15,PF/BT,608200.0,STS11 - POLIAMBULATORIO San Giorgio,SIC,30-39,2,5,0,5,2,0,0,7,0,7,Sicilia,ITG1
2021-01-15,PF/BT,608200.0,STS11 - POLIAMBULATORIO San Giorgio,SIC,40-49,5,6,0,7,4,0,0,11,0,11,Sicilia,ITG1
2021-01-15,PF/BT,608200.0,STS11 - POLIAMBULATORIO San Giorgio,SIC,50-59,5,12,0,11,6,0,0,17,0,17,Sicilia,ITG1
2021-01-15,PF/BT,608200.0,STS11 - POLIAMBULATORIO San Giorgio,SIC,60-69,7,9,0,8,8,0,0,16,0,16,Sicilia,ITG1
2021-01-15,PF/BT,608200.0,STS11 - POLIAMBULATORIO San Giorgio,SIC,70-79,3,2,0,4,1,0,0,5,0,5,Sicilia,ITG1
2021-01-15,PF/BT,608400.0,STS11 - POLIAMBULATORIO  San Luigi,SIC,20-29,3,3,0,6,0,0,0,6,0,6,Sicilia,ITG1
2021-01-15,PF/BT,608400.0,STS11 - POLIAMBULATORIO  San Luigi,SIC,30-39,4,5,0,5,4,0,0,9,0,9,Sicilia,ITG1
2021-01-15,PF/BT,608400.0,STS11 - POLIAMBULATORIO  San Luigi,SIC,40-49,6,2,0,3,5,0,0,8,0,8,Sicilia,ITG1
2021-01-15,PF/BT,608400.0,STS11 - POLIAMBULATORIO  San Luigi,SIC,50-59,15,14,0,12,17,0,0,29,0,29,Sicilia,ITG1
2021-01-15,PF/BT,608400.0,STS11 - POLIAMBULATORIO  San Luigi,SIC,60-69,10,9,0,11,8,0,0,19,0,19,Sicilia,ITG1
2021-01-15,PF/BT,608400.0,STS11 - POLIAMBULATORIO  San Luigi,SIC,70-79,1,0,0,1,0,0,0,1,0,1,Sicilia,ITG1
2021-01-15,PF/BT,800901.0,STS11 - CTA VILLA SALVADOR,SIC,16-19,1,0,0,0,1,0,0,1,0,1,Sicilia,ITG1
2021-01-15,PF/BT,800901.0,STS11 - CTA VILLA SALVADOR,SIC,30-39,12,1,0,3,4,0,6,13,0,13,Sicilia,ITG1
2021-01-15,PF/BT,800901.0,STS11 - CTA VILLA SALVADOR,SIC,40-49,4,6,0,2,2,0,6,10,0,10,Sicilia,ITG1
2021-01-15,PF/BT,800901.0,STS11 - CTA VILLA SALVADOR,SIC,50-59,7,6,0,2,5,0,6,13,0,13,Sicilia,ITG1
2021-01-15,PF/BT,800901.0,STS11 - CTA VILLA SALVADOR,SIC,60-69,7,7,0,3,5,0,6,14,0,14,Sicilia,ITG1
2021-01-15,PF/BT,800901.0,STS11 - CTA VILLA SALVADOR,SIC,70-79,1,1,0,0,0,0,2,2,0,2,Sicilia,ITG1
2021-01-15,PF/BT,800901.0,STS11 - CTA VILLA SALVADOR,SIC,80-89,1,0,0,0,0,0,1,1,0,1,Sicilia,ITG1
2021-01-15,PF/BT,805700.0,STS11 - RSA ANNI DORO,SIC,20-29,3,1,0,4,0,0,0,4,0,4,Sicilia,ITG1
2021-01-15,PF/BT,805700.0,STS11 - RSA ANNI DORO,SIC,30-39,6,5,0,11,0,0,0,11,0,11,Sicilia,ITG1
2021-01-15,PF/BT,805700.0,STS11 - RSA ANNI DORO,SIC,40-49,4,6,0,10,0,0,0,10,0,10,Sicilia,ITG1
2021-01-15,PF/BT,805700.0,STS11 - RSA ANNI DORO,SIC,50-59,1,1,0,2,0,0,0,2,0,2,Sicilia,ITG1
2021-01-15,PF/BT,805700.0,STS11 - RSA ANNI DORO,SIC,60-69,0,1,0,1,0,0,0,1,0,1,Sicilia,ITG1
2021-01-15,PF/BT,805700.0,STS11 - RSA ANNI DORO,SIC,70-79,1,3,0,0,0,4,0,4,0,4,Sicilia,ITG1
2021-01-15,PF/BT,805700.0,STS11 - RSA ANNI DORO,SIC,80-89,3,3,0,0,0,6,0,6,0,6,Sicilia,ITG1
2021-01-15,PF/BT,805700.0,STS11 - RSA ANNI DORO,SIC,90+,1,3,0,0,0,4,0,4,0,4,Sicilia,ITG1
2021-01-16,PF/BT,190199.0,OSP. BUCCHERI LA FERLA FATEBENEFRATELLI,SIC,30-39,1,1,0,2,0,0,0,2,0,2,Sicilia,ITG1
2021-01-16,PF/BT,190199.0,OSP. BUCCHERI LA FERLA FATEBENEFRATELLI,SIC,40-49,1,1,0,0,2,0,0,2,0,2,Sicilia,ITG1
2021-01-16,PF/BT,190199.0,OSP. BUCCHERI LA FERLA FATEBENEFRATELLI,SIC,50-59,1,0,0,0,1,0,0,1,0,1,Sicilia,ITG1
2021-01-16,PF/BT,190199.0,OSP. BUCCHERI LA FERLA FATEBENEFRATELLI,SIC,60-69,1,0,0,0,1,0,0,1,0,1,Sicilia,ITG1
2021-01-16,PF/BT,1902027.0,AMERICANRESIDENCE,SIC,16-19,1,0,0,0,1,0,0,1,0,1,Sicilia,ITG1
2021-01-16,PF/BT,1902027.0,AMERICANRESIDENCE,SIC,20-29,1,1,0,0,2,0,0,2,0,2,Sicilia,ITG1
2021-01-16,PF/BT,1902027.0,AMERICANRESIDENCE,SIC,40-49,1,1,0,0,1,0,1,2,0,2,Sicilia,ITG1
2021-01-16,PF/BT,1902027.0,AMERICANRESIDENCE,SIC,50-59,1,0,0,1,0,0,0,1,0,1,Sicilia,ITG1
2021-01-16,PF/BT,1902027.0,AMERICANRESIDENCE,SIC,60-69,1,0,0,0,0,1,0,1,0,1,Sicilia,ITG1
2021-01-16,PF/BT,1902027.0,AMERICANRESIDENCE,SIC,70-79,2,0,0,0,0,2,0,2,0,2,Sicilia,ITG1
2021-01-16,PF/BT,1902027.0,AMERICANRESIDENCE,SIC,80-89,1,2,0,0,0,3,0,3,0,3,Sicilia,ITG1
2021-01-16,PF/BT,1902027.0,AMERICANRESIDENCE,SIC,90+,2,2,0,0,0,4,0,4,0,4,Sicilia,ITG1
2021-01-16,PF/BT,1902027.0,BOCCONEDELPOVERO,SIC,20-29,2,2,0,0,0,0,4,4,0,4,Sicilia,ITG1
2021-01-16,PF/BT,1902027.0,BOCCONEDELPOVERO,SIC,30-39,3,4,0,0,0,1,6,7,0,7,Sicilia,ITG1
2021-01-16,PF/BT,1902027.0,BOCCONEDELPOVERO,SIC,40-49,2,3,0,0,0,0,5,5,0,5,Sicilia,ITG1
2021-01-16,PF/BT,1902027.0,BOCCONEDELPOVERO,SIC,50-59,4,3,0,0,0,2,5,7,0,7,Sicilia,ITG1
2021-01-16,PF/BT,1902027.0,BOCCONEDELPOVERO,SIC,60-69,8,3,0,0,0,7,4,11,0,11,Sicilia,ITG1
2021-01-16,PF/BT,1902027.0,BOCCONEDELPOVERO,SIC,70-79,2,2,0,0,0,4,0,4,0,4,Sicilia,ITG1
2021-01-16,PF/BT,1902027.0,BOCCONEDELPOVERO,SIC,80-89,4,3,0,0,0,7,0,7,0,7,Sicilia,ITG1
2021-01-16,PF/BT,1902027.0,BOCCONEDELPOVERO,SIC,90+,0,4,0,0,0,4,0,4,0,4,Sicilia,ITG1
2021-01-16,PF/BT,1902027.0,IRIS,SIC,20-29,1,0,0,0,1,0,0,1,0,1,Sicilia,ITG1
2021-01-16,PF/BT,1902027.0,IRIS,SIC,40-49,0,1,0,0,1,0,0,1,0,1,Sicilia,ITG1
2021-01-16,PF/BT,1902027.0,IRIS,SIC,50-59,1,0,0,0,1,0,0,1,0,1,Sicilia,ITG1
2021-01-16,PF/BT,1902027.0,IRIS,SIC,70-79,1,0,0,0,0,1,0,1,0,1,Sicilia,ITG1
2021-01-16,PF/BT,1902027.0,IRIS,SIC,80-89,0,2,0,0,0,2,0,2,0,2,Sicilia,ITG1
2021-01-16,PF/BT,1902027.0,IRIS,SIC,90+,1,2,0,0,0,3,0,3,0,3,Sicilia,ITG1
2021-01-16,PF/BT,1902027.0,MOSAIKO,SIC,20-29,1,0,0,0,0,0,1,1,0,1,Sicilia,ITG1
2021-01-16,PF/BT,1902027.0,MOSAIKO,SIC,30-39,1,2,0,0,0,0,3,3,0,3,Sicilia,ITG1
2021-01-16,PF/BT,1902027.0,MOSAIKO,SIC,40-49,0,3,0,0,0,0,3,3,0,3,Sicilia,ITG1
2021-01-16,PF/BT,1902027.0,MOSAIKO,SIC,50-59,1,3,0,0,0,1,3,4,0,4,Sicilia,ITG1
2021-01-16,PF/BT,1902027.0,MOSAIKO,SIC,60-69,0,2,0,0,0,1,1,2,0,2,Sicilia,ITG1
2021-01-16,PF/BT,1902027.0,MOSAIKO,SIC,70-79,1,3,0,0,0,4,0,4,0,4,Sicilia,ITG1
2021-01-16,PF/BT,1902027.0,MOSAIKO,SIC,80-89,5,3,0,0,0,8,0,8,0,8,Sicilia,ITG1
2021-01-16,PF/BT,1902027.0,MOSAIKO,SIC,90+,3,1,0,0,0,4,0,4,0,4,Sicilia,ITG1
2021-01-16,PF/BT,1902027.0,PADRECALA,SIC,30-39,1,1,0,2,0,0,0,2,0,2,Sicilia,ITG1
2021-01-16,PF/BT,1902027.0,PADRECALA,SIC,40-49,0,3,0,1,0,0,2,3,0,3,Sicilia,ITG1
2021-01-16,PF/BT,1902027.0,PADRECALA,SIC,50-59,2,2,0,2,0,0,2,4,0,4,Sicilia,ITG1
2021-01-16,PF/BT,1902027.0,PADRECALA,SIC,60-69,1,4,0,0,0,2,3,5,0,5,Sicilia,ITG1
2021-01-16,PF/BT,1902027.0,PADRECALA,SIC,70-79,2,3,0,0,0,4,1,5,0,5,Sicilia,ITG1
2021-01-16,PF/BT,1902027.0,PADRECALA,SIC,80-89,4,5,0,0,0,9,0,9,0,9,Sicilia,ITG1
2021-01-16,PF/BT,1902027.0,PADRECALA,SIC,90+,1,3,0,0,0,4,0,4,0,4,Sicilia,ITG1
2021-01-16,PF/BT,1902047.0,STRUTTURE PRIVATE NON CODIFICATE NSIS,SIC,20-29,1,2,0,0,1,0,2,3,0,3,Sicilia,ITG1
2021-01-16,PF/BT,1902047.0,STRUTTURE PRIVATE NON CODIFICATE NSIS,SIC,30-39,3,4,0,5,0,0,2,7,0,7,Sicilia,ITG1
2021-01-16,PF/BT,1902047.0,STRUTTURE PRIVATE NON CODIFICATE NSIS,SIC,40-49,5,7,0,12,0,0,0,12,0,12,Sicilia,ITG1
2021-01-16,PF/BT,1902047.0,STRUTTURE PRIVATE NON CODIFICATE NSIS,SIC,50-59,5,7,0,6,0,4,2,12,0,12,Sicilia,ITG1
2021-01-16,PF/BT,1902047.0,STRUTTURE PRIVATE NON CODIFICATE NSIS,SIC,60-69,1,6,0,2,0,4,1,7,0,7,Sicilia,ITG1
2021-01-16,PF/BT,1902047.0,STRUTTURE PRIVATE NON CODIFICATE NSIS,SIC,70-79,4,3,0,0,0,7,0,7,0,7,Sicilia,ITG1
2021-01-16,PF/BT,1902047.0,STRUTTURE PRIVATE NON CODIFICATE NSIS,SIC,80-89,8,12,0,0,0,20,0,20,0,20,Sicilia,ITG1
2021-01-16,PF/BT,1902047.0,STRUTTURE PRIVATE NON CODIFICATE NSIS,SIC,90+,4,12,0,0,0,16,0,16,0,16,Sicilia,ITG1
2021-01-16,PF/BT,190205.0,CITTADELLA DELLA SALUTE,SIC,20-29,6,8,0,11,2,0,1,14,0,14,Sicilia,ITG1
2021-01-16,PF/BT,190205.0,CITTADELLA DELLA SALUTE,SIC,30-39,25,19,0,43,1,0,0,44,0,44,Sicilia,ITG1
2021-01-16,PF/BT,190205.0,CITTADELLA DELLA SALUTE,SIC,40-49,17,14,0,27,2,0,2,31,0,31,Sicilia,ITG1
2021-01-16,PF/BT,190205.0,CITTADELLA DELLA SALUTE,SIC,50-59,24,23,0,41,6,0,0,47,0,47,Sicilia,ITG1
2021-01-16,PF/BT,190205.0,CITTADELLA DELLA SALUTE,SIC,60-69,50,29,0,72,3,0,4,79,0,79,Sicilia,ITG1
2021-01-16,PF/BT,190205.0,CITTADELLA DELLA SALUTE,SIC,70-79,30,1,0,30,0,0,1,31,0,31,Sicilia,ITG1
2021-01-16,PF/BT,190205.0,CITTADELLA DELLA SALUTE,SIC,80-89,6,0,0,4,1,0,1,6,0,6,Sicilia,ITG1
2021-01-16,PF/BT,190205.0,CITTADELLA DELLA SALUTE,SIC,90+,2,0,0,2,0,0,0,2,0,2,Sicilia,ITG1
2021-01-16,PF/BT,1902087.0,AZIENDA SANITARIA PROVINCIALE DI SIRACUSA,SIC,20-29,0,2,0,0,2,0,0,2,0,2,Sicilia,ITG1
2021-01-16,PF/BT,1902087.0,AZIENDA SANITARIA PROVINCIALE DI SIRACUSA,SIC,30-39,0,7,0,0,7,0,0,7,0,7,Sicilia,ITG1
2021-01-16,PF/BT,1902087.0,AZIENDA SANITARIA PROVINCIALE DI SIRACUSA,SIC,40-49,1,7,0,0,8,0,0,8,0,8,Sicilia,ITG1
2021-01-16,PF/BT,1902087.0,AZIENDA SANITARIA PROVINCIALE DI SIRACUSA,SIC,50-59,0,12,0,0,12,0,0,12,0,12,Sicilia,ITG1
2021-01-16,PF/BT,1902087.0,AZIENDA SANITARIA PROVINCIALE DI SIRACUSA,SIC,60-69,3,1,0,0,1,3,0,4,0,4,Sicilia,ITG1
2021-01-16,PF/BT,1902087.0,AZIENDA SANITARIA PROVINCIALE DI SIRACUSA,SIC,70-79,3,1,0,0,0,4,0,4,0,4,Sicilia,ITG1
2021-01-16,PF/BT,1902087.0,AZIENDA SANITARIA PROVINCIALE DI SIRACUSA,SIC,80-89,6,10,0,0,0,16,0,16,0,16,Sicilia,ITG1
2021-01-16,PF/BT,1902087.0,AZIENDA SANITARIA PROVINCIALE DI SIRACUSA,SIC,90+,6,11,0,0,0,17,0,17,0,17,Sicilia,ITG1
2021-01-16,PF/BT,190306.0,PO S.ELIA,SIC,16-19,1,3,0,3,0,0,1,4,0,4,Sicilia,ITG1
2021-01-16,PF/BT,190306.0,PO S.ELIA,SIC,20-29,11,10,0,17,2,0,2,21,0,21,Sicilia,ITG1
2021-01-16,PF/BT,190306.0,PO S.ELIA,SIC,30-39,11,12,0,21,2,0,0,23,0,23,Sicilia,ITG1
2021-01-16,PF/BT,190306.0,PO S.ELIA,SIC,40-49,17,20,0,33,3,0,1,37,0,37,Sicilia,ITG1
2021-01-16,PF/BT,190306.0,PO S.ELIA,SIC,50-59,19,10,0,25,4,0,0,29,0,29,Sicilia,ITG1
2021-01-16,PF/BT,190306.0,PO S.ELIA,SIC,60-69,11,7,0,16,2,0,0,18,0,18,Sicilia,ITG1
2021-01-16,PF/BT,190306.0,PO S.ELIA,SIC,70-79,1,1,0,0,0,0,2,2,0,2,Sicilia,ITG1
2021-01-16,PF/BT,190306.0,PO S.ELIA,SIC,90+,1,0,0,1,0,0,0,1,0,1,Sicilia,ITG1
2021-01-16,PF/BT,190309.0,PO VITTORIO EMANUELE,SIC,16-19,1,1,0,0,0,0,2,2,0,2,Sicilia,ITG1
2021-01-16,PF/BT,190309.0,PO VITTORIO EMANUELE,SIC,20-29,8,3,0,4,0,0,7,11,0,11,Sicilia,ITG1
2021-01-16,PF/BT,190309.0,PO VITTORIO EMANUELE,SIC,30-39,6,8,0,7,0,0,7,14,0,14,Sicilia,ITG1
2021-01-16,PF/BT,190309.0,PO VITTORIO EMANUELE,SIC,40-49,1,8,0,5,0,0,4,9,0,9,Sicilia,ITG1
2021-01-16,PF/BT,190309.0,PO VITTORIO EMANUELE,SIC,50-59,4,3,0,4,0,0,3,7,0,7,Sicilia,ITG1
2021-01-16,PF/BT,190309.0,PO VITTORIO EMANUELE,SIC,60-69,2,1,0,3,0,0,0,3,0,3,Sicilia,ITG1
2021-01-16,PF/BT,190312.0,P.O. SANTA MARTA E SANTA VENERA,SIC,20-29,4,6,0,7,3,0,0,10,0,10,Sicilia,ITG1
2021-01-16,PF/BT,190312.0,P.O. SANTA MARTA E SANTA VENERA,SIC,30-39,5,16,0,13,8,0,0,21,0,21,Sicilia,ITG1
2021-01-16,PF/BT,190312.0,P.O. SANTA MARTA E SANTA VENERA,SIC,40-49,9,31,0,29,11,0,0,40,0,40,Sicilia,ITG1
2021-01-16,PF/BT,190312.0,P.O. SANTA MARTA E SANTA VENERA,SIC,50-59,10,38,0,43,5,0,0,48,0,48,Sicilia,ITG1
2021-01-16,PF/BT,190312.0,P.O. SANTA MARTA E SANTA VENERA,SIC,60-69,11,25,0,36,0,0,0,36,0,36,Sicilia,ITG1
2021-01-16,PF/BT,190312.0,P.O. SANTA MARTA E SANTA VENERA,SIC,70-79,1,0,0,1,0,0,0,1,0,1,Sicilia,ITG1
2021-01-16,PF/BT,190313.0,"P.O. ""S.GIOVANNI DI DIO E S. ISIDORO"" - GIARRE",SIC,20-29,3,6,0,8,1,0,0,9,0,9,Sicilia,ITG1
2021-01-16,PF/BT,190313.0,"P.O. ""S.GIOVANNI DI DIO E S. ISIDORO"" - GIARRE",SIC,30-39,8,19,0,15,9,0,3,27,0,27,Sicilia,ITG1
2021-01-16,PF/BT,190313.0,"P.O. ""S.GIOVANNI DI DIO E S. ISIDORO"" - GIARRE",SIC,40-49,9,22,0,18,9,0,4,31,0,31,Sicilia,ITG1
2021-01-16,PF/BT,190313.0,"P.O. ""S.GIOVANNI DI DIO E S. ISIDORO"" - GIARRE",SIC,50-59,12,14,0,15,9,0,2,26,0,26,Sicilia,ITG1
2021-01-16,PF/BT,190313.0,"P.O. ""S.GIOVANNI DI DIO E S. ISIDORO"" - GIARRE",SIC,60-69,8,6,0,7,5,0,2,14,0,14,Sicilia,ITG1
2021-01-16,PF/BT,190313.0,"P.O. ""S.GIOVANNI DI DIO E S. ISIDORO"" - GIARRE",SIC,70-79,1,0,0,1,0,0,0,1,0,1,Sicilia,ITG1
2021-01-16,PF/BT,190314.0,P.O. MARIA SS. ADDOLORATA - BIANCAVILLA (CT),SIC,16-19,1,1,0,2,0,0,0,2,0,2,Sicilia,ITG1
2021-01-16,PF/BT,190314.0,P.O. MARIA SS. ADDOLORATA - BIANCAVILLA (CT),SIC,20-29,5,6,0,11,0,0,0,11,0,11,Sicilia,ITG1
2021-01-16,PF/BT,190314.0,P.O. MARIA SS. ADDOLORATA - BIANCAVILLA (CT),SIC,30-39,3,9,0,11,1,0,0,12,0,12,Sicilia,ITG1
2021-01-16,PF/BT,190314.0,P.O. MARIA SS. ADDOLORATA - BIANCAVILLA (CT),SIC,40-49,6,29,0,33,2,0,0,35,0,35,Sicilia,ITG1
2021-01-16,PF/BT,190314.0,P.O. MARIA SS. ADDOLORATA - BIANCAVILLA (CT),SIC,50-59,8,30,0,28,10,0,0,38,0,38,Sicilia,ITG1
2021-01-16,PF/BT,190314.0,P.O. MARIA SS. ADDOLORATA - BIANCAVILLA (CT),SIC,60-69,6,6,0,9,3,0,0,12,0,12,Sicilia,ITG1
2021-01-16,PF/BT,190314.0,P.O. MARIA SS. ADDOLORATA - BIANCAVILLA (CT),SIC,70-79,0,3,0,0,3,0,0,3,0,3,Sicilia,ITG1
2021-01-16,PF/BT,190314.0,P.O. MARIA SS. ADDOLORATA - BIANCAVILLA (CT),SIC,80-89,0,1,0,0,1,0,0,1,0,1,Sicilia,ITG1
2021-01-16,PF/BT,190316.0,PRESIDIO OSPEDALIERO SANTISSIMO SALVATORE - PATERNO' (CT),SIC,16-19,0,2,0,1,1,0,0,2,0,2,Sicilia,ITG1
2021-01-16,PF/BT,190316.0,PRESIDIO OSPEDALIERO SANTISSIMO SALVATORE - PATERNO' (CT),SIC,20-29,6,7,0,8,5,0,0,13,0,13,Sicilia,ITG1
2021-01-16,PF/BT,190316.0,PRESIDIO OSPEDALIERO SANTISSIMO SALVATORE - PATERNO' (CT),SIC,30-39,8,12,0,14,6,0,0,20,0,20,Sicilia,ITG1
2021-01-16,PF/BT,190316.0,PRESIDIO OSPEDALIERO SANTISSIMO SALVATORE - PATERNO' (CT),SIC,40-49,7,14,0,13,8,0,0,21,0,21,Sicilia,ITG1
2021-01-16,PF/BT,190316.0,PRESIDIO OSPEDALIERO SANTISSIMO SALVATORE - PATERNO' (CT),SIC,50-59,7,19,0,20,6,0,0,26,0,26,Sicilia,ITG1
2021-01-16,PF/BT,190316.0,PRESIDIO OSPEDALIERO SANTISSIMO SALVATORE - PATERNO' (CT),SIC,60-69,6,7,0,10,3,0,0,13,0,13,Sicilia,ITG1
2021-01-16,PF/BT,190316.0,PRESIDIO OSPEDALIERO SANTISSIMO SALVATORE - PATERNO' (CT),SIC,70-79,0,1,0,1,0,0,0,1,0,1,Sicilia,ITG1
2021-01-16,PF/BT,190317.0,P.O. CALTAGIRONE,SIC,20-29,2,3,0,0,2,0,3,5,0,5,Sicilia,ITG1
2021-01-16,PF/BT,190317.0,P.O. CALTAGIRONE,SIC,30-39,2,2,0,2,1,0,1,4,0,4,Sicilia,ITG1
2021-01-16,PF/BT,190317.0,P.O. CALTAGIRONE,SIC,40-49,4,5,0,1,4,0,4,9,0,9,Sicilia,ITG1
2021-01-16,PF/BT,190317.0,P.O. CALTAGIRONE,SIC,50-59,1,0,0,0,1,0,0,1,0,1,Sicilia,ITG1
2021-01-16,PF/BT,190317.0,P.O. CALTAGIRONE,SIC,60-69,1,3,0,1,0,1,2,4,0,4,Sicilia,ITG1
2021-01-16,PF/BT,190317.0,P.O. CALTAGIRONE,SIC,70-79,1,0,0,0,1,0,0,1,0,1,Sicilia,ITG1
2021-01-16,PF/BT,190319.0,P.O. UMBERTO I DI ENNA,SIC,20-29,7,6,0,1,12,0,0,13,0,13,Sicilia,ITG1
2021-01-16,PF/BT,190319.0,P.O. UMBERTO I DI ENNA,SIC,30-39,7,6,0,3,10,0,0,13,0,13,Sicilia,ITG1
2021-01-16,PF/BT,190319.0,P.O. UMBERTO I DI ENNA,SIC,40-49,7,5,0,5,7,0,0,12,0,12,Sicilia,ITG1
2021-01-16,PF/BT,190319.0,P.O. UMBERTO I DI ENNA,SIC,50-59,4,8,0,9,3,0,0,12,0,12,Sicilia,ITG1
2021-01-16,PF/BT,190319.0,P.O. UMBERTO I DI ENNA,SIC,60-69,16,11,0,23,4,0,0,27,0,27,Sicilia,ITG1
2021-01-16,PF/BT,190319.0,P.O. UMBERTO I DI ENNA,SIC,70-79,1,0,0,1,0,0,0,1,0,1,Sicilia,ITG1
2021-01-16,PF/BT,190330.0,P.O. DEI BIANCHI CORLEONE,SIC,20-29,0,4,0,3,0,0,1,4,0,4,Sicilia,ITG1
2021-01-16,PF/BT,190330.0,P.O. DEI BIANCHI CORLEONE,SIC,30-39,0,5,0,2,3,0,0,5,0,5,Sicilia,ITG1
2021-01-16,PF/BT,190330.0,P.O. DEI BIANCHI CORLEONE,SIC,40-49,5,10,0,8,4,0,3,15,0,15,Sicilia,ITG1
2021-01-16,PF/BT,190330.0,P.O. DEI BIANCHI CORLEONE,SIC,50-59,3,11,0,11,3,0,0,14,0,14,Sicilia,ITG1
2021-01-16,PF/BT,190330.0,P.O. DEI BIANCHI CORLEONE,SIC,60-69,5,1,0,4,2,0,0,6,0,6,Sicilia,ITG1
2021-01-16,PF/BT,190330.0,P.O. DEI BIANCHI CORLEONE,SIC,70-79,5,4,0,4,2,0,3,9,0,9,Sicilia,ITG1
2021-01-16,PF/BT,190330.0,P.O. DEI BIANCHI CORLEONE,SIC,80-89,0,1,0,0,0,0,1,1,0,1,Sicilia,ITG1
2021-01-16,PF/BT,190334.0,P.O. S. CIMINO TERMINI IMERESE,SIC,16-19,1,0,0,1,0,0,0,1,0,1,Sicilia,ITG1
2021-01-16,PF/BT,190334.0,P.O. S. CIMINO TERMINI IMERESE,SIC,20-29,3,4,0,6,1,0,0,7,0,7,Sicilia,ITG1
2021-01-16,PF/BT,190334.0,P.O. S. CIMINO TERMINI IMERESE,SIC,30-39,9,9,0,18,0,0,0,18,0,18,Sicilia,ITG1
2021-01-16,PF/BT,190334.0,P.O. S. CIMINO TERMINI IMERESE,SIC,40-49,9,12,0,17,4,0,0,21,0,21,Sicilia,ITG1
2021-01-16,PF/BT,190334.0,P.O. S. CIMINO TERMINI IMERESE,SIC,50-59,7,7,0,10,4,0,0,14,0,14,Sicilia,ITG1
2021-01-16,PF/BT,190334.0,P.O. S. CIMINO TERMINI IMERESE,SIC,60-69,11,5,0,15,1,0,0,16,0,16,Sicilia,ITG1
2021-01-16,PF/BT,190334.0,P.O. S. CIMINO TERMINI IMERESE,SIC,70-79,3,0,0,2,1,0,0,3,0,3,Sicilia,ITG1
2021-01-16,PF/BT,190335.0,G.F.Ingrassia,SIC,20-29,0,1,0,1,0,0,0,1,0,1,Sicilia,ITG1
2021-01-16,PF/BT,190335.0,G.F.Ingrassia,SIC,30-39,4,1,0,5,0,0,0,5,0,5,Sicilia,ITG1
2021-01-16,PF/BT,190335.0,G.F.Ingrassia,SIC,40-49,3,4,0,7,0,0,0,7,0,7,Sicilia,ITG1
2021-01-16,PF/BT,190335.0,G.F.Ingrassia,SIC,50-59,3,5,0,6,0,0,2,8,0,8,Sicilia,ITG1
2021-01-16,PF/BT,190335.0,G.F.Ingrassia,SIC,60-69,5,2,0,7,0,0,0,7,0,7,Sicilia,ITG1
2021-01-16,PF/BT,190335.0,G.F.Ingrassia,SIC,70-79,2,0,0,2,0,0,0,2,0,2,Sicilia,ITG1
2021-01-16,PF/BT,190337.0,P.O. VILLA DELLE GINESTRE,SIC,16-19,1,0,0,1,0,0,0,1,0,1,Sicilia,ITG1
2021-01-16,PF/BT,190337.0,P.O. VILLA DELLE GINESTRE,SIC,20-29,5,11,0,11,4,0,1,16,0,16,Sicilia,ITG1
2021-01-16,PF/BT,190337.0,P.O. VILLA DELLE GINESTRE,SIC,30-39,13,13,0,16,8,0,2,26,0,26,Sicilia,ITG1
2021-01-16,PF/BT,190337.0,P.O. VILLA DELLE GINESTRE,SIC,40-49,22,19,0,20,16,0,5,41,0,41,Sicilia,ITG1
2021-01-16,PF/BT,190337.0,P.O. VILLA DELLE GINESTRE,SIC,50-59,13,27,0,22,14,0,4,40,0,40,Sicilia,ITG1
2021-01-16,PF/BT,190337.0,P.O. VILLA DELLE GINESTRE,SIC,60-69,17,25,0,33,6,0,3,42,0,42,Sicilia,ITG1
2021-01-16,PF/BT,190337.0,P.O. VILLA DELLE GINESTRE,SIC,70-79,6,4,0,9,1,0,0,10,0,10,Sicilia,ITG1
2021-01-16,PF/BT,190520.0,Centro Catanese di Medicina,SIC,20-29,1,3,0,4,0,0,0,4,0,4,Sicilia,ITG1
2021-01-16,PF/BT,190520.0,Centro Catanese di Medicina,SIC,30-39,6,1,0,7,0,0,0,7,0,7,Sicilia,ITG1
2021-01-16,PF/BT,190520.0,Centro Catanese di Medicina,SIC,40-49,5,4,0,7,2,0,0,9,0,9,Sicilia,ITG1
2021-01-16,PF/BT,190520.0,Centro Catanese di Medicina,SIC,50-59,2,3,0,2,3,0,0,5,0,5,Sicilia,ITG1
2021-01-16,PF/BT,190520.0,Centro Catanese di Medicina,SIC,60-69,3,1,0,3,1,0,0,4,0,4,Sicilia,ITG1
2021-01-16,PF/BT,190520.0,Centro Catanese di Medicina,SIC,70-79,0,1,0,0,1,0,0,1,0,1,Sicilia,ITG1
2021-01-16,PF/BT,190533.0,CASA DI CURA CANDELA SPA,SIC,20-29,1,0,0,0,0,0,1,1,0,1,Sicilia,ITG1
2021-01-16,PF/BT,190533.0,CASA DI CURA CANDELA SPA,SIC,30-39,1,2,0,2,1,0,0,3,0,3,Sicilia,ITG1
2021-01-16,PF/BT,190533.0,CASA DI CURA CANDELA SPA,SIC,40-49,0,3,0,2,1,0,0,3,0,3,Sicilia,ITG1
2021-01-16,PF/BT,190533.0,CASA DI CURA CANDELA SPA,SIC,50-59,1,1,0,1,1,0,0,2,0,2,Sicilia,ITG1
2021-01-16,PF/BT,190533.0,CASA DI CURA CANDELA SPA,SIC,60-69,1,0,0,1,0,0,0,1,0,1,Sicilia,ITG1
2021-01-16,PF/BT,190533.0,CASA DI CURA CANDELA SPA,SIC,80-89,1,1,0,0,0,2,0,2,0,2,Sicilia,ITG1
2021-01-16,PF/BT,190537.0,CASA DI CURA SERENA S.P.A.,SIC,20-29,2,1,0,1,0,0,2,3,0,3,Sicilia,ITG1
2021-01-16,PF/BT,190537.0,CASA DI CURA SERENA S.P.A.,SIC,30-39,0,2,0,1,0,0,1,2,0,2,Sicilia,ITG1
2021-01-16,PF/BT,190537.0,CASA DI CURA SERENA S.P.A.,SIC,40-49,2,0,0,0,0,0,2,2,0,2,Sicilia,ITG1
2021-01-16,PF/BT,190537.0,CASA DI CURA SERENA S.P.A.,SIC,50-59,2,4,0,1,1,0,4,6,0,6,Sicilia,ITG1
2021-01-16,PF/BT,190537.0,CASA DI CURA SERENA S.P.A.,SIC,60-69,2,0,0,0,0,0,2,2,0,2,Sicilia,ITG1
2021-01-16,PF/BT,190537.0,CASA DI CURA SERENA S.P.A.,SIC,70-79,1,2,0,1,0,0,2,3,0,3,Sicilia,ITG1
2021-01-16,PF/BT,190538.0,CASA DI CURA NOTO PASQUALINO S.R.L.,SIC,20-29,1,0,0,1,0,0,0,1,0,1,Sicilia,ITG1
2021-01-16,PF/BT,190538.0,CASA DI CURA NOTO PASQUALINO S.R.L.,SIC,30-39,1,1,0,0,2,0,0,2,0,2,Sicilia,ITG1
2021-01-16,PF/BT,190538.0,CASA DI CURA NOTO PASQUALINO S.R.L.,SIC,40-49,4,2,0,5,1,0,0,6,0,6,Sicilia,ITG1
2021-01-16,PF/BT,190538.0,CASA DI CURA NOTO PASQUALINO S.R.L.,SIC,50-59,2,3,0,4,1,0,0,5,0,5,Sicilia,ITG1
2021-01-16,PF/BT,190538.0,CASA DI CURA NOTO PASQUALINO S.R.L.,SIC,60-69,0,1,0,0,1,0,0,1,0,1,Sicilia,ITG1
2021-01-16,PF/BT,190538.0,CASA DI CURA NOTO PASQUALINO S.R.L.,SIC,70-79,3,0,0,0,3,0,0,3,0,3,Sicilia,ITG1
2021-01-16,PF/BT,190551.0,CASA DI CURA LA MADDALENA S.P.A.,SIC,20-29,1,7,0,6,0,0,2,8,0,8,Sicilia,ITG1
2021-01-16,PF/BT,190551.0,CASA DI CURA LA MADDALENA S.P.A.,SIC,30-39,11,10,0,6,5,0,10,21,0,21,Sicilia,ITG1
2021-01-16,PF/BT,190551.0,CASA DI CURA LA MADDALENA S.P.A.,SIC,40-49,15,21,0,3,14,0,19,36,0,36,Sicilia,ITG1
2021-01-16,PF/BT,190551.0,CASA DI CURA LA MADDALENA S.P.A.,SIC,50-59,11,13,0,8,6,0,10,24,0,24,Sicilia,ITG1
2021-01-16,PF/BT,190551.0,CASA DI CURA LA MADDALENA S.P.A.,SIC,60-69,3,0,0,2,0,0,1,3,0,3,Sicilia,ITG1
2021-01-16,PF/BT,190551.0,CASA DI CURA LA MADDALENA S.P.A.,SIC,70-79,3,0,0,0,1,0,2,3,0,3,Sicilia,ITG1
2021-01-16,PF/BT,190551.0,CASA DI CURA LA MADDALENA S.P.A.,SIC,80-89,1,0,0,0,0,0,1,1,0,1,Sicilia,ITG1
2021-01-16,PF/BT,1907180.0,Casa di Cura Latteri di Valsalva,SIC,20-29,2,0,0,2,0,0,0,2,0,2,Sicilia,ITG1
2021-01-16,PF/BT,1907180.0,Casa di Cura Latteri di Valsalva,SIC,30-39,0,3,0,2,1,0,0,3,0,3,Sicilia,ITG1
2021-01-16,PF/BT,1907180.0,Casa di Cura Latteri di Valsalva,SIC,40-49,2,3,0,5,0,0,0,5,0,5,Sicilia,ITG1
2021-01-16,PF/BT,1907180.0,Casa di Cura Latteri di Valsalva,SIC,50-59,7,2,0,7,2,0,0,9,0,9,Sicilia,ITG1
2021-01-16,PF/BT,1907180.0,Casa di Cura Latteri di Valsalva,SIC,60-69,2,2,0,3,1,0,0,4,0,4,Sicilia,ITG1
2021-01-16,PF/BT,1907180.0,Casa di Cura Latteri di Valsalva,SIC,70-79,2,0,0,2,0,0,0,2,0,2,Sicilia,ITG1
2021-01-16,PF/BT,190921.0,Azienda Ospedaliera per l'Emergenza Cannizzaro,SIC,30-39,2,1,0,0,3,0,0,3,0,3,Sicilia,ITG1
2021-01-16,PF/BT,190921.0,Azienda Ospedaliera per l'Emergenza Cannizzaro,SIC,40-49,6,4,0,4,6,0,0,10,0,10,Sicilia,ITG1
2021-01-16,PF/BT,190921.0,Azienda Ospedaliera per l'Emergenza Cannizzaro,SIC,50-59,5,6,0,7,4,0,0,11,0,11,Sicilia,ITG1
2021-01-16,PF/BT,190921.0,Azienda Ospedaliera per l'Emergenza Cannizzaro,SIC,60-69,2,3,0,1,4,0,0,5,0,5,Sicilia,ITG1
2021-01-16,PF/BT,190921.0,Azienda Ospedaliera per l'Emergenza Cannizzaro,SIC,70-79,0,1,0,0,1,0,0,1,0,1,Sicilia,ITG1
2021-01-16,PF/BT,19092201.0,ARNAS GARIBALDI P. O. CENTRO,SIC,20-29,1,0,0,0,0,0,1,1,0,1,Sicilia,ITG1
2021-01-16,PF/BT,19092201.0,ARNAS GARIBALDI P. O. CENTRO,SIC,30-39,2,1,0,0,0,0,3,3,0,3,Sicilia,ITG1
2021-01-16,PF/BT,19092201.0,ARNAS GARIBALDI P. O. CENTRO,SIC,40-49,7,0,0,0,0,0,7,7,0,7,Sicilia,ITG1
2021-01-16,PF/BT,19092201.0,ARNAS GARIBALDI P. O. CENTRO,SIC,50-59,4,2,0,2,0,0,4,6,0,6,Sicilia,ITG1
2021-01-16,PF/BT,19092201.0,ARNAS GARIBALDI P. O. CENTRO,SIC,60-69,1,0,0,0,0,0,1,1,0,1,Sicilia,ITG1
2021-01-16,PF/BT,19092204.0,ARNAS GARIBALDI P. O. NESIMA,SIC,30-39,1,3,0,3,1,0,0,4,0,4,Sicilia,ITG1
2021-01-16,PF/BT,19092204.0,ARNAS GARIBALDI P. O. NESIMA,SIC,40-49,4,2,0,3,3,0,0,6,0,6,Sicilia,ITG1
2021-01-16,PF/BT,19092204.0,ARNAS GARIBALDI P. O. NESIMA,SIC,50-59,8,1,0,1,8,0,0,9,0,9,Sicilia,ITG1
2021-01-16,PF/BT,19092204.0,ARNAS GARIBALDI P. O. NESIMA,SIC,60-69,3,1,0,1,3,0,0,4,0,4,Sicilia,ITG1
2021-01-16,PF/BT,19092204.0,ARNAS GARIBALDI P. O. NESIMA,SIC,70-79,1,0,0,0,1,0,0,1,0,1,Sicilia,ITG1
2021-01-16,PF/BT,190925.0,A.O.U. Policlinico G.Martino,SIC,16-19,0,8,0,0,0,0,8,8,0,8,Sicilia,ITG1
2021-01-16,PF/BT,190925.0,A.O.U. Policlinico G.Martino,SIC,20-29,82,197,0,3,0,0,276,279,0,279,Sicilia,ITG1
2021-01-16,PF/BT,190925.0,A.O.U. Policlinico G.Martino,SIC,30-39,12,9,0,1,0,0,20,21,0,21,Sicilia,ITG1
2021-01-16,PF/BT,190925.0,A.O.U. Policlinico G.Martino,SIC,40-49,4,11,0,3,0,0,12,15,0,15,Sicilia,ITG1
2021-01-16,PF/BT,190925.0,A.O.U. Policlinico G.Martino,SIC,50-59,2,2,0,3,0,0,1,4,0,4,Sicilia,ITG1
2021-01-16,PF/BT,190925.0,A.O.U. Policlinico G.Martino,SIC,60-69,2,1,0,2,0,0,1,3,0,3,Sicilia,ITG1
2021-01-16,PF/BT,190928.0,AZ.OSP.UNIV.P.GIACCONE,SIC,20-29,31,56,0,46,1,0,40,87,0,87,Sicilia,ITG1
2021-01-16,PF/BT,190928.0,AZ.OSP.UNIV.P.GIACCONE,SIC,30-39,5,12,0,8,2,0,7,17,0,17,Sicilia,ITG1
2021-01-16,PF/BT,190928.0,AZ.OSP.UNIV.P.GIACCONE,SIC,40-49,9,9,0,11,0,0,7,18,0,18,Sicilia,ITG1
2021-01-16,PF/BT,190928.0,AZ.OSP.UNIV.P.GIACCONE,SIC,50-59,7,7,0,6,7,0,1,14,0,14,Sicilia,ITG1
2021-01-16,PF/BT,190928.0,AZ.OSP.UNIV.P.GIACCONE,SIC,60-69,3,2,0,2,2,0,1,5,0,5,Sicilia,ITG1
2021-01-16,PF/BT,190928.0,AZ.OSP.UNIV.P.GIACCONE,SIC,80-89,1,0,0,1,0,0,0,1,0,1,Sicilia,ITG1
2021-01-16,PF/BT,608200.0,PTA SAN GIORGIO,SIC,20-29,5,5,0,6,4,0,0,10,0,10,Sicilia,ITG1
2021-01-16,PF/BT,608200.0,PTA SAN GIORGIO,SIC,30-39,6,10,0,12,4,0,0,16,0,16,Sicilia,ITG1
2021-01-16,PF/BT,608200.0,PTA SAN GIORGIO,SIC,40-49,6,13,0,13,6,0,0,19,0,19,Sicilia,ITG1
2021-01-16,PF/BT,608200.0,PTA SAN GIORGIO,SIC,50-59,4,8,0,6,6,0,0,12,0,12,Sicilia,ITG1
2021-01-16,PF/BT,608200.0,PTA SAN GIORGIO,SIC,60-69,2,8,0,6,4,0,0,10,0,10,Sicilia,ITG1
2021-01-16,PF/BT,608200.0,PTA SAN GIORGIO,SIC,70-79,4,1,0,3,2,0,0,5,0,5,Sicilia,ITG1
2021-01-16,PF/BT,608400.0,PTA CORLEONE,SIC,40-49,0,3,0,3,0,0,0,3,0,3,Sicilia,ITG1
2021-01-16,PF/BT,608400.0,PTA CORLEONE,SIC,50-59,0,4,0,3,0,1,0,4,0,4,Sicilia,ITG1
2021-01-16,PF/BT,608400.0,PTA CORLEONE,SIC,60-69,1,2,0,2,0,1,0,3,0,3,Sicilia,ITG1
2021-01-16,PF/BT,608400.0,PTA CORLEONE,SIC,70-79,0,3,0,0,0,3,0,3,0,3,Sicilia,ITG1
2021-01-16,PF/BT,608400.0,PTA CORLEONE,SIC,80-89,0,17,0,0,0,17,0,17,0,17,Sicilia,ITG1
2021-01-16,PF/BT,608400.0,PTA CORLEONE,SIC,90+,0,6,0,0,0,6,0,6,0,6,Sicilia,ITG1
2021-01-16,PF/BT,608400.0,PTA S. Luigi,SIC,20-29,3,4,0,6,1,0,0,7,0,7,Sicilia,ITG1
2021-01-16,PF/BT,608400.0,PTA S. Luigi,SIC,30-39,5,2,0,6,1,0,0,7,0,7,Sicilia,ITG1
2021-01-16,PF/BT,608400.0,PTA S. Luigi,SIC,40-49,10,2,0,5,7,0,0,12,0,12,Sicilia,ITG1
2021-01-16,PF/BT,608400.0,PTA S. Luigi,SIC,50-59,10,13,0,11,12,0,0,23,0,23,Sicilia,ITG1
2021-01-16,PF/BT,608400.0,PTA S. Luigi,SIC,60-69,7,8,0,13,2,0,0,15,0,15,Sicilia,ITG1
2021-01-16,PF/BT,608400.0,PTA S. Luigi,SIC,70-79,2,0,0,2,0,0,0,2,0,2,Sicilia,ITG1
2021-01-16,PF/BT,809200.0,CTA CENTRO S.PAOLO,SIC,20-29,1,0,0,0,0,0,1,1,0,1,Sicilia,ITG1
2021-01-16,PF/BT,809200.0,CTA CENTRO S.PAOLO,SIC,30-39,2,1,0,0,1,0,2,3,0,3,Sicilia,ITG1
2021-01-16,PF/BT,809200.0,CTA CENTRO S.PAOLO,SIC,40-49,4,3,0,0,0,0,7,7,0,7,Sicilia,ITG1
2021-01-16,PF/BT,809200.0,CTA CENTRO S.PAOLO,SIC,50-59,8,4,0,0,1,0,11,12,0,12,Sicilia,ITG1
2021-01-16,PF/BT,809200.0,CTA CENTRO S.PAOLO,SIC,60-69,4,1,0,0,1,0,4,5,0,5,Sicilia,ITG1
2021-01-16,PF/BT,809200.0,CTA CENTRO S.PAOLO,SIC,70-79,1,1,0,0,0,0,2,2,0,2,Sicilia,ITG1
2021-01-16,PF/BT,820500.0,CTA CAPPUCCINI,SIC,20-29,1,1,0,0,2,0,0,2,0,2,Sicilia,ITG1
2021-01-16,PF/BT,820500.0,CTA CAPPUCCINI,SIC,30-39,3,6,0,3,1,0,5,9,0,9,Sicilia,ITG1
2021-01-16,PF/BT,820500.0,CTA CAPPUCCINI,SIC,40-49,9,3,0,3,3,0,6,12,0,12,Sicilia,ITG1
2021-01-16,PF/BT,820500.0,CTA CAPPUCCINI,SIC,50-59,7,8,0,0,3,0,12,15,0,15,Sicilia,ITG1
2021-01-16,PF/BT,820500.0,CTA CAPPUCCINI,SIC,60-69,3,3,0,0,0,0,6,6,0,6,Sicilia,ITG1
2021-01-16,PF/BT,820500.0,CTA CAPPUCCINI,SIC,70-79,2,1,0,0,0,0,3,3,0,3,Sicilia,ITG1
2021-01-16,PF/BT,820500.0,CTA CAPPUCCINI,SIC,80-89,1,0,0,0,0,0,1,1,0,1,Sicilia,ITG1
2021-01-17,PF/BT,1902027.0,AZZURRA,SIC,50-59,1,0,0,1,0,0,0,1,0,1,Sicilia,ITG1
2021-01-17,PF/BT,1902027.0,AZZURRA,SIC,60-69,1,0,0,0,0,1,0,1,0,1,Sicilia,ITG1
2021-01-17,PF/BT,1902027.0,AZZURRA,SIC,70-79,3,1,0,0,0,4,0,4,0,4,Sicilia,ITG1
2021-01-17,PF/BT,1902027.0,FONDAZIONEBURGIO,SIC,40-49,0,3,0,0,0,0,3,3,0,3,Sicilia,ITG1
2021-01-17,PF/BT,1902027.0,FONDAZIONEBURGIO,SIC,50-59,0,2,0,0,0,0,2,2,0,2,Sicilia,ITG1
2021-01-17,PF/BT,1902027.0,FONDAZIONEBURGIO,SIC,70-79,0,2,0,0,0,1,1,2,0,2,Sicilia,ITG1
2021-01-17,PF/BT,1902027.0,FONDAZIONEBURGIO,SIC,80-89,0,6,0,0,0,4,2,6,0,6,Sicilia,ITG1
2021-01-17,PF/BT,1902027.0,FONDAZIONEBURGIO,SIC,90+,0,2,0,0,0,2,0,2,0,2,Sicilia,ITG1
2021-01-17,PF/BT,1902027.0,SANTANTONIO,SIC,30-39,0,1,0,0,0,0,1,1,0,1,Sicilia,ITG1
2021-01-17,PF/BT,1902027.0,SANTANTONIO,SIC,40-49,0,2,0,0,0,0,2,2,0,2,Sicilia,ITG1
2021-01-17,PF/BT,1902027.0,SANTANTONIO,SIC,50-59,0,3,0,0,0,0,3,3,0,3,Sicilia,ITG1
2021-01-17,PF/BT,1902027.0,SANTANTONIO,SIC,70-79,0,3,0,0,0,0,3,3,0,3,Sicilia,ITG1
2021-01-17,PF/BT,1902027.0,SANTANTONIO,SIC,80-89,0,5,0,0,0,0,5,5,0,5,Sicilia,ITG1
2021-01-17,PF/BT,1902027.0,SANTANTONIO,SIC,90+,0,9,0,0,0,0,9,9,0,9,Sicilia,ITG1
2021-01-17,PF/BT,190205.0,CITTADELLA DELLA SALUTE,SIC,20-29,3,6,0,9,0,0,0,9,0,9,Sicilia,ITG1
2021-01-17,PF/BT,190205.0,CITTADELLA DELLA SALUTE,SIC,30-39,13,15,0,25,2,0,1,28,0,28,Sicilia,ITG1
2021-01-17,PF/BT,190205.0,CITTADELLA DELLA SALUTE,SIC,40-49,20,23,0,43,0,0,0,43,0,43,Sicilia,ITG1
2021-01-17,PF/BT,190205.0,CITTADELLA DELLA SALUTE,SIC,50-59,15,8,0,21,1,0,1,23,0,23,Sicilia,ITG1
2021-01-17,PF/BT,190205.0,CITTADELLA DELLA SALUTE,SIC,60-69,29,19,0,46,1,0,1,46,2,48,Sicilia,ITG1
2021-01-17,PF/BT,190205.0,CITTADELLA DELLA SALUTE,SIC,70-79,16,5,0,18,0,0,3,21,0,21,Sicilia,ITG1
2021-01-17,PF/BT,190205.0,CITTADELLA DELLA SALUTE,SIC,80-89,2,0,0,0,0,0,2,2,0,2,Sicilia,ITG1
2021-01-17,PF/BT,190205.0,CITTADELLA DELLA SALUTE,SIC,90+,1,0,0,0,0,0,1,1,0,1,Sicilia,ITG1
2021-01-17,PF/BT,1902087.0,AZIENDA SANITARIA PROVINCIALE DI SIRACUSA,SIC,20-29,5,3,0,0,7,1,0,8,0,8,Sicilia,ITG1
2021-01-17,PF/BT,1902087.0,AZIENDA SANITARIA PROVINCIALE DI SIRACUSA,SIC,30-39,8,6,0,0,12,2,0,14,0,14,Sicilia,ITG1
2021-01-17,PF/BT,1902087.0,AZIENDA SANITARIA PROVINCIALE DI SIRACUSA,SIC,40-49,7,7,0,0,10,4,0,14,0,14,Sicilia,ITG1
2021-01-17,PF/BT,1902087.0,AZIENDA SANITARIA PROVINCIALE DI SIRACUSA,SIC,50-59,3,8,0,0,8,3,0,11,0,11,Sicilia,ITG1
2021-01-17,PF/BT,1902087.0,AZIENDA SANITARIA PROVINCIALE DI SIRACUSA,SIC,60-69,5,6,0,0,2,9,0,11,0,11,Sicilia,ITG1
2021-01-17,PF/BT,1902087.0,AZIENDA SANITARIA PROVINCIALE DI SIRACUSA,SIC,70-79,4,8,0,0,0,12,0,12,0,12,Sicilia,ITG1
2021-01-17,PF/BT,1902087.0,AZIENDA SANITARIA PROVINCIALE DI SIRACUSA,SIC,80-89,11,28,0,0,1,38,0,39,0,39,Sicilia,ITG1
2021-01-17,PF/BT,1902087.0,AZIENDA SANITARIA PROVINCIALE DI SIRACUSA,SIC,90+,6,15,0,0,0,21,0,21,0,21,Sicilia,ITG1
2021-01-17,PF/BT,190306.0,PO S.ELIA,SIC,16-19,0,1,0,0,0,0,1,1,0,1,Sicilia,ITG1
2021-01-17,PF/BT,190306.0,PO S.ELIA,SIC,20-29,7,12,0,10,2,0,7,19,0,19,Sicilia,ITG1
2021-01-17,PF/BT,190306.0,PO S.ELIA,SIC,30-39,7,12,0,10,5,0,4,19,0,19,Sicilia,ITG1
2021-01-17,PF/BT,190306.0,PO S.ELIA,SIC,40-49,5,10,0,8,1,0,6,15,0,15,Sicilia,ITG1
2021-01-17,PF/BT,190306.0,PO S.ELIA,SIC,50-59,4,6,0,3,2,0,5,10,0,10,Sicilia,ITG1
2021-01-17,PF/BT,190306.0,PO S.ELIA,SIC,60-69,8,3,0,7,2,0,2,11,0,11,Sicilia,ITG1
2021-01-17,PF/BT,190306.0,PO S.ELIA,SIC,70-79,5,1,0,4,0,0,2,6,0,6,Sicilia,ITG1
2021-01-17,PF/BT,190306.0,PO S.ELIA,SIC,80-89,1,0,0,1,0,0,0,1,0,1,Sicilia,ITG1
2021-01-17,PF/BT,190309.0,PO VITTORIO EMANUELE,SIC,20-29,1,2,0,3,0,0,0,3,0,3,Sicilia,ITG1
2021-01-17,PF/BT,190309.0,PO VITTORIO EMANUELE,SIC,30-39,3,1,0,3,0,0,1,4,0,4,Sicilia,ITG1
2021-01-17,PF/BT,190309.0,PO VITTORIO EMANUELE,SIC,40-49,3,1,0,2,0,0,2,4,0,4,Sicilia,ITG1
2021-01-17,PF/BT,190309.0,PO VITTORIO EMANUELE,SIC,50-59,3,5,0,7,0,0,1,8,0,8,Sicilia,ITG1
2021-01-17,PF/BT,190309.0,PO VITTORIO EMANUELE,SIC,60-69,3,2,0,5,0,0,0,5,0,5,Sicilia,ITG1
2021-01-17,PF/BT,190313.0,"P.O. ""S.GIOVANNI DI DIO E S. ISIDORO"" - GIARRE",SIC,16-19,0,2,0,2,0,0,0,2,0,2,Sicilia,ITG1
2021-01-17,PF/BT,190313.0,"P.O. ""S.GIOVANNI DI DIO E S. ISIDORO"" - GIARRE",SIC,20-29,4,2,0,6,0,0,0,6,0,6,Sicilia,ITG1
2021-01-17,PF/BT,190313.0,"P.O. ""S.GIOVANNI DI DIO E S. ISIDORO"" - GIARRE",SIC,30-39,6,14,0,14,6,0,0,20,0,20,Sicilia,ITG1
2021-01-17,PF/BT,190313.0,"P.O. ""S.GIOVANNI DI DIO E S. ISIDORO"" - GIARRE",SIC,40-49,6,20,0,18,8,0,0,26,0,26,Sicilia,ITG1
2021-01-17,PF/BT,190313.0,"P.O. ""S.GIOVANNI DI DIO E S. ISIDORO"" - GIARRE",SIC,50-59,7,25,0,28,4,0,0,32,0,32,Sicilia,ITG1
2021-01-17,PF/BT,190313.0,"P.O. ""S.GIOVANNI DI DIO E S. ISIDORO"" - GIARRE",SIC,60-69,4,10,0,10,4,0,0,14,0,14,Sicilia,ITG1
2021-01-17,PF/BT,190313.0,"P.O. ""S.GIOVANNI DI DIO E S. ISIDORO"" - GIARRE",SIC,70-79,1,1,0,1,1,0,0,2,0,2,Sicilia,ITG1
2021-01-17,PF/BT,190335.0,G.F.Ingrassia,SIC,20-29,0,2,0,2,0,0,0,2,0,2,Sicilia,ITG1
2021-01-17,PF/BT,190335.0,G.F.Ingrassia,SIC,30-39,1,3,0,2,1,0,1,4,0,4,Sicilia,ITG1
2021-01-17,PF/BT,190335.0,G.F.Ingrassia,SIC,40-49,4,3,0,5,0,0,2,7,0,7,Sicilia,ITG1
2021-01-17,PF/BT,190335.0,G.F.Ingrassia,SIC,50-59,1,4,0,3,0,0,2,5,0,5,Sicilia,ITG1
2021-01-17,PF/BT,190335.0,G.F.Ingrassia,SIC,60-69,6,3,0,8,0,0,1,9,0,9,Sicilia,ITG1
2021-01-17,PF/BT,190335.0,G.F.Ingrassia,SIC,70-79,2,4,0,4,0,0,2,6,0,6,Sicilia,ITG1
2021-01-17,PF/BT,190335.0,G.F.Ingrassia,SIC,80-89,3,0,0,3,0,0,0,3,0,3,Sicilia,ITG1
2021-01-17,PF/BT,190927.01,A.R.N.A.S. Civico,SIC,30-39,4,4,0,8,0,0,0,2,6,8,Sicilia,ITG1
2021-01-17,PF/BT,190927.01,A.R.N.A.S. Civico,SIC,50-59,11,5,0,16,0,0,0,4,12,16,Sicilia,ITG1
2021-01-17,PF/BT,190927.01,A.R.N.A.S. Civico,SIC,60-69,14,1,0,15,0,0,0,1,14,15,Sicilia,ITG1
2021-01-17,PF/BT,190928.0,AZ.OSP.UNIV.P.GIACCONE,SIC,20-29,85,75,0,68,0,0,92,160,0,160,Sicilia,ITG1
2021-01-17,PF/BT,190928.0,AZ.OSP.UNIV.P.GIACCONE,SIC,30-39,8,9,0,5,0,0,12,17,0,17,Sicilia,ITG1
2021-01-17,PF/BT,190928.0,AZ.OSP.UNIV.P.GIACCONE,SIC,40-49,3,1,0,2,0,0,2,4,0,4,Sicilia,ITG1
2021-01-17,PF/BT,190928.0,AZ.OSP.UNIV.P.GIACCONE,SIC,50-59,3,3,0,3,3,0,0,6,0,6,Sicilia,ITG1
2021-01-17,PF/BT,190928.0,AZ.OSP.UNIV.P.GIACCONE,SIC,60-69,1,1,0,1,1,0,0,2,0,2,Sicilia,ITG1
2021-01-17,PF/BT,434000.0,Centro di Medicina Nucleare San Gaetano S.r.l.,SIC,20-29,1,0,0,0,1,0,0,1,0,1,Sicilia,ITG1
2021-01-17,PF/BT,434000.0,Centro di Medicina Nucleare San Gaetano S.r.l.,SIC,30-39,2,3,0,0,5,0,0,5,0,5,Sicilia,ITG1
2021-01-17,PF/BT,434000.0,Centro di Medicina Nucleare San Gaetano S.r.l.,SIC,40-49,10,7,0,0,17,0,0,17,0,17,Sicilia,ITG1
2021-01-17,PF/BT,434000.0,Centro di Medicina Nucleare San Gaetano S.r.l.,SIC,50-59,10,7,0,0,17,0,0,17,0,17,Sicilia,ITG1
2021-01-17,PF/BT,434000.0,Centro di Medicina Nucleare San Gaetano S.r.l.,SIC,60-69,1,5,0,0,6,0,0,6,0,6,Sicilia,ITG1
2021-01-17,PF/BT,434000.0,Centro di Medicina Nucleare San Gaetano S.r.l.,SIC,70-79,1,5,0,0,6,0,0,6,0,6,Sicilia,ITG1
2021-01-17,PF/BT,434000.0,Centro di Medicina Nucleare San Gaetano S.r.l.,SIC,80-89,4,2,0,0,6,0,0,6,0,6,Sicilia,ITG1
2021-01-17,PF/BT,434000.0,Centro di Medicina Nucleare San Gaetano S.r.l.,SIC,90+,0,1,0,0,1,0,0,1,0,1,Sicilia,ITG1
2021-01-17,PF/BT,446400.0,Villa Santa Teresa Diagnostica per Immagini e Radioterapia S.r.l.,SIC,30-39,2,0,0,0,2,0,0,2,0,2,Sicilia,ITG1
2021-01-17,PF/BT,446400.0,Villa Santa Teresa Diagnostica per Immagini e Radioterapia S.r.l.,SIC,40-49,17,8,0,0,25,0,0,25,0,25,Sicilia,ITG1
2021-01-17,PF/BT,446400.0,Villa Santa Teresa Diagnostica per Immagini e Radioterapia S.r.l.,SIC,50-59,15,6,0,0,21,0,0,21,0,21,Sicilia,ITG1
2021-01-17,PF/BT,446400.0,Villa Santa Teresa Diagnostica per Immagini e Radioterapia S.r.l.,SIC,60-69,2,5,0,0,7,0,0,7,0,7,Sicilia,ITG1
2021-01-17,PF/BT,608400.0,PTA S.Luigi,SIC,20-29,2,5,0,6,1,0,0,7,0,7,Sicilia,ITG1
2021-01-17,PF/BT,608400.0,PTA S.Luigi,SIC,30-39,5,9,0,13,1,0,0,14,0,14,Sicilia,ITG1
2021-01-17,PF/BT,608400.0,PTA S.Luigi,SIC,40-49,2,16,0,11,7,0,0,18,0,18,Sicilia,ITG1
2021-01-17,PF/BT,608400.0,PTA S.Luigi,SIC,50-59,7,12,0,10,9,0,0,19,0,19,Sicilia,ITG1
2021-01-17,PF/BT,608400.0,PTA S.Luigi,SIC,60-69,6,10,0,12,4,0,0,16,0,16,Sicilia,ITG1
2021-01-17,PF/BT,608400.0,PTA S.Luigi,SIC,70-79,8,2,0,9,1,0,0,10,0,10,Sicilia,ITG1
2021-01-17,PF/BT,820400.0,CTA CENTRO LA GRAZIA,SIC,20-29,3,2,0,1,0,0,4,5,0,5,Sicilia,ITG1
2021-01-17,PF/BT,820400.0,CTA CENTRO LA GRAZIA,SIC,30-39,1,0,0,0,0,0,1,1,0,1,Sicilia,ITG1
2021-01-17,PF/BT,820400.0,CTA CENTRO LA GRAZIA,SIC,40-49,8,4,0,1,1,0,10,12,0,12,Sicilia,ITG1
2021-01-17,PF/BT,820400.0,CTA CENTRO LA GRAZIA,SIC,50-59,13,4,0,2,4,0,11,17,0,17,Sicilia,ITG1
2021-01-17,PF/BT,820400.0,CTA CENTRO LA GRAZIA,SIC,60-69,3,2,0,0,1,0,4,5,0,5,Sicilia,ITG1
2021-01-17,PF/BT,820400.0,CTA CENTRO LA GRAZIA,SIC,70-79,1,1,0,0,1,0,1,2,0,2,Sicilia,ITG1
