TML_DTA_SOMM,TML_VAX_FORNITORE,TML_COD_STRUTTURA,TML_DES_STRUTTURA,TML_AREA,TML_FASCIA_ETA,TML_SESSO_M,TML_SESSO_F,TML_GRAVIDANZA,TML_CAT_OSS,TML_CAT_PERSONALE,TML_CAT_RSA_OSPITI,TML_CAT_ALTRO,TML_DOSE_1,TML_DOSE_2,TML_TOT_SOMM,TML_REGIONE,TML_NUTS
2020-12-27,COMIRNATY Vaccino a mRNA contro COVID-19,090602,Covid 19 - Nuovo Ospedale Apuane,TOS,20-29,1,2,0,3,0,0,0,3,0,3,Toscana,ITI1
2020-12-27,COMIRNATY Vaccino a mRNA contro COVID-19,090602,Covid 19 - Nuovo Ospedale Apuane,TOS,30-39,3,4,0,7,0,0,0,7,0,7,Toscana,ITI1
2020-12-27,COMIRNATY Vaccino a mRNA contro COVID-19,090602,Covid 19 - Nuovo Ospedale Apuane,TOS,40-49,6,7,0,13,0,0,0,13,0,13,Toscana,ITI1
2020-12-27,COMIRNATY Vaccino a mRNA contro COVID-19,090602,Covid 19 - Nuovo Ospedale Apuane,TOS,50-59,4,7,0,11,0,0,0,11,0,11,Toscana,ITI1
2020-12-27,COMIRNATY Vaccino a mRNA contro COVID-19,090602,Covid 19 - Nuovo Ospedale Apuane,TOS,60-69,7,3,0,10,0,0,0,10,0,10,Toscana,ITI1
2020-12-27,COMIRNATY Vaccino a mRNA contro COVID-19,090602,Covid 19 - Nuovo Ospedale Apuane,TOS,70-79,1,0,0,1,0,0,0,1,0,1,Toscana,ITI1
2020-12-27,COMIRNATY Vaccino a mRNA contro COVID-19,090604,Covid 19 - Ospedale San Luca di  Lucca,TOS,20-29,1,3,0,4,0,0,0,4,0,4,Toscana,ITI1
2020-12-27,COMIRNATY Vaccino a mRNA contro COVID-19,090604,Covid 19 - Ospedale San Luca di  Lucca,TOS,30-39,3,6,0,9,0,0,0,9,0,9,Toscana,ITI1
2020-12-27,COMIRNATY Vaccino a mRNA contro COVID-19,090604,Covid 19 - Ospedale San Luca di  Lucca,TOS,40-49,2,11,0,12,1,0,0,13,0,13,Toscana,ITI1
2020-12-27,COMIRNATY Vaccino a mRNA contro COVID-19,090604,Covid 19 - Ospedale San Luca di  Lucca,TOS,50-59,0,10,0,10,0,0,0,10,0,10,Toscana,ITI1
2020-12-27,COMIRNATY Vaccino a mRNA contro COVID-19,090604,Covid 19 - Ospedale San Luca di  Lucca,TOS,60-69,7,2,0,9,0,0,0,9,0,9,Toscana,ITI1
2020-12-27,COMIRNATY Vaccino a mRNA contro COVID-19,090606,COVID19 - Ospedale San Iacopo,TOS,20-29,1,1,0,2,0,0,0,2,0,2,Toscana,ITI1
2020-12-27,COMIRNATY Vaccino a mRNA contro COVID-19,090606,COVID19 - Ospedale San Iacopo,TOS,30-39,2,4,0,6,0,0,0,6,0,6,Toscana,ITI1
2020-12-27,COMIRNATY Vaccino a mRNA contro COVID-19,090606,COVID19 - Ospedale San Iacopo,TOS,40-49,0,11,0,11,0,0,0,11,0,11,Toscana,ITI1
2020-12-27,COMIRNATY Vaccino a mRNA contro COVID-19,090606,COVID19 - Ospedale San Iacopo,TOS,50-59,6,12,0,18,0,0,0,18,0,18,Toscana,ITI1
2020-12-27,COMIRNATY Vaccino a mRNA contro COVID-19,090606,COVID19 - Ospedale San Iacopo,TOS,60-69,6,2,0,7,1,0,0,8,0,8,Toscana,ITI1
2020-12-27,COMIRNATY Vaccino a mRNA contro COVID-19,090608,COVID19 - Ospedale Santo Stefano,TOS,30-39,3,2,0,5,0,0,0,5,0,5,Toscana,ITI1
2020-12-27,COMIRNATY Vaccino a mRNA contro COVID-19,090608,COVID19 - Ospedale Santo Stefano,TOS,40-49,7,9,0,16,0,0,0,16,0,16,Toscana,ITI1
2020-12-27,COMIRNATY Vaccino a mRNA contro COVID-19,090608,COVID19 - Ospedale Santo Stefano,TOS,50-59,6,12,0,18,0,0,0,18,0,18,Toscana,ITI1
2020-12-27,COMIRNATY Vaccino a mRNA contro COVID-19,090608,COVID19 - Ospedale Santo Stefano,TOS,60-69,2,4,0,6,0,0,0,6,0,6,Toscana,ITI1
2020-12-27,COMIRNATY Vaccino a mRNA contro COVID-19,090613,Covid 19 - Ospedali Riuniti di Livorno,TOS,20-29,2,6,0,8,0,0,0,8,0,8,Toscana,ITI1
2020-12-27,COMIRNATY Vaccino a mRNA contro COVID-19,090613,Covid 19 - Ospedali Riuniti di Livorno,TOS,30-39,2,7,0,9,0,0,0,9,0,9,Toscana,ITI1
2020-12-27,COMIRNATY Vaccino a mRNA contro COVID-19,090613,Covid 19 - Ospedali Riuniti di Livorno,TOS,40-49,0,8,0,8,0,0,0,8,0,8,Toscana,ITI1
2020-12-27,COMIRNATY Vaccino a mRNA contro COVID-19,090613,Covid 19 - Ospedali Riuniti di Livorno,TOS,50-59,3,11,0,13,1,0,0,14,0,14,Toscana,ITI1
2020-12-27,COMIRNATY Vaccino a mRNA contro COVID-19,090613,Covid 19 - Ospedali Riuniti di Livorno,TOS,60-69,5,6,0,10,1,0,0,11,0,11,Toscana,ITI1
2020-12-27,COMIRNATY Vaccino a mRNA contro COVID-19,090621,COVID19 - Ospedale di Arezzo,TOS,20-29,1,2,0,3,0,0,0,3,0,3,Toscana,ITI1
2020-12-27,COMIRNATY Vaccino a mRNA contro COVID-19,090621,COVID19 - Ospedale di Arezzo,TOS,30-39,5,5,0,10,0,0,0,10,0,10,Toscana,ITI1
2020-12-27,COMIRNATY Vaccino a mRNA contro COVID-19,090621,COVID19 - Ospedale di Arezzo,TOS,40-49,4,8,0,12,0,0,0,12,0,12,Toscana,ITI1
2020-12-27,COMIRNATY Vaccino a mRNA contro COVID-19,090621,COVID19 - Ospedale di Arezzo,TOS,50-59,7,8,0,15,0,0,0,15,0,15,Toscana,ITI1
2020-12-27,COMIRNATY Vaccino a mRNA contro COVID-19,090621,COVID19 - Ospedale di Arezzo,TOS,60-69,1,4,0,4,1,0,0,5,0,5,Toscana,ITI1
2020-12-27,COMIRNATY Vaccino a mRNA contro COVID-19,090626,COVID19 - Ospedale di Grosseto,TOS,20-29,0,1,0,1,0,0,0,1,0,1,Toscana,ITI1
2020-12-27,COMIRNATY Vaccino a mRNA contro COVID-19,090626,COVID19 - Ospedale di Grosseto,TOS,30-39,5,2,0,7,0,0,0,7,0,7,Toscana,ITI1
2020-12-27,COMIRNATY Vaccino a mRNA contro COVID-19,090626,COVID19 - Ospedale di Grosseto,TOS,40-49,3,12,0,14,1,0,0,15,0,15,Toscana,ITI1
2020-12-27,COMIRNATY Vaccino a mRNA contro COVID-19,090626,COVID19 - Ospedale di Grosseto,TOS,50-59,9,7,0,14,2,0,0,16,0,16,Toscana,ITI1
2020-12-27,COMIRNATY Vaccino a mRNA contro COVID-19,090626,COVID19 - Ospedale di Grosseto,TOS,60-69,4,2,0,6,0,0,0,6,0,6,Toscana,ITI1
2020-12-27,COMIRNATY Vaccino a mRNA contro COVID-19,090901,COVID19 - AOU Pisana,TOS,20-29,8,1,0,9,0,0,0,9,0,9,Toscana,ITI1
2020-12-27,COMIRNATY Vaccino a mRNA contro COVID-19,090901,COVID19 - AOU Pisana,TOS,30-39,5,4,0,9,0,0,0,9,0,9,Toscana,ITI1
2020-12-27,COMIRNATY Vaccino a mRNA contro COVID-19,090901,COVID19 - AOU Pisana,TOS,40-49,6,9,0,15,0,0,0,15,0,15,Toscana,ITI1
2020-12-27,COMIRNATY Vaccino a mRNA contro COVID-19,090901,COVID19 - AOU Pisana,TOS,50-59,4,9,0,13,0,0,0,13,0,13,Toscana,ITI1
2020-12-27,COMIRNATY Vaccino a mRNA contro COVID-19,090901,COVID19 - AOU Pisana,TOS,60-69,2,2,0,4,0,0,0,4,0,4,Toscana,ITI1
2020-12-27,COMIRNATY Vaccino a mRNA contro COVID-19,090902,COVID19 - AOU Senese,TOS,20-29,4,4,0,8,0,0,0,8,0,8,Toscana,ITI1
2020-12-27,COMIRNATY Vaccino a mRNA contro COVID-19,090902,COVID19 - AOU Senese,TOS,30-39,4,4,0,8,0,0,0,8,0,8,Toscana,ITI1
2020-12-27,COMIRNATY Vaccino a mRNA contro COVID-19,090902,COVID19 - AOU Senese,TOS,40-49,9,4,0,13,0,0,0,13,0,13,Toscana,ITI1
2020-12-27,COMIRNATY Vaccino a mRNA contro COVID-19,090902,COVID19 - AOU Senese,TOS,50-59,7,8,0,13,2,0,0,15,0,15,Toscana,ITI1
2020-12-27,COMIRNATY Vaccino a mRNA contro COVID-19,090902,COVID19 - AOU Senese,TOS,60-69,4,2,0,6,0,0,0,6,0,6,Toscana,ITI1
2020-12-27,COMIRNATY Vaccino a mRNA contro COVID-19,090903,COVID19 - AOU Careggi - CTO,TOS,20-29,1,1,0,2,0,0,0,2,0,2,Toscana,ITI1
2020-12-27,COMIRNATY Vaccino a mRNA contro COVID-19,090903,COVID19 - AOU Careggi - CTO,TOS,30-39,6,6,0,12,0,0,0,12,0,12,Toscana,ITI1
2020-12-27,COMIRNATY Vaccino a mRNA contro COVID-19,090903,COVID19 - AOU Careggi - CTO,TOS,40-49,6,4,0,10,0,0,0,10,0,10,Toscana,ITI1
2020-12-27,COMIRNATY Vaccino a mRNA contro COVID-19,090903,COVID19 - AOU Careggi - CTO,TOS,50-59,4,8,0,12,0,0,0,12,0,12,Toscana,ITI1
2020-12-27,COMIRNATY Vaccino a mRNA contro COVID-19,090903,COVID19 - AOU Careggi - CTO,TOS,60-69,6,3,0,8,1,0,0,9,0,9,Toscana,ITI1
2020-12-27,COMIRNATY Vaccino a mRNA contro COVID-19,11012E,COVID19 - Ospedale San Giuseppe,TOS,20-29,2,4,0,6,0,0,0,6,0,6,Toscana,ITI1
2020-12-27,COMIRNATY Vaccino a mRNA contro COVID-19,11012E,COVID19 - Ospedale San Giuseppe,TOS,30-39,5,5,0,10,0,0,0,10,0,10,Toscana,ITI1
2020-12-27,COMIRNATY Vaccino a mRNA contro COVID-19,11012E,COVID19 - Ospedale San Giuseppe,TOS,40-49,4,11,0,15,0,0,0,15,0,15,Toscana,ITI1
2020-12-27,COMIRNATY Vaccino a mRNA contro COVID-19,11012E,COVID19 - Ospedale San Giuseppe,TOS,50-59,5,8,0,13,0,0,0,13,0,13,Toscana,ITI1
2020-12-27,COMIRNATY Vaccino a mRNA contro COVID-19,11012E,COVID19 - Ospedale San Giuseppe,TOS,60-69,1,5,0,6,0,0,0,6,0,6,Toscana,ITI1
2020-12-27,COMIRNATY Vaccino a mRNA contro COVID-19,13021A,COVID19 - Ospedale S.Giovanni di Dio,TOS,20-29,0,4,0,4,0,0,0,4,0,4,Toscana,ITI1
2020-12-27,COMIRNATY Vaccino a mRNA contro COVID-19,13021A,COVID19 - Ospedale S.Giovanni di Dio,TOS,30-39,7,15,0,22,0,0,0,22,0,22,Toscana,ITI1
2020-12-27,COMIRNATY Vaccino a mRNA contro COVID-19,13021A,COVID19 - Ospedale S.Giovanni di Dio,TOS,40-49,4,5,0,9,0,0,0,9,0,9,Toscana,ITI1
2020-12-27,COMIRNATY Vaccino a mRNA contro COVID-19,13021A,COVID19 - Ospedale S.Giovanni di Dio,TOS,50-59,12,10,0,22,0,0,0,22,0,22,Toscana,ITI1
2020-12-27,COMIRNATY Vaccino a mRNA contro COVID-19,13021A,COVID19 - Ospedale S.Giovanni di Dio,TOS,60-69,12,6,0,18,0,0,0,18,0,18,Toscana,ITI1
2020-12-27,COMIRNATY Vaccino a mRNA contro COVID-19,60804I,COVID19 - RSA ASP  MONTEDOMINI,TOS,40-49,1,0,0,0,0,1,0,1,0,1,Toscana,ITI1
2020-12-27,COMIRNATY Vaccino a mRNA contro COVID-19,60804I,COVID19 - RSA ASP  MONTEDOMINI,TOS,50-59,5,3,0,0,0,8,0,8,0,8,Toscana,ITI1
2020-12-27,COMIRNATY Vaccino a mRNA contro COVID-19,60804I,COVID19 - RSA ASP  MONTEDOMINI,TOS,60-69,5,0,0,0,0,5,0,5,0,5,Toscana,ITI1
2020-12-27,COMIRNATY Vaccino a mRNA contro COVID-19,60804I,COVID19 - RSA ASP  MONTEDOMINI,TOS,70-79,7,1,0,0,0,8,0,8,0,8,Toscana,ITI1
2020-12-27,COMIRNATY Vaccino a mRNA contro COVID-19,60804I,COVID19 - RSA ASP  MONTEDOMINI,TOS,80-89,2,1,0,0,0,3,0,3,0,3,Toscana,ITI1
2020-12-27,COMIRNATY Vaccino a mRNA contro COVID-19,60804I,COVID19 - RSA ASP  MONTEDOMINI,TOS,90+,0,5,0,0,0,5,0,5,0,5,Toscana,ITI1
2020-12-30,COMIRNATY Vaccino a mRNA contro COVID-19,090604,Covid 19 - Ospedale San Luca di  Lucca,TOS,60-69,1,0,0,0,0,1,0,1,0,1,Toscana,ITI1
2020-12-30,COMIRNATY Vaccino a mRNA contro COVID-19,090604,Covid 19 - Ospedale San Luca di  Lucca,TOS,70-79,1,2,0,0,0,3,0,3,0,3,Toscana,ITI1
2020-12-30,COMIRNATY Vaccino a mRNA contro COVID-19,090604,Covid 19 - Ospedale San Luca di  Lucca,TOS,80-89,3,10,0,0,0,13,0,13,0,13,Toscana,ITI1
2020-12-30,COMIRNATY Vaccino a mRNA contro COVID-19,090604,Covid 19 - Ospedale San Luca di  Lucca,TOS,90+,0,7,0,0,0,7,0,7,0,7,Toscana,ITI1
2020-12-30,COMIRNATY Vaccino a mRNA contro COVID-19,090606,COVID19 - Ospedale San Iacopo,TOS,30-39,0,2,0,1,1,0,0,2,0,2,Toscana,ITI1
2020-12-30,COMIRNATY Vaccino a mRNA contro COVID-19,090606,COVID19 - Ospedale San Iacopo,TOS,60-69,2,0,0,0,0,2,0,2,0,2,Toscana,ITI1
2020-12-30,COMIRNATY Vaccino a mRNA contro COVID-19,090606,COVID19 - Ospedale San Iacopo,TOS,70-79,2,1,0,0,0,3,0,3,0,3,Toscana,ITI1
2020-12-30,COMIRNATY Vaccino a mRNA contro COVID-19,090606,COVID19 - Ospedale San Iacopo,TOS,80-89,0,17,0,0,0,17,0,17,0,17,Toscana,ITI1
2020-12-30,COMIRNATY Vaccino a mRNA contro COVID-19,090606,COVID19 - Ospedale San Iacopo,TOS,90+,1,10,0,0,0,11,0,11,0,11,Toscana,ITI1
2020-12-30,COMIRNATY Vaccino a mRNA contro COVID-19,090608,COVID19 - Ospedale Santo Stefano,TOS,60-69,0,1,0,0,0,1,0,1,0,1,Toscana,ITI1
2020-12-30,COMIRNATY Vaccino a mRNA contro COVID-19,090608,COVID19 - Ospedale Santo Stefano,TOS,70-79,2,1,0,0,0,3,0,3,0,3,Toscana,ITI1
2020-12-30,COMIRNATY Vaccino a mRNA contro COVID-19,090608,COVID19 - Ospedale Santo Stefano,TOS,80-89,1,4,0,0,0,5,0,5,0,5,Toscana,ITI1
2020-12-30,COMIRNATY Vaccino a mRNA contro COVID-19,090608,COVID19 - Ospedale Santo Stefano,TOS,90+,1,1,0,0,0,2,0,2,0,2,Toscana,ITI1
2020-12-30,COMIRNATY Vaccino a mRNA contro COVID-19,090614,Covid 19 - Ospedale Civile di Piombino,TOS,40-49,0,4,0,0,0,4,0,4,0,4,Toscana,ITI1
2020-12-30,COMIRNATY Vaccino a mRNA contro COVID-19,090614,Covid 19 - Ospedale Civile di Piombino,TOS,50-59,0,1,0,0,0,1,0,1,0,1,Toscana,ITI1
2020-12-30,COMIRNATY Vaccino a mRNA contro COVID-19,090614,Covid 19 - Ospedale Civile di Piombino,TOS,60-69,0,1,0,0,0,1,0,1,0,1,Toscana,ITI1
2020-12-30,COMIRNATY Vaccino a mRNA contro COVID-19,090614,Covid 19 - Ospedale Civile di Piombino,TOS,80-89,0,6,0,0,0,6,0,6,0,6,Toscana,ITI1
2020-12-30,COMIRNATY Vaccino a mRNA contro COVID-19,090614,Covid 19 - Ospedale Civile di Piombino,TOS,90+,0,6,0,0,0,6,0,6,0,6,Toscana,ITI1
2020-12-30,COMIRNATY Vaccino a mRNA contro COVID-19,090621,COVID19 - Ospedale di Arezzo,TOS,20-29,1,0,0,1,0,0,0,1,0,1,Toscana,ITI1
2020-12-30,COMIRNATY Vaccino a mRNA contro COVID-19,090621,COVID19 - Ospedale di Arezzo,TOS,40-49,1,1,0,1,0,1,0,2,0,2,Toscana,ITI1
2020-12-30,COMIRNATY Vaccino a mRNA contro COVID-19,090621,COVID19 - Ospedale di Arezzo,TOS,50-59,0,5,0,5,0,0,0,5,0,5,Toscana,ITI1
2020-12-30,COMIRNATY Vaccino a mRNA contro COVID-19,090621,COVID19 - Ospedale di Arezzo,TOS,60-69,1,1,0,1,0,1,0,2,0,2,Toscana,ITI1
2020-12-30,COMIRNATY Vaccino a mRNA contro COVID-19,090621,COVID19 - Ospedale di Arezzo,TOS,70-79,4,0,0,0,0,4,0,4,0,4,Toscana,ITI1
2020-12-30,COMIRNATY Vaccino a mRNA contro COVID-19,090621,COVID19 - Ospedale di Arezzo,TOS,80-89,7,8,0,0,0,15,0,15,0,15,Toscana,ITI1
2020-12-30,COMIRNATY Vaccino a mRNA contro COVID-19,090621,COVID19 - Ospedale di Arezzo,TOS,90+,1,6,0,0,0,7,0,7,0,7,Toscana,ITI1
2020-12-30,COMIRNATY Vaccino a mRNA contro COVID-19,090626,COVID19 - Ospedale di Grosseto,TOS,60-69,1,1,0,0,2,0,0,2,0,2,Toscana,ITI1
2020-12-30,COMIRNATY Vaccino a mRNA contro COVID-19,090626,COVID19 - Ospedale di Grosseto,TOS,80-89,0,5,0,0,0,5,0,5,0,5,Toscana,ITI1
2020-12-30,COMIRNATY Vaccino a mRNA contro COVID-19,090626,COVID19 - Ospedale di Grosseto,TOS,90+,0,4,0,0,0,4,0,4,0,4,Toscana,ITI1
2020-12-30,COMIRNATY Vaccino a mRNA contro COVID-19,090640,Covid 19 - Ospedale Unico Versilia,TOS,30-39,0,1,0,0,0,1,0,1,0,1,Toscana,ITI1
2020-12-30,COMIRNATY Vaccino a mRNA contro COVID-19,090640,Covid 19 - Ospedale Unico Versilia,TOS,40-49,1,0,0,0,1,0,0,1,0,1,Toscana,ITI1
2020-12-30,COMIRNATY Vaccino a mRNA contro COVID-19,090640,Covid 19 - Ospedale Unico Versilia,TOS,50-59,0,2,0,0,2,0,0,2,0,2,Toscana,ITI1
2020-12-30,COMIRNATY Vaccino a mRNA contro COVID-19,090640,Covid 19 - Ospedale Unico Versilia,TOS,70-79,1,1,0,0,0,2,0,2,0,2,Toscana,ITI1
2020-12-30,COMIRNATY Vaccino a mRNA contro COVID-19,090640,Covid 19 - Ospedale Unico Versilia,TOS,80-89,2,1,0,0,0,3,0,3,0,3,Toscana,ITI1
2020-12-30,COMIRNATY Vaccino a mRNA contro COVID-19,090640,Covid 19 - Ospedale Unico Versilia,TOS,90+,1,8,0,0,0,9,0,9,0,9,Toscana,ITI1
2020-12-30,COMIRNATY Vaccino a mRNA contro COVID-19,11012E,COVID19 - Ospedale San Giuseppe,TOS,40-49,0,1,0,1,0,0,0,1,0,1,Toscana,ITI1
2020-12-30,COMIRNATY Vaccino a mRNA contro COVID-19,11012E,COVID19 - Ospedale San Giuseppe,TOS,50-59,2,1,0,1,0,2,0,3,0,3,Toscana,ITI1
2020-12-30,COMIRNATY Vaccino a mRNA contro COVID-19,11012E,COVID19 - Ospedale San Giuseppe,TOS,60-69,3,1,0,0,0,4,0,4,0,4,Toscana,ITI1
2020-12-30,COMIRNATY Vaccino a mRNA contro COVID-19,11012E,COVID19 - Ospedale San Giuseppe,TOS,70-79,1,3,0,0,0,4,0,4,0,4,Toscana,ITI1
2020-12-30,COMIRNATY Vaccino a mRNA contro COVID-19,11012E,COVID19 - Ospedale San Giuseppe,TOS,80-89,2,5,0,0,0,7,0,7,0,7,Toscana,ITI1
2020-12-30,COMIRNATY Vaccino a mRNA contro COVID-19,11012E,COVID19 - Ospedale San Giuseppe,TOS,90+,0,5,0,0,0,5,0,5,0,5,Toscana,ITI1
2020-12-30,COMIRNATY Vaccino a mRNA contro COVID-19,13021A,COVID19 - Ospedale S.Giovanni di Dio,TOS,16-19,2,0,0,0,0,2,0,2,0,2,Toscana,ITI1
2020-12-30,COMIRNATY Vaccino a mRNA contro COVID-19,13021A,COVID19 - Ospedale S.Giovanni di Dio,TOS,20-29,6,1,0,0,0,7,0,7,0,7,Toscana,ITI1
2020-12-30,COMIRNATY Vaccino a mRNA contro COVID-19,13021A,COVID19 - Ospedale S.Giovanni di Dio,TOS,30-39,6,3,0,1,0,8,0,9,0,9,Toscana,ITI1
2020-12-30,COMIRNATY Vaccino a mRNA contro COVID-19,13021A,COVID19 - Ospedale S.Giovanni di Dio,TOS,40-49,3,6,0,1,0,8,0,9,0,9,Toscana,ITI1
2020-12-30,COMIRNATY Vaccino a mRNA contro COVID-19,13021A,COVID19 - Ospedale S.Giovanni di Dio,TOS,50-59,10,3,0,3,0,10,0,13,0,13,Toscana,ITI1
2020-12-30,COMIRNATY Vaccino a mRNA contro COVID-19,13021A,COVID19 - Ospedale S.Giovanni di Dio,TOS,60-69,1,1,0,0,0,2,0,2,0,2,Toscana,ITI1
2020-12-30,COMIRNATY Vaccino a mRNA contro COVID-19,16121A,Covid 19 - Ospedale Civile di Cecina,TOS,20-29,1,0,0,0,0,1,0,1,0,1,Toscana,ITI1
2020-12-30,COMIRNATY Vaccino a mRNA contro COVID-19,16121A,Covid 19 - Ospedale Civile di Cecina,TOS,50-59,2,3,0,2,0,3,0,5,0,5,Toscana,ITI1
2020-12-30,COMIRNATY Vaccino a mRNA contro COVID-19,16121A,Covid 19 - Ospedale Civile di Cecina,TOS,60-69,1,0,0,0,0,1,0,1,0,1,Toscana,ITI1
2020-12-30,COMIRNATY Vaccino a mRNA contro COVID-19,16121A,Covid 19 - Ospedale Civile di Cecina,TOS,70-79,3,1,0,0,0,4,0,4,0,4,Toscana,ITI1
2020-12-30,COMIRNATY Vaccino a mRNA contro COVID-19,16121A,Covid 19 - Ospedale Civile di Cecina,TOS,80-89,1,5,0,0,0,6,0,6,0,6,Toscana,ITI1
2020-12-30,COMIRNATY Vaccino a mRNA contro COVID-19,16121A,Covid 19 - Ospedale Civile di Cecina,TOS,90+,0,1,0,0,0,1,0,1,0,1,Toscana,ITI1
2020-12-30,COMIRNATY Vaccino a mRNA contro COVID-19,22391A,PRESIDIO AVENZA,TOS,50-59,0,1,0,1,0,0,0,1,0,1,Toscana,ITI1
2020-12-30,COMIRNATY Vaccino a mRNA contro COVID-19,22391A,PRESIDIO AVENZA,TOS,60-69,1,0,0,1,0,0,0,1,0,1,Toscana,ITI1
2020-12-30,COMIRNATY Vaccino a mRNA contro COVID-19,22391A,PRESIDIO AVENZA,TOS,70-79,2,2,0,0,0,4,0,4,0,4,Toscana,ITI1
2020-12-30,COMIRNATY Vaccino a mRNA contro COVID-19,22391A,PRESIDIO AVENZA,TOS,80-89,1,4,0,0,0,5,0,5,0,5,Toscana,ITI1
2020-12-30,COMIRNATY Vaccino a mRNA contro COVID-19,22391A,PRESIDIO AVENZA,TOS,90+,3,4,0,0,0,7,0,7,0,7,Toscana,ITI1
2020-12-30,COMIRNATY Vaccino a mRNA contro COVID-19,40911A,COVID19 - Dip. Prevenzione Ruffolo Siena,TOS,20-29,1,1,0,2,0,0,0,2,0,2,Toscana,ITI1
2020-12-30,COMIRNATY Vaccino a mRNA contro COVID-19,40911A,COVID19 - Dip. Prevenzione Ruffolo Siena,TOS,30-39,0,2,0,2,0,0,0,2,0,2,Toscana,ITI1
2020-12-30,COMIRNATY Vaccino a mRNA contro COVID-19,40911A,COVID19 - Dip. Prevenzione Ruffolo Siena,TOS,40-49,0,1,0,1,0,0,0,1,0,1,Toscana,ITI1
2020-12-30,COMIRNATY Vaccino a mRNA contro COVID-19,40911A,COVID19 - Dip. Prevenzione Ruffolo Siena,TOS,50-59,1,3,0,4,0,0,0,4,0,4,Toscana,ITI1
2020-12-30,COMIRNATY Vaccino a mRNA contro COVID-19,40911A,COVID19 - Dip. Prevenzione Ruffolo Siena,TOS,70-79,0,1,0,0,0,1,0,1,0,1,Toscana,ITI1
2020-12-30,COMIRNATY Vaccino a mRNA contro COVID-19,40911A,COVID19 - Dip. Prevenzione Ruffolo Siena,TOS,80-89,0,7,0,0,0,7,0,7,0,7,Toscana,ITI1
2020-12-30,COMIRNATY Vaccino a mRNA contro COVID-19,40911A,COVID19 - Dip. Prevenzione Ruffolo Siena,TOS,90+,2,4,0,0,0,6,0,6,0,6,Toscana,ITI1
2020-12-30,COMIRNATY Vaccino a mRNA contro COVID-19,ND,Dip.Prevenzione PISA - ISP,TOS,20-29,0,1,0,1,0,0,0,1,0,1,Toscana,ITI1
2020-12-30,COMIRNATY Vaccino a mRNA contro COVID-19,ND,Dip.Prevenzione PISA - ISP,TOS,30-39,1,0,0,1,0,0,0,1,0,1,Toscana,ITI1
2020-12-30,COMIRNATY Vaccino a mRNA contro COVID-19,ND,Dip.Prevenzione PISA - ISP,TOS,40-49,0,2,0,2,0,0,0,2,0,2,Toscana,ITI1
2020-12-30,COMIRNATY Vaccino a mRNA contro COVID-19,ND,Dip.Prevenzione PISA - ISP,TOS,60-69,0,3,0,0,0,3,0,3,0,3,Toscana,ITI1
2020-12-30,COMIRNATY Vaccino a mRNA contro COVID-19,ND,Dip.Prevenzione PISA - ISP,TOS,70-79,0,2,0,1,0,1,0,2,0,2,Toscana,ITI1
2020-12-30,COMIRNATY Vaccino a mRNA contro COVID-19,ND,Dip.Prevenzione PISA - ISP,TOS,80-89,5,8,0,0,0,13,0,13,0,13,Toscana,ITI1
2020-12-30,COMIRNATY Vaccino a mRNA contro COVID-19,ND,Dip.Prevenzione PISA - ISP,TOS,90+,0,2,0,0,0,2,0,2,0,2,Toscana,ITI1
2020-12-31,COMIRNATY Vaccino a mRNA contro COVID-19,03002D,Covid 19 - Ospedale S.Francesco di Barga,TOS,20-29,1,0,0,1,0,0,0,1,0,1,Toscana,ITI1
2020-12-31,COMIRNATY Vaccino a mRNA contro COVID-19,03002D,Covid 19 - Ospedale S.Francesco di Barga,TOS,30-39,1,0,0,1,0,0,0,1,0,1,Toscana,ITI1
2020-12-31,COMIRNATY Vaccino a mRNA contro COVID-19,03002D,Covid 19 - Ospedale S.Francesco di Barga,TOS,60-69,0,1,0,0,0,1,0,1,0,1,Toscana,ITI1
2020-12-31,COMIRNATY Vaccino a mRNA contro COVID-19,03002D,Covid 19 - Ospedale S.Francesco di Barga,TOS,70-79,1,1,0,0,0,2,0,2,0,2,Toscana,ITI1
2020-12-31,COMIRNATY Vaccino a mRNA contro COVID-19,03002D,Covid 19 - Ospedale S.Francesco di Barga,TOS,80-89,0,4,0,0,0,4,0,4,0,4,Toscana,ITI1
2020-12-31,COMIRNATY Vaccino a mRNA contro COVID-19,03002D,Covid 19 - Ospedale S.Francesco di Barga,TOS,90+,1,2,0,0,0,3,0,3,0,3,Toscana,ITI1
2020-12-31,COMIRNATY Vaccino a mRNA contro COVID-19,090603,Covid 19 - Ospedale Santa Croce in Garfagnana,TOS,80-89,3,5,0,0,0,8,0,8,0,8,Toscana,ITI1
2020-12-31,COMIRNATY Vaccino a mRNA contro COVID-19,090603,Covid 19 - Ospedale Santa Croce in Garfagnana,TOS,90+,0,4,0,0,0,4,0,4,0,4,Toscana,ITI1
2020-12-31,COMIRNATY Vaccino a mRNA contro COVID-19,090604,Covid 19 - Ospedale San Luca di  Lucca,TOS,30-39,0,1,0,1,0,0,0,1,0,1,Toscana,ITI1
2020-12-31,COMIRNATY Vaccino a mRNA contro COVID-19,090604,Covid 19 - Ospedale San Luca di  Lucca,TOS,40-49,0,3,0,3,0,0,0,3,0,3,Toscana,ITI1
2020-12-31,COMIRNATY Vaccino a mRNA contro COVID-19,090604,Covid 19 - Ospedale San Luca di  Lucca,TOS,60-69,0,1,0,1,0,0,0,1,0,1,Toscana,ITI1
2020-12-31,COMIRNATY Vaccino a mRNA contro COVID-19,090604,Covid 19 - Ospedale San Luca di  Lucca,TOS,70-79,0,3,0,0,0,3,0,3,0,3,Toscana,ITI1
2020-12-31,COMIRNATY Vaccino a mRNA contro COVID-19,090604,Covid 19 - Ospedale San Luca di  Lucca,TOS,80-89,3,2,0,0,0,5,0,5,0,5,Toscana,ITI1
2020-12-31,COMIRNATY Vaccino a mRNA contro COVID-19,090604,Covid 19 - Ospedale San Luca di  Lucca,TOS,90+,1,4,0,0,0,5,0,5,0,5,Toscana,ITI1
2020-12-31,COMIRNATY Vaccino a mRNA contro COVID-19,090606,COVID19 - Ospedale San Iacopo,TOS,40-49,0,1,0,1,0,0,0,1,0,1,Toscana,ITI1
2020-12-31,COMIRNATY Vaccino a mRNA contro COVID-19,090606,COVID19 - Ospedale San Iacopo,TOS,50-59,2,3,0,3,0,2,0,5,0,5,Toscana,ITI1
2020-12-31,COMIRNATY Vaccino a mRNA contro COVID-19,090606,COVID19 - Ospedale San Iacopo,TOS,60-69,1,1,0,0,0,2,0,2,0,2,Toscana,ITI1
2020-12-31,COMIRNATY Vaccino a mRNA contro COVID-19,090606,COVID19 - Ospedale San Iacopo,TOS,70-79,4,2,0,0,0,6,0,6,0,6,Toscana,ITI1
2020-12-31,COMIRNATY Vaccino a mRNA contro COVID-19,090606,COVID19 - Ospedale San Iacopo,TOS,80-89,4,2,0,0,0,6,0,6,0,6,Toscana,ITI1
2020-12-31,COMIRNATY Vaccino a mRNA contro COVID-19,090606,COVID19 - Ospedale San Iacopo,TOS,90+,1,2,0,0,0,3,0,3,0,3,Toscana,ITI1
2020-12-31,COMIRNATY Vaccino a mRNA contro COVID-19,090608,COVID19 - Ospedale Santo Stefano,TOS,50-59,0,1,0,0,0,1,0,1,0,1,Toscana,ITI1
2020-12-31,COMIRNATY Vaccino a mRNA contro COVID-19,090608,COVID19 - Ospedale Santo Stefano,TOS,60-69,0,2,0,0,0,2,0,2,0,2,Toscana,ITI1
2020-12-31,COMIRNATY Vaccino a mRNA contro COVID-19,090608,COVID19 - Ospedale Santo Stefano,TOS,70-79,0,3,0,0,0,3,0,3,0,3,Toscana,ITI1
2020-12-31,COMIRNATY Vaccino a mRNA contro COVID-19,090608,COVID19 - Ospedale Santo Stefano,TOS,80-89,2,9,0,0,0,11,0,11,0,11,Toscana,ITI1
2020-12-31,COMIRNATY Vaccino a mRNA contro COVID-19,090608,COVID19 - Ospedale Santo Stefano,TOS,90+,1,10,0,0,0,11,0,11,0,11,Toscana,ITI1
2020-12-31,COMIRNATY Vaccino a mRNA contro COVID-19,090613,Covid 19 - Ospedali Riuniti di Livorno,TOS,70-79,0,1,0,0,0,1,0,1,0,1,Toscana,ITI1
2020-12-31,COMIRNATY Vaccino a mRNA contro COVID-19,090613,Covid 19 - Ospedali Riuniti di Livorno,TOS,80-89,0,5,0,0,0,5,0,5,0,5,Toscana,ITI1
2020-12-31,COMIRNATY Vaccino a mRNA contro COVID-19,090613,Covid 19 - Ospedali Riuniti di Livorno,TOS,90+,0,5,0,0,0,5,0,5,0,5,Toscana,ITI1
2020-12-31,COMIRNATY Vaccino a mRNA contro COVID-19,090614,Covid 19 - Ospedale Civile di Piombino,TOS,50-59,1,0,0,0,0,1,0,1,0,1,Toscana,ITI1
2020-12-31,COMIRNATY Vaccino a mRNA contro COVID-19,090614,Covid 19 - Ospedale Civile di Piombino,TOS,60-69,1,0,0,0,0,1,0,1,0,1,Toscana,ITI1
2020-12-31,COMIRNATY Vaccino a mRNA contro COVID-19,090614,Covid 19 - Ospedale Civile di Piombino,TOS,70-79,1,6,0,0,0,7,0,7,0,7,Toscana,ITI1
2020-12-31,COMIRNATY Vaccino a mRNA contro COVID-19,090614,Covid 19 - Ospedale Civile di Piombino,TOS,80-89,6,4,0,0,0,10,0,10,0,10,Toscana,ITI1
2020-12-31,COMIRNATY Vaccino a mRNA contro COVID-19,090614,Covid 19 - Ospedale Civile di Piombino,TOS,90+,1,3,0,0,0,4,0,4,0,4,Toscana,ITI1
2020-12-31,COMIRNATY Vaccino a mRNA contro COVID-19,090621,COVID19 - Ospedale di Arezzo,TOS,20-29,0,1,0,1,0,0,0,1,0,1,Toscana,ITI1
2020-12-31,COMIRNATY Vaccino a mRNA contro COVID-19,090621,COVID19 - Ospedale di Arezzo,TOS,30-39,1,0,0,1,0,0,0,1,0,1,Toscana,ITI1
2020-12-31,COMIRNATY Vaccino a mRNA contro COVID-19,090621,COVID19 - Ospedale di Arezzo,TOS,50-59,0,3,0,2,0,1,0,3,0,3,Toscana,ITI1
2020-12-31,COMIRNATY Vaccino a mRNA contro COVID-19,090621,COVID19 - Ospedale di Arezzo,TOS,60-69,1,3,0,3,0,1,0,4,0,4,Toscana,ITI1
2020-12-31,COMIRNATY Vaccino a mRNA contro COVID-19,090621,COVID19 - Ospedale di Arezzo,TOS,70-79,1,1,0,0,0,2,0,2,0,2,Toscana,ITI1
2020-12-31,COMIRNATY Vaccino a mRNA contro COVID-19,090621,COVID19 - Ospedale di Arezzo,TOS,80-89,2,3,0,0,0,5,0,5,0,5,Toscana,ITI1
2020-12-31,COMIRNATY Vaccino a mRNA contro COVID-19,090621,COVID19 - Ospedale di Arezzo,TOS,90+,3,5,0,0,0,8,0,8,0,8,Toscana,ITI1
2020-12-31,COMIRNATY Vaccino a mRNA contro COVID-19,090623,COVID19 - Ospedale S.Andrea Massa Marittima,TOS,40-49,0,1,0,0,0,1,0,1,0,1,Toscana,ITI1
2020-12-31,COMIRNATY Vaccino a mRNA contro COVID-19,090623,COVID19 - Ospedale S.Andrea Massa Marittima,TOS,50-59,0,3,0,0,0,3,0,3,0,3,Toscana,ITI1
2020-12-31,COMIRNATY Vaccino a mRNA contro COVID-19,090623,COVID19 - Ospedale S.Andrea Massa Marittima,TOS,70-79,0,1,0,0,0,1,0,1,0,1,Toscana,ITI1
2020-12-31,COMIRNATY Vaccino a mRNA contro COVID-19,090623,COVID19 - Ospedale S.Andrea Massa Marittima,TOS,80-89,0,6,0,0,0,6,0,6,0,6,Toscana,ITI1
2020-12-31,COMIRNATY Vaccino a mRNA contro COVID-19,090623,COVID19 - Ospedale S.Andrea Massa Marittima,TOS,90+,0,5,0,0,0,5,0,5,0,5,Toscana,ITI1
2020-12-31,COMIRNATY Vaccino a mRNA contro COVID-19,090627,COVID19 - Ospedale Mugello,TOS,60-69,1,3,0,0,0,4,0,4,0,4,Toscana,ITI1
2020-12-31,COMIRNATY Vaccino a mRNA contro COVID-19,090627,COVID19 - Ospedale Mugello,TOS,70-79,2,5,0,0,0,7,0,7,0,7,Toscana,ITI1
2020-12-31,COMIRNATY Vaccino a mRNA contro COVID-19,090627,COVID19 - Ospedale Mugello,TOS,80-89,5,11,0,0,0,16,0,16,0,16,Toscana,ITI1
2020-12-31,COMIRNATY Vaccino a mRNA contro COVID-19,090627,COVID19 - Ospedale Mugello,TOS,90+,3,5,0,0,0,8,0,8,0,8,Toscana,ITI1
2020-12-31,COMIRNATY Vaccino a mRNA contro COVID-19,090629,COVID19 - Ospedale SS. Maria Annunziata,TOS,20-29,0,1,0,1,0,0,0,1,0,1,Toscana,ITI1
2020-12-31,COMIRNATY Vaccino a mRNA contro COVID-19,090629,COVID19 - Ospedale SS. Maria Annunziata,TOS,30-39,1,0,0,1,0,0,0,1,0,1,Toscana,ITI1
2020-12-31,COMIRNATY Vaccino a mRNA contro COVID-19,090629,COVID19 - Ospedale SS. Maria Annunziata,TOS,50-59,1,2,0,2,0,1,0,3,0,3,Toscana,ITI1
2020-12-31,COMIRNATY Vaccino a mRNA contro COVID-19,090629,COVID19 - Ospedale SS. Maria Annunziata,TOS,60-69,2,4,0,1,0,5,0,6,0,6,Toscana,ITI1
2020-12-31,COMIRNATY Vaccino a mRNA contro COVID-19,090629,COVID19 - Ospedale SS. Maria Annunziata,TOS,70-79,3,3,0,0,0,6,0,6,0,6,Toscana,ITI1
2020-12-31,COMIRNATY Vaccino a mRNA contro COVID-19,090629,COVID19 - Ospedale SS. Maria Annunziata,TOS,80-89,3,9,0,0,0,12,0,12,0,12,Toscana,ITI1
2020-12-31,COMIRNATY Vaccino a mRNA contro COVID-19,090629,COVID19 - Ospedale SS. Maria Annunziata,TOS,90+,4,8,0,0,0,12,0,12,0,12,Toscana,ITI1
2020-12-31,COMIRNATY Vaccino a mRNA contro COVID-19,090638,COVID19 - Ospedale di Campostaggia Poggibonsi,TOS,40-49,1,2,0,2,0,1,0,3,0,3,Toscana,ITI1
2020-12-31,COMIRNATY Vaccino a mRNA contro COVID-19,090638,COVID19 - Ospedale di Campostaggia Poggibonsi,TOS,50-59,0,1,0,0,0,1,0,1,0,1,Toscana,ITI1
2020-12-31,COMIRNATY Vaccino a mRNA contro COVID-19,090638,COVID19 - Ospedale di Campostaggia Poggibonsi,TOS,60-69,1,3,0,1,0,3,0,4,0,4,Toscana,ITI1
2020-12-31,COMIRNATY Vaccino a mRNA contro COVID-19,090638,COVID19 - Ospedale di Campostaggia Poggibonsi,TOS,70-79,2,4,0,0,1,5,0,6,0,6,Toscana,ITI1
2020-12-31,COMIRNATY Vaccino a mRNA contro COVID-19,090638,COVID19 - Ospedale di Campostaggia Poggibonsi,TOS,80-89,7,14,0,0,0,21,0,21,0,21,Toscana,ITI1
2020-12-31,COMIRNATY Vaccino a mRNA contro COVID-19,090638,COVID19 - Ospedale di Campostaggia Poggibonsi,TOS,90+,5,15,0,0,0,20,0,20,0,20,Toscana,ITI1
2020-12-31,COMIRNATY Vaccino a mRNA contro COVID-19,090639,COVID19 - Ospedale di Nottola Montepulciano,TOS,50-59,0,1,0,0,0,1,0,1,0,1,Toscana,ITI1
2020-12-31,COMIRNATY Vaccino a mRNA contro COVID-19,090639,COVID19 - Ospedale di Nottola Montepulciano,TOS,70-79,0,1,0,0,0,1,0,1,0,1,Toscana,ITI1
2020-12-31,COMIRNATY Vaccino a mRNA contro COVID-19,090639,COVID19 - Ospedale di Nottola Montepulciano,TOS,80-89,2,7,0,0,0,9,0,9,0,9,Toscana,ITI1
2020-12-31,COMIRNATY Vaccino a mRNA contro COVID-19,090639,COVID19 - Ospedale di Nottola Montepulciano,TOS,90+,0,7,0,0,0,7,0,7,0,7,Toscana,ITI1
2020-12-31,COMIRNATY Vaccino a mRNA contro COVID-19,090641,COVID19 - Ospedale La Gruccia Montevarchi,TOS,20-29,0,1,0,1,0,0,0,1,0,1,Toscana,ITI1
2020-12-31,COMIRNATY Vaccino a mRNA contro COVID-19,090641,COVID19 - Ospedale La Gruccia Montevarchi,TOS,40-49,0,2,0,1,1,0,0,2,0,2,Toscana,ITI1
2020-12-31,COMIRNATY Vaccino a mRNA contro COVID-19,090641,COVID19 - Ospedale La Gruccia Montevarchi,TOS,50-59,0,4,0,2,2,0,0,4,0,4,Toscana,ITI1
2020-12-31,COMIRNATY Vaccino a mRNA contro COVID-19,090641,COVID19 - Ospedale La Gruccia Montevarchi,TOS,60-69,2,3,0,0,0,5,0,5,0,5,Toscana,ITI1
2020-12-31,COMIRNATY Vaccino a mRNA contro COVID-19,090641,COVID19 - Ospedale La Gruccia Montevarchi,TOS,70-79,2,12,0,0,0,14,0,14,0,14,Toscana,ITI1
2020-12-31,COMIRNATY Vaccino a mRNA contro COVID-19,090641,COVID19 - Ospedale La Gruccia Montevarchi,TOS,80-89,0,10,0,0,0,10,0,10,0,10,Toscana,ITI1
2020-12-31,COMIRNATY Vaccino a mRNA contro COVID-19,090641,COVID19 - Ospedale La Gruccia Montevarchi,TOS,90+,0,6,0,0,0,6,0,6,0,6,Toscana,ITI1
2020-12-31,COMIRNATY Vaccino a mRNA contro COVID-19,090643,COVID19 - Ospedale S. Margherita Cortona,TOS,30-39,0,1,0,1,0,0,0,1,0,1,Toscana,ITI1
2020-12-31,COMIRNATY Vaccino a mRNA contro COVID-19,090643,COVID19 - Ospedale S. Margherita Cortona,TOS,40-49,1,0,0,1,0,0,0,1,0,1,Toscana,ITI1
2020-12-31,COMIRNATY Vaccino a mRNA contro COVID-19,090643,COVID19 - Ospedale S. Margherita Cortona,TOS,50-59,1,0,0,0,0,1,0,1,0,1,Toscana,ITI1
2020-12-31,COMIRNATY Vaccino a mRNA contro COVID-19,090643,COVID19 - Ospedale S. Margherita Cortona,TOS,60-69,1,1,0,0,0,2,0,2,0,2,Toscana,ITI1
2020-12-31,COMIRNATY Vaccino a mRNA contro COVID-19,090643,COVID19 - Ospedale S. Margherita Cortona,TOS,70-79,2,4,0,0,0,6,0,6,0,6,Toscana,ITI1
2020-12-31,COMIRNATY Vaccino a mRNA contro COVID-19,090643,COVID19 - Ospedale S. Margherita Cortona,TOS,80-89,2,14,0,0,0,16,0,16,0,16,Toscana,ITI1
2020-12-31,COMIRNATY Vaccino a mRNA contro COVID-19,090643,COVID19 - Ospedale S. Margherita Cortona,TOS,90+,2,13,0,0,0,15,0,15,0,15,Toscana,ITI1
2020-12-31,COMIRNATY Vaccino a mRNA contro COVID-19,11012E,COVID19 - Ospedale San Giuseppe,TOS,20-29,1,0,0,1,0,0,0,1,0,1,Toscana,ITI1
2020-12-31,COMIRNATY Vaccino a mRNA contro COVID-19,11012E,COVID19 - Ospedale San Giuseppe,TOS,30-39,1,5,0,6,0,0,0,6,0,6,Toscana,ITI1
2020-12-31,COMIRNATY Vaccino a mRNA contro COVID-19,11012E,COVID19 - Ospedale San Giuseppe,TOS,40-49,2,3,0,3,0,2,0,5,0,5,Toscana,ITI1
2020-12-31,COMIRNATY Vaccino a mRNA contro COVID-19,11012E,COVID19 - Ospedale San Giuseppe,TOS,50-59,8,5,0,3,0,10,0,13,0,13,Toscana,ITI1
2020-12-31,COMIRNATY Vaccino a mRNA contro COVID-19,11012E,COVID19 - Ospedale San Giuseppe,TOS,60-69,1,7,0,3,0,5,0,8,0,8,Toscana,ITI1
2020-12-31,COMIRNATY Vaccino a mRNA contro COVID-19,11012E,COVID19 - Ospedale San Giuseppe,TOS,70-79,2,5,0,0,0,7,0,7,0,7,Toscana,ITI1
2020-12-31,COMIRNATY Vaccino a mRNA contro COVID-19,11012E,COVID19 - Ospedale San Giuseppe,TOS,80-89,5,6,0,0,0,11,0,11,0,11,Toscana,ITI1
2020-12-31,COMIRNATY Vaccino a mRNA contro COVID-19,11012E,COVID19 - Ospedale San Giuseppe,TOS,90+,0,2,0,0,0,2,0,2,0,2,Toscana,ITI1
2020-12-31,COMIRNATY Vaccino a mRNA contro COVID-19,11151A,Covid 19 - Ospedale S.Antonio Abate di Pontremoli,TOS,30-39,0,1,0,0,0,1,0,1,0,1,Toscana,ITI1
2020-12-31,COMIRNATY Vaccino a mRNA contro COVID-19,11151A,Covid 19 - Ospedale S.Antonio Abate di Pontremoli,TOS,50-59,1,0,0,0,0,1,0,1,0,1,Toscana,ITI1
2020-12-31,COMIRNATY Vaccino a mRNA contro COVID-19,11151A,Covid 19 - Ospedale S.Antonio Abate di Pontremoli,TOS,60-69,2,2,0,0,0,4,0,4,0,4,Toscana,ITI1
2020-12-31,COMIRNATY Vaccino a mRNA contro COVID-19,11151A,Covid 19 - Ospedale S.Antonio Abate di Pontremoli,TOS,70-79,4,0,0,0,0,4,0,4,0,4,Toscana,ITI1
2020-12-31,COMIRNATY Vaccino a mRNA contro COVID-19,11151A,Covid 19 - Ospedale S.Antonio Abate di Pontremoli,TOS,80-89,0,4,0,0,0,4,0,4,0,4,Toscana,ITI1
2020-12-31,COMIRNATY Vaccino a mRNA contro COVID-19,11151A,Covid 19 - Ospedale S.Antonio Abate di Pontremoli,TOS,90+,0,4,0,0,0,4,0,4,0,4,Toscana,ITI1
2020-12-31,COMIRNATY Vaccino a mRNA contro COVID-19,13021A,COVID19 - Ospedale S.Giovanni di Dio,TOS,20-29,1,1,0,2,0,0,0,2,0,2,Toscana,ITI1
2020-12-31,COMIRNATY Vaccino a mRNA contro COVID-19,13021A,COVID19 - Ospedale S.Giovanni di Dio,TOS,30-39,3,4,0,5,0,2,0,7,0,7,Toscana,ITI1
2020-12-31,COMIRNATY Vaccino a mRNA contro COVID-19,13021A,COVID19 - Ospedale S.Giovanni di Dio,TOS,40-49,2,6,0,3,0,5,0,8,0,8,Toscana,ITI1
2020-12-31,COMIRNATY Vaccino a mRNA contro COVID-19,13021A,COVID19 - Ospedale S.Giovanni di Dio,TOS,50-59,2,8,0,3,0,7,0,10,0,10,Toscana,ITI1
2020-12-31,COMIRNATY Vaccino a mRNA contro COVID-19,13021A,COVID19 - Ospedale S.Giovanni di Dio,TOS,60-69,6,10,0,1,0,15,0,16,0,16,Toscana,ITI1
2020-12-31,COMIRNATY Vaccino a mRNA contro COVID-19,13021A,COVID19 - Ospedale S.Giovanni di Dio,TOS,70-79,6,19,0,0,0,25,0,25,0,25,Toscana,ITI1
2020-12-31,COMIRNATY Vaccino a mRNA contro COVID-19,13021A,COVID19 - Ospedale S.Giovanni di Dio,TOS,80-89,6,50,0,0,0,56,0,56,0,56,Toscana,ITI1
2020-12-31,COMIRNATY Vaccino a mRNA contro COVID-19,13021A,COVID19 - Ospedale S.Giovanni di Dio,TOS,90+,3,35,0,0,0,38,0,38,0,38,Toscana,ITI1
2020-12-31,COMIRNATY Vaccino a mRNA contro COVID-19,220V4I,RSA MARGHERITA LEONCINI,TOS,40-49,1,1,0,2,0,0,0,2,0,2,Toscana,ITI1
2020-12-31,COMIRNATY Vaccino a mRNA contro COVID-19,220V4I,RSA MARGHERITA LEONCINI,TOS,50-59,2,1,0,1,0,2,0,3,0,3,Toscana,ITI1
2020-12-31,COMIRNATY Vaccino a mRNA contro COVID-19,220V4I,RSA MARGHERITA LEONCINI,TOS,60-69,1,1,0,2,0,0,0,2,0,2,Toscana,ITI1
2020-12-31,COMIRNATY Vaccino a mRNA contro COVID-19,220V4I,RSA MARGHERITA LEONCINI,TOS,70-79,1,0,0,0,0,1,0,1,0,1,Toscana,ITI1
2020-12-31,COMIRNATY Vaccino a mRNA contro COVID-19,220V4I,RSA MARGHERITA LEONCINI,TOS,80-89,0,1,0,0,0,1,0,1,0,1,Toscana,ITI1
2020-12-31,COMIRNATY Vaccino a mRNA contro COVID-19,220Z4I,RSA SORELLE MIGLIORATI,TOS,30-39,0,1,0,1,0,0,0,1,0,1,Toscana,ITI1
2020-12-31,COMIRNATY Vaccino a mRNA contro COVID-19,220Z4I,RSA SORELLE MIGLIORATI,TOS,40-49,0,1,0,1,0,0,0,1,0,1,Toscana,ITI1
2020-12-31,COMIRNATY Vaccino a mRNA contro COVID-19,220Z4I,RSA SORELLE MIGLIORATI,TOS,50-59,0,2,0,2,0,0,0,2,0,2,Toscana,ITI1
2020-12-31,COMIRNATY Vaccino a mRNA contro COVID-19,220Z4I,RSA SORELLE MIGLIORATI,TOS,60-69,0,1,0,0,0,1,0,1,0,1,Toscana,ITI1
2020-12-31,COMIRNATY Vaccino a mRNA contro COVID-19,220Z4I,RSA SORELLE MIGLIORATI,TOS,70-79,0,2,0,0,0,2,0,2,0,2,Toscana,ITI1
2020-12-31,COMIRNATY Vaccino a mRNA contro COVID-19,220Z4I,RSA SORELLE MIGLIORATI,TOS,80-89,1,2,0,0,0,3,0,3,0,3,Toscana,ITI1
2020-12-31,COMIRNATY Vaccino a mRNA contro COVID-19,220Z4I,RSA SORELLE MIGLIORATI,TOS,90+,1,3,0,0,0,4,0,4,0,4,Toscana,ITI1
2020-12-31,COMIRNATY Vaccino a mRNA contro COVID-19,22391A,PRESIDIO AVENZA,TOS,30-39,0,1,0,1,0,0,0,1,0,1,Toscana,ITI1
2020-12-31,COMIRNATY Vaccino a mRNA contro COVID-19,22391A,PRESIDIO AVENZA,TOS,50-59,0,2,0,2,0,0,0,2,0,2,Toscana,ITI1
2020-12-31,COMIRNATY Vaccino a mRNA contro COVID-19,22391A,PRESIDIO AVENZA,TOS,70-79,2,1,0,0,0,3,0,3,0,3,Toscana,ITI1
2020-12-31,COMIRNATY Vaccino a mRNA contro COVID-19,22391A,PRESIDIO AVENZA,TOS,80-89,0,3,0,0,0,3,0,3,0,3,Toscana,ITI1
2020-12-31,COMIRNATY Vaccino a mRNA contro COVID-19,22391A,PRESIDIO AVENZA,TOS,90+,0,3,0,0,0,3,0,3,0,3,Toscana,ITI1
2020-12-31,COMIRNATY Vaccino a mRNA contro COVID-19,31711A,Centro Vaccinale Abbadia S. Salvatore,TOS,30-39,1,0,0,1,0,0,0,1,0,1,Toscana,ITI1
2020-12-31,COMIRNATY Vaccino a mRNA contro COVID-19,31711A,Centro Vaccinale Abbadia S. Salvatore,TOS,40-49,0,2,0,2,0,0,0,2,0,2,Toscana,ITI1
2020-12-31,COMIRNATY Vaccino a mRNA contro COVID-19,31711A,Centro Vaccinale Abbadia S. Salvatore,TOS,60-69,2,0,0,0,0,2,0,2,0,2,Toscana,ITI1
2020-12-31,COMIRNATY Vaccino a mRNA contro COVID-19,31711A,Centro Vaccinale Abbadia S. Salvatore,TOS,70-79,2,2,0,0,0,4,0,4,0,4,Toscana,ITI1
2020-12-31,COMIRNATY Vaccino a mRNA contro COVID-19,31711A,Centro Vaccinale Abbadia S. Salvatore,TOS,80-89,1,7,0,2,0,6,0,8,0,8,Toscana,ITI1
2020-12-31,COMIRNATY Vaccino a mRNA contro COVID-19,31711A,Centro Vaccinale Abbadia S. Salvatore,TOS,90+,0,12,0,0,0,12,0,12,0,12,Toscana,ITI1
2020-12-31,COMIRNATY Vaccino a mRNA contro COVID-19,40911A,COVID19 - Dip. Prevenzione Ruffolo Siena,TOS,20-29,1,4,0,5,0,0,0,5,0,5,Toscana,ITI1
2020-12-31,COMIRNATY Vaccino a mRNA contro COVID-19,40911A,COVID19 - Dip. Prevenzione Ruffolo Siena,TOS,30-39,1,1,0,2,0,0,0,2,0,2,Toscana,ITI1
2020-12-31,COMIRNATY Vaccino a mRNA contro COVID-19,40911A,COVID19 - Dip. Prevenzione Ruffolo Siena,TOS,40-49,0,1,0,1,0,0,0,1,0,1,Toscana,ITI1
2020-12-31,COMIRNATY Vaccino a mRNA contro COVID-19,40911A,COVID19 - Dip. Prevenzione Ruffolo Siena,TOS,50-59,0,1,0,1,0,0,0,1,0,1,Toscana,ITI1
2020-12-31,COMIRNATY Vaccino a mRNA contro COVID-19,40911A,COVID19 - Dip. Prevenzione Ruffolo Siena,TOS,60-69,1,0,0,0,0,1,0,1,0,1,Toscana,ITI1
2020-12-31,COMIRNATY Vaccino a mRNA contro COVID-19,40911A,COVID19 - Dip. Prevenzione Ruffolo Siena,TOS,70-79,1,0,0,0,0,1,0,1,0,1,Toscana,ITI1
2020-12-31,COMIRNATY Vaccino a mRNA contro COVID-19,40911A,COVID19 - Dip. Prevenzione Ruffolo Siena,TOS,80-89,3,3,0,0,0,6,0,6,0,6,Toscana,ITI1
2020-12-31,COMIRNATY Vaccino a mRNA contro COVID-19,40911A,COVID19 - Dip. Prevenzione Ruffolo Siena,TOS,90+,0,7,0,0,0,7,0,7,0,7,Toscana,ITI1
2020-12-31,COMIRNATY Vaccino a mRNA contro COVID-19,46151A,CSS Portoferraio,TOS,40-49,0,2,0,2,0,0,0,2,0,2,Toscana,ITI1
2020-12-31,COMIRNATY Vaccino a mRNA contro COVID-19,46151A,CSS Portoferraio,TOS,50-59,0,2,0,2,0,0,0,2,0,2,Toscana,ITI1
2020-12-31,COMIRNATY Vaccino a mRNA contro COVID-19,46151A,CSS Portoferraio,TOS,60-69,0,2,0,2,0,0,0,2,0,2,Toscana,ITI1
2020-12-31,COMIRNATY Vaccino a mRNA contro COVID-19,46151A,CSS Portoferraio,TOS,70-79,0,2,0,0,0,2,0,2,0,2,Toscana,ITI1
2020-12-31,COMIRNATY Vaccino a mRNA contro COVID-19,46151A,CSS Portoferraio,TOS,80-89,0,7,0,0,0,7,0,7,0,7,Toscana,ITI1
2020-12-31,COMIRNATY Vaccino a mRNA contro COVID-19,46151A,CSS Portoferraio,TOS,90+,0,3,0,0,0,3,0,3,0,3,Toscana,ITI1
2020-12-31,COMIRNATY Vaccino a mRNA contro COVID-19,ND,Dip.Prevenzione PISA - ISP,TOS,20-29,1,0,0,1,0,0,0,1,0,1,Toscana,ITI1
2020-12-31,COMIRNATY Vaccino a mRNA contro COVID-19,ND,Dip.Prevenzione PISA - ISP,TOS,30-39,0,1,0,1,0,0,0,1,0,1,Toscana,ITI1
2020-12-31,COMIRNATY Vaccino a mRNA contro COVID-19,ND,Dip.Prevenzione PISA - ISP,TOS,40-49,1,0,0,1,0,0,0,1,0,1,Toscana,ITI1
2020-12-31,COMIRNATY Vaccino a mRNA contro COVID-19,ND,Dip.Prevenzione PISA - ISP,TOS,50-59,1,1,0,0,0,2,0,2,0,2,Toscana,ITI1
2020-12-31,COMIRNATY Vaccino a mRNA contro COVID-19,ND,Dip.Prevenzione PISA - ISP,TOS,60-69,2,0,0,0,0,2,0,2,0,2,Toscana,ITI1
2020-12-31,COMIRNATY Vaccino a mRNA contro COVID-19,ND,Dip.Prevenzione PISA - ISP,TOS,70-79,3,0,0,0,0,3,0,3,0,3,Toscana,ITI1
2020-12-31,COMIRNATY Vaccino a mRNA contro COVID-19,ND,Dip.Prevenzione PISA - ISP,TOS,80-89,2,2,0,0,0,4,0,4,0,4,Toscana,ITI1
2020-12-31,COMIRNATY Vaccino a mRNA contro COVID-19,ND,Dip.Prevenzione PISA - ISP,TOS,90+,0,8,0,0,0,8,0,8,0,8,Toscana,ITI1
2021-01-01,COMIRNATY Vaccino a mRNA contro COVID-19,090602,Covid 19 - Nuovo Ospedale Apuane,TOS,20-29,4,4,0,8,0,0,0,8,0,8,Toscana,ITI1
2021-01-01,COMIRNATY Vaccino a mRNA contro COVID-19,090602,Covid 19 - Nuovo Ospedale Apuane,TOS,30-39,4,5,0,9,0,0,0,9,0,9,Toscana,ITI1
2021-01-01,COMIRNATY Vaccino a mRNA contro COVID-19,090602,Covid 19 - Nuovo Ospedale Apuane,TOS,40-49,1,6,0,7,0,0,0,7,0,7,Toscana,ITI1
2021-01-01,COMIRNATY Vaccino a mRNA contro COVID-19,090602,Covid 19 - Nuovo Ospedale Apuane,TOS,50-59,4,14,0,18,0,0,0,18,0,18,Toscana,ITI1
2021-01-01,COMIRNATY Vaccino a mRNA contro COVID-19,090602,Covid 19 - Nuovo Ospedale Apuane,TOS,60-69,4,2,0,6,0,0,0,6,0,6,Toscana,ITI1
2021-01-01,COMIRNATY Vaccino a mRNA contro COVID-19,090604,Covid 19 - Ospedale San Luca di  Lucca,TOS,20-29,1,1,0,2,0,0,0,2,0,2,Toscana,ITI1
2021-01-01,COMIRNATY Vaccino a mRNA contro COVID-19,090604,Covid 19 - Ospedale San Luca di  Lucca,TOS,30-39,3,9,0,12,0,0,0,12,0,12,Toscana,ITI1
2021-01-01,COMIRNATY Vaccino a mRNA contro COVID-19,090604,Covid 19 - Ospedale San Luca di  Lucca,TOS,40-49,5,10,0,15,0,0,0,15,0,15,Toscana,ITI1
2021-01-01,COMIRNATY Vaccino a mRNA contro COVID-19,090604,Covid 19 - Ospedale San Luca di  Lucca,TOS,50-59,5,14,0,19,0,0,0,19,0,19,Toscana,ITI1
2021-01-01,COMIRNATY Vaccino a mRNA contro COVID-19,090604,Covid 19 - Ospedale San Luca di  Lucca,TOS,60-69,6,4,0,7,0,3,0,10,0,10,Toscana,ITI1
2021-01-01,COMIRNATY Vaccino a mRNA contro COVID-19,090604,Covid 19 - Ospedale San Luca di  Lucca,TOS,70-79,3,2,0,0,0,5,0,5,0,5,Toscana,ITI1
2021-01-01,COMIRNATY Vaccino a mRNA contro COVID-19,090604,Covid 19 - Ospedale San Luca di  Lucca,TOS,80-89,2,2,0,0,0,4,0,4,0,4,Toscana,ITI1
2021-01-01,COMIRNATY Vaccino a mRNA contro COVID-19,090604,Covid 19 - Ospedale San Luca di  Lucca,TOS,90+,0,1,0,0,0,1,0,1,0,1,Toscana,ITI1
2021-01-01,COMIRNATY Vaccino a mRNA contro COVID-19,090606,COVID19 - Ospedale San Iacopo,TOS,20-29,2,5,0,7,0,0,0,7,0,7,Toscana,ITI1
2021-01-01,COMIRNATY Vaccino a mRNA contro COVID-19,090606,COVID19 - Ospedale San Iacopo,TOS,30-39,3,13,0,16,0,0,0,16,0,16,Toscana,ITI1
2021-01-01,COMIRNATY Vaccino a mRNA contro COVID-19,090606,COVID19 - Ospedale San Iacopo,TOS,40-49,6,15,0,21,0,0,0,21,0,21,Toscana,ITI1
2021-01-01,COMIRNATY Vaccino a mRNA contro COVID-19,090606,COVID19 - Ospedale San Iacopo,TOS,50-59,7,18,0,25,0,0,0,25,0,25,Toscana,ITI1
2021-01-01,COMIRNATY Vaccino a mRNA contro COVID-19,090606,COVID19 - Ospedale San Iacopo,TOS,60-69,4,8,0,10,0,2,0,12,0,12,Toscana,ITI1
2021-01-01,COMIRNATY Vaccino a mRNA contro COVID-19,090606,COVID19 - Ospedale San Iacopo,TOS,70-79,3,3,0,0,0,6,0,6,0,6,Toscana,ITI1
2021-01-01,COMIRNATY Vaccino a mRNA contro COVID-19,090606,COVID19 - Ospedale San Iacopo,TOS,80-89,2,8,0,0,0,10,0,10,0,10,Toscana,ITI1
2021-01-01,COMIRNATY Vaccino a mRNA contro COVID-19,090606,COVID19 - Ospedale San Iacopo,TOS,90+,4,14,0,2,0,16,0,18,0,18,Toscana,ITI1
2021-01-01,COMIRNATY Vaccino a mRNA contro COVID-19,090608,COVID19 - Ospedale Santo Stefano,TOS,20-29,1,7,0,8,0,0,0,8,0,8,Toscana,ITI1
2021-01-01,COMIRNATY Vaccino a mRNA contro COVID-19,090608,COVID19 - Ospedale Santo Stefano,TOS,30-39,9,17,0,25,0,1,0,26,0,26,Toscana,ITI1
2021-01-01,COMIRNATY Vaccino a mRNA contro COVID-19,090608,COVID19 - Ospedale Santo Stefano,TOS,40-49,6,15,0,21,0,0,0,21,0,21,Toscana,ITI1
2021-01-01,COMIRNATY Vaccino a mRNA contro COVID-19,090608,COVID19 - Ospedale Santo Stefano,TOS,50-59,5,16,0,21,0,0,0,21,0,21,Toscana,ITI1
2021-01-01,COMIRNATY Vaccino a mRNA contro COVID-19,090608,COVID19 - Ospedale Santo Stefano,TOS,60-69,5,5,0,6,0,4,0,10,0,10,Toscana,ITI1
2021-01-01,COMIRNATY Vaccino a mRNA contro COVID-19,090608,COVID19 - Ospedale Santo Stefano,TOS,70-79,7,1,0,0,0,8,0,8,0,8,Toscana,ITI1
2021-01-01,COMIRNATY Vaccino a mRNA contro COVID-19,090608,COVID19 - Ospedale Santo Stefano,TOS,80-89,6,15,0,0,0,21,0,21,0,21,Toscana,ITI1
2021-01-01,COMIRNATY Vaccino a mRNA contro COVID-19,090608,COVID19 - Ospedale Santo Stefano,TOS,90+,1,18,0,0,0,19,0,19,0,19,Toscana,ITI1
2021-01-01,COMIRNATY Vaccino a mRNA contro COVID-19,090610,Covid 19 - Ospedale F.Lotti di Pontedera,TOS,20-29,1,3,0,4,0,0,0,4,0,4,Toscana,ITI1
2021-01-01,COMIRNATY Vaccino a mRNA contro COVID-19,090610,Covid 19 - Ospedale F.Lotti di Pontedera,TOS,30-39,0,7,0,7,0,0,0,7,0,7,Toscana,ITI1
2021-01-01,COMIRNATY Vaccino a mRNA contro COVID-19,090610,Covid 19 - Ospedale F.Lotti di Pontedera,TOS,40-49,3,7,0,10,0,0,0,10,0,10,Toscana,ITI1
2021-01-01,COMIRNATY Vaccino a mRNA contro COVID-19,090610,Covid 19 - Ospedale F.Lotti di Pontedera,TOS,50-59,3,6,0,9,0,0,0,9,0,9,Toscana,ITI1
2021-01-01,COMIRNATY Vaccino a mRNA contro COVID-19,090610,Covid 19 - Ospedale F.Lotti di Pontedera,TOS,60-69,0,1,0,1,0,0,0,1,0,1,Toscana,ITI1
2021-01-01,COMIRNATY Vaccino a mRNA contro COVID-19,090613,Covid 19 - Ospedali Riuniti di Livorno,TOS,20-29,2,3,0,5,0,0,0,5,0,5,Toscana,ITI1
2021-01-01,COMIRNATY Vaccino a mRNA contro COVID-19,090613,Covid 19 - Ospedali Riuniti di Livorno,TOS,30-39,3,6,0,9,0,0,0,9,0,9,Toscana,ITI1
2021-01-01,COMIRNATY Vaccino a mRNA contro COVID-19,090613,Covid 19 - Ospedali Riuniti di Livorno,TOS,40-49,2,17,0,19,0,0,0,19,0,19,Toscana,ITI1
2021-01-01,COMIRNATY Vaccino a mRNA contro COVID-19,090613,Covid 19 - Ospedali Riuniti di Livorno,TOS,50-59,6,10,0,16,0,0,0,16,0,16,Toscana,ITI1
2021-01-01,COMIRNATY Vaccino a mRNA contro COVID-19,090613,Covid 19 - Ospedali Riuniti di Livorno,TOS,60-69,7,3,0,10,0,0,0,10,0,10,Toscana,ITI1
2021-01-01,COMIRNATY Vaccino a mRNA contro COVID-19,090614,Covid 19 - Ospedale Civile di Piombino,TOS,20-29,1,2,0,3,0,0,0,3,0,3,Toscana,ITI1
2021-01-01,COMIRNATY Vaccino a mRNA contro COVID-19,090614,Covid 19 - Ospedale Civile di Piombino,TOS,30-39,3,3,0,6,0,0,0,6,0,6,Toscana,ITI1
2021-01-01,COMIRNATY Vaccino a mRNA contro COVID-19,090614,Covid 19 - Ospedale Civile di Piombino,TOS,40-49,2,3,0,5,0,0,0,5,0,5,Toscana,ITI1
2021-01-01,COMIRNATY Vaccino a mRNA contro COVID-19,090614,Covid 19 - Ospedale Civile di Piombino,TOS,50-59,4,7,0,11,0,0,0,11,0,11,Toscana,ITI1
2021-01-01,COMIRNATY Vaccino a mRNA contro COVID-19,090614,Covid 19 - Ospedale Civile di Piombino,TOS,60-69,2,2,0,4,0,0,0,4,0,4,Toscana,ITI1
2021-01-01,COMIRNATY Vaccino a mRNA contro COVID-19,090621,COVID19 - Ospedale di Arezzo,TOS,20-29,3,27,0,30,0,0,0,30,0,30,Toscana,ITI1
2021-01-01,COMIRNATY Vaccino a mRNA contro COVID-19,090621,COVID19 - Ospedale di Arezzo,TOS,30-39,7,19,0,26,0,0,0,26,0,26,Toscana,ITI1
2021-01-01,COMIRNATY Vaccino a mRNA contro COVID-19,090621,COVID19 - Ospedale di Arezzo,TOS,40-49,5,16,0,21,0,0,0,21,0,21,Toscana,ITI1
2021-01-01,COMIRNATY Vaccino a mRNA contro COVID-19,090621,COVID19 - Ospedale di Arezzo,TOS,50-59,8,16,0,24,0,0,0,24,0,24,Toscana,ITI1
2021-01-01,COMIRNATY Vaccino a mRNA contro COVID-19,090621,COVID19 - Ospedale di Arezzo,TOS,60-69,1,0,0,1,0,0,0,1,0,1,Toscana,ITI1
2021-01-01,COMIRNATY Vaccino a mRNA contro COVID-19,090625,COVID19 - Ospedale Amiata Castel del Piano,TOS,20-29,1,2,0,3,0,0,0,3,0,3,Toscana,ITI1
2021-01-01,COMIRNATY Vaccino a mRNA contro COVID-19,090625,COVID19 - Ospedale Amiata Castel del Piano,TOS,30-39,0,2,0,2,0,0,0,2,0,2,Toscana,ITI1
2021-01-01,COMIRNATY Vaccino a mRNA contro COVID-19,090625,COVID19 - Ospedale Amiata Castel del Piano,TOS,40-49,2,0,0,2,0,0,0,2,0,2,Toscana,ITI1
2021-01-01,COMIRNATY Vaccino a mRNA contro COVID-19,090625,COVID19 - Ospedale Amiata Castel del Piano,TOS,50-59,1,5,0,3,0,3,0,6,0,6,Toscana,ITI1
2021-01-01,COMIRNATY Vaccino a mRNA contro COVID-19,090625,COVID19 - Ospedale Amiata Castel del Piano,TOS,60-69,3,1,0,0,0,4,0,4,0,4,Toscana,ITI1
2021-01-01,COMIRNATY Vaccino a mRNA contro COVID-19,090625,COVID19 - Ospedale Amiata Castel del Piano,TOS,70-79,6,4,0,0,0,10,0,10,0,10,Toscana,ITI1
2021-01-01,COMIRNATY Vaccino a mRNA contro COVID-19,090625,COVID19 - Ospedale Amiata Castel del Piano,TOS,80-89,6,10,0,0,0,16,0,16,0,16,Toscana,ITI1
2021-01-01,COMIRNATY Vaccino a mRNA contro COVID-19,090625,COVID19 - Ospedale Amiata Castel del Piano,TOS,90+,4,18,0,0,0,22,0,22,0,22,Toscana,ITI1
2021-01-01,COMIRNATY Vaccino a mRNA contro COVID-19,090626,COVID19 - Ospedale di Grosseto,TOS,20-29,1,12,0,13,0,0,0,13,0,13,Toscana,ITI1
2021-01-01,COMIRNATY Vaccino a mRNA contro COVID-19,090626,COVID19 - Ospedale di Grosseto,TOS,30-39,6,17,0,23,0,0,0,23,0,23,Toscana,ITI1
2021-01-01,COMIRNATY Vaccino a mRNA contro COVID-19,090626,COVID19 - Ospedale di Grosseto,TOS,40-49,7,19,0,26,0,0,0,26,0,26,Toscana,ITI1
2021-01-01,COMIRNATY Vaccino a mRNA contro COVID-19,090626,COVID19 - Ospedale di Grosseto,TOS,50-59,5,27,0,32,0,0,0,32,0,32,Toscana,ITI1
2021-01-01,COMIRNATY Vaccino a mRNA contro COVID-19,090626,COVID19 - Ospedale di Grosseto,TOS,60-69,2,6,0,8,0,0,0,8,0,8,Toscana,ITI1
2021-01-01,COMIRNATY Vaccino a mRNA contro COVID-19,090627,COVID19 - Ospedale Mugello,TOS,50-59,1,0,0,0,0,1,0,1,0,1,Toscana,ITI1
2021-01-01,COMIRNATY Vaccino a mRNA contro COVID-19,090627,COVID19 - Ospedale Mugello,TOS,60-69,0,2,0,0,0,2,0,2,0,2,Toscana,ITI1
2021-01-01,COMIRNATY Vaccino a mRNA contro COVID-19,090627,COVID19 - Ospedale Mugello,TOS,70-79,5,3,0,0,0,8,0,8,0,8,Toscana,ITI1
2021-01-01,COMIRNATY Vaccino a mRNA contro COVID-19,090627,COVID19 - Ospedale Mugello,TOS,80-89,7,6,0,0,0,13,0,13,0,13,Toscana,ITI1
2021-01-01,COMIRNATY Vaccino a mRNA contro COVID-19,090627,COVID19 - Ospedale Mugello,TOS,90+,2,8,0,0,0,10,0,10,0,10,Toscana,ITI1
2021-01-01,COMIRNATY Vaccino a mRNA contro COVID-19,090629,COVID19 - Ospedale SS. Maria Annunziata,TOS,20-29,4,8,0,11,1,0,0,12,0,12,Toscana,ITI1
2021-01-01,COMIRNATY Vaccino a mRNA contro COVID-19,090629,COVID19 - Ospedale SS. Maria Annunziata,TOS,30-39,6,14,0,20,0,0,0,20,0,20,Toscana,ITI1
2021-01-01,COMIRNATY Vaccino a mRNA contro COVID-19,090629,COVID19 - Ospedale SS. Maria Annunziata,TOS,40-49,9,14,0,23,0,0,0,23,0,23,Toscana,ITI1
2021-01-01,COMIRNATY Vaccino a mRNA contro COVID-19,090629,COVID19 - Ospedale SS. Maria Annunziata,TOS,50-59,12,25,0,37,0,0,0,37,0,37,Toscana,ITI1
2021-01-01,COMIRNATY Vaccino a mRNA contro COVID-19,090629,COVID19 - Ospedale SS. Maria Annunziata,TOS,60-69,9,5,0,14,0,0,0,14,0,14,Toscana,ITI1
2021-01-01,COMIRNATY Vaccino a mRNA contro COVID-19,090629,COVID19 - Ospedale SS. Maria Annunziata,TOS,70-79,1,0,0,0,0,1,0,1,0,1,Toscana,ITI1
2021-01-01,COMIRNATY Vaccino a mRNA contro COVID-19,090629,COVID19 - Ospedale SS. Maria Annunziata,TOS,80-89,1,12,0,0,0,13,0,13,0,13,Toscana,ITI1
2021-01-01,COMIRNATY Vaccino a mRNA contro COVID-19,090629,COVID19 - Ospedale SS. Maria Annunziata,TOS,90+,3,18,0,0,0,21,0,21,0,21,Toscana,ITI1
2021-01-01,COMIRNATY Vaccino a mRNA contro COVID-19,090638,COVID19 - Ospedale di Campostaggia Poggibonsi,TOS,30-39,1,0,0,1,0,0,0,1,0,1,Toscana,ITI1
2021-01-01,COMIRNATY Vaccino a mRNA contro COVID-19,090638,COVID19 - Ospedale di Campostaggia Poggibonsi,TOS,40-49,0,2,0,2,0,0,0,2,0,2,Toscana,ITI1
2021-01-01,COMIRNATY Vaccino a mRNA contro COVID-19,090638,COVID19 - Ospedale di Campostaggia Poggibonsi,TOS,50-59,0,1,0,1,0,0,0,1,0,1,Toscana,ITI1
2021-01-01,COMIRNATY Vaccino a mRNA contro COVID-19,090638,COVID19 - Ospedale di Campostaggia Poggibonsi,TOS,60-69,0,1,0,0,0,1,0,1,0,1,Toscana,ITI1
2021-01-01,COMIRNATY Vaccino a mRNA contro COVID-19,090638,COVID19 - Ospedale di Campostaggia Poggibonsi,TOS,70-79,1,1,0,0,0,2,0,2,0,2,Toscana,ITI1
2021-01-01,COMIRNATY Vaccino a mRNA contro COVID-19,090638,COVID19 - Ospedale di Campostaggia Poggibonsi,TOS,80-89,3,5,0,0,0,8,0,8,0,8,Toscana,ITI1
2021-01-01,COMIRNATY Vaccino a mRNA contro COVID-19,090638,COVID19 - Ospedale di Campostaggia Poggibonsi,TOS,90+,1,9,0,0,0,10,0,10,0,10,Toscana,ITI1
2021-01-01,COMIRNATY Vaccino a mRNA contro COVID-19,090639,COVID19 - Ospedale di Nottola Montepulciano,TOS,20-29,0,1,0,1,0,0,0,1,0,1,Toscana,ITI1
2021-01-01,COMIRNATY Vaccino a mRNA contro COVID-19,090639,COVID19 - Ospedale di Nottola Montepulciano,TOS,30-39,2,1,0,2,0,1,0,3,0,3,Toscana,ITI1
2021-01-01,COMIRNATY Vaccino a mRNA contro COVID-19,090639,COVID19 - Ospedale di Nottola Montepulciano,TOS,40-49,1,0,0,1,0,0,0,1,0,1,Toscana,ITI1
2021-01-01,COMIRNATY Vaccino a mRNA contro COVID-19,090639,COVID19 - Ospedale di Nottola Montepulciano,TOS,50-59,2,3,0,3,0,2,0,5,0,5,Toscana,ITI1
2021-01-01,COMIRNATY Vaccino a mRNA contro COVID-19,090639,COVID19 - Ospedale di Nottola Montepulciano,TOS,60-69,2,0,0,1,0,1,0,2,0,2,Toscana,ITI1
2021-01-01,COMIRNATY Vaccino a mRNA contro COVID-19,090639,COVID19 - Ospedale di Nottola Montepulciano,TOS,70-79,1,1,0,0,0,2,0,2,0,2,Toscana,ITI1
2021-01-01,COMIRNATY Vaccino a mRNA contro COVID-19,090639,COVID19 - Ospedale di Nottola Montepulciano,TOS,80-89,3,17,0,0,0,20,0,20,0,20,Toscana,ITI1
2021-01-01,COMIRNATY Vaccino a mRNA contro COVID-19,090639,COVID19 - Ospedale di Nottola Montepulciano,TOS,90+,2,6,0,0,0,8,0,8,0,8,Toscana,ITI1
2021-01-01,COMIRNATY Vaccino a mRNA contro COVID-19,090640,Covid 19 - Ospedale Unico Versilia,TOS,20-29,2,1,0,3,0,0,0,3,0,3,Toscana,ITI1
2021-01-01,COMIRNATY Vaccino a mRNA contro COVID-19,090640,Covid 19 - Ospedale Unico Versilia,TOS,30-39,5,7,0,12,0,0,0,12,0,12,Toscana,ITI1
2021-01-01,COMIRNATY Vaccino a mRNA contro COVID-19,090640,Covid 19 - Ospedale Unico Versilia,TOS,40-49,2,8,0,10,0,0,0,10,0,10,Toscana,ITI1
2021-01-01,COMIRNATY Vaccino a mRNA contro COVID-19,090640,Covid 19 - Ospedale Unico Versilia,TOS,50-59,5,9,0,14,0,0,0,14,0,14,Toscana,ITI1
2021-01-01,COMIRNATY Vaccino a mRNA contro COVID-19,090640,Covid 19 - Ospedale Unico Versilia,TOS,60-69,7,2,0,9,0,0,0,9,0,9,Toscana,ITI1
2021-01-01,COMIRNATY Vaccino a mRNA contro COVID-19,090641,COVID19 - Ospedale La Gruccia Montevarchi,TOS,30-39,0,2,0,2,0,0,0,2,0,2,Toscana,ITI1
2021-01-01,COMIRNATY Vaccino a mRNA contro COVID-19,090641,COVID19 - Ospedale La Gruccia Montevarchi,TOS,50-59,0,2,0,2,0,0,0,2,0,2,Toscana,ITI1
2021-01-01,COMIRNATY Vaccino a mRNA contro COVID-19,090641,COVID19 - Ospedale La Gruccia Montevarchi,TOS,60-69,2,1,0,2,0,1,0,3,0,3,Toscana,ITI1
2021-01-01,COMIRNATY Vaccino a mRNA contro COVID-19,090641,COVID19 - Ospedale La Gruccia Montevarchi,TOS,70-79,0,1,0,1,0,0,0,1,0,1,Toscana,ITI1
2021-01-01,COMIRNATY Vaccino a mRNA contro COVID-19,090641,COVID19 - Ospedale La Gruccia Montevarchi,TOS,80-89,1,10,0,0,0,11,0,11,0,11,Toscana,ITI1
2021-01-01,COMIRNATY Vaccino a mRNA contro COVID-19,090641,COVID19 - Ospedale La Gruccia Montevarchi,TOS,90+,2,15,0,0,0,17,0,17,0,17,Toscana,ITI1
2021-01-01,COMIRNATY Vaccino a mRNA contro COVID-19,090901,COVID19 - AOU Pisana,TOS,20-29,7,10,0,17,0,0,0,17,0,17,Toscana,ITI1
2021-01-01,COMIRNATY Vaccino a mRNA contro COVID-19,090901,COVID19 - AOU Pisana,TOS,30-39,19,30,0,49,0,0,0,49,0,49,Toscana,ITI1
2021-01-01,COMIRNATY Vaccino a mRNA contro COVID-19,090901,COVID19 - AOU Pisana,TOS,40-49,19,44,0,62,1,0,0,63,0,63,Toscana,ITI1
2021-01-01,COMIRNATY Vaccino a mRNA contro COVID-19,090901,COVID19 - AOU Pisana,TOS,50-59,32,31,0,63,0,0,0,63,0,63,Toscana,ITI1
2021-01-01,COMIRNATY Vaccino a mRNA contro COVID-19,090901,COVID19 - AOU Pisana,TOS,60-69,18,12,0,30,0,0,0,30,0,30,Toscana,ITI1
2021-01-01,COMIRNATY Vaccino a mRNA contro COVID-19,090902,COVID19 - AOU Senese,TOS,20-29,5,1,0,6,0,0,0,6,0,6,Toscana,ITI1
2021-01-01,COMIRNATY Vaccino a mRNA contro COVID-19,090902,COVID19 - AOU Senese,TOS,30-39,11,9,0,20,0,0,0,20,0,20,Toscana,ITI1
2021-01-01,COMIRNATY Vaccino a mRNA contro COVID-19,090902,COVID19 - AOU Senese,TOS,40-49,12,11,0,23,0,0,0,23,0,23,Toscana,ITI1
2021-01-01,COMIRNATY Vaccino a mRNA contro COVID-19,090902,COVID19 - AOU Senese,TOS,50-59,14,33,0,47,0,0,0,47,0,47,Toscana,ITI1
2021-01-01,COMIRNATY Vaccino a mRNA contro COVID-19,090902,COVID19 - AOU Senese,TOS,60-69,19,13,0,32,0,0,0,32,0,32,Toscana,ITI1
2021-01-01,COMIRNATY Vaccino a mRNA contro COVID-19,090903,COVID19 - AOU Careggi - CTO,TOS,20-29,21,41,0,62,0,0,0,62,0,62,Toscana,ITI1
2021-01-01,COMIRNATY Vaccino a mRNA contro COVID-19,090903,COVID19 - AOU Careggi - CTO,TOS,30-39,28,34,0,62,0,0,0,62,0,62,Toscana,ITI1
2021-01-01,COMIRNATY Vaccino a mRNA contro COVID-19,090903,COVID19 - AOU Careggi - CTO,TOS,40-49,26,44,0,70,0,0,0,70,0,70,Toscana,ITI1
2021-01-01,COMIRNATY Vaccino a mRNA contro COVID-19,090903,COVID19 - AOU Careggi - CTO,TOS,50-59,30,36,0,66,0,0,0,66,0,66,Toscana,ITI1
2021-01-01,COMIRNATY Vaccino a mRNA contro COVID-19,090903,COVID19 - AOU Careggi - CTO,TOS,60-69,12,9,0,21,0,0,0,21,0,21,Toscana,ITI1
2021-01-01,COMIRNATY Vaccino a mRNA contro COVID-19,090904,COVID19 - Ospedale AOU Meyer,TOS,20-29,0,6,0,6,0,0,0,6,0,6,Toscana,ITI1
2021-01-01,COMIRNATY Vaccino a mRNA contro COVID-19,090904,COVID19 - Ospedale AOU Meyer,TOS,30-39,2,8,0,10,0,0,0,10,0,10,Toscana,ITI1
2021-01-01,COMIRNATY Vaccino a mRNA contro COVID-19,090904,COVID19 - Ospedale AOU Meyer,TOS,40-49,5,14,0,19,0,0,0,19,0,19,Toscana,ITI1
2021-01-01,COMIRNATY Vaccino a mRNA contro COVID-19,090904,COVID19 - Ospedale AOU Meyer,TOS,50-59,1,6,0,6,0,1,0,7,0,7,Toscana,ITI1
2021-01-01,COMIRNATY Vaccino a mRNA contro COVID-19,090904,COVID19 - Ospedale AOU Meyer,TOS,60-69,0,2,0,2,0,0,0,2,0,2,Toscana,ITI1
2021-01-01,COMIRNATY Vaccino a mRNA contro COVID-19,11012E,COVID19 - Ospedale San Giuseppe,TOS,20-29,4,2,0,6,0,0,0,6,0,6,Toscana,ITI1
2021-01-01,COMIRNATY Vaccino a mRNA contro COVID-19,11012E,COVID19 - Ospedale San Giuseppe,TOS,30-39,6,12,0,16,0,2,0,18,0,18,Toscana,ITI1
2021-01-01,COMIRNATY Vaccino a mRNA contro COVID-19,11012E,COVID19 - Ospedale San Giuseppe,TOS,40-49,8,17,0,24,0,1,0,25,0,25,Toscana,ITI1
2021-01-01,COMIRNATY Vaccino a mRNA contro COVID-19,11012E,COVID19 - Ospedale San Giuseppe,TOS,50-59,6,22,0,25,0,3,0,28,0,28,Toscana,ITI1
2021-01-01,COMIRNATY Vaccino a mRNA contro COVID-19,11012E,COVID19 - Ospedale San Giuseppe,TOS,60-69,4,5,0,6,0,3,0,9,0,9,Toscana,ITI1
2021-01-01,COMIRNATY Vaccino a mRNA contro COVID-19,11012E,COVID19 - Ospedale San Giuseppe,TOS,70-79,1,3,0,0,0,4,0,4,0,4,Toscana,ITI1
2021-01-01,COMIRNATY Vaccino a mRNA contro COVID-19,11012E,COVID19 - Ospedale San Giuseppe,TOS,80-89,3,10,0,0,0,13,0,13,0,13,Toscana,ITI1
2021-01-01,COMIRNATY Vaccino a mRNA contro COVID-19,11012E,COVID19 - Ospedale San Giuseppe,TOS,90+,2,9,0,0,0,11,0,11,0,11,Toscana,ITI1
2021-01-01,COMIRNATY Vaccino a mRNA contro COVID-19,11151A,Covid 19 - Ospedale S.Antonio Abate di Pontremoli,TOS,60-69,2,0,0,0,0,2,0,2,0,2,Toscana,ITI1
2021-01-01,COMIRNATY Vaccino a mRNA contro COVID-19,11151A,Covid 19 - Ospedale S.Antonio Abate di Pontremoli,TOS,70-79,3,2,0,0,0,5,0,5,0,5,Toscana,ITI1
2021-01-01,COMIRNATY Vaccino a mRNA contro COVID-19,11151A,Covid 19 - Ospedale S.Antonio Abate di Pontremoli,TOS,80-89,3,5,0,0,0,8,0,8,0,8,Toscana,ITI1
2021-01-01,COMIRNATY Vaccino a mRNA contro COVID-19,11151A,Covid 19 - Ospedale S.Antonio Abate di Pontremoli,TOS,90+,1,2,0,0,0,3,0,3,0,3,Toscana,ITI1
2021-01-01,COMIRNATY Vaccino a mRNA contro COVID-19,13021A,COVID19 - Ospedale S.Giovanni di Dio,TOS,20-29,9,13,0,22,0,0,0,22,0,22,Toscana,ITI1
2021-01-01,COMIRNATY Vaccino a mRNA contro COVID-19,13021A,COVID19 - Ospedale S.Giovanni di Dio,TOS,30-39,8,15,0,23,0,0,0,23,0,23,Toscana,ITI1
2021-01-01,COMIRNATY Vaccino a mRNA contro COVID-19,13021A,COVID19 - Ospedale S.Giovanni di Dio,TOS,40-49,14,21,0,34,0,1,0,35,0,35,Toscana,ITI1
2021-01-01,COMIRNATY Vaccino a mRNA contro COVID-19,13021A,COVID19 - Ospedale S.Giovanni di Dio,TOS,50-59,18,26,0,40,0,4,0,44,0,44,Toscana,ITI1
2021-01-01,COMIRNATY Vaccino a mRNA contro COVID-19,13021A,COVID19 - Ospedale S.Giovanni di Dio,TOS,60-69,12,6,0,15,0,3,0,18,0,18,Toscana,ITI1
2021-01-01,COMIRNATY Vaccino a mRNA contro COVID-19,13021A,COVID19 - Ospedale S.Giovanni di Dio,TOS,70-79,5,9,0,1,0,13,0,14,0,14,Toscana,ITI1
2021-01-01,COMIRNATY Vaccino a mRNA contro COVID-19,13021A,COVID19 - Ospedale S.Giovanni di Dio,TOS,80-89,7,53,0,2,0,58,0,60,0,60,Toscana,ITI1
2021-01-01,COMIRNATY Vaccino a mRNA contro COVID-19,13021A,COVID19 - Ospedale S.Giovanni di Dio,TOS,90+,3,63,0,0,0,66,0,66,0,66,Toscana,ITI1
2021-01-01,COMIRNATY Vaccino a mRNA contro COVID-19,16121A,Covid 19 - Ospedale Civile di Cecina,TOS,30-39,0,1,0,1,0,0,0,1,0,1,Toscana,ITI1
2021-01-01,COMIRNATY Vaccino a mRNA contro COVID-19,16121A,Covid 19 - Ospedale Civile di Cecina,TOS,40-49,0,9,0,9,0,0,0,9,0,9,Toscana,ITI1
2021-01-01,COMIRNATY Vaccino a mRNA contro COVID-19,16121A,Covid 19 - Ospedale Civile di Cecina,TOS,50-59,7,7,0,13,0,1,0,14,0,14,Toscana,ITI1
2021-01-01,COMIRNATY Vaccino a mRNA contro COVID-19,16121A,Covid 19 - Ospedale Civile di Cecina,TOS,60-69,5,3,0,8,0,0,0,8,0,8,Toscana,ITI1
2021-01-01,COMIRNATY Vaccino a mRNA contro COVID-19,16121A,Covid 19 - Ospedale Civile di Cecina,TOS,70-79,5,3,0,2,0,6,0,8,0,8,Toscana,ITI1
2021-01-01,COMIRNATY Vaccino a mRNA contro COVID-19,16121A,Covid 19 - Ospedale Civile di Cecina,TOS,80-89,3,8,0,1,0,10,0,11,0,11,Toscana,ITI1
2021-01-01,COMIRNATY Vaccino a mRNA contro COVID-19,16121A,Covid 19 - Ospedale Civile di Cecina,TOS,90+,1,8,0,0,0,9,0,9,0,9,Toscana,ITI1
2021-01-01,COMIRNATY Vaccino a mRNA contro COVID-19,22391A,PRESIDIO AVENZA,TOS,20-29,0,1,0,1,0,0,0,1,0,1,Toscana,ITI1
2021-01-01,COMIRNATY Vaccino a mRNA contro COVID-19,22391A,PRESIDIO AVENZA,TOS,30-39,0,1,0,1,0,0,0,1,0,1,Toscana,ITI1
2021-01-01,COMIRNATY Vaccino a mRNA contro COVID-19,22391A,PRESIDIO AVENZA,TOS,40-49,0,1,0,0,0,1,0,1,0,1,Toscana,ITI1
2021-01-01,COMIRNATY Vaccino a mRNA contro COVID-19,22391A,PRESIDIO AVENZA,TOS,50-59,1,0,0,1,0,0,0,1,0,1,Toscana,ITI1
2021-01-01,COMIRNATY Vaccino a mRNA contro COVID-19,22391A,PRESIDIO AVENZA,TOS,60-69,2,3,0,2,0,3,0,5,0,5,Toscana,ITI1
2021-01-01,COMIRNATY Vaccino a mRNA contro COVID-19,22391A,PRESIDIO AVENZA,TOS,70-79,5,1,0,0,0,6,0,6,0,6,Toscana,ITI1
2021-01-01,COMIRNATY Vaccino a mRNA contro COVID-19,22391A,PRESIDIO AVENZA,TOS,80-89,4,6,0,0,0,10,0,10,0,10,Toscana,ITI1
2021-01-01,COMIRNATY Vaccino a mRNA contro COVID-19,22391A,PRESIDIO AVENZA,TOS,90+,1,4,0,0,0,5,0,5,0,5,Toscana,ITI1
2021-01-01,COMIRNATY Vaccino a mRNA contro COVID-19,30511A,Ambulatorio MMG Casa della Salute Castiglion Fiorentino,TOS,50-59,1,0,0,0,0,1,0,1,0,1,Toscana,ITI1
2021-01-01,COMIRNATY Vaccino a mRNA contro COVID-19,30511A,Ambulatorio MMG Casa della Salute Castiglion Fiorentino,TOS,60-69,0,1,0,0,0,1,0,1,0,1,Toscana,ITI1
2021-01-01,COMIRNATY Vaccino a mRNA contro COVID-19,30511A,Ambulatorio MMG Casa della Salute Castiglion Fiorentino,TOS,70-79,4,3,0,1,0,6,0,7,0,7,Toscana,ITI1
2021-01-01,COMIRNATY Vaccino a mRNA contro COVID-19,30511A,Ambulatorio MMG Casa della Salute Castiglion Fiorentino,TOS,80-89,3,9,0,0,0,12,0,12,0,12,Toscana,ITI1
2021-01-01,COMIRNATY Vaccino a mRNA contro COVID-19,30511A,Ambulatorio MMG Casa della Salute Castiglion Fiorentino,TOS,90+,1,3,0,0,0,4,0,4,0,4,Toscana,ITI1
2021-01-01,COMIRNATY Vaccino a mRNA contro COVID-19,33111A,Ambulatorio MMG Casa della Salute Cortona Camucia,TOS,20-29,0,2,0,2,0,0,0,2,0,2,Toscana,ITI1
2021-01-01,COMIRNATY Vaccino a mRNA contro COVID-19,33111A,Ambulatorio MMG Casa della Salute Cortona Camucia,TOS,30-39,0,1,0,1,0,0,0,1,0,1,Toscana,ITI1
2021-01-01,COMIRNATY Vaccino a mRNA contro COVID-19,33111A,Ambulatorio MMG Casa della Salute Cortona Camucia,TOS,50-59,3,1,0,1,0,3,0,4,0,4,Toscana,ITI1
2021-01-01,COMIRNATY Vaccino a mRNA contro COVID-19,33111A,Ambulatorio MMG Casa della Salute Cortona Camucia,TOS,60-69,0,1,0,0,0,1,0,1,0,1,Toscana,ITI1
2021-01-01,COMIRNATY Vaccino a mRNA contro COVID-19,33111A,Ambulatorio MMG Casa della Salute Cortona Camucia,TOS,70-79,2,2,0,0,0,4,0,4,0,4,Toscana,ITI1
2021-01-01,COMIRNATY Vaccino a mRNA contro COVID-19,33111A,Ambulatorio MMG Casa della Salute Cortona Camucia,TOS,80-89,0,4,0,0,0,4,0,4,0,4,Toscana,ITI1
2021-01-01,COMIRNATY Vaccino a mRNA contro COVID-19,33111A,Ambulatorio MMG Casa della Salute Cortona Camucia,TOS,90+,3,3,0,0,0,6,0,6,0,6,Toscana,ITI1
2021-01-01,COMIRNATY Vaccino a mRNA contro COVID-19,40911A,COVID19 - Dip. Prevenzione Ruffolo Siena,TOS,20-29,0,1,0,1,0,0,0,1,0,1,Toscana,ITI1
2021-01-01,COMIRNATY Vaccino a mRNA contro COVID-19,40911A,COVID19 - Dip. Prevenzione Ruffolo Siena,TOS,30-39,0,1,0,1,0,0,0,1,0,1,Toscana,ITI1
2021-01-01,COMIRNATY Vaccino a mRNA contro COVID-19,40911A,COVID19 - Dip. Prevenzione Ruffolo Siena,TOS,40-49,0,2,0,2,0,0,0,2,0,2,Toscana,ITI1
2021-01-01,COMIRNATY Vaccino a mRNA contro COVID-19,40911A,COVID19 - Dip. Prevenzione Ruffolo Siena,TOS,50-59,1,3,0,4,0,0,0,4,0,4,Toscana,ITI1
2021-01-01,COMIRNATY Vaccino a mRNA contro COVID-19,40911A,COVID19 - Dip. Prevenzione Ruffolo Siena,TOS,60-69,2,1,0,1,0,2,0,3,0,3,Toscana,ITI1
2021-01-01,COMIRNATY Vaccino a mRNA contro COVID-19,40911A,COVID19 - Dip. Prevenzione Ruffolo Siena,TOS,70-79,1,1,0,0,0,2,0,2,0,2,Toscana,ITI1
2021-01-01,COMIRNATY Vaccino a mRNA contro COVID-19,40911A,COVID19 - Dip. Prevenzione Ruffolo Siena,TOS,80-89,2,7,0,0,0,9,0,9,0,9,Toscana,ITI1
2021-01-01,COMIRNATY Vaccino a mRNA contro COVID-19,40911A,COVID19 - Dip. Prevenzione Ruffolo Siena,TOS,90+,2,12,0,0,0,14,0,14,0,14,Toscana,ITI1
2021-01-01,COMIRNATY Vaccino a mRNA contro COVID-19,P0054I,RSA PICCOLA CASA COTTOLENGO,TOS,50-59,0,2,0,0,0,2,0,2,0,2,Toscana,ITI1
2021-01-01,COMIRNATY Vaccino a mRNA contro COVID-19,P0054I,RSA PICCOLA CASA COTTOLENGO,TOS,70-79,0,1,0,1,0,0,0,1,0,1,Toscana,ITI1
2021-01-01,COMIRNATY Vaccino a mRNA contro COVID-19,P0054I,RSA PICCOLA CASA COTTOLENGO,TOS,80-89,0,14,0,3,0,11,0,14,0,14,Toscana,ITI1
2021-01-01,COMIRNATY Vaccino a mRNA contro COVID-19,P0054I,RSA PICCOLA CASA COTTOLENGO,TOS,90+,1,6,0,0,0,7,0,7,0,7,Toscana,ITI1
2021-01-02,COMIRNATY Vaccino a mRNA contro COVID-19,03002D,Covid 19 - Ospedale S.Francesco di Barga,TOS,30-39,0,3,0,3,0,0,0,3,0,3,Toscana,ITI1
2021-01-02,COMIRNATY Vaccino a mRNA contro COVID-19,03002D,Covid 19 - Ospedale S.Francesco di Barga,TOS,40-49,0,4,0,3,0,1,0,4,0,4,Toscana,ITI1
2021-01-02,COMIRNATY Vaccino a mRNA contro COVID-19,03002D,Covid 19 - Ospedale S.Francesco di Barga,TOS,60-69,2,0,0,0,0,2,0,2,0,2,Toscana,ITI1
2021-01-02,COMIRNATY Vaccino a mRNA contro COVID-19,03002D,Covid 19 - Ospedale S.Francesco di Barga,TOS,70-79,3,3,0,0,0,6,0,6,0,6,Toscana,ITI1
2021-01-02,COMIRNATY Vaccino a mRNA contro COVID-19,03002D,Covid 19 - Ospedale S.Francesco di Barga,TOS,80-89,4,13,0,0,0,17,0,17,0,17,Toscana,ITI1
2021-01-02,COMIRNATY Vaccino a mRNA contro COVID-19,03002D,Covid 19 - Ospedale S.Francesco di Barga,TOS,90+,3,13,0,0,0,16,0,16,0,16,Toscana,ITI1
2021-01-02,COMIRNATY Vaccino a mRNA contro COVID-19,090601,Covid 19 - Ospedale S.Antonio Abate di Fivizzano,TOS,40-49,0,1,0,0,0,1,0,1,0,1,Toscana,ITI1
2021-01-02,COMIRNATY Vaccino a mRNA contro COVID-19,090601,Covid 19 - Ospedale S.Antonio Abate di Fivizzano,TOS,50-59,2,1,0,0,0,3,0,3,0,3,Toscana,ITI1
2021-01-02,COMIRNATY Vaccino a mRNA contro COVID-19,090601,Covid 19 - Ospedale S.Antonio Abate di Fivizzano,TOS,60-69,3,1,0,0,0,4,0,4,0,4,Toscana,ITI1
2021-01-02,COMIRNATY Vaccino a mRNA contro COVID-19,090601,Covid 19 - Ospedale S.Antonio Abate di Fivizzano,TOS,70-79,4,1,0,0,0,5,0,5,0,5,Toscana,ITI1
2021-01-02,COMIRNATY Vaccino a mRNA contro COVID-19,090601,Covid 19 - Ospedale S.Antonio Abate di Fivizzano,TOS,80-89,2,6,0,0,0,8,0,8,0,8,Toscana,ITI1
2021-01-02,COMIRNATY Vaccino a mRNA contro COVID-19,090601,Covid 19 - Ospedale S.Antonio Abate di Fivizzano,TOS,90+,1,2,0,0,0,3,0,3,0,3,Toscana,ITI1
2021-01-02,COMIRNATY Vaccino a mRNA contro COVID-19,090602,Covid 19 - Nuovo Ospedale Apuane,TOS,20-29,4,9,0,13,0,0,0,13,0,13,Toscana,ITI1
2021-01-02,COMIRNATY Vaccino a mRNA contro COVID-19,090602,Covid 19 - Nuovo Ospedale Apuane,TOS,30-39,7,22,0,29,0,0,0,29,0,29,Toscana,ITI1
2021-01-02,COMIRNATY Vaccino a mRNA contro COVID-19,090602,Covid 19 - Nuovo Ospedale Apuane,TOS,40-49,7,20,0,27,0,0,0,27,0,27,Toscana,ITI1
2021-01-02,COMIRNATY Vaccino a mRNA contro COVID-19,090602,Covid 19 - Nuovo Ospedale Apuane,TOS,50-59,5,20,0,25,0,0,0,25,0,25,Toscana,ITI1
2021-01-02,COMIRNATY Vaccino a mRNA contro COVID-19,090602,Covid 19 - Nuovo Ospedale Apuane,TOS,60-69,8,5,0,13,0,0,0,13,0,13,Toscana,ITI1
2021-01-02,COMIRNATY Vaccino a mRNA contro COVID-19,090604,Covid 19 - Ospedale San Luca di  Lucca,TOS,20-29,10,13,0,23,0,0,0,23,0,23,Toscana,ITI1
2021-01-02,COMIRNATY Vaccino a mRNA contro COVID-19,090604,Covid 19 - Ospedale San Luca di  Lucca,TOS,30-39,3,14,0,17,0,0,0,17,0,17,Toscana,ITI1
2021-01-02,COMIRNATY Vaccino a mRNA contro COVID-19,090604,Covid 19 - Ospedale San Luca di  Lucca,TOS,40-49,4,25,0,29,0,0,0,29,0,29,Toscana,ITI1
2021-01-02,COMIRNATY Vaccino a mRNA contro COVID-19,090604,Covid 19 - Ospedale San Luca di  Lucca,TOS,50-59,9,24,0,32,0,1,0,33,0,33,Toscana,ITI1
2021-01-02,COMIRNATY Vaccino a mRNA contro COVID-19,090604,Covid 19 - Ospedale San Luca di  Lucca,TOS,60-69,9,4,0,12,0,1,0,13,0,13,Toscana,ITI1
2021-01-02,COMIRNATY Vaccino a mRNA contro COVID-19,090604,Covid 19 - Ospedale San Luca di  Lucca,TOS,70-79,2,1,0,0,0,3,0,3,0,3,Toscana,ITI1
2021-01-02,COMIRNATY Vaccino a mRNA contro COVID-19,090604,Covid 19 - Ospedale San Luca di  Lucca,TOS,80-89,4,6,0,0,0,10,0,10,0,10,Toscana,ITI1
2021-01-02,COMIRNATY Vaccino a mRNA contro COVID-19,090604,Covid 19 - Ospedale San Luca di  Lucca,TOS,90+,1,7,0,0,0,8,0,8,0,8,Toscana,ITI1
2021-01-02,COMIRNATY Vaccino a mRNA contro COVID-19,090606,COVID19 - Ospedale San Iacopo,TOS,20-29,1,8,0,9,0,0,0,9,0,9,Toscana,ITI1
2021-01-02,COMIRNATY Vaccino a mRNA contro COVID-19,090606,COVID19 - Ospedale San Iacopo,TOS,30-39,12,14,0,26,0,0,0,26,0,26,Toscana,ITI1
2021-01-02,COMIRNATY Vaccino a mRNA contro COVID-19,090606,COVID19 - Ospedale San Iacopo,TOS,40-49,11,24,0,34,0,1,0,35,0,35,Toscana,ITI1
2021-01-02,COMIRNATY Vaccino a mRNA contro COVID-19,090606,COVID19 - Ospedale San Iacopo,TOS,50-59,12,18,0,28,0,2,0,30,0,30,Toscana,ITI1
2021-01-02,COMIRNATY Vaccino a mRNA contro COVID-19,090606,COVID19 - Ospedale San Iacopo,TOS,60-69,18,5,0,16,0,7,0,23,0,23,Toscana,ITI1
2021-01-02,COMIRNATY Vaccino a mRNA contro COVID-19,090606,COVID19 - Ospedale San Iacopo,TOS,70-79,5,2,0,0,0,7,0,7,0,7,Toscana,ITI1
2021-01-02,COMIRNATY Vaccino a mRNA contro COVID-19,090606,COVID19 - Ospedale San Iacopo,TOS,80-89,7,12,0,0,0,19,0,19,0,19,Toscana,ITI1
2021-01-02,COMIRNATY Vaccino a mRNA contro COVID-19,090606,COVID19 - Ospedale San Iacopo,TOS,90+,0,10,0,1,0,9,0,10,0,10,Toscana,ITI1
2021-01-02,COMIRNATY Vaccino a mRNA contro COVID-19,090608,COVID19 - Ospedale Santo Stefano,TOS,20-29,7,12,0,19,0,0,0,19,0,19,Toscana,ITI1
2021-01-02,COMIRNATY Vaccino a mRNA contro COVID-19,090608,COVID19 - Ospedale Santo Stefano,TOS,30-39,9,15,0,24,0,0,0,24,0,24,Toscana,ITI1
2021-01-02,COMIRNATY Vaccino a mRNA contro COVID-19,090608,COVID19 - Ospedale Santo Stefano,TOS,40-49,10,28,0,37,0,1,0,38,0,38,Toscana,ITI1
2021-01-02,COMIRNATY Vaccino a mRNA contro COVID-19,090608,COVID19 - Ospedale Santo Stefano,TOS,50-59,11,21,0,31,0,1,0,32,0,32,Toscana,ITI1
2021-01-02,COMIRNATY Vaccino a mRNA contro COVID-19,090608,COVID19 - Ospedale Santo Stefano,TOS,60-69,8,12,0,15,0,5,0,20,0,20,Toscana,ITI1
2021-01-02,COMIRNATY Vaccino a mRNA contro COVID-19,090608,COVID19 - Ospedale Santo Stefano,TOS,70-79,4,6,0,0,0,10,0,10,0,10,Toscana,ITI1
2021-01-02,COMIRNATY Vaccino a mRNA contro COVID-19,090608,COVID19 - Ospedale Santo Stefano,TOS,80-89,5,7,0,0,0,12,0,12,0,12,Toscana,ITI1
2021-01-02,COMIRNATY Vaccino a mRNA contro COVID-19,090608,COVID19 - Ospedale Santo Stefano,TOS,90+,3,12,0,0,0,15,0,15,0,15,Toscana,ITI1
2021-01-02,COMIRNATY Vaccino a mRNA contro COVID-19,090610,Covid 19 - Ospedale F.Lotti di Pontedera,TOS,20-29,0,2,0,2,0,0,0,2,0,2,Toscana,ITI1
2021-01-02,COMIRNATY Vaccino a mRNA contro COVID-19,090610,Covid 19 - Ospedale F.Lotti di Pontedera,TOS,30-39,4,5,0,9,0,0,0,9,0,9,Toscana,ITI1
2021-01-02,COMIRNATY Vaccino a mRNA contro COVID-19,090610,Covid 19 - Ospedale F.Lotti di Pontedera,TOS,40-49,2,13,0,15,0,0,0,15,0,15,Toscana,ITI1
2021-01-02,COMIRNATY Vaccino a mRNA contro COVID-19,090610,Covid 19 - Ospedale F.Lotti di Pontedera,TOS,50-59,5,11,0,16,0,0,0,16,0,16,Toscana,ITI1
2021-01-02,COMIRNATY Vaccino a mRNA contro COVID-19,090610,Covid 19 - Ospedale F.Lotti di Pontedera,TOS,60-69,3,3,0,6,0,0,0,6,0,6,Toscana,ITI1
2021-01-02,COMIRNATY Vaccino a mRNA contro COVID-19,090613,Covid 19 - Ospedali Riuniti di Livorno,TOS,20-29,7,18,0,25,0,0,0,25,0,25,Toscana,ITI1
2021-01-02,COMIRNATY Vaccino a mRNA contro COVID-19,090613,Covid 19 - Ospedali Riuniti di Livorno,TOS,30-39,6,14,0,20,0,0,0,20,0,20,Toscana,ITI1
2021-01-02,COMIRNATY Vaccino a mRNA contro COVID-19,090613,Covid 19 - Ospedali Riuniti di Livorno,TOS,40-49,2,23,0,25,0,0,0,25,0,25,Toscana,ITI1
2021-01-02,COMIRNATY Vaccino a mRNA contro COVID-19,090613,Covid 19 - Ospedali Riuniti di Livorno,TOS,50-59,13,27,0,40,0,0,0,40,0,40,Toscana,ITI1
2021-01-02,COMIRNATY Vaccino a mRNA contro COVID-19,090613,Covid 19 - Ospedali Riuniti di Livorno,TOS,60-69,6,9,0,15,0,0,0,15,0,15,Toscana,ITI1
2021-01-02,COMIRNATY Vaccino a mRNA contro COVID-19,090614,Covid 19 - Ospedale Civile di Piombino,TOS,20-29,2,3,0,5,0,0,0,5,0,5,Toscana,ITI1
2021-01-02,COMIRNATY Vaccino a mRNA contro COVID-19,090614,Covid 19 - Ospedale Civile di Piombino,TOS,30-39,2,1,0,3,0,0,0,3,0,3,Toscana,ITI1
2021-01-02,COMIRNATY Vaccino a mRNA contro COVID-19,090614,Covid 19 - Ospedale Civile di Piombino,TOS,40-49,1,3,0,4,0,0,0,4,0,4,Toscana,ITI1
2021-01-02,COMIRNATY Vaccino a mRNA contro COVID-19,090614,Covid 19 - Ospedale Civile di Piombino,TOS,50-59,2,6,0,7,0,1,0,8,0,8,Toscana,ITI1
2021-01-02,COMIRNATY Vaccino a mRNA contro COVID-19,090614,Covid 19 - Ospedale Civile di Piombino,TOS,60-69,4,0,0,2,0,2,0,4,0,4,Toscana,ITI1
2021-01-02,COMIRNATY Vaccino a mRNA contro COVID-19,090614,Covid 19 - Ospedale Civile di Piombino,TOS,70-79,3,5,0,1,0,7,0,8,0,8,Toscana,ITI1
2021-01-02,COMIRNATY Vaccino a mRNA contro COVID-19,090614,Covid 19 - Ospedale Civile di Piombino,TOS,80-89,2,11,0,0,0,13,0,13,0,13,Toscana,ITI1
2021-01-02,COMIRNATY Vaccino a mRNA contro COVID-19,090614,Covid 19 - Ospedale Civile di Piombino,TOS,90+,2,5,0,1,0,6,0,7,0,7,Toscana,ITI1
2021-01-02,COMIRNATY Vaccino a mRNA contro COVID-19,090618,COVID19 - Ospedale del Bibbiena,TOS,20-29,6,1,0,7,0,0,0,7,0,7,Toscana,ITI1
2021-01-02,COMIRNATY Vaccino a mRNA contro COVID-19,090618,COVID19 - Ospedale del Bibbiena,TOS,30-39,2,2,0,4,0,0,0,4,0,4,Toscana,ITI1
2021-01-02,COMIRNATY Vaccino a mRNA contro COVID-19,090618,COVID19 - Ospedale del Bibbiena,TOS,40-49,1,0,0,1,0,0,0,1,0,1,Toscana,ITI1
2021-01-02,COMIRNATY Vaccino a mRNA contro COVID-19,090618,COVID19 - Ospedale del Bibbiena,TOS,50-59,1,4,0,5,0,0,0,5,0,5,Toscana,ITI1
2021-01-02,COMIRNATY Vaccino a mRNA contro COVID-19,090618,COVID19 - Ospedale del Bibbiena,TOS,60-69,0,1,0,1,0,0,0,1,0,1,Toscana,ITI1
2021-01-02,COMIRNATY Vaccino a mRNA contro COVID-19,090621,COVID19 - Ospedale di Arezzo,TOS,20-29,2,20,0,22,0,0,0,22,0,22,Toscana,ITI1
2021-01-02,COMIRNATY Vaccino a mRNA contro COVID-19,090621,COVID19 - Ospedale di Arezzo,TOS,30-39,10,25,0,35,0,0,0,35,0,35,Toscana,ITI1
2021-01-02,COMIRNATY Vaccino a mRNA contro COVID-19,090621,COVID19 - Ospedale di Arezzo,TOS,40-49,7,28,0,35,0,0,0,35,0,35,Toscana,ITI1
2021-01-02,COMIRNATY Vaccino a mRNA contro COVID-19,090621,COVID19 - Ospedale di Arezzo,TOS,50-59,9,28,0,34,1,2,0,37,0,37,Toscana,ITI1
2021-01-02,COMIRNATY Vaccino a mRNA contro COVID-19,090621,COVID19 - Ospedale di Arezzo,TOS,60-69,5,8,0,10,0,3,0,13,0,13,Toscana,ITI1
2021-01-02,COMIRNATY Vaccino a mRNA contro COVID-19,090621,COVID19 - Ospedale di Arezzo,TOS,70-79,3,6,0,0,0,9,0,9,0,9,Toscana,ITI1
2021-01-02,COMIRNATY Vaccino a mRNA contro COVID-19,090621,COVID19 - Ospedale di Arezzo,TOS,80-89,4,7,0,0,0,11,0,11,0,11,Toscana,ITI1
2021-01-02,COMIRNATY Vaccino a mRNA contro COVID-19,090621,COVID19 - Ospedale di Arezzo,TOS,90+,0,4,0,0,0,4,0,4,0,4,Toscana,ITI1
2021-01-02,COMIRNATY Vaccino a mRNA contro COVID-19,090624,COVID19 - Ospedale di Orbetello,TOS,20-29,0,1,0,1,0,0,0,1,0,1,Toscana,ITI1
2021-01-02,COMIRNATY Vaccino a mRNA contro COVID-19,090624,COVID19 - Ospedale di Orbetello,TOS,30-39,0,2,0,2,0,0,0,2,0,2,Toscana,ITI1
2021-01-02,COMIRNATY Vaccino a mRNA contro COVID-19,090624,COVID19 - Ospedale di Orbetello,TOS,40-49,1,2,0,2,0,1,0,3,0,3,Toscana,ITI1
2021-01-02,COMIRNATY Vaccino a mRNA contro COVID-19,090624,COVID19 - Ospedale di Orbetello,TOS,50-59,0,7,0,6,0,1,0,7,0,7,Toscana,ITI1
2021-01-02,COMIRNATY Vaccino a mRNA contro COVID-19,090624,COVID19 - Ospedale di Orbetello,TOS,60-69,3,3,0,0,0,6,0,6,0,6,Toscana,ITI1
2021-01-02,COMIRNATY Vaccino a mRNA contro COVID-19,090624,COVID19 - Ospedale di Orbetello,TOS,70-79,6,7,0,0,0,13,0,13,0,13,Toscana,ITI1
2021-01-02,COMIRNATY Vaccino a mRNA contro COVID-19,090624,COVID19 - Ospedale di Orbetello,TOS,80-89,10,23,0,1,0,32,0,33,0,33,Toscana,ITI1
2021-01-02,COMIRNATY Vaccino a mRNA contro COVID-19,090624,COVID19 - Ospedale di Orbetello,TOS,90+,4,9,0,0,0,13,0,13,0,13,Toscana,ITI1
2021-01-02,COMIRNATY Vaccino a mRNA contro COVID-19,090625,COVID19 - Ospedale Amiata Castel del Piano,TOS,20-29,0,7,0,7,0,0,0,7,0,7,Toscana,ITI1
2021-01-02,COMIRNATY Vaccino a mRNA contro COVID-19,090625,COVID19 - Ospedale Amiata Castel del Piano,TOS,30-39,7,5,0,12,0,0,0,12,0,12,Toscana,ITI1
2021-01-02,COMIRNATY Vaccino a mRNA contro COVID-19,090625,COVID19 - Ospedale Amiata Castel del Piano,TOS,40-49,2,8,0,10,0,0,0,10,0,10,Toscana,ITI1
2021-01-02,COMIRNATY Vaccino a mRNA contro COVID-19,090625,COVID19 - Ospedale Amiata Castel del Piano,TOS,50-59,4,10,0,13,0,1,0,14,0,14,Toscana,ITI1
2021-01-02,COMIRNATY Vaccino a mRNA contro COVID-19,090625,COVID19 - Ospedale Amiata Castel del Piano,TOS,60-69,2,4,0,4,0,2,0,6,0,6,Toscana,ITI1
2021-01-02,COMIRNATY Vaccino a mRNA contro COVID-19,090625,COVID19 - Ospedale Amiata Castel del Piano,TOS,70-79,1,6,0,0,0,7,0,7,0,7,Toscana,ITI1
2021-01-02,COMIRNATY Vaccino a mRNA contro COVID-19,090625,COVID19 - Ospedale Amiata Castel del Piano,TOS,80-89,7,17,0,0,0,24,0,24,0,24,Toscana,ITI1
2021-01-02,COMIRNATY Vaccino a mRNA contro COVID-19,090625,COVID19 - Ospedale Amiata Castel del Piano,TOS,90+,0,10,0,0,0,10,0,10,0,10,Toscana,ITI1
2021-01-02,COMIRNATY Vaccino a mRNA contro COVID-19,090626,COVID19 - Ospedale di Grosseto,TOS,20-29,4,9,0,13,0,0,0,13,0,13,Toscana,ITI1
2021-01-02,COMIRNATY Vaccino a mRNA contro COVID-19,090626,COVID19 - Ospedale di Grosseto,TOS,30-39,7,14,0,21,0,0,0,21,0,21,Toscana,ITI1
2021-01-02,COMIRNATY Vaccino a mRNA contro COVID-19,090626,COVID19 - Ospedale di Grosseto,TOS,40-49,3,12,0,15,0,0,0,15,0,15,Toscana,ITI1
2021-01-02,COMIRNATY Vaccino a mRNA contro COVID-19,090626,COVID19 - Ospedale di Grosseto,TOS,50-59,6,11,0,17,0,0,0,17,0,17,Toscana,ITI1
2021-01-02,COMIRNATY Vaccino a mRNA contro COVID-19,090626,COVID19 - Ospedale di Grosseto,TOS,60-69,4,2,0,6,0,0,0,6,0,6,Toscana,ITI1
2021-01-02,COMIRNATY Vaccino a mRNA contro COVID-19,090627,COVID19 - Ospedale Mugello,TOS,20-29,1,1,0,2,0,0,0,2,0,2,Toscana,ITI1
2021-01-02,COMIRNATY Vaccino a mRNA contro COVID-19,090627,COVID19 - Ospedale Mugello,TOS,30-39,1,1,0,1,0,1,0,2,0,2,Toscana,ITI1
2021-01-02,COMIRNATY Vaccino a mRNA contro COVID-19,090627,COVID19 - Ospedale Mugello,TOS,40-49,3,1,0,1,0,3,0,4,0,4,Toscana,ITI1
2021-01-02,COMIRNATY Vaccino a mRNA contro COVID-19,090627,COVID19 - Ospedale Mugello,TOS,50-59,2,6,0,2,0,6,0,8,0,8,Toscana,ITI1
2021-01-02,COMIRNATY Vaccino a mRNA contro COVID-19,090627,COVID19 - Ospedale Mugello,TOS,60-69,8,6,0,0,0,14,0,14,0,14,Toscana,ITI1
2021-01-02,COMIRNATY Vaccino a mRNA contro COVID-19,090627,COVID19 - Ospedale Mugello,TOS,70-79,6,5,0,0,0,11,0,11,0,11,Toscana,ITI1
2021-01-02,COMIRNATY Vaccino a mRNA contro COVID-19,090627,COVID19 - Ospedale Mugello,TOS,80-89,4,4,0,0,0,8,0,8,0,8,Toscana,ITI1
2021-01-02,COMIRNATY Vaccino a mRNA contro COVID-19,090627,COVID19 - Ospedale Mugello,TOS,90+,1,4,0,0,0,5,0,5,0,5,Toscana,ITI1
2021-01-02,COMIRNATY Vaccino a mRNA contro COVID-19,090629,COVID19 - Ospedale SS. Maria Annunziata,TOS,20-29,4,6,0,10,0,0,0,10,0,10,Toscana,ITI1
2021-01-02,COMIRNATY Vaccino a mRNA contro COVID-19,090629,COVID19 - Ospedale SS. Maria Annunziata,TOS,30-39,9,16,0,25,0,0,0,25,0,25,Toscana,ITI1
2021-01-02,COMIRNATY Vaccino a mRNA contro COVID-19,090629,COVID19 - Ospedale SS. Maria Annunziata,TOS,40-49,12,24,0,35,0,1,0,36,0,36,Toscana,ITI1
2021-01-02,COMIRNATY Vaccino a mRNA contro COVID-19,090629,COVID19 - Ospedale SS. Maria Annunziata,TOS,50-59,14,21,0,31,0,4,0,35,0,35,Toscana,ITI1
2021-01-02,COMIRNATY Vaccino a mRNA contro COVID-19,090629,COVID19 - Ospedale SS. Maria Annunziata,TOS,60-69,10,8,0,17,0,1,0,18,0,18,Toscana,ITI1
2021-01-02,COMIRNATY Vaccino a mRNA contro COVID-19,090629,COVID19 - Ospedale SS. Maria Annunziata,TOS,70-79,0,1,0,0,0,1,0,1,0,1,Toscana,ITI1
2021-01-02,COMIRNATY Vaccino a mRNA contro COVID-19,090629,COVID19 - Ospedale SS. Maria Annunziata,TOS,80-89,4,5,0,1,0,8,0,9,0,9,Toscana,ITI1
2021-01-02,COMIRNATY Vaccino a mRNA contro COVID-19,090629,COVID19 - Ospedale SS. Maria Annunziata,TOS,90+,0,16,0,1,0,15,0,16,0,16,Toscana,ITI1
2021-01-02,COMIRNATY Vaccino a mRNA contro COVID-19,090637,COVID19 - Ospedale Amiata Val d'Orcia  Abbadia San Salvatore,TOS,20-29,2,8,0,10,0,0,0,10,0,10,Toscana,ITI1
2021-01-02,COMIRNATY Vaccino a mRNA contro COVID-19,090637,COVID19 - Ospedale Amiata Val d'Orcia  Abbadia San Salvatore,TOS,30-39,5,8,0,13,0,0,0,13,0,13,Toscana,ITI1
2021-01-02,COMIRNATY Vaccino a mRNA contro COVID-19,090637,COVID19 - Ospedale Amiata Val d'Orcia  Abbadia San Salvatore,TOS,40-49,2,7,0,9,0,0,0,9,0,9,Toscana,ITI1
2021-01-02,COMIRNATY Vaccino a mRNA contro COVID-19,090637,COVID19 - Ospedale Amiata Val d'Orcia  Abbadia San Salvatore,TOS,50-59,2,5,0,7,0,0,0,7,0,7,Toscana,ITI1
2021-01-02,COMIRNATY Vaccino a mRNA contro COVID-19,090637,COVID19 - Ospedale Amiata Val d'Orcia  Abbadia San Salvatore,TOS,60-69,3,1,0,4,0,0,0,4,0,4,Toscana,ITI1
2021-01-02,COMIRNATY Vaccino a mRNA contro COVID-19,090639,COVID19 - Ospedale di Nottola Montepulciano,TOS,50-59,0,1,0,1,0,0,0,1,0,1,Toscana,ITI1
2021-01-02,COMIRNATY Vaccino a mRNA contro COVID-19,090639,COVID19 - Ospedale di Nottola Montepulciano,TOS,60-69,1,0,0,0,0,1,0,1,0,1,Toscana,ITI1
2021-01-02,COMIRNATY Vaccino a mRNA contro COVID-19,090639,COVID19 - Ospedale di Nottola Montepulciano,TOS,70-79,2,4,0,0,0,6,0,6,0,6,Toscana,ITI1
2021-01-02,COMIRNATY Vaccino a mRNA contro COVID-19,090639,COVID19 - Ospedale di Nottola Montepulciano,TOS,80-89,4,6,0,0,0,10,0,10,0,10,Toscana,ITI1
2021-01-02,COMIRNATY Vaccino a mRNA contro COVID-19,090639,COVID19 - Ospedale di Nottola Montepulciano,TOS,90+,6,18,0,0,0,24,0,24,0,24,Toscana,ITI1
2021-01-02,COMIRNATY Vaccino a mRNA contro COVID-19,090640,Covid 19 - Ospedale Unico Versilia,TOS,20-29,2,6,0,7,0,1,0,8,0,8,Toscana,ITI1
2021-01-02,COMIRNATY Vaccino a mRNA contro COVID-19,090640,Covid 19 - Ospedale Unico Versilia,TOS,30-39,5,5,0,10,0,0,0,10,0,10,Toscana,ITI1
2021-01-02,COMIRNATY Vaccino a mRNA contro COVID-19,090640,Covid 19 - Ospedale Unico Versilia,TOS,40-49,6,18,0,24,0,0,0,24,0,24,Toscana,ITI1
2021-01-02,COMIRNATY Vaccino a mRNA contro COVID-19,090640,Covid 19 - Ospedale Unico Versilia,TOS,50-59,9,14,0,23,0,0,0,23,0,23,Toscana,ITI1
2021-01-02,COMIRNATY Vaccino a mRNA contro COVID-19,090640,Covid 19 - Ospedale Unico Versilia,TOS,60-69,4,7,0,11,0,0,0,11,0,11,Toscana,ITI1
2021-01-02,COMIRNATY Vaccino a mRNA contro COVID-19,090641,COVID19 - Ospedale La Gruccia Montevarchi,TOS,30-39,1,1,0,1,1,0,0,2,0,2,Toscana,ITI1
2021-01-02,COMIRNATY Vaccino a mRNA contro COVID-19,090641,COVID19 - Ospedale La Gruccia Montevarchi,TOS,40-49,1,0,0,1,0,0,0,1,0,1,Toscana,ITI1
2021-01-02,COMIRNATY Vaccino a mRNA contro COVID-19,090641,COVID19 - Ospedale La Gruccia Montevarchi,TOS,50-59,1,9,0,1,8,1,0,10,0,10,Toscana,ITI1
2021-01-02,COMIRNATY Vaccino a mRNA contro COVID-19,090641,COVID19 - Ospedale La Gruccia Montevarchi,TOS,60-69,4,4,0,1,3,4,0,8,0,8,Toscana,ITI1
2021-01-02,COMIRNATY Vaccino a mRNA contro COVID-19,090641,COVID19 - Ospedale La Gruccia Montevarchi,TOS,70-79,6,4,0,1,1,8,0,10,0,10,Toscana,ITI1
2021-01-02,COMIRNATY Vaccino a mRNA contro COVID-19,090641,COVID19 - Ospedale La Gruccia Montevarchi,TOS,80-89,5,13,0,0,0,18,0,18,0,18,Toscana,ITI1
2021-01-02,COMIRNATY Vaccino a mRNA contro COVID-19,090641,COVID19 - Ospedale La Gruccia Montevarchi,TOS,90+,1,16,0,0,0,17,0,17,0,17,Toscana,ITI1
2021-01-02,COMIRNATY Vaccino a mRNA contro COVID-19,090901,COVID19 - AOU Pisana,TOS,20-29,16,35,0,51,0,0,0,51,0,51,Toscana,ITI1
2021-01-02,COMIRNATY Vaccino a mRNA contro COVID-19,090901,COVID19 - AOU Pisana,TOS,30-39,34,70,0,104,0,0,0,104,0,104,Toscana,ITI1
2021-01-02,COMIRNATY Vaccino a mRNA contro COVID-19,090901,COVID19 - AOU Pisana,TOS,40-49,27,81,0,108,0,0,0,108,0,108,Toscana,ITI1
2021-01-02,COMIRNATY Vaccino a mRNA contro COVID-19,090901,COVID19 - AOU Pisana,TOS,50-59,25,54,0,79,0,0,0,79,0,79,Toscana,ITI1
2021-01-02,COMIRNATY Vaccino a mRNA contro COVID-19,090901,COVID19 - AOU Pisana,TOS,60-69,9,11,0,20,0,0,0,20,0,20,Toscana,ITI1
2021-01-02,COMIRNATY Vaccino a mRNA contro COVID-19,090902,COVID19 - AOU Senese,TOS,20-29,9,14,0,23,0,0,0,23,0,23,Toscana,ITI1
2021-01-02,COMIRNATY Vaccino a mRNA contro COVID-19,090902,COVID19 - AOU Senese,TOS,30-39,18,26,0,44,0,0,0,44,0,44,Toscana,ITI1
2021-01-02,COMIRNATY Vaccino a mRNA contro COVID-19,090902,COVID19 - AOU Senese,TOS,40-49,21,48,0,69,0,0,0,69,0,69,Toscana,ITI1
2021-01-02,COMIRNATY Vaccino a mRNA contro COVID-19,090902,COVID19 - AOU Senese,TOS,50-59,20,49,0,69,0,0,0,69,0,69,Toscana,ITI1
2021-01-02,COMIRNATY Vaccino a mRNA contro COVID-19,090902,COVID19 - AOU Senese,TOS,60-69,15,16,0,31,0,0,0,31,0,31,Toscana,ITI1
2021-01-02,COMIRNATY Vaccino a mRNA contro COVID-19,090903,COVID19 - AOU Careggi - CTO,TOS,20-29,25,68,0,93,0,0,0,93,0,93,Toscana,ITI1
2021-01-02,COMIRNATY Vaccino a mRNA contro COVID-19,090903,COVID19 - AOU Careggi - CTO,TOS,30-39,45,54,0,99,0,0,0,99,0,99,Toscana,ITI1
2021-01-02,COMIRNATY Vaccino a mRNA contro COVID-19,090903,COVID19 - AOU Careggi - CTO,TOS,40-49,28,74,0,102,0,0,0,102,0,102,Toscana,ITI1
2021-01-02,COMIRNATY Vaccino a mRNA contro COVID-19,090903,COVID19 - AOU Careggi - CTO,TOS,50-59,42,92,0,134,0,0,0,134,0,134,Toscana,ITI1
2021-01-02,COMIRNATY Vaccino a mRNA contro COVID-19,090903,COVID19 - AOU Careggi - CTO,TOS,60-69,20,26,0,46,0,0,0,46,0,46,Toscana,ITI1
2021-01-02,COMIRNATY Vaccino a mRNA contro COVID-19,090904,COVID19 - Ospedale AOU Meyer,TOS,20-29,0,6,0,6,0,0,0,6,0,6,Toscana,ITI1
2021-01-02,COMIRNATY Vaccino a mRNA contro COVID-19,090904,COVID19 - Ospedale AOU Meyer,TOS,30-39,3,21,0,24,0,0,0,24,0,24,Toscana,ITI1
2021-01-02,COMIRNATY Vaccino a mRNA contro COVID-19,090904,COVID19 - Ospedale AOU Meyer,TOS,40-49,2,14,0,16,0,0,0,16,0,16,Toscana,ITI1
2021-01-02,COMIRNATY Vaccino a mRNA contro COVID-19,090904,COVID19 - Ospedale AOU Meyer,TOS,50-59,0,16,0,16,0,0,0,16,0,16,Toscana,ITI1
2021-01-02,COMIRNATY Vaccino a mRNA contro COVID-19,090904,COVID19 - Ospedale AOU Meyer,TOS,60-69,1,3,0,4,0,0,0,4,0,4,Toscana,ITI1
2021-01-02,COMIRNATY Vaccino a mRNA contro COVID-19,11012E,COVID19 - Ospedale San Giuseppe,TOS,20-29,2,11,0,13,0,0,0,13,0,13,Toscana,ITI1
2021-01-02,COMIRNATY Vaccino a mRNA contro COVID-19,11012E,COVID19 - Ospedale San Giuseppe,TOS,30-39,5,9,0,14,0,0,0,14,0,14,Toscana,ITI1
2021-01-02,COMIRNATY Vaccino a mRNA contro COVID-19,11012E,COVID19 - Ospedale San Giuseppe,TOS,40-49,6,22,0,28,0,0,0,28,0,28,Toscana,ITI1
2021-01-02,COMIRNATY Vaccino a mRNA contro COVID-19,11012E,COVID19 - Ospedale San Giuseppe,TOS,50-59,13,36,0,47,0,2,0,49,0,49,Toscana,ITI1
2021-01-02,COMIRNATY Vaccino a mRNA contro COVID-19,11012E,COVID19 - Ospedale San Giuseppe,TOS,60-69,6,5,0,6,0,5,0,11,0,11,Toscana,ITI1
2021-01-02,COMIRNATY Vaccino a mRNA contro COVID-19,11012E,COVID19 - Ospedale San Giuseppe,TOS,70-79,9,4,0,1,0,12,0,13,0,13,Toscana,ITI1
2021-01-02,COMIRNATY Vaccino a mRNA contro COVID-19,11012E,COVID19 - Ospedale San Giuseppe,TOS,80-89,5,18,0,0,0,23,0,23,0,23,Toscana,ITI1
2021-01-02,COMIRNATY Vaccino a mRNA contro COVID-19,11012E,COVID19 - Ospedale San Giuseppe,TOS,90+,2,9,0,0,0,11,0,11,0,11,Toscana,ITI1
2021-01-02,COMIRNATY Vaccino a mRNA contro COVID-19,13021A,COVID19 - Ospedale S.Giovanni di Dio,TOS,20-29,8,8,0,16,0,0,0,16,0,16,Toscana,ITI1
2021-01-02,COMIRNATY Vaccino a mRNA contro COVID-19,13021A,COVID19 - Ospedale S.Giovanni di Dio,TOS,30-39,18,19,0,37,0,0,0,37,0,37,Toscana,ITI1
2021-01-02,COMIRNATY Vaccino a mRNA contro COVID-19,13021A,COVID19 - Ospedale S.Giovanni di Dio,TOS,40-49,12,20,0,31,1,0,0,32,0,32,Toscana,ITI1
2021-01-02,COMIRNATY Vaccino a mRNA contro COVID-19,13021A,COVID19 - Ospedale S.Giovanni di Dio,TOS,50-59,11,33,0,41,0,3,0,44,0,44,Toscana,ITI1
2021-01-02,COMIRNATY Vaccino a mRNA contro COVID-19,13021A,COVID19 - Ospedale S.Giovanni di Dio,TOS,60-69,13,16,0,25,0,4,0,29,0,29,Toscana,ITI1
2021-01-02,COMIRNATY Vaccino a mRNA contro COVID-19,13021A,COVID19 - Ospedale S.Giovanni di Dio,TOS,70-79,8,10,0,0,0,18,0,18,0,18,Toscana,ITI1
2021-01-02,COMIRNATY Vaccino a mRNA contro COVID-19,13021A,COVID19 - Ospedale S.Giovanni di Dio,TOS,80-89,6,51,0,1,0,56,0,57,0,57,Toscana,ITI1
2021-01-02,COMIRNATY Vaccino a mRNA contro COVID-19,13021A,COVID19 - Ospedale S.Giovanni di Dio,TOS,90+,5,47,0,0,0,52,0,52,0,52,Toscana,ITI1
2021-01-02,COMIRNATY Vaccino a mRNA contro COVID-19,16121A,Covid 19 - Ospedale Civile di Cecina,TOS,20-29,1,1,0,2,0,0,0,2,0,2,Toscana,ITI1
2021-01-02,COMIRNATY Vaccino a mRNA contro COVID-19,16121A,Covid 19 - Ospedale Civile di Cecina,TOS,30-39,1,2,0,3,0,0,0,3,0,3,Toscana,ITI1
2021-01-02,COMIRNATY Vaccino a mRNA contro COVID-19,16121A,Covid 19 - Ospedale Civile di Cecina,TOS,40-49,1,3,0,4,0,0,0,4,0,4,Toscana,ITI1
2021-01-02,COMIRNATY Vaccino a mRNA contro COVID-19,16121A,Covid 19 - Ospedale Civile di Cecina,TOS,50-59,3,6,0,9,0,0,0,9,0,9,Toscana,ITI1
2021-01-02,COMIRNATY Vaccino a mRNA contro COVID-19,16121A,Covid 19 - Ospedale Civile di Cecina,TOS,60-69,1,0,0,0,0,1,0,1,0,1,Toscana,ITI1
2021-01-02,COMIRNATY Vaccino a mRNA contro COVID-19,16121A,Covid 19 - Ospedale Civile di Cecina,TOS,70-79,1,0,0,0,0,1,0,1,0,1,Toscana,ITI1
2021-01-02,COMIRNATY Vaccino a mRNA contro COVID-19,16121A,Covid 19 - Ospedale Civile di Cecina,TOS,80-89,1,6,0,0,0,7,0,7,0,7,Toscana,ITI1
2021-01-02,COMIRNATY Vaccino a mRNA contro COVID-19,16121A,Covid 19 - Ospedale Civile di Cecina,TOS,90+,0,3,0,1,0,2,0,3,0,3,Toscana,ITI1
2021-01-02,COMIRNATY Vaccino a mRNA contro COVID-19,212F4I,R.S.A. I MAGGI,TOS,30-39,0,1,0,1,0,0,0,1,0,1,Toscana,ITI1
2021-01-02,COMIRNATY Vaccino a mRNA contro COVID-19,212F4I,R.S.A. I MAGGI,TOS,40-49,0,2,0,2,0,0,0,2,0,2,Toscana,ITI1
2021-01-02,COMIRNATY Vaccino a mRNA contro COVID-19,212F4I,R.S.A. I MAGGI,TOS,50-59,0,3,0,3,0,0,0,3,0,3,Toscana,ITI1
2021-01-02,COMIRNATY Vaccino a mRNA contro COVID-19,212F4I,R.S.A. I MAGGI,TOS,70-79,0,1,0,0,0,1,0,1,0,1,Toscana,ITI1
2021-01-02,COMIRNATY Vaccino a mRNA contro COVID-19,212F4I,R.S.A. I MAGGI,TOS,80-89,1,3,0,0,0,4,0,4,0,4,Toscana,ITI1
2021-01-02,COMIRNATY Vaccino a mRNA contro COVID-19,212F4I,R.S.A. I MAGGI,TOS,90+,0,1,0,0,0,1,0,1,0,1,Toscana,ITI1
2021-01-02,COMIRNATY Vaccino a mRNA contro COVID-19,22391A,PRESIDIO AVENZA,TOS,20-29,0,1,0,1,0,0,0,1,0,1,Toscana,ITI1
2021-01-02,COMIRNATY Vaccino a mRNA contro COVID-19,22391A,PRESIDIO AVENZA,TOS,50-59,1,4,0,4,0,1,0,5,0,5,Toscana,ITI1
2021-01-02,COMIRNATY Vaccino a mRNA contro COVID-19,22391A,PRESIDIO AVENZA,TOS,60-69,2,1,0,1,0,2,0,3,0,3,Toscana,ITI1
2021-01-02,COMIRNATY Vaccino a mRNA contro COVID-19,22391A,PRESIDIO AVENZA,TOS,70-79,6,5,0,0,0,11,0,11,0,11,Toscana,ITI1
2021-01-02,COMIRNATY Vaccino a mRNA contro COVID-19,22391A,PRESIDIO AVENZA,TOS,80-89,2,5,0,1,0,6,0,7,0,7,Toscana,ITI1
2021-01-02,COMIRNATY Vaccino a mRNA contro COVID-19,22391A,PRESIDIO AVENZA,TOS,90+,1,2,0,0,0,3,0,3,0,3,Toscana,ITI1
2021-01-02,COMIRNATY Vaccino a mRNA contro COVID-19,24911A,Igiene Pubblica Sansepolcro,TOS,20-29,0,4,0,4,0,0,0,4,0,4,Toscana,ITI1
2021-01-02,COMIRNATY Vaccino a mRNA contro COVID-19,24911A,Igiene Pubblica Sansepolcro,TOS,30-39,2,2,0,4,0,0,0,4,0,4,Toscana,ITI1
2021-01-02,COMIRNATY Vaccino a mRNA contro COVID-19,24911A,Igiene Pubblica Sansepolcro,TOS,50-59,2,4,0,6,0,0,0,6,0,6,Toscana,ITI1
2021-01-02,COMIRNATY Vaccino a mRNA contro COVID-19,24911A,Igiene Pubblica Sansepolcro,TOS,60-69,2,2,0,4,0,0,0,4,0,4,Toscana,ITI1
2021-01-02,COMIRNATY Vaccino a mRNA contro COVID-19,40911A,COVID19 - Dip. Prevenzione Ruffolo Siena,TOS,20-29,0,7,0,7,0,0,0,7,0,7,Toscana,ITI1
2021-01-02,COMIRNATY Vaccino a mRNA contro COVID-19,40911A,COVID19 - Dip. Prevenzione Ruffolo Siena,TOS,30-39,1,2,0,3,0,0,0,3,0,3,Toscana,ITI1
2021-01-02,COMIRNATY Vaccino a mRNA contro COVID-19,40911A,COVID19 - Dip. Prevenzione Ruffolo Siena,TOS,40-49,3,6,0,9,0,0,0,9,0,9,Toscana,ITI1
2021-01-02,COMIRNATY Vaccino a mRNA contro COVID-19,40911A,COVID19 - Dip. Prevenzione Ruffolo Siena,TOS,50-59,2,3,0,4,0,1,0,5,0,5,Toscana,ITI1
2021-01-02,COMIRNATY Vaccino a mRNA contro COVID-19,40911A,COVID19 - Dip. Prevenzione Ruffolo Siena,TOS,60-69,5,3,0,1,0,7,0,8,0,8,Toscana,ITI1
2021-01-02,COMIRNATY Vaccino a mRNA contro COVID-19,40911A,COVID19 - Dip. Prevenzione Ruffolo Siena,TOS,70-79,2,4,0,1,0,5,0,6,0,6,Toscana,ITI1
2021-01-02,COMIRNATY Vaccino a mRNA contro COVID-19,40911A,COVID19 - Dip. Prevenzione Ruffolo Siena,TOS,80-89,0,12,0,0,0,12,0,12,0,12,Toscana,ITI1
2021-01-02,COMIRNATY Vaccino a mRNA contro COVID-19,40911A,COVID19 - Dip. Prevenzione Ruffolo Siena,TOS,90+,1,8,0,0,0,9,0,9,0,9,Toscana,ITI1
2021-01-02,COMIRNATY Vaccino a mRNA contro COVID-19,ND,Dip.Prevenzione PISA - ISP,TOS,20-29,0,1,0,1,0,0,0,1,0,1,Toscana,ITI1
2021-01-02,COMIRNATY Vaccino a mRNA contro COVID-19,ND,Dip.Prevenzione PISA - ISP,TOS,40-49,1,2,0,3,0,0,0,3,0,3,Toscana,ITI1
2021-01-02,COMIRNATY Vaccino a mRNA contro COVID-19,ND,Dip.Prevenzione PISA - ISP,TOS,50-59,2,4,0,5,0,1,0,6,0,6,Toscana,ITI1
2021-01-02,COMIRNATY Vaccino a mRNA contro COVID-19,ND,Dip.Prevenzione PISA - ISP,TOS,70-79,1,4,0,0,0,5,0,5,0,5,Toscana,ITI1
2021-01-02,COMIRNATY Vaccino a mRNA contro COVID-19,ND,Dip.Prevenzione PISA - ISP,TOS,80-89,2,7,0,0,0,9,0,9,0,9,Toscana,ITI1
2021-01-02,COMIRNATY Vaccino a mRNA contro COVID-19,ND,Dip.Prevenzione PISA - ISP,TOS,90+,0,11,0,0,0,11,0,11,0,11,Toscana,ITI1
2021-01-03,COMIRNATY Vaccino a mRNA contro COVID-19,090601,Covid 19 - Ospedale S.Antonio Abate di Fivizzano,TOS,20-29,0,1,0,0,0,1,0,1,0,1,Toscana,ITI1
2021-01-03,COMIRNATY Vaccino a mRNA contro COVID-19,090601,Covid 19 - Ospedale S.Antonio Abate di Fivizzano,TOS,40-49,1,3,0,1,0,3,0,4,0,4,Toscana,ITI1
2021-01-03,COMIRNATY Vaccino a mRNA contro COVID-19,090601,Covid 19 - Ospedale S.Antonio Abate di Fivizzano,TOS,50-59,4,6,0,2,0,8,0,10,0,10,Toscana,ITI1
2021-01-03,COMIRNATY Vaccino a mRNA contro COVID-19,090601,Covid 19 - Ospedale S.Antonio Abate di Fivizzano,TOS,60-69,8,5,0,2,0,11,0,13,0,13,Toscana,ITI1
2021-01-03,COMIRNATY Vaccino a mRNA contro COVID-19,090601,Covid 19 - Ospedale S.Antonio Abate di Fivizzano,TOS,70-79,6,9,0,3,0,12,0,15,0,15,Toscana,ITI1
2021-01-03,COMIRNATY Vaccino a mRNA contro COVID-19,090601,Covid 19 - Ospedale S.Antonio Abate di Fivizzano,TOS,80-89,8,22,0,0,0,30,0,30,0,30,Toscana,ITI1
2021-01-03,COMIRNATY Vaccino a mRNA contro COVID-19,090601,Covid 19 - Ospedale S.Antonio Abate di Fivizzano,TOS,90+,2,15,0,0,0,17,0,17,0,17,Toscana,ITI1
2021-01-03,COMIRNATY Vaccino a mRNA contro COVID-19,090602,Covid 19 - Nuovo Ospedale Apuane,TOS,20-29,12,7,0,19,0,0,0,19,0,19,Toscana,ITI1
2021-01-03,COMIRNATY Vaccino a mRNA contro COVID-19,090602,Covid 19 - Nuovo Ospedale Apuane,TOS,30-39,14,20,0,34,0,0,0,34,0,34,Toscana,ITI1
2021-01-03,COMIRNATY Vaccino a mRNA contro COVID-19,090602,Covid 19 - Nuovo Ospedale Apuane,TOS,40-49,0,19,0,19,0,0,0,19,0,19,Toscana,ITI1
2021-01-03,COMIRNATY Vaccino a mRNA contro COVID-19,090602,Covid 19 - Nuovo Ospedale Apuane,TOS,50-59,8,16,0,23,0,1,0,24,0,24,Toscana,ITI1
2021-01-03,COMIRNATY Vaccino a mRNA contro COVID-19,090602,Covid 19 - Nuovo Ospedale Apuane,TOS,60-69,4,4,0,8,0,0,0,8,0,8,Toscana,ITI1
2021-01-03,COMIRNATY Vaccino a mRNA contro COVID-19,090604,Covid 19 - Ospedale San Luca di  Lucca,TOS,20-29,7,9,0,16,0,0,0,16,0,16,Toscana,ITI1
2021-01-03,COMIRNATY Vaccino a mRNA contro COVID-19,090604,Covid 19 - Ospedale San Luca di  Lucca,TOS,30-39,9,14,0,23,0,0,0,23,0,23,Toscana,ITI1
2021-01-03,COMIRNATY Vaccino a mRNA contro COVID-19,090604,Covid 19 - Ospedale San Luca di  Lucca,TOS,40-49,3,18,0,21,0,0,0,21,0,21,Toscana,ITI1
2021-01-03,COMIRNATY Vaccino a mRNA contro COVID-19,090604,Covid 19 - Ospedale San Luca di  Lucca,TOS,50-59,7,26,0,33,0,0,0,33,0,33,Toscana,ITI1
2021-01-03,COMIRNATY Vaccino a mRNA contro COVID-19,090604,Covid 19 - Ospedale San Luca di  Lucca,TOS,60-69,12,12,0,16,0,8,0,24,0,24,Toscana,ITI1
2021-01-03,COMIRNATY Vaccino a mRNA contro COVID-19,090604,Covid 19 - Ospedale San Luca di  Lucca,TOS,70-79,3,13,0,0,0,16,0,16,0,16,Toscana,ITI1
2021-01-03,COMIRNATY Vaccino a mRNA contro COVID-19,090604,Covid 19 - Ospedale San Luca di  Lucca,TOS,80-89,12,20,0,0,0,32,0,32,0,32,Toscana,ITI1
2021-01-03,COMIRNATY Vaccino a mRNA contro COVID-19,090604,Covid 19 - Ospedale San Luca di  Lucca,TOS,90+,3,12,0,0,0,15,0,15,0,15,Toscana,ITI1
2021-01-03,COMIRNATY Vaccino a mRNA contro COVID-19,090606,COVID19 - Ospedale San Iacopo,TOS,20-29,3,10,0,12,1,0,0,13,0,13,Toscana,ITI1
2021-01-03,COMIRNATY Vaccino a mRNA contro COVID-19,090606,COVID19 - Ospedale San Iacopo,TOS,30-39,10,17,0,26,0,1,0,27,0,27,Toscana,ITI1
2021-01-03,COMIRNATY Vaccino a mRNA contro COVID-19,090606,COVID19 - Ospedale San Iacopo,TOS,40-49,3,23,0,25,0,1,0,26,0,26,Toscana,ITI1
2021-01-03,COMIRNATY Vaccino a mRNA contro COVID-19,090606,COVID19 - Ospedale San Iacopo,TOS,50-59,10,31,0,41,0,0,0,41,0,41,Toscana,ITI1
2021-01-03,COMIRNATY Vaccino a mRNA contro COVID-19,090606,COVID19 - Ospedale San Iacopo,TOS,60-69,13,9,0,21,0,1,0,22,0,22,Toscana,ITI1
2021-01-03,COMIRNATY Vaccino a mRNA contro COVID-19,090606,COVID19 - Ospedale San Iacopo,TOS,70-79,4,1,0,0,0,5,0,5,0,5,Toscana,ITI1
2021-01-03,COMIRNATY Vaccino a mRNA contro COVID-19,090606,COVID19 - Ospedale San Iacopo,TOS,80-89,1,5,0,0,0,6,0,6,0,6,Toscana,ITI1
2021-01-03,COMIRNATY Vaccino a mRNA contro COVID-19,090606,COVID19 - Ospedale San Iacopo,TOS,90+,2,6,0,0,0,8,0,8,0,8,Toscana,ITI1
2021-01-03,COMIRNATY Vaccino a mRNA contro COVID-19,090608,COVID19 - Ospedale Santo Stefano,TOS,20-29,3,13,0,15,0,1,0,16,0,16,Toscana,ITI1
2021-01-03,COMIRNATY Vaccino a mRNA contro COVID-19,090608,COVID19 - Ospedale Santo Stefano,TOS,30-39,13,25,0,38,0,0,0,38,0,38,Toscana,ITI1
2021-01-03,COMIRNATY Vaccino a mRNA contro COVID-19,090608,COVID19 - Ospedale Santo Stefano,TOS,40-49,18,23,0,35,0,6,0,41,0,41,Toscana,ITI1
2021-01-03,COMIRNATY Vaccino a mRNA contro COVID-19,090608,COVID19 - Ospedale Santo Stefano,TOS,50-59,14,18,0,25,0,7,0,32,0,32,Toscana,ITI1
2021-01-03,COMIRNATY Vaccino a mRNA contro COVID-19,090608,COVID19 - Ospedale Santo Stefano,TOS,60-69,8,1,0,5,0,4,0,9,0,9,Toscana,ITI1
2021-01-03,COMIRNATY Vaccino a mRNA contro COVID-19,090608,COVID19 - Ospedale Santo Stefano,TOS,70-79,2,5,0,0,0,7,0,7,0,7,Toscana,ITI1
2021-01-03,COMIRNATY Vaccino a mRNA contro COVID-19,090608,COVID19 - Ospedale Santo Stefano,TOS,80-89,3,12,0,0,0,15,0,15,0,15,Toscana,ITI1
2021-01-03,COMIRNATY Vaccino a mRNA contro COVID-19,090608,COVID19 - Ospedale Santo Stefano,TOS,90+,3,13,0,0,0,16,0,16,0,16,Toscana,ITI1
2021-01-03,COMIRNATY Vaccino a mRNA contro COVID-19,090610,Covid 19 - Ospedale F.Lotti di Pontedera,TOS,20-29,3,4,0,7,0,0,0,7,0,7,Toscana,ITI1
2021-01-03,COMIRNATY Vaccino a mRNA contro COVID-19,090610,Covid 19 - Ospedale F.Lotti di Pontedera,TOS,30-39,4,5,0,9,0,0,0,9,0,9,Toscana,ITI1
2021-01-03,COMIRNATY Vaccino a mRNA contro COVID-19,090610,Covid 19 - Ospedale F.Lotti di Pontedera,TOS,40-49,4,10,0,14,0,0,0,14,0,14,Toscana,ITI1
2021-01-03,COMIRNATY Vaccino a mRNA contro COVID-19,090610,Covid 19 - Ospedale F.Lotti di Pontedera,TOS,50-59,3,11,0,14,0,0,0,14,0,14,Toscana,ITI1
2021-01-03,COMIRNATY Vaccino a mRNA contro COVID-19,090610,Covid 19 - Ospedale F.Lotti di Pontedera,TOS,60-69,1,3,0,4,0,0,0,4,0,4,Toscana,ITI1
2021-01-03,COMIRNATY Vaccino a mRNA contro COVID-19,090613,Covid 19 - Ospedali Riuniti di Livorno,TOS,20-29,3,12,0,15,0,0,0,15,0,15,Toscana,ITI1
2021-01-03,COMIRNATY Vaccino a mRNA contro COVID-19,090613,Covid 19 - Ospedali Riuniti di Livorno,TOS,30-39,7,13,0,19,1,0,0,20,0,20,Toscana,ITI1
2021-01-03,COMIRNATY Vaccino a mRNA contro COVID-19,090613,Covid 19 - Ospedali Riuniti di Livorno,TOS,40-49,12,22,0,33,1,0,0,34,0,34,Toscana,ITI1
2021-01-03,COMIRNATY Vaccino a mRNA contro COVID-19,090613,Covid 19 - Ospedali Riuniti di Livorno,TOS,50-59,10,27,0,37,0,0,0,37,0,37,Toscana,ITI1
2021-01-03,COMIRNATY Vaccino a mRNA contro COVID-19,090613,Covid 19 - Ospedali Riuniti di Livorno,TOS,60-69,5,9,0,14,0,0,0,14,0,14,Toscana,ITI1
2021-01-03,COMIRNATY Vaccino a mRNA contro COVID-19,090613,Covid 19 - Ospedali Riuniti di Livorno,TOS,70-79,1,1,0,0,0,2,0,2,0,2,Toscana,ITI1
2021-01-03,COMIRNATY Vaccino a mRNA contro COVID-19,090613,Covid 19 - Ospedali Riuniti di Livorno,TOS,80-89,1,3,0,0,0,4,0,4,0,4,Toscana,ITI1
2021-01-03,COMIRNATY Vaccino a mRNA contro COVID-19,090613,Covid 19 - Ospedali Riuniti di Livorno,TOS,90+,1,3,0,0,0,4,0,4,0,4,Toscana,ITI1
2021-01-03,COMIRNATY Vaccino a mRNA contro COVID-19,090614,Covid 19 - Ospedale Civile di Piombino,TOS,20-29,1,0,0,1,0,0,0,1,0,1,Toscana,ITI1
2021-01-03,COMIRNATY Vaccino a mRNA contro COVID-19,090614,Covid 19 - Ospedale Civile di Piombino,TOS,30-39,0,1,0,1,0,0,0,1,0,1,Toscana,ITI1
2021-01-03,COMIRNATY Vaccino a mRNA contro COVID-19,090614,Covid 19 - Ospedale Civile di Piombino,TOS,40-49,0,5,0,5,0,0,0,5,0,5,Toscana,ITI1
2021-01-03,COMIRNATY Vaccino a mRNA contro COVID-19,090614,Covid 19 - Ospedale Civile di Piombino,TOS,50-59,0,9,0,9,0,0,0,9,0,9,Toscana,ITI1
2021-01-03,COMIRNATY Vaccino a mRNA contro COVID-19,090614,Covid 19 - Ospedale Civile di Piombino,TOS,60-69,0,2,0,2,0,0,0,2,0,2,Toscana,ITI1
2021-01-03,COMIRNATY Vaccino a mRNA contro COVID-19,090619,COVID19 - Ospedale Valtiberina Sansepolcro,TOS,30-39,0,1,0,1,0,0,0,1,0,1,Toscana,ITI1
2021-01-03,COMIRNATY Vaccino a mRNA contro COVID-19,090619,COVID19 - Ospedale Valtiberina Sansepolcro,TOS,50-59,2,2,0,1,0,3,0,4,0,4,Toscana,ITI1
2021-01-03,COMIRNATY Vaccino a mRNA contro COVID-19,090619,COVID19 - Ospedale Valtiberina Sansepolcro,TOS,60-69,0,1,0,0,0,1,0,1,0,1,Toscana,ITI1
2021-01-03,COMIRNATY Vaccino a mRNA contro COVID-19,090619,COVID19 - Ospedale Valtiberina Sansepolcro,TOS,70-79,3,4,0,1,0,6,0,7,0,7,Toscana,ITI1
2021-01-03,COMIRNATY Vaccino a mRNA contro COVID-19,090619,COVID19 - Ospedale Valtiberina Sansepolcro,TOS,80-89,5,8,0,0,0,13,0,13,0,13,Toscana,ITI1
2021-01-03,COMIRNATY Vaccino a mRNA contro COVID-19,090619,COVID19 - Ospedale Valtiberina Sansepolcro,TOS,90+,2,7,0,2,0,7,0,9,0,9,Toscana,ITI1
2021-01-03,COMIRNATY Vaccino a mRNA contro COVID-19,090621,COVID19 - Ospedale di Arezzo,TOS,20-29,7,18,0,25,0,0,0,25,0,25,Toscana,ITI1
2021-01-03,COMIRNATY Vaccino a mRNA contro COVID-19,090621,COVID19 - Ospedale di Arezzo,TOS,30-39,3,15,0,17,0,1,0,18,0,18,Toscana,ITI1
2021-01-03,COMIRNATY Vaccino a mRNA contro COVID-19,090621,COVID19 - Ospedale di Arezzo,TOS,40-49,6,16,0,22,0,0,0,22,0,22,Toscana,ITI1
2021-01-03,COMIRNATY Vaccino a mRNA contro COVID-19,090621,COVID19 - Ospedale di Arezzo,TOS,50-59,3,13,0,16,0,0,0,16,0,16,Toscana,ITI1
2021-01-03,COMIRNATY Vaccino a mRNA contro COVID-19,090621,COVID19 - Ospedale di Arezzo,TOS,60-69,1,2,0,3,0,0,0,3,0,3,Toscana,ITI1
2021-01-03,COMIRNATY Vaccino a mRNA contro COVID-19,090624,COVID19 - Ospedale di Orbetello,TOS,20-29,1,3,0,4,0,0,0,4,0,4,Toscana,ITI1
2021-01-03,COMIRNATY Vaccino a mRNA contro COVID-19,090624,COVID19 - Ospedale di Orbetello,TOS,30-39,1,0,0,1,0,0,0,1,0,1,Toscana,ITI1
2021-01-03,COMIRNATY Vaccino a mRNA contro COVID-19,090624,COVID19 - Ospedale di Orbetello,TOS,40-49,0,1,0,1,0,0,0,1,0,1,Toscana,ITI1
2021-01-03,COMIRNATY Vaccino a mRNA contro COVID-19,090624,COVID19 - Ospedale di Orbetello,TOS,50-59,1,0,0,1,0,0,0,1,0,1,Toscana,ITI1
2021-01-03,COMIRNATY Vaccino a mRNA contro COVID-19,090624,COVID19 - Ospedale di Orbetello,TOS,60-69,4,4,0,1,0,7,0,8,0,8,Toscana,ITI1
2021-01-03,COMIRNATY Vaccino a mRNA contro COVID-19,090624,COVID19 - Ospedale di Orbetello,TOS,70-79,4,10,0,0,0,14,0,14,0,14,Toscana,ITI1
2021-01-03,COMIRNATY Vaccino a mRNA contro COVID-19,090624,COVID19 - Ospedale di Orbetello,TOS,80-89,2,14,0,0,0,16,0,16,0,16,Toscana,ITI1
2021-01-03,COMIRNATY Vaccino a mRNA contro COVID-19,090624,COVID19 - Ospedale di Orbetello,TOS,90+,1,8,0,0,0,9,0,9,0,9,Toscana,ITI1
2021-01-03,COMIRNATY Vaccino a mRNA contro COVID-19,090626,COVID19 - Ospedale di Grosseto,TOS,20-29,1,1,0,2,0,0,0,2,0,2,Toscana,ITI1
2021-01-03,COMIRNATY Vaccino a mRNA contro COVID-19,090626,COVID19 - Ospedale di Grosseto,TOS,30-39,1,1,0,0,0,2,0,2,0,2,Toscana,ITI1
2021-01-03,COMIRNATY Vaccino a mRNA contro COVID-19,090626,COVID19 - Ospedale di Grosseto,TOS,40-49,0,5,0,2,0,3,0,5,0,5,Toscana,ITI1
2021-01-03,COMIRNATY Vaccino a mRNA contro COVID-19,090626,COVID19 - Ospedale di Grosseto,TOS,50-59,2,5,0,2,0,5,0,7,0,7,Toscana,ITI1
2021-01-03,COMIRNATY Vaccino a mRNA contro COVID-19,090626,COVID19 - Ospedale di Grosseto,TOS,60-69,2,0,0,2,0,0,0,2,0,2,Toscana,ITI1
2021-01-03,COMIRNATY Vaccino a mRNA contro COVID-19,090627,COVID19 - Ospedale Mugello,TOS,50-59,1,0,0,1,0,0,0,1,0,1,Toscana,ITI1
2021-01-03,COMIRNATY Vaccino a mRNA contro COVID-19,090627,COVID19 - Ospedale Mugello,TOS,70-79,0,4,0,0,0,4,0,4,0,4,Toscana,ITI1
2021-01-03,COMIRNATY Vaccino a mRNA contro COVID-19,090627,COVID19 - Ospedale Mugello,TOS,80-89,2,7,0,0,0,9,0,9,0,9,Toscana,ITI1
2021-01-03,COMIRNATY Vaccino a mRNA contro COVID-19,090627,COVID19 - Ospedale Mugello,TOS,90+,1,9,0,0,0,10,0,10,0,10,Toscana,ITI1
2021-01-03,COMIRNATY Vaccino a mRNA contro COVID-19,090629,COVID19 - Ospedale SS. Maria Annunziata,TOS,20-29,1,8,0,8,0,1,0,9,0,9,Toscana,ITI1
2021-01-03,COMIRNATY Vaccino a mRNA contro COVID-19,090629,COVID19 - Ospedale SS. Maria Annunziata,TOS,30-39,10,13,0,23,0,0,0,23,0,23,Toscana,ITI1
2021-01-03,COMIRNATY Vaccino a mRNA contro COVID-19,090629,COVID19 - Ospedale SS. Maria Annunziata,TOS,40-49,11,17,0,22,0,6,0,28,0,28,Toscana,ITI1
2021-01-03,COMIRNATY Vaccino a mRNA contro COVID-19,090629,COVID19 - Ospedale SS. Maria Annunziata,TOS,50-59,22,37,0,41,0,18,0,59,0,59,Toscana,ITI1
2021-01-03,COMIRNATY Vaccino a mRNA contro COVID-19,090629,COVID19 - Ospedale SS. Maria Annunziata,TOS,60-69,11,8,0,13,0,6,0,19,0,19,Toscana,ITI1
2021-01-03,COMIRNATY Vaccino a mRNA contro COVID-19,090638,COVID19 - Ospedale di Campostaggia Poggibonsi,TOS,20-29,6,8,0,14,0,0,0,14,0,14,Toscana,ITI1
2021-01-03,COMIRNATY Vaccino a mRNA contro COVID-19,090638,COVID19 - Ospedale di Campostaggia Poggibonsi,TOS,30-39,3,9,0,12,0,0,0,12,0,12,Toscana,ITI1
2021-01-03,COMIRNATY Vaccino a mRNA contro COVID-19,090638,COVID19 - Ospedale di Campostaggia Poggibonsi,TOS,40-49,11,6,0,17,0,0,0,17,0,17,Toscana,ITI1
2021-01-03,COMIRNATY Vaccino a mRNA contro COVID-19,090638,COVID19 - Ospedale di Campostaggia Poggibonsi,TOS,50-59,7,7,0,14,0,0,0,14,0,14,Toscana,ITI1
2021-01-03,COMIRNATY Vaccino a mRNA contro COVID-19,090638,COVID19 - Ospedale di Campostaggia Poggibonsi,TOS,60-69,4,4,0,8,0,0,0,8,0,8,Toscana,ITI1
2021-01-03,COMIRNATY Vaccino a mRNA contro COVID-19,090639,COVID19 - Ospedale di Nottola Montepulciano,TOS,20-29,3,5,0,8,0,0,0,8,0,8,Toscana,ITI1
2021-01-03,COMIRNATY Vaccino a mRNA contro COVID-19,090639,COVID19 - Ospedale di Nottola Montepulciano,TOS,30-39,1,5,0,6,0,0,0,6,0,6,Toscana,ITI1
2021-01-03,COMIRNATY Vaccino a mRNA contro COVID-19,090639,COVID19 - Ospedale di Nottola Montepulciano,TOS,40-49,0,3,0,3,0,0,0,3,0,3,Toscana,ITI1
2021-01-03,COMIRNATY Vaccino a mRNA contro COVID-19,090639,COVID19 - Ospedale di Nottola Montepulciano,TOS,50-59,0,3,0,3,0,0,0,3,0,3,Toscana,ITI1
2021-01-03,COMIRNATY Vaccino a mRNA contro COVID-19,090639,COVID19 - Ospedale di Nottola Montepulciano,TOS,60-69,2,1,0,1,0,2,0,3,0,3,Toscana,ITI1
2021-01-03,COMIRNATY Vaccino a mRNA contro COVID-19,090639,COVID19 - Ospedale di Nottola Montepulciano,TOS,70-79,3,2,0,0,0,5,0,5,0,5,Toscana,ITI1
2021-01-03,COMIRNATY Vaccino a mRNA contro COVID-19,090639,COVID19 - Ospedale di Nottola Montepulciano,TOS,80-89,3,8,0,0,0,11,0,11,0,11,Toscana,ITI1
2021-01-03,COMIRNATY Vaccino a mRNA contro COVID-19,090639,COVID19 - Ospedale di Nottola Montepulciano,TOS,90+,2,17,0,0,0,19,0,19,0,19,Toscana,ITI1
2021-01-03,COMIRNATY Vaccino a mRNA contro COVID-19,090640,Covid 19 - Ospedale Unico Versilia,TOS,20-29,2,8,0,10,0,0,0,10,0,10,Toscana,ITI1
2021-01-03,COMIRNATY Vaccino a mRNA contro COVID-19,090640,Covid 19 - Ospedale Unico Versilia,TOS,30-39,4,6,0,10,0,0,0,10,0,10,Toscana,ITI1
2021-01-03,COMIRNATY Vaccino a mRNA contro COVID-19,090640,Covid 19 - Ospedale Unico Versilia,TOS,40-49,8,11,0,19,0,0,0,19,0,19,Toscana,ITI1
2021-01-03,COMIRNATY Vaccino a mRNA contro COVID-19,090640,Covid 19 - Ospedale Unico Versilia,TOS,50-59,8,23,0,31,0,0,0,31,0,31,Toscana,ITI1
2021-01-03,COMIRNATY Vaccino a mRNA contro COVID-19,090640,Covid 19 - Ospedale Unico Versilia,TOS,60-69,3,5,0,8,0,0,0,8,0,8,Toscana,ITI1
2021-01-03,COMIRNATY Vaccino a mRNA contro COVID-19,090641,COVID19 - Ospedale La Gruccia Montevarchi,TOS,20-29,4,11,0,15,0,0,0,15,0,15,Toscana,ITI1
2021-01-03,COMIRNATY Vaccino a mRNA contro COVID-19,090641,COVID19 - Ospedale La Gruccia Montevarchi,TOS,30-39,0,8,0,8,0,0,0,8,0,8,Toscana,ITI1
2021-01-03,COMIRNATY Vaccino a mRNA contro COVID-19,090641,COVID19 - Ospedale La Gruccia Montevarchi,TOS,40-49,2,4,0,5,0,1,0,6,0,6,Toscana,ITI1
2021-01-03,COMIRNATY Vaccino a mRNA contro COVID-19,090641,COVID19 - Ospedale La Gruccia Montevarchi,TOS,50-59,0,7,0,6,1,0,0,7,0,7,Toscana,ITI1
2021-01-03,COMIRNATY Vaccino a mRNA contro COVID-19,090641,COVID19 - Ospedale La Gruccia Montevarchi,TOS,60-69,2,5,0,3,0,4,0,7,0,7,Toscana,ITI1
2021-01-03,COMIRNATY Vaccino a mRNA contro COVID-19,090641,COVID19 - Ospedale La Gruccia Montevarchi,TOS,70-79,3,4,0,0,0,7,0,7,0,7,Toscana,ITI1
2021-01-03,COMIRNATY Vaccino a mRNA contro COVID-19,090641,COVID19 - Ospedale La Gruccia Montevarchi,TOS,80-89,6,13,0,0,0,19,0,19,0,19,Toscana,ITI1
2021-01-03,COMIRNATY Vaccino a mRNA contro COVID-19,090641,COVID19 - Ospedale La Gruccia Montevarchi,TOS,90+,0,14,0,0,0,14,0,14,0,14,Toscana,ITI1
2021-01-03,COMIRNATY Vaccino a mRNA contro COVID-19,090643,COVID19 - Ospedale S. Margherita Cortona,TOS,20-29,0,5,0,5,0,0,0,5,0,5,Toscana,ITI1
2021-01-03,COMIRNATY Vaccino a mRNA contro COVID-19,090643,COVID19 - Ospedale S. Margherita Cortona,TOS,30-39,1,8,0,9,0,0,0,9,0,9,Toscana,ITI1
2021-01-03,COMIRNATY Vaccino a mRNA contro COVID-19,090643,COVID19 - Ospedale S. Margherita Cortona,TOS,40-49,3,14,0,17,0,0,0,17,0,17,Toscana,ITI1
2021-01-03,COMIRNATY Vaccino a mRNA contro COVID-19,090643,COVID19 - Ospedale S. Margherita Cortona,TOS,50-59,4,23,0,27,0,0,0,27,0,27,Toscana,ITI1
2021-01-03,COMIRNATY Vaccino a mRNA contro COVID-19,090643,COVID19 - Ospedale S. Margherita Cortona,TOS,60-69,0,1,0,1,0,0,0,1,0,1,Toscana,ITI1
2021-01-03,COMIRNATY Vaccino a mRNA contro COVID-19,090643,COVID19 - Ospedale S. Margherita Cortona,TOS,70-79,0,1,0,1,0,0,0,1,0,1,Toscana,ITI1
2021-01-03,COMIRNATY Vaccino a mRNA contro COVID-19,090901,COVID19 - AOU Pisana,TOS,20-29,15,36,0,51,0,0,0,51,0,51,Toscana,ITI1
2021-01-03,COMIRNATY Vaccino a mRNA contro COVID-19,090901,COVID19 - AOU Pisana,TOS,30-39,31,61,0,92,0,0,0,92,0,92,Toscana,ITI1
2021-01-03,COMIRNATY Vaccino a mRNA contro COVID-19,090901,COVID19 - AOU Pisana,TOS,40-49,31,90,0,121,0,0,0,121,0,121,Toscana,ITI1
2021-01-03,COMIRNATY Vaccino a mRNA contro COVID-19,090901,COVID19 - AOU Pisana,TOS,50-59,20,61,0,81,0,0,0,81,0,81,Toscana,ITI1
2021-01-03,COMIRNATY Vaccino a mRNA contro COVID-19,090901,COVID19 - AOU Pisana,TOS,60-69,13,17,0,30,0,0,0,30,0,30,Toscana,ITI1
2021-01-03,COMIRNATY Vaccino a mRNA contro COVID-19,090902,COVID19 - AOU Senese,TOS,20-29,24,45,0,69,0,0,0,69,0,69,Toscana,ITI1
2021-01-03,COMIRNATY Vaccino a mRNA contro COVID-19,090902,COVID19 - AOU Senese,TOS,30-39,30,37,0,67,0,0,0,67,0,67,Toscana,ITI1
2021-01-03,COMIRNATY Vaccino a mRNA contro COVID-19,090902,COVID19 - AOU Senese,TOS,40-49,7,21,0,28,0,0,0,28,0,28,Toscana,ITI1
2021-01-03,COMIRNATY Vaccino a mRNA contro COVID-19,090902,COVID19 - AOU Senese,TOS,50-59,27,45,0,72,0,0,0,72,0,72,Toscana,ITI1
2021-01-03,COMIRNATY Vaccino a mRNA contro COVID-19,090902,COVID19 - AOU Senese,TOS,60-69,1,3,0,4,0,0,0,4,0,4,Toscana,ITI1
2021-01-03,COMIRNATY Vaccino a mRNA contro COVID-19,090903,COVID19 - AOU Careggi - CTO,TOS,20-29,22,48,0,70,0,0,0,70,0,70,Toscana,ITI1
2021-01-03,COMIRNATY Vaccino a mRNA contro COVID-19,090903,COVID19 - AOU Careggi - CTO,TOS,30-39,39,53,0,92,0,0,0,92,0,92,Toscana,ITI1
2021-01-03,COMIRNATY Vaccino a mRNA contro COVID-19,090903,COVID19 - AOU Careggi - CTO,TOS,40-49,26,63,0,89,0,0,0,89,0,89,Toscana,ITI1
2021-01-03,COMIRNATY Vaccino a mRNA contro COVID-19,090903,COVID19 - AOU Careggi - CTO,TOS,50-59,23,82,0,105,0,0,0,105,0,105,Toscana,ITI1
2021-01-03,COMIRNATY Vaccino a mRNA contro COVID-19,090903,COVID19 - AOU Careggi - CTO,TOS,60-69,14,15,0,29,0,0,0,29,0,29,Toscana,ITI1
2021-01-03,COMIRNATY Vaccino a mRNA contro COVID-19,090904,COVID19 - Ospedale AOU Meyer,TOS,20-29,4,5,0,9,0,0,0,9,0,9,Toscana,ITI1
2021-01-03,COMIRNATY Vaccino a mRNA contro COVID-19,090904,COVID19 - Ospedale AOU Meyer,TOS,30-39,7,13,0,20,0,0,0,20,0,20,Toscana,ITI1
2021-01-03,COMIRNATY Vaccino a mRNA contro COVID-19,090904,COVID19 - Ospedale AOU Meyer,TOS,40-49,4,15,0,19,0,0,0,19,0,19,Toscana,ITI1
2021-01-03,COMIRNATY Vaccino a mRNA contro COVID-19,090904,COVID19 - Ospedale AOU Meyer,TOS,50-59,3,12,0,15,0,0,0,15,0,15,Toscana,ITI1
2021-01-03,COMIRNATY Vaccino a mRNA contro COVID-19,090904,COVID19 - Ospedale AOU Meyer,TOS,60-69,1,2,0,3,0,0,0,3,0,3,Toscana,ITI1
2021-01-03,COMIRNATY Vaccino a mRNA contro COVID-19,11012E,COVID19 - Ospedale San Giuseppe,TOS,20-29,5,4,0,8,0,1,0,9,0,9,Toscana,ITI1
2021-01-03,COMIRNATY Vaccino a mRNA contro COVID-19,11012E,COVID19 - Ospedale San Giuseppe,TOS,30-39,9,15,0,23,0,1,0,24,0,24,Toscana,ITI1
2021-01-03,COMIRNATY Vaccino a mRNA contro COVID-19,11012E,COVID19 - Ospedale San Giuseppe,TOS,40-49,10,20,0,29,0,1,0,30,0,30,Toscana,ITI1
2021-01-03,COMIRNATY Vaccino a mRNA contro COVID-19,11012E,COVID19 - Ospedale San Giuseppe,TOS,50-59,9,30,0,39,0,0,0,39,0,39,Toscana,ITI1
2021-01-03,COMIRNATY Vaccino a mRNA contro COVID-19,11012E,COVID19 - Ospedale San Giuseppe,TOS,60-69,9,4,0,10,0,3,0,13,0,13,Toscana,ITI1
2021-01-03,COMIRNATY Vaccino a mRNA contro COVID-19,11012E,COVID19 - Ospedale San Giuseppe,TOS,70-79,5,2,0,0,0,7,0,7,0,7,Toscana,ITI1
2021-01-03,COMIRNATY Vaccino a mRNA contro COVID-19,11012E,COVID19 - Ospedale San Giuseppe,TOS,80-89,7,12,0,0,0,19,0,19,0,19,Toscana,ITI1
2021-01-03,COMIRNATY Vaccino a mRNA contro COVID-19,11012E,COVID19 - Ospedale San Giuseppe,TOS,90+,1,14,0,0,0,15,0,15,0,15,Toscana,ITI1
2021-01-03,COMIRNATY Vaccino a mRNA contro COVID-19,113B4I,RSA LO SPEDALETTO - RESID.,TOS,30-39,2,2,0,4,0,0,0,4,0,4,Toscana,ITI1
2021-01-03,COMIRNATY Vaccino a mRNA contro COVID-19,113B4I,RSA LO SPEDALETTO - RESID.,TOS,40-49,1,1,0,2,0,0,0,2,0,2,Toscana,ITI1
2021-01-03,COMIRNATY Vaccino a mRNA contro COVID-19,113B4I,RSA LO SPEDALETTO - RESID.,TOS,50-59,0,4,0,4,0,0,0,4,0,4,Toscana,ITI1
2021-01-03,COMIRNATY Vaccino a mRNA contro COVID-19,113B4I,RSA LO SPEDALETTO - RESID.,TOS,70-79,3,0,0,0,0,3,0,3,0,3,Toscana,ITI1
2021-01-03,COMIRNATY Vaccino a mRNA contro COVID-19,113B4I,RSA LO SPEDALETTO - RESID.,TOS,80-89,2,2,0,0,0,4,0,4,0,4,Toscana,ITI1
2021-01-03,COMIRNATY Vaccino a mRNA contro COVID-19,113B4I,RSA LO SPEDALETTO - RESID.,TOS,90+,0,1,0,0,0,1,0,1,0,1,Toscana,ITI1
2021-01-03,COMIRNATY Vaccino a mRNA contro COVID-19,13021A,COVID19 - Ospedale S.Giovanni di Dio,TOS,20-29,16,28,0,44,0,0,0,44,0,44,Toscana,ITI1
2021-01-03,COMIRNATY Vaccino a mRNA contro COVID-19,13021A,COVID19 - Ospedale S.Giovanni di Dio,TOS,30-39,11,29,0,39,0,1,0,40,0,40,Toscana,ITI1
2021-01-03,COMIRNATY Vaccino a mRNA contro COVID-19,13021A,COVID19 - Ospedale S.Giovanni di Dio,TOS,40-49,10,31,0,39,0,2,0,41,0,41,Toscana,ITI1
2021-01-03,COMIRNATY Vaccino a mRNA contro COVID-19,13021A,COVID19 - Ospedale S.Giovanni di Dio,TOS,50-59,17,29,0,41,0,5,0,46,0,46,Toscana,ITI1
2021-01-03,COMIRNATY Vaccino a mRNA contro COVID-19,13021A,COVID19 - Ospedale S.Giovanni di Dio,TOS,60-69,13,17,0,19,0,11,0,30,0,30,Toscana,ITI1
2021-01-03,COMIRNATY Vaccino a mRNA contro COVID-19,13021A,COVID19 - Ospedale S.Giovanni di Dio,TOS,70-79,11,10,0,1,0,20,0,21,0,21,Toscana,ITI1
2021-01-03,COMIRNATY Vaccino a mRNA contro COVID-19,13021A,COVID19 - Ospedale S.Giovanni di Dio,TOS,80-89,6,28,0,0,0,34,0,34,0,34,Toscana,ITI1
2021-01-03,COMIRNATY Vaccino a mRNA contro COVID-19,13021A,COVID19 - Ospedale S.Giovanni di Dio,TOS,90+,3,35,0,0,0,38,0,38,0,38,Toscana,ITI1
2021-01-03,COMIRNATY Vaccino a mRNA contro COVID-19,16121A,Covid 19 - Ospedale Civile di Cecina,TOS,20-29,1,1,0,2,0,0,0,2,0,2,Toscana,ITI1
2021-01-03,COMIRNATY Vaccino a mRNA contro COVID-19,16121A,Covid 19 - Ospedale Civile di Cecina,TOS,30-39,1,3,0,4,0,0,0,4,0,4,Toscana,ITI1
2021-01-03,COMIRNATY Vaccino a mRNA contro COVID-19,16121A,Covid 19 - Ospedale Civile di Cecina,TOS,40-49,3,4,0,7,0,0,0,7,0,7,Toscana,ITI1
2021-01-03,COMIRNATY Vaccino a mRNA contro COVID-19,16121A,Covid 19 - Ospedale Civile di Cecina,TOS,50-59,0,8,0,7,1,0,0,8,0,8,Toscana,ITI1
2021-01-03,COMIRNATY Vaccino a mRNA contro COVID-19,16121A,Covid 19 - Ospedale Civile di Cecina,TOS,60-69,1,1,0,2,0,0,0,2,0,2,Toscana,ITI1
2021-01-03,COMIRNATY Vaccino a mRNA contro COVID-19,16121A,Covid 19 - Ospedale Civile di Cecina,TOS,70-79,1,2,0,1,0,2,0,3,0,3,Toscana,ITI1
2021-01-03,COMIRNATY Vaccino a mRNA contro COVID-19,16121A,Covid 19 - Ospedale Civile di Cecina,TOS,80-89,1,5,0,1,0,5,0,6,0,6,Toscana,ITI1
2021-01-03,COMIRNATY Vaccino a mRNA contro COVID-19,16121A,Covid 19 - Ospedale Civile di Cecina,TOS,90+,0,10,0,0,0,10,0,10,0,10,Toscana,ITI1
2021-01-03,COMIRNATY Vaccino a mRNA contro COVID-19,21184I,Covid - RSA VILLA SERENA - LIVORNO,TOS,60-69,7,3,0,0,0,10,0,10,0,10,Toscana,ITI1
2021-01-03,COMIRNATY Vaccino a mRNA contro COVID-19,21184I,Covid - RSA VILLA SERENA - LIVORNO,TOS,70-79,8,6,0,1,0,13,0,14,0,14,Toscana,ITI1
2021-01-03,COMIRNATY Vaccino a mRNA contro COVID-19,21184I,Covid - RSA VILLA SERENA - LIVORNO,TOS,80-89,8,10,0,0,0,18,0,18,0,18,Toscana,ITI1
2021-01-03,COMIRNATY Vaccino a mRNA contro COVID-19,21184I,Covid - RSA VILLA SERENA - LIVORNO,TOS,90+,1,16,0,0,0,17,0,17,0,17,Toscana,ITI1
2021-01-03,COMIRNATY Vaccino a mRNA contro COVID-19,21301A,COVID19 - Ospedale F. Petruccioli Pitigliano,TOS,20-29,0,2,0,2,0,0,0,2,0,2,Toscana,ITI1
2021-01-03,COMIRNATY Vaccino a mRNA contro COVID-19,21301A,COVID19 - Ospedale F. Petruccioli Pitigliano,TOS,30-39,2,4,0,5,1,0,0,6,0,6,Toscana,ITI1
2021-01-03,COMIRNATY Vaccino a mRNA contro COVID-19,21301A,COVID19 - Ospedale F. Petruccioli Pitigliano,TOS,40-49,0,5,0,5,0,0,0,5,0,5,Toscana,ITI1
2021-01-03,COMIRNATY Vaccino a mRNA contro COVID-19,21301A,COVID19 - Ospedale F. Petruccioli Pitigliano,TOS,50-59,2,5,0,5,1,1,0,7,0,7,Toscana,ITI1
2021-01-03,COMIRNATY Vaccino a mRNA contro COVID-19,21301A,COVID19 - Ospedale F. Petruccioli Pitigliano,TOS,60-69,1,1,0,2,0,0,0,2,0,2,Toscana,ITI1
2021-01-03,COMIRNATY Vaccino a mRNA contro COVID-19,22391A,PRESIDIO AVENZA,TOS,20-29,2,1,0,3,0,0,0,3,0,3,Toscana,ITI1
2021-01-03,COMIRNATY Vaccino a mRNA contro COVID-19,22391A,PRESIDIO AVENZA,TOS,30-39,2,3,0,4,0,1,0,5,0,5,Toscana,ITI1
2021-01-03,COMIRNATY Vaccino a mRNA contro COVID-19,22391A,PRESIDIO AVENZA,TOS,40-49,2,1,0,2,0,1,0,3,0,3,Toscana,ITI1
2021-01-03,COMIRNATY Vaccino a mRNA contro COVID-19,22391A,PRESIDIO AVENZA,TOS,50-59,2,5,0,6,0,1,0,7,0,7,Toscana,ITI1
2021-01-03,COMIRNATY Vaccino a mRNA contro COVID-19,22391A,PRESIDIO AVENZA,TOS,60-69,0,2,0,1,0,1,0,2,0,2,Toscana,ITI1
2021-01-03,COMIRNATY Vaccino a mRNA contro COVID-19,22391A,PRESIDIO AVENZA,TOS,70-79,2,2,0,0,0,4,0,4,0,4,Toscana,ITI1
2021-01-03,COMIRNATY Vaccino a mRNA contro COVID-19,22391A,PRESIDIO AVENZA,TOS,80-89,1,4,0,0,0,5,0,5,0,5,Toscana,ITI1
2021-01-03,COMIRNATY Vaccino a mRNA contro COVID-19,22391A,PRESIDIO AVENZA,TOS,90+,0,1,0,0,0,1,0,1,0,1,Toscana,ITI1
2021-01-03,COMIRNATY Vaccino a mRNA contro COVID-19,30511A,Ambulatorio MMG Casa della Salute Castiglion Fiorentino,TOS,20-29,0,1,0,1,0,0,0,1,0,1,Toscana,ITI1
2021-01-03,COMIRNATY Vaccino a mRNA contro COVID-19,30511A,Ambulatorio MMG Casa della Salute Castiglion Fiorentino,TOS,30-39,1,1,0,2,0,0,0,2,0,2,Toscana,ITI1
2021-01-03,COMIRNATY Vaccino a mRNA contro COVID-19,30511A,Ambulatorio MMG Casa della Salute Castiglion Fiorentino,TOS,40-49,0,2,0,2,0,0,0,2,0,2,Toscana,ITI1
2021-01-03,COMIRNATY Vaccino a mRNA contro COVID-19,30511A,Ambulatorio MMG Casa della Salute Castiglion Fiorentino,TOS,60-69,3,1,0,0,0,4,0,4,0,4,Toscana,ITI1
2021-01-03,COMIRNATY Vaccino a mRNA contro COVID-19,30511A,Ambulatorio MMG Casa della Salute Castiglion Fiorentino,TOS,70-79,4,5,0,0,0,9,0,9,0,9,Toscana,ITI1
2021-01-03,COMIRNATY Vaccino a mRNA contro COVID-19,30511A,Ambulatorio MMG Casa della Salute Castiglion Fiorentino,TOS,80-89,8,8,0,0,0,16,0,16,0,16,Toscana,ITI1
2021-01-03,COMIRNATY Vaccino a mRNA contro COVID-19,30511A,Ambulatorio MMG Casa della Salute Castiglion Fiorentino,TOS,90+,2,12,0,0,0,14,0,14,0,14,Toscana,ITI1
2021-01-03,COMIRNATY Vaccino a mRNA contro COVID-19,40911A,COVID19 - Dip. Prevenzione Ruffolo Siena,TOS,20-29,0,2,0,2,0,0,0,2,0,2,Toscana,ITI1
2021-01-03,COMIRNATY Vaccino a mRNA contro COVID-19,40911A,COVID19 - Dip. Prevenzione Ruffolo Siena,TOS,30-39,0,2,0,1,0,1,0,2,0,2,Toscana,ITI1
2021-01-03,COMIRNATY Vaccino a mRNA contro COVID-19,40911A,COVID19 - Dip. Prevenzione Ruffolo Siena,TOS,40-49,1,3,0,3,1,0,0,4,0,4,Toscana,ITI1
2021-01-03,COMIRNATY Vaccino a mRNA contro COVID-19,40911A,COVID19 - Dip. Prevenzione Ruffolo Siena,TOS,50-59,0,4,0,3,0,1,0,4,0,4,Toscana,ITI1
2021-01-03,COMIRNATY Vaccino a mRNA contro COVID-19,40911A,COVID19 - Dip. Prevenzione Ruffolo Siena,TOS,60-69,1,1,0,1,0,1,0,2,0,2,Toscana,ITI1
2021-01-03,COMIRNATY Vaccino a mRNA contro COVID-19,40911A,COVID19 - Dip. Prevenzione Ruffolo Siena,TOS,70-79,4,2,0,0,0,6,0,6,0,6,Toscana,ITI1
2021-01-03,COMIRNATY Vaccino a mRNA contro COVID-19,40911A,COVID19 - Dip. Prevenzione Ruffolo Siena,TOS,80-89,4,4,0,0,0,8,0,8,0,8,Toscana,ITI1
2021-01-03,COMIRNATY Vaccino a mRNA contro COVID-19,40911A,COVID19 - Dip. Prevenzione Ruffolo Siena,TOS,90+,3,11,0,1,0,13,0,14,0,14,Toscana,ITI1
2021-01-04,COMIRNATY Vaccino a mRNA contro COVID-19,03002D,Covid 19 - Ospedale S.Francesco di Barga,TOS,20-29,1,2,0,3,0,0,0,3,0,3,Toscana,ITI1
2021-01-04,COMIRNATY Vaccino a mRNA contro COVID-19,03002D,Covid 19 - Ospedale S.Francesco di Barga,TOS,30-39,1,4,0,5,0,0,0,5,0,5,Toscana,ITI1
2021-01-04,COMIRNATY Vaccino a mRNA contro COVID-19,03002D,Covid 19 - Ospedale S.Francesco di Barga,TOS,40-49,0,4,0,4,0,0,0,4,0,4,Toscana,ITI1
2021-01-04,COMIRNATY Vaccino a mRNA contro COVID-19,03002D,Covid 19 - Ospedale S.Francesco di Barga,TOS,50-59,3,10,0,13,0,0,0,13,0,13,Toscana,ITI1
2021-01-04,COMIRNATY Vaccino a mRNA contro COVID-19,03002D,Covid 19 - Ospedale S.Francesco di Barga,TOS,60-69,2,2,0,4,0,0,0,4,0,4,Toscana,ITI1
2021-01-04,COMIRNATY Vaccino a mRNA contro COVID-19,090601,Covid 19 - Ospedale S.Antonio Abate di Fivizzano,TOS,20-29,1,0,0,1,0,0,0,1,0,1,Toscana,ITI1
2021-01-04,COMIRNATY Vaccino a mRNA contro COVID-19,090601,Covid 19 - Ospedale S.Antonio Abate di Fivizzano,TOS,30-39,1,2,0,3,0,0,0,3,0,3,Toscana,ITI1
2021-01-04,COMIRNATY Vaccino a mRNA contro COVID-19,090601,Covid 19 - Ospedale S.Antonio Abate di Fivizzano,TOS,40-49,2,9,0,9,1,1,0,11,0,11,Toscana,ITI1
2021-01-04,COMIRNATY Vaccino a mRNA contro COVID-19,090601,Covid 19 - Ospedale S.Antonio Abate di Fivizzano,TOS,50-59,6,7,0,10,0,3,0,13,0,13,Toscana,ITI1
2021-01-04,COMIRNATY Vaccino a mRNA contro COVID-19,090601,Covid 19 - Ospedale S.Antonio Abate di Fivizzano,TOS,60-69,10,4,0,2,0,12,0,14,0,14,Toscana,ITI1
2021-01-04,COMIRNATY Vaccino a mRNA contro COVID-19,090601,Covid 19 - Ospedale S.Antonio Abate di Fivizzano,TOS,70-79,6,1,0,0,0,7,0,7,0,7,Toscana,ITI1
2021-01-04,COMIRNATY Vaccino a mRNA contro COVID-19,090601,Covid 19 - Ospedale S.Antonio Abate di Fivizzano,TOS,80-89,5,5,0,0,0,10,0,10,0,10,Toscana,ITI1
2021-01-04,COMIRNATY Vaccino a mRNA contro COVID-19,090601,Covid 19 - Ospedale S.Antonio Abate di Fivizzano,TOS,90+,0,7,0,0,0,7,0,7,0,7,Toscana,ITI1
2021-01-04,COMIRNATY Vaccino a mRNA contro COVID-19,090602,Covid 19 - Nuovo Ospedale Apuane,TOS,16-19,1,1,0,2,0,0,0,2,0,2,Toscana,ITI1
2021-01-04,COMIRNATY Vaccino a mRNA contro COVID-19,090602,Covid 19 - Nuovo Ospedale Apuane,TOS,20-29,3,3,0,6,0,0,0,6,0,6,Toscana,ITI1
2021-01-04,COMIRNATY Vaccino a mRNA contro COVID-19,090602,Covid 19 - Nuovo Ospedale Apuane,TOS,30-39,16,15,0,31,0,0,0,31,0,31,Toscana,ITI1
2021-01-04,COMIRNATY Vaccino a mRNA contro COVID-19,090602,Covid 19 - Nuovo Ospedale Apuane,TOS,40-49,4,22,0,26,0,0,0,26,0,26,Toscana,ITI1
2021-01-04,COMIRNATY Vaccino a mRNA contro COVID-19,090602,Covid 19 - Nuovo Ospedale Apuane,TOS,50-59,18,24,0,42,0,0,0,42,0,42,Toscana,ITI1
2021-01-04,COMIRNATY Vaccino a mRNA contro COVID-19,090602,Covid 19 - Nuovo Ospedale Apuane,TOS,60-69,10,7,0,17,0,0,0,17,0,17,Toscana,ITI1
2021-01-04,COMIRNATY Vaccino a mRNA contro COVID-19,090603,Covid 19 - Ospedale Santa Croce in Garfagnana,TOS,20-29,0,4,0,4,0,0,0,4,0,4,Toscana,ITI1
2021-01-04,COMIRNATY Vaccino a mRNA contro COVID-19,090603,Covid 19 - Ospedale Santa Croce in Garfagnana,TOS,30-39,1,3,0,4,0,0,0,4,0,4,Toscana,ITI1
2021-01-04,COMIRNATY Vaccino a mRNA contro COVID-19,090603,Covid 19 - Ospedale Santa Croce in Garfagnana,TOS,40-49,3,4,0,7,0,0,0,7,0,7,Toscana,ITI1
2021-01-04,COMIRNATY Vaccino a mRNA contro COVID-19,090603,Covid 19 - Ospedale Santa Croce in Garfagnana,TOS,50-59,1,10,0,11,0,0,0,11,0,11,Toscana,ITI1
2021-01-04,COMIRNATY Vaccino a mRNA contro COVID-19,090603,Covid 19 - Ospedale Santa Croce in Garfagnana,TOS,60-69,2,2,0,4,0,0,0,4,0,4,Toscana,ITI1
2021-01-04,COMIRNATY Vaccino a mRNA contro COVID-19,090604,Covid 19 - Ospedale San Luca di  Lucca,TOS,16-19,1,0,0,1,0,0,0,1,0,1,Toscana,ITI1
2021-01-04,COMIRNATY Vaccino a mRNA contro COVID-19,090604,Covid 19 - Ospedale San Luca di  Lucca,TOS,20-29,6,15,0,21,0,0,0,21,0,21,Toscana,ITI1
2021-01-04,COMIRNATY Vaccino a mRNA contro COVID-19,090604,Covid 19 - Ospedale San Luca di  Lucca,TOS,30-39,15,27,0,42,0,0,0,42,0,42,Toscana,ITI1
2021-01-04,COMIRNATY Vaccino a mRNA contro COVID-19,090604,Covid 19 - Ospedale San Luca di  Lucca,TOS,40-49,6,33,0,39,0,0,0,39,0,39,Toscana,ITI1
2021-01-04,COMIRNATY Vaccino a mRNA contro COVID-19,090604,Covid 19 - Ospedale San Luca di  Lucca,TOS,50-59,9,14,0,23,0,0,0,23,0,23,Toscana,ITI1
2021-01-04,COMIRNATY Vaccino a mRNA contro COVID-19,090604,Covid 19 - Ospedale San Luca di  Lucca,TOS,60-69,7,10,0,17,0,0,0,17,0,17,Toscana,ITI1
2021-01-04,COMIRNATY Vaccino a mRNA contro COVID-19,090606,COVID19 - Ospedale San Iacopo,TOS,20-29,10,9,1,19,0,0,0,19,0,19,Toscana,ITI1
2021-01-04,COMIRNATY Vaccino a mRNA contro COVID-19,090606,COVID19 - Ospedale San Iacopo,TOS,30-39,7,25,1,31,0,0,1,32,0,32,Toscana,ITI1
2021-01-04,COMIRNATY Vaccino a mRNA contro COVID-19,090606,COVID19 - Ospedale San Iacopo,TOS,40-49,10,28,1,38,0,0,0,38,0,38,Toscana,ITI1
2021-01-04,COMIRNATY Vaccino a mRNA contro COVID-19,090606,COVID19 - Ospedale San Iacopo,TOS,50-59,12,33,1,40,0,5,0,45,0,45,Toscana,ITI1
2021-01-04,COMIRNATY Vaccino a mRNA contro COVID-19,090606,COVID19 - Ospedale San Iacopo,TOS,60-69,17,10,1,25,0,2,0,27,0,27,Toscana,ITI1
2021-01-04,COMIRNATY Vaccino a mRNA contro COVID-19,090606,COVID19 - Ospedale San Iacopo,TOS,70-79,5,0,1,0,0,5,0,5,0,5,Toscana,ITI1
2021-01-04,COMIRNATY Vaccino a mRNA contro COVID-19,090606,COVID19 - Ospedale San Iacopo,TOS,80-89,2,8,1,0,0,10,0,10,0,10,Toscana,ITI1
2021-01-04,COMIRNATY Vaccino a mRNA contro COVID-19,090606,COVID19 - Ospedale San Iacopo,TOS,90+,1,15,1,0,0,16,0,16,0,16,Toscana,ITI1
2021-01-04,COMIRNATY Vaccino a mRNA contro COVID-19,090607,COVID19 - Ospedale SS.Cosma e Damiano,TOS,20-29,0,2,0,2,0,0,0,2,0,2,Toscana,ITI1
2021-01-04,COMIRNATY Vaccino a mRNA contro COVID-19,090607,COVID19 - Ospedale SS.Cosma e Damiano,TOS,30-39,2,7,0,9,0,0,0,9,0,9,Toscana,ITI1
2021-01-04,COMIRNATY Vaccino a mRNA contro COVID-19,090607,COVID19 - Ospedale SS.Cosma e Damiano,TOS,40-49,6,12,0,18,0,0,0,18,0,18,Toscana,ITI1
2021-01-04,COMIRNATY Vaccino a mRNA contro COVID-19,090607,COVID19 - Ospedale SS.Cosma e Damiano,TOS,50-59,5,6,0,11,0,0,0,11,0,11,Toscana,ITI1
2021-01-04,COMIRNATY Vaccino a mRNA contro COVID-19,090607,COVID19 - Ospedale SS.Cosma e Damiano,TOS,60-69,4,4,0,8,0,0,0,8,0,8,Toscana,ITI1
2021-01-04,COMIRNATY Vaccino a mRNA contro COVID-19,090608,COVID19 - Ospedale Santo Stefano,TOS,16-19,1,0,0,0,0,1,0,1,0,1,Toscana,ITI1
2021-01-04,COMIRNATY Vaccino a mRNA contro COVID-19,090608,COVID19 - Ospedale Santo Stefano,TOS,20-29,9,14,0,23,0,0,0,23,0,23,Toscana,ITI1
2021-01-04,COMIRNATY Vaccino a mRNA contro COVID-19,090608,COVID19 - Ospedale Santo Stefano,TOS,30-39,16,32,0,46,0,2,0,48,0,48,Toscana,ITI1
2021-01-04,COMIRNATY Vaccino a mRNA contro COVID-19,090608,COVID19 - Ospedale Santo Stefano,TOS,40-49,15,29,0,43,0,1,0,44,0,44,Toscana,ITI1
2021-01-04,COMIRNATY Vaccino a mRNA contro COVID-19,090608,COVID19 - Ospedale Santo Stefano,TOS,50-59,12,27,0,34,0,5,0,39,0,39,Toscana,ITI1
2021-01-04,COMIRNATY Vaccino a mRNA contro COVID-19,090608,COVID19 - Ospedale Santo Stefano,TOS,60-69,5,1,0,5,0,1,0,6,0,6,Toscana,ITI1
2021-01-04,COMIRNATY Vaccino a mRNA contro COVID-19,090608,COVID19 - Ospedale Santo Stefano,TOS,70-79,3,2,0,1,0,4,0,5,0,5,Toscana,ITI1
2021-01-04,COMIRNATY Vaccino a mRNA contro COVID-19,090608,COVID19 - Ospedale Santo Stefano,TOS,80-89,5,3,0,0,0,8,0,8,0,8,Toscana,ITI1
2021-01-04,COMIRNATY Vaccino a mRNA contro COVID-19,090608,COVID19 - Ospedale Santo Stefano,TOS,90+,3,12,0,0,0,15,0,15,0,15,Toscana,ITI1
2021-01-04,COMIRNATY Vaccino a mRNA contro COVID-19,090609,Covid 19 - Ospedale S.Maria Maddalena di Volterra,TOS,20-29,1,4,0,5,0,0,0,5,0,5,Toscana,ITI1
2021-01-04,COMIRNATY Vaccino a mRNA contro COVID-19,090609,Covid 19 - Ospedale S.Maria Maddalena di Volterra,TOS,30-39,2,2,0,4,0,0,0,4,0,4,Toscana,ITI1
2021-01-04,COMIRNATY Vaccino a mRNA contro COVID-19,090609,Covid 19 - Ospedale S.Maria Maddalena di Volterra,TOS,40-49,3,3,0,6,0,0,0,6,0,6,Toscana,ITI1
2021-01-04,COMIRNATY Vaccino a mRNA contro COVID-19,090609,Covid 19 - Ospedale S.Maria Maddalena di Volterra,TOS,50-59,3,7,0,10,0,0,0,10,0,10,Toscana,ITI1
2021-01-04,COMIRNATY Vaccino a mRNA contro COVID-19,090609,Covid 19 - Ospedale S.Maria Maddalena di Volterra,TOS,60-69,2,2,0,3,1,0,0,4,0,4,Toscana,ITI1
2021-01-04,COMIRNATY Vaccino a mRNA contro COVID-19,090609,Covid 19 - Ospedale S.Maria Maddalena di Volterra,TOS,70-79,0,1,0,1,0,0,0,1,0,1,Toscana,ITI1
2021-01-04,COMIRNATY Vaccino a mRNA contro COVID-19,090610,Covid 19 - Ospedale F.Lotti di Pontedera,TOS,20-29,7,13,0,20,0,0,0,20,0,20,Toscana,ITI1
2021-01-04,COMIRNATY Vaccino a mRNA contro COVID-19,090610,Covid 19 - Ospedale F.Lotti di Pontedera,TOS,30-39,2,6,0,8,0,0,0,8,0,8,Toscana,ITI1
2021-01-04,COMIRNATY Vaccino a mRNA contro COVID-19,090610,Covid 19 - Ospedale F.Lotti di Pontedera,TOS,40-49,2,10,0,12,0,0,0,12,0,12,Toscana,ITI1
2021-01-04,COMIRNATY Vaccino a mRNA contro COVID-19,090610,Covid 19 - Ospedale F.Lotti di Pontedera,TOS,50-59,3,11,0,14,0,0,0,14,0,14,Toscana,ITI1
2021-01-04,COMIRNATY Vaccino a mRNA contro COVID-19,090610,Covid 19 - Ospedale F.Lotti di Pontedera,TOS,60-69,4,2,0,6,0,0,0,6,0,6,Toscana,ITI1
2021-01-04,COMIRNATY Vaccino a mRNA contro COVID-19,090613,Covid 19 - Ospedali Riuniti di Livorno,TOS,20-29,11,10,0,21,0,0,0,21,0,21,Toscana,ITI1
2021-01-04,COMIRNATY Vaccino a mRNA contro COVID-19,090613,Covid 19 - Ospedali Riuniti di Livorno,TOS,30-39,10,13,0,23,0,0,0,23,0,23,Toscana,ITI1
2021-01-04,COMIRNATY Vaccino a mRNA contro COVID-19,090613,Covid 19 - Ospedali Riuniti di Livorno,TOS,40-49,7,31,0,38,0,0,0,38,0,38,Toscana,ITI1
2021-01-04,COMIRNATY Vaccino a mRNA contro COVID-19,090613,Covid 19 - Ospedali Riuniti di Livorno,TOS,50-59,17,40,0,56,1,0,0,57,0,57,Toscana,ITI1
2021-01-04,COMIRNATY Vaccino a mRNA contro COVID-19,090613,Covid 19 - Ospedali Riuniti di Livorno,TOS,60-69,12,11,0,23,0,0,0,23,0,23,Toscana,ITI1
2021-01-04,COMIRNATY Vaccino a mRNA contro COVID-19,090614,Covid 19 - Ospedale Civile di Piombino,TOS,20-29,1,0,0,1,0,0,0,1,0,1,Toscana,ITI1
2021-01-04,COMIRNATY Vaccino a mRNA contro COVID-19,090614,Covid 19 - Ospedale Civile di Piombino,TOS,30-39,0,4,0,4,0,0,0,4,0,4,Toscana,ITI1
2021-01-04,COMIRNATY Vaccino a mRNA contro COVID-19,090614,Covid 19 - Ospedale Civile di Piombino,TOS,40-49,2,3,0,5,0,0,0,5,0,5,Toscana,ITI1
2021-01-04,COMIRNATY Vaccino a mRNA contro COVID-19,090614,Covid 19 - Ospedale Civile di Piombino,TOS,50-59,5,12,0,17,0,0,0,17,0,17,Toscana,ITI1
2021-01-04,COMIRNATY Vaccino a mRNA contro COVID-19,090614,Covid 19 - Ospedale Civile di Piombino,TOS,60-69,2,1,0,3,0,0,0,3,0,3,Toscana,ITI1
2021-01-04,COMIRNATY Vaccino a mRNA contro COVID-19,090615,Covid 19 - Ospedale Civile di Portoferraio,TOS,20-29,1,2,0,3,0,0,0,3,0,3,Toscana,ITI1
2021-01-04,COMIRNATY Vaccino a mRNA contro COVID-19,090615,Covid 19 - Ospedale Civile di Portoferraio,TOS,30-39,2,2,0,4,0,0,0,4,0,4,Toscana,ITI1
2021-01-04,COMIRNATY Vaccino a mRNA contro COVID-19,090615,Covid 19 - Ospedale Civile di Portoferraio,TOS,40-49,6,6,0,12,0,0,0,12,0,12,Toscana,ITI1
2021-01-04,COMIRNATY Vaccino a mRNA contro COVID-19,090615,Covid 19 - Ospedale Civile di Portoferraio,TOS,50-59,2,4,0,6,0,0,0,6,0,6,Toscana,ITI1
2021-01-04,COMIRNATY Vaccino a mRNA contro COVID-19,090615,Covid 19 - Ospedale Civile di Portoferraio,TOS,60-69,1,3,0,4,0,0,0,4,0,4,Toscana,ITI1
2021-01-04,COMIRNATY Vaccino a mRNA contro COVID-19,090619,COVID19 - Ospedale Valtiberina Sansepolcro,TOS,20-29,1,0,0,1,0,0,0,1,0,1,Toscana,ITI1
2021-01-04,COMIRNATY Vaccino a mRNA contro COVID-19,090619,COVID19 - Ospedale Valtiberina Sansepolcro,TOS,30-39,0,4,0,4,0,0,0,4,0,4,Toscana,ITI1
2021-01-04,COMIRNATY Vaccino a mRNA contro COVID-19,090619,COVID19 - Ospedale Valtiberina Sansepolcro,TOS,40-49,3,0,0,3,0,0,0,3,0,3,Toscana,ITI1
2021-01-04,COMIRNATY Vaccino a mRNA contro COVID-19,090619,COVID19 - Ospedale Valtiberina Sansepolcro,TOS,50-59,0,2,0,1,0,1,0,2,0,2,Toscana,ITI1
2021-01-04,COMIRNATY Vaccino a mRNA contro COVID-19,090619,COVID19 - Ospedale Valtiberina Sansepolcro,TOS,60-69,1,0,0,0,0,1,0,1,0,1,Toscana,ITI1
2021-01-04,COMIRNATY Vaccino a mRNA contro COVID-19,090619,COVID19 - Ospedale Valtiberina Sansepolcro,TOS,70-79,1,5,0,1,0,5,0,6,0,6,Toscana,ITI1
2021-01-04,COMIRNATY Vaccino a mRNA contro COVID-19,090619,COVID19 - Ospedale Valtiberina Sansepolcro,TOS,80-89,7,12,0,1,0,18,0,19,0,19,Toscana,ITI1
2021-01-04,COMIRNATY Vaccino a mRNA contro COVID-19,090619,COVID19 - Ospedale Valtiberina Sansepolcro,TOS,90+,1,9,0,0,0,10,0,10,0,10,Toscana,ITI1
2021-01-04,COMIRNATY Vaccino a mRNA contro COVID-19,090621,COVID19 - Ospedale di Arezzo,TOS,20-29,4,4,0,8,0,0,0,8,0,8,Toscana,ITI1
2021-01-04,COMIRNATY Vaccino a mRNA contro COVID-19,090621,COVID19 - Ospedale di Arezzo,TOS,30-39,14,20,0,34,0,0,0,34,0,34,Toscana,ITI1
2021-01-04,COMIRNATY Vaccino a mRNA contro COVID-19,090621,COVID19 - Ospedale di Arezzo,TOS,40-49,13,25,0,38,0,0,0,38,0,38,Toscana,ITI1
2021-01-04,COMIRNATY Vaccino a mRNA contro COVID-19,090621,COVID19 - Ospedale di Arezzo,TOS,50-59,9,19,0,28,0,0,0,28,0,28,Toscana,ITI1
2021-01-04,COMIRNATY Vaccino a mRNA contro COVID-19,090621,COVID19 - Ospedale di Arezzo,TOS,60-69,7,2,0,9,0,0,0,9,0,9,Toscana,ITI1
2021-01-04,COMIRNATY Vaccino a mRNA contro COVID-19,090621,COVID19 - Ospedale di Arezzo,TOS,70-79,2,1,0,3,0,0,0,3,0,3,Toscana,ITI1
2021-01-04,COMIRNATY Vaccino a mRNA contro COVID-19,090626,COVID19 - Ospedale di Grosseto,TOS,20-29,4,10,0,14,0,0,0,14,0,14,Toscana,ITI1
2021-01-04,COMIRNATY Vaccino a mRNA contro COVID-19,090626,COVID19 - Ospedale di Grosseto,TOS,30-39,19,23,0,41,1,0,0,42,0,42,Toscana,ITI1
2021-01-04,COMIRNATY Vaccino a mRNA contro COVID-19,090626,COVID19 - Ospedale di Grosseto,TOS,40-49,13,30,0,43,0,0,0,43,0,43,Toscana,ITI1
2021-01-04,COMIRNATY Vaccino a mRNA contro COVID-19,090626,COVID19 - Ospedale di Grosseto,TOS,50-59,15,38,0,52,0,1,0,53,0,53,Toscana,ITI1
2021-01-04,COMIRNATY Vaccino a mRNA contro COVID-19,090626,COVID19 - Ospedale di Grosseto,TOS,60-69,8,16,0,22,1,1,0,24,0,24,Toscana,ITI1
2021-01-04,COMIRNATY Vaccino a mRNA contro COVID-19,090626,COVID19 - Ospedale di Grosseto,TOS,70-79,4,4,0,0,0,8,0,8,0,8,Toscana,ITI1
2021-01-04,COMIRNATY Vaccino a mRNA contro COVID-19,090626,COVID19 - Ospedale di Grosseto,TOS,80-89,3,23,0,0,0,26,0,26,0,26,Toscana,ITI1
2021-01-04,COMIRNATY Vaccino a mRNA contro COVID-19,090626,COVID19 - Ospedale di Grosseto,TOS,90+,3,21,0,0,0,24,0,24,0,24,Toscana,ITI1
2021-01-04,COMIRNATY Vaccino a mRNA contro COVID-19,090627,COVID19 - Ospedale Mugello,TOS,20-29,4,4,0,8,0,0,0,8,0,8,Toscana,ITI1
2021-01-04,COMIRNATY Vaccino a mRNA contro COVID-19,090627,COVID19 - Ospedale Mugello,TOS,30-39,3,6,0,9,0,0,0,9,0,9,Toscana,ITI1
2021-01-04,COMIRNATY Vaccino a mRNA contro COVID-19,090627,COVID19 - Ospedale Mugello,TOS,40-49,3,9,0,12,0,0,0,12,0,12,Toscana,ITI1
2021-01-04,COMIRNATY Vaccino a mRNA contro COVID-19,090627,COVID19 - Ospedale Mugello,TOS,50-59,5,14,0,18,0,1,0,19,0,19,Toscana,ITI1
2021-01-04,COMIRNATY Vaccino a mRNA contro COVID-19,090627,COVID19 - Ospedale Mugello,TOS,60-69,5,4,0,4,0,5,0,9,0,9,Toscana,ITI1
2021-01-04,COMIRNATY Vaccino a mRNA contro COVID-19,090627,COVID19 - Ospedale Mugello,TOS,70-79,0,3,0,0,0,3,0,3,0,3,Toscana,ITI1
2021-01-04,COMIRNATY Vaccino a mRNA contro COVID-19,090627,COVID19 - Ospedale Mugello,TOS,80-89,5,9,0,0,0,14,0,14,0,14,Toscana,ITI1
2021-01-04,COMIRNATY Vaccino a mRNA contro COVID-19,090627,COVID19 - Ospedale Mugello,TOS,90+,2,8,0,0,0,10,0,10,0,10,Toscana,ITI1
2021-01-04,COMIRNATY Vaccino a mRNA contro COVID-19,090629,COVID19 - Ospedale SS. Maria Annunziata,TOS,20-29,4,12,0,16,0,0,0,16,0,16,Toscana,ITI1
2021-01-04,COMIRNATY Vaccino a mRNA contro COVID-19,090629,COVID19 - Ospedale SS. Maria Annunziata,TOS,30-39,23,23,0,46,0,0,0,46,0,46,Toscana,ITI1
2021-01-04,COMIRNATY Vaccino a mRNA contro COVID-19,090629,COVID19 - Ospedale SS. Maria Annunziata,TOS,40-49,14,20,0,34,0,0,0,34,0,34,Toscana,ITI1
2021-01-04,COMIRNATY Vaccino a mRNA contro COVID-19,090629,COVID19 - Ospedale SS. Maria Annunziata,TOS,50-59,6,29,0,35,0,0,0,35,0,35,Toscana,ITI1
2021-01-04,COMIRNATY Vaccino a mRNA contro COVID-19,090629,COVID19 - Ospedale SS. Maria Annunziata,TOS,60-69,12,9,0,17,0,4,0,21,0,21,Toscana,ITI1
2021-01-04,COMIRNATY Vaccino a mRNA contro COVID-19,090629,COVID19 - Ospedale SS. Maria Annunziata,TOS,70-79,8,4,0,2,0,10,0,12,0,12,Toscana,ITI1
2021-01-04,COMIRNATY Vaccino a mRNA contro COVID-19,090629,COVID19 - Ospedale SS. Maria Annunziata,TOS,80-89,5,17,0,0,0,22,0,22,0,22,Toscana,ITI1
2021-01-04,COMIRNATY Vaccino a mRNA contro COVID-19,090629,COVID19 - Ospedale SS. Maria Annunziata,TOS,90+,6,21,0,0,0,27,0,27,0,27,Toscana,ITI1
2021-01-04,COMIRNATY Vaccino a mRNA contro COVID-19,090632,COVID19 - Ospedale Santa Maria Nuova,TOS,20-29,4,9,0,13,0,0,0,13,0,13,Toscana,ITI1
2021-01-04,COMIRNATY Vaccino a mRNA contro COVID-19,090632,COVID19 - Ospedale Santa Maria Nuova,TOS,30-39,17,11,0,28,0,0,0,28,0,28,Toscana,ITI1
2021-01-04,COMIRNATY Vaccino a mRNA contro COVID-19,090632,COVID19 - Ospedale Santa Maria Nuova,TOS,40-49,5,18,0,23,0,0,0,23,0,23,Toscana,ITI1
2021-01-04,COMIRNATY Vaccino a mRNA contro COVID-19,090632,COVID19 - Ospedale Santa Maria Nuova,TOS,50-59,9,15,0,24,0,0,0,24,0,24,Toscana,ITI1
2021-01-04,COMIRNATY Vaccino a mRNA contro COVID-19,090632,COVID19 - Ospedale Santa Maria Nuova,TOS,60-69,8,8,0,16,0,0,0,16,0,16,Toscana,ITI1
2021-01-04,COMIRNATY Vaccino a mRNA contro COVID-19,090632,COVID19 - Ospedale Santa Maria Nuova,TOS,70-79,1,0,0,1,0,0,0,1,0,1,Toscana,ITI1
2021-01-04,COMIRNATY Vaccino a mRNA contro COVID-19,090637,COVID19 - Ospedale Amiata Val d'Orcia  Abbadia San Salvatore,TOS,20-29,0,1,0,1,0,0,0,1,0,1,Toscana,ITI1
2021-01-04,COMIRNATY Vaccino a mRNA contro COVID-19,090637,COVID19 - Ospedale Amiata Val d'Orcia  Abbadia San Salvatore,TOS,40-49,1,2,0,3,0,0,0,3,0,3,Toscana,ITI1
2021-01-04,COMIRNATY Vaccino a mRNA contro COVID-19,090637,COVID19 - Ospedale Amiata Val d'Orcia  Abbadia San Salvatore,TOS,70-79,4,2,0,0,0,6,0,6,0,6,Toscana,ITI1
2021-01-04,COMIRNATY Vaccino a mRNA contro COVID-19,090637,COVID19 - Ospedale Amiata Val d'Orcia  Abbadia San Salvatore,TOS,80-89,2,7,0,0,0,9,0,9,0,9,Toscana,ITI1
2021-01-04,COMIRNATY Vaccino a mRNA contro COVID-19,090637,COVID19 - Ospedale Amiata Val d'Orcia  Abbadia San Salvatore,TOS,90+,1,10,0,0,0,11,0,11,0,11,Toscana,ITI1
2021-01-04,COMIRNATY Vaccino a mRNA contro COVID-19,090638,COVID19 - Ospedale di Campostaggia Poggibonsi,TOS,30-39,0,1,0,1,0,0,0,1,0,1,Toscana,ITI1
2021-01-04,COMIRNATY Vaccino a mRNA contro COVID-19,090638,COVID19 - Ospedale di Campostaggia Poggibonsi,TOS,50-59,1,3,0,2,0,2,0,4,0,4,Toscana,ITI1
2021-01-04,COMIRNATY Vaccino a mRNA contro COVID-19,090638,COVID19 - Ospedale di Campostaggia Poggibonsi,TOS,70-79,1,3,0,0,0,4,0,4,0,4,Toscana,ITI1
2021-01-04,COMIRNATY Vaccino a mRNA contro COVID-19,090638,COVID19 - Ospedale di Campostaggia Poggibonsi,TOS,80-89,2,15,0,0,0,17,0,17,0,17,Toscana,ITI1
2021-01-04,COMIRNATY Vaccino a mRNA contro COVID-19,090638,COVID19 - Ospedale di Campostaggia Poggibonsi,TOS,90+,1,24,0,0,0,25,0,25,0,25,Toscana,ITI1
2021-01-04,COMIRNATY Vaccino a mRNA contro COVID-19,090639,COVID19 - Ospedale di Nottola Montepulciano,TOS,20-29,1,2,0,3,0,0,0,3,0,3,Toscana,ITI1
2021-01-04,COMIRNATY Vaccino a mRNA contro COVID-19,090639,COVID19 - Ospedale di Nottola Montepulciano,TOS,30-39,4,15,0,19,0,0,0,19,0,19,Toscana,ITI1
2021-01-04,COMIRNATY Vaccino a mRNA contro COVID-19,090639,COVID19 - Ospedale di Nottola Montepulciano,TOS,40-49,3,15,0,18,0,0,0,18,0,18,Toscana,ITI1
2021-01-04,COMIRNATY Vaccino a mRNA contro COVID-19,090639,COVID19 - Ospedale di Nottola Montepulciano,TOS,50-59,1,18,0,19,0,0,0,19,0,19,Toscana,ITI1
2021-01-04,COMIRNATY Vaccino a mRNA contro COVID-19,090639,COVID19 - Ospedale di Nottola Montepulciano,TOS,60-69,7,5,0,12,0,0,0,12,0,12,Toscana,ITI1
2021-01-04,COMIRNATY Vaccino a mRNA contro COVID-19,090640,Covid 19 - Ospedale Unico Versilia,TOS,20-29,6,11,0,15,2,0,0,17,0,17,Toscana,ITI1
2021-01-04,COMIRNATY Vaccino a mRNA contro COVID-19,090640,Covid 19 - Ospedale Unico Versilia,TOS,30-39,9,10,0,16,3,0,0,19,0,19,Toscana,ITI1
2021-01-04,COMIRNATY Vaccino a mRNA contro COVID-19,090640,Covid 19 - Ospedale Unico Versilia,TOS,40-49,9,19,0,25,3,0,0,28,0,28,Toscana,ITI1
2021-01-04,COMIRNATY Vaccino a mRNA contro COVID-19,090640,Covid 19 - Ospedale Unico Versilia,TOS,50-59,11,14,0,24,1,0,0,25,0,25,Toscana,ITI1
2021-01-04,COMIRNATY Vaccino a mRNA contro COVID-19,090640,Covid 19 - Ospedale Unico Versilia,TOS,60-69,9,7,0,10,0,6,0,16,0,16,Toscana,ITI1
2021-01-04,COMIRNATY Vaccino a mRNA contro COVID-19,090640,Covid 19 - Ospedale Unico Versilia,TOS,70-79,13,9,0,0,0,22,0,22,0,22,Toscana,ITI1
2021-01-04,COMIRNATY Vaccino a mRNA contro COVID-19,090640,Covid 19 - Ospedale Unico Versilia,TOS,80-89,10,21,0,1,0,30,0,31,0,31,Toscana,ITI1
2021-01-04,COMIRNATY Vaccino a mRNA contro COVID-19,090640,Covid 19 - Ospedale Unico Versilia,TOS,90+,2,13,0,0,0,15,0,15,0,15,Toscana,ITI1
2021-01-04,COMIRNATY Vaccino a mRNA contro COVID-19,090641,COVID19 - Ospedale La Gruccia Montevarchi,TOS,20-29,4,6,0,10,0,0,0,10,0,10,Toscana,ITI1
2021-01-04,COMIRNATY Vaccino a mRNA contro COVID-19,090641,COVID19 - Ospedale La Gruccia Montevarchi,TOS,30-39,8,13,0,21,0,0,0,21,0,21,Toscana,ITI1
2021-01-04,COMIRNATY Vaccino a mRNA contro COVID-19,090641,COVID19 - Ospedale La Gruccia Montevarchi,TOS,40-49,7,19,0,25,0,1,0,26,0,26,Toscana,ITI1
2021-01-04,COMIRNATY Vaccino a mRNA contro COVID-19,090641,COVID19 - Ospedale La Gruccia Montevarchi,TOS,50-59,12,21,0,33,0,0,0,33,0,33,Toscana,ITI1
2021-01-04,COMIRNATY Vaccino a mRNA contro COVID-19,090641,COVID19 - Ospedale La Gruccia Montevarchi,TOS,60-69,12,6,0,12,0,6,0,18,0,18,Toscana,ITI1
2021-01-04,COMIRNATY Vaccino a mRNA contro COVID-19,090641,COVID19 - Ospedale La Gruccia Montevarchi,TOS,70-79,4,7,0,0,0,11,0,11,0,11,Toscana,ITI1
2021-01-04,COMIRNATY Vaccino a mRNA contro COVID-19,090641,COVID19 - Ospedale La Gruccia Montevarchi,TOS,80-89,4,12,0,0,0,16,0,16,0,16,Toscana,ITI1
2021-01-04,COMIRNATY Vaccino a mRNA contro COVID-19,090641,COVID19 - Ospedale La Gruccia Montevarchi,TOS,90+,2,13,0,0,0,15,0,15,0,15,Toscana,ITI1
2021-01-04,COMIRNATY Vaccino a mRNA contro COVID-19,090643,COVID19 - Ospedale S. Margherita Cortona,TOS,20-29,0,4,0,4,0,0,0,4,0,4,Toscana,ITI1
2021-01-04,COMIRNATY Vaccino a mRNA contro COVID-19,090643,COVID19 - Ospedale S. Margherita Cortona,TOS,30-39,2,7,0,9,0,0,0,9,0,9,Toscana,ITI1
2021-01-04,COMIRNATY Vaccino a mRNA contro COVID-19,090643,COVID19 - Ospedale S. Margherita Cortona,TOS,40-49,3,11,0,14,0,0,0,14,0,14,Toscana,ITI1
2021-01-04,COMIRNATY Vaccino a mRNA contro COVID-19,090643,COVID19 - Ospedale S. Margherita Cortona,TOS,50-59,7,16,0,23,0,0,0,23,0,23,Toscana,ITI1
2021-01-04,COMIRNATY Vaccino a mRNA contro COVID-19,090643,COVID19 - Ospedale S. Margherita Cortona,TOS,60-69,6,3,0,9,0,0,0,9,0,9,Toscana,ITI1
2021-01-04,COMIRNATY Vaccino a mRNA contro COVID-19,090643,COVID19 - Ospedale S. Margherita Cortona,TOS,70-79,1,0,0,1,0,0,0,1,0,1,Toscana,ITI1
2021-01-04,COMIRNATY Vaccino a mRNA contro COVID-19,090901,COVID19 - AOU Pisana,TOS,16-19,0,2,1,2,0,0,0,2,0,2,Toscana,ITI1
2021-01-04,COMIRNATY Vaccino a mRNA contro COVID-19,090901,COVID19 - AOU Pisana,TOS,20-29,78,160,1,227,10,1,0,238,0,238,Toscana,ITI1
2021-01-04,COMIRNATY Vaccino a mRNA contro COVID-19,090901,COVID19 - AOU Pisana,TOS,30-39,69,70,1,135,3,0,1,139,0,139,Toscana,ITI1
2021-01-04,COMIRNATY Vaccino a mRNA contro COVID-19,090901,COVID19 - AOU Pisana,TOS,40-49,18,52,1,70,0,0,0,70,0,70,Toscana,ITI1
2021-01-04,COMIRNATY Vaccino a mRNA contro COVID-19,090901,COVID19 - AOU Pisana,TOS,50-59,38,58,1,95,1,0,0,96,0,96,Toscana,ITI1
2021-01-04,COMIRNATY Vaccino a mRNA contro COVID-19,090901,COVID19 - AOU Pisana,TOS,60-69,21,19,1,40,0,0,0,40,0,40,Toscana,ITI1
2021-01-04,COMIRNATY Vaccino a mRNA contro COVID-19,090901,COVID19 - AOU Pisana,TOS,70-79,1,0,1,1,0,0,0,1,0,1,Toscana,ITI1
2021-01-04,COMIRNATY Vaccino a mRNA contro COVID-19,090902,COVID19 - AOU Senese,TOS,20-29,48,46,0,93,0,1,0,94,0,94,Toscana,ITI1
2021-01-04,COMIRNATY Vaccino a mRNA contro COVID-19,090902,COVID19 - AOU Senese,TOS,30-39,43,46,0,89,0,0,0,89,0,89,Toscana,ITI1
2021-01-04,COMIRNATY Vaccino a mRNA contro COVID-19,090902,COVID19 - AOU Senese,TOS,40-49,23,26,0,49,0,0,0,49,0,49,Toscana,ITI1
2021-01-04,COMIRNATY Vaccino a mRNA contro COVID-19,090902,COVID19 - AOU Senese,TOS,50-59,27,33,0,60,0,0,0,60,0,60,Toscana,ITI1
2021-01-04,COMIRNATY Vaccino a mRNA contro COVID-19,090902,COVID19 - AOU Senese,TOS,60-69,12,13,0,25,0,0,0,25,0,25,Toscana,ITI1
2021-01-04,COMIRNATY Vaccino a mRNA contro COVID-19,090902,COVID19 - AOU Senese,TOS,70-79,1,0,0,1,0,0,0,1,0,1,Toscana,ITI1
2021-01-04,COMIRNATY Vaccino a mRNA contro COVID-19,090903,COVID19 - AOU Careggi - CTO,TOS,16-19,1,1,0,2,0,0,0,2,0,2,Toscana,ITI1
2021-01-04,COMIRNATY Vaccino a mRNA contro COVID-19,090903,COVID19 - AOU Careggi - CTO,TOS,20-29,99,103,0,202,0,0,0,202,0,202,Toscana,ITI1
2021-01-04,COMIRNATY Vaccino a mRNA contro COVID-19,090903,COVID19 - AOU Careggi - CTO,TOS,30-39,71,87,0,158,0,0,0,158,0,158,Toscana,ITI1
2021-01-04,COMIRNATY Vaccino a mRNA contro COVID-19,090903,COVID19 - AOU Careggi - CTO,TOS,40-49,51,77,0,128,0,0,0,128,0,128,Toscana,ITI1
2021-01-04,COMIRNATY Vaccino a mRNA contro COVID-19,090903,COVID19 - AOU Careggi - CTO,TOS,50-59,51,100,0,151,0,0,0,151,0,151,Toscana,ITI1
2021-01-04,COMIRNATY Vaccino a mRNA contro COVID-19,090903,COVID19 - AOU Careggi - CTO,TOS,60-69,47,30,0,77,0,0,0,77,0,77,Toscana,ITI1
2021-01-04,COMIRNATY Vaccino a mRNA contro COVID-19,090903,COVID19 - AOU Careggi - CTO,TOS,70-79,1,0,0,1,0,0,0,1,0,1,Toscana,ITI1
2021-01-04,COMIRNATY Vaccino a mRNA contro COVID-19,090904,COVID19 - Ospedale AOU Meyer,TOS,20-29,10,12,0,22,0,0,0,22,0,22,Toscana,ITI1
2021-01-04,COMIRNATY Vaccino a mRNA contro COVID-19,090904,COVID19 - Ospedale AOU Meyer,TOS,30-39,14,22,0,36,0,0,0,36,0,36,Toscana,ITI1
2021-01-04,COMIRNATY Vaccino a mRNA contro COVID-19,090904,COVID19 - Ospedale AOU Meyer,TOS,40-49,7,15,0,22,0,0,0,22,0,22,Toscana,ITI1
2021-01-04,COMIRNATY Vaccino a mRNA contro COVID-19,090904,COVID19 - Ospedale AOU Meyer,TOS,50-59,5,11,0,16,0,0,0,16,0,16,Toscana,ITI1
2021-01-04,COMIRNATY Vaccino a mRNA contro COVID-19,090904,COVID19 - Ospedale AOU Meyer,TOS,60-69,7,5,0,12,0,0,0,12,0,12,Toscana,ITI1
2021-01-04,COMIRNATY Vaccino a mRNA contro COVID-19,11012E,COVID19 - Ospedale San Giuseppe,TOS,20-29,5,8,0,11,0,2,0,13,0,13,Toscana,ITI1
2021-01-04,COMIRNATY Vaccino a mRNA contro COVID-19,11012E,COVID19 - Ospedale San Giuseppe,TOS,30-39,22,26,0,41,0,7,0,48,0,48,Toscana,ITI1
2021-01-04,COMIRNATY Vaccino a mRNA contro COVID-19,11012E,COVID19 - Ospedale San Giuseppe,TOS,40-49,14,29,0,37,0,6,0,43,0,43,Toscana,ITI1
2021-01-04,COMIRNATY Vaccino a mRNA contro COVID-19,11012E,COVID19 - Ospedale San Giuseppe,TOS,50-59,14,42,0,46,0,10,0,56,0,56,Toscana,ITI1
2021-01-04,COMIRNATY Vaccino a mRNA contro COVID-19,11012E,COVID19 - Ospedale San Giuseppe,TOS,60-69,9,13,0,18,0,4,0,22,0,22,Toscana,ITI1
2021-01-04,COMIRNATY Vaccino a mRNA contro COVID-19,11012E,COVID19 - Ospedale San Giuseppe,TOS,70-79,3,2,0,0,0,5,0,5,0,5,Toscana,ITI1
2021-01-04,COMIRNATY Vaccino a mRNA contro COVID-19,11012E,COVID19 - Ospedale San Giuseppe,TOS,80-89,7,13,0,0,0,20,0,20,0,20,Toscana,ITI1
2021-01-04,COMIRNATY Vaccino a mRNA contro COVID-19,11012E,COVID19 - Ospedale San Giuseppe,TOS,90+,1,7,0,0,0,8,0,8,0,8,Toscana,ITI1
2021-01-04,COMIRNATY Vaccino a mRNA contro COVID-19,11151A,Covid 19 - Ospedale S.Antonio Abate di Pontremoli,TOS,30-39,2,2,0,4,0,0,0,4,0,4,Toscana,ITI1
2021-01-04,COMIRNATY Vaccino a mRNA contro COVID-19,11151A,Covid 19 - Ospedale S.Antonio Abate di Pontremoli,TOS,40-49,1,6,0,7,0,0,0,7,0,7,Toscana,ITI1
2021-01-04,COMIRNATY Vaccino a mRNA contro COVID-19,11151A,Covid 19 - Ospedale S.Antonio Abate di Pontremoli,TOS,50-59,2,4,0,6,0,0,0,6,0,6,Toscana,ITI1
2021-01-04,COMIRNATY Vaccino a mRNA contro COVID-19,11151A,Covid 19 - Ospedale S.Antonio Abate di Pontremoli,TOS,60-69,0,1,0,1,0,0,0,1,0,1,Toscana,ITI1
2021-01-04,COMIRNATY Vaccino a mRNA contro COVID-19,13021A,COVID19 - Ospedale S.Giovanni di Dio,TOS,20-29,9,22,0,31,0,0,0,31,0,31,Toscana,ITI1
2021-01-04,COMIRNATY Vaccino a mRNA contro COVID-19,13021A,COVID19 - Ospedale S.Giovanni di Dio,TOS,30-39,23,33,0,56,0,0,0,56,0,56,Toscana,ITI1
2021-01-04,COMIRNATY Vaccino a mRNA contro COVID-19,13021A,COVID19 - Ospedale S.Giovanni di Dio,TOS,40-49,6,31,0,35,0,2,0,37,0,37,Toscana,ITI1
2021-01-04,COMIRNATY Vaccino a mRNA contro COVID-19,13021A,COVID19 - Ospedale S.Giovanni di Dio,TOS,50-59,10,29,0,35,0,4,0,39,0,39,Toscana,ITI1
2021-01-04,COMIRNATY Vaccino a mRNA contro COVID-19,13021A,COVID19 - Ospedale S.Giovanni di Dio,TOS,60-69,18,16,0,19,0,15,0,34,0,34,Toscana,ITI1
2021-01-04,COMIRNATY Vaccino a mRNA contro COVID-19,13021A,COVID19 - Ospedale S.Giovanni di Dio,TOS,70-79,12,11,0,1,0,22,0,23,0,23,Toscana,ITI1
2021-01-04,COMIRNATY Vaccino a mRNA contro COVID-19,13021A,COVID19 - Ospedale S.Giovanni di Dio,TOS,80-89,19,38,0,0,1,56,0,57,0,57,Toscana,ITI1
2021-01-04,COMIRNATY Vaccino a mRNA contro COVID-19,13021A,COVID19 - Ospedale S.Giovanni di Dio,TOS,90+,7,27,0,0,0,34,0,34,0,34,Toscana,ITI1
2021-01-04,COMIRNATY Vaccino a mRNA contro COVID-19,16121A,Covid 19 - Ospedale Civile di Cecina,TOS,20-29,3,1,1,4,0,0,0,4,0,4,Toscana,ITI1
2021-01-04,COMIRNATY Vaccino a mRNA contro COVID-19,16121A,Covid 19 - Ospedale Civile di Cecina,TOS,30-39,3,2,1,3,0,2,0,5,0,5,Toscana,ITI1
2021-01-04,COMIRNATY Vaccino a mRNA contro COVID-19,16121A,Covid 19 - Ospedale Civile di Cecina,TOS,40-49,5,8,1,12,0,1,0,13,0,13,Toscana,ITI1
2021-01-04,COMIRNATY Vaccino a mRNA contro COVID-19,16121A,Covid 19 - Ospedale Civile di Cecina,TOS,50-59,8,21,1,19,0,9,1,29,0,29,Toscana,ITI1
2021-01-04,COMIRNATY Vaccino a mRNA contro COVID-19,16121A,Covid 19 - Ospedale Civile di Cecina,TOS,60-69,15,14,1,6,0,23,0,29,0,29,Toscana,ITI1
2021-01-04,COMIRNATY Vaccino a mRNA contro COVID-19,16121A,Covid 19 - Ospedale Civile di Cecina,TOS,70-79,10,10,1,0,0,20,0,20,0,20,Toscana,ITI1
2021-01-04,COMIRNATY Vaccino a mRNA contro COVID-19,16121A,Covid 19 - Ospedale Civile di Cecina,TOS,80-89,5,7,1,0,0,12,0,12,0,12,Toscana,ITI1
2021-01-04,COMIRNATY Vaccino a mRNA contro COVID-19,16121A,Covid 19 - Ospedale Civile di Cecina,TOS,90+,0,6,1,0,0,6,0,6,0,6,Toscana,ITI1
2021-01-04,COMIRNATY Vaccino a mRNA contro COVID-19,22391A,PRESIDIO AVENZA,TOS,20-29,0,1,0,1,0,0,0,1,0,1,Toscana,ITI1
2021-01-04,COMIRNATY Vaccino a mRNA contro COVID-19,22391A,PRESIDIO AVENZA,TOS,30-39,0,1,0,1,0,0,0,1,0,1,Toscana,ITI1
2021-01-04,COMIRNATY Vaccino a mRNA contro COVID-19,22391A,PRESIDIO AVENZA,TOS,40-49,0,2,0,2,0,0,0,2,0,2,Toscana,ITI1
2021-01-04,COMIRNATY Vaccino a mRNA contro COVID-19,22391A,PRESIDIO AVENZA,TOS,50-59,1,4,0,5,0,0,0,5,0,5,Toscana,ITI1
2021-01-04,COMIRNATY Vaccino a mRNA contro COVID-19,22391A,PRESIDIO AVENZA,TOS,60-69,6,1,0,1,0,6,0,7,0,7,Toscana,ITI1
2021-01-04,COMIRNATY Vaccino a mRNA contro COVID-19,22391A,PRESIDIO AVENZA,TOS,70-79,7,5,0,3,0,9,0,12,0,12,Toscana,ITI1
2021-01-04,COMIRNATY Vaccino a mRNA contro COVID-19,22391A,PRESIDIO AVENZA,TOS,80-89,4,18,0,0,0,22,0,22,0,22,Toscana,ITI1
2021-01-04,COMIRNATY Vaccino a mRNA contro COVID-19,22391A,PRESIDIO AVENZA,TOS,90+,1,15,0,0,0,16,0,16,0,16,Toscana,ITI1
2021-01-04,COMIRNATY Vaccino a mRNA contro COVID-19,25324I,R.S.A. PIERO BARGAGLI,TOS,20-29,1,0,0,1,0,0,0,1,0,1,Toscana,ITI1
2021-01-04,COMIRNATY Vaccino a mRNA contro COVID-19,25324I,R.S.A. PIERO BARGAGLI,TOS,30-39,0,1,0,1,0,0,0,1,0,1,Toscana,ITI1
2021-01-04,COMIRNATY Vaccino a mRNA contro COVID-19,25324I,R.S.A. PIERO BARGAGLI,TOS,40-49,1,0,0,0,0,1,0,1,0,1,Toscana,ITI1
2021-01-04,COMIRNATY Vaccino a mRNA contro COVID-19,25324I,R.S.A. PIERO BARGAGLI,TOS,50-59,1,1,0,1,0,1,0,2,0,2,Toscana,ITI1
2021-01-04,COMIRNATY Vaccino a mRNA contro COVID-19,25324I,R.S.A. PIERO BARGAGLI,TOS,60-69,1,2,0,1,0,2,0,3,0,3,Toscana,ITI1
2021-01-04,COMIRNATY Vaccino a mRNA contro COVID-19,25324I,R.S.A. PIERO BARGAGLI,TOS,70-79,4,1,0,0,0,5,0,5,0,5,Toscana,ITI1
2021-01-04,COMIRNATY Vaccino a mRNA contro COVID-19,25324I,R.S.A. PIERO BARGAGLI,TOS,80-89,6,14,0,1,0,19,0,20,0,20,Toscana,ITI1
2021-01-04,COMIRNATY Vaccino a mRNA contro COVID-19,25324I,R.S.A. PIERO BARGAGLI,TOS,90+,4,16,0,0,0,20,0,20,0,20,Toscana,ITI1
2021-01-04,COMIRNATY Vaccino a mRNA contro COVID-19,312A4I,Covid19 - RSA CASA OTTAVINA CASTELNUOVO,TOS,30-39,1,0,0,0,0,1,0,1,0,1,Toscana,ITI1
2021-01-04,COMIRNATY Vaccino a mRNA contro COVID-19,312A4I,Covid19 - RSA CASA OTTAVINA CASTELNUOVO,TOS,50-59,1,1,0,0,0,2,0,2,0,2,Toscana,ITI1
2021-01-04,COMIRNATY Vaccino a mRNA contro COVID-19,312A4I,Covid19 - RSA CASA OTTAVINA CASTELNUOVO,TOS,60-69,5,0,0,0,0,5,0,5,0,5,Toscana,ITI1
2021-01-04,COMIRNATY Vaccino a mRNA contro COVID-19,312A4I,Covid19 - RSA CASA OTTAVINA CASTELNUOVO,TOS,70-79,2,1,0,0,0,3,0,3,0,3,Toscana,ITI1
2021-01-04,COMIRNATY Vaccino a mRNA contro COVID-19,312A4I,Covid19 - RSA CASA OTTAVINA CASTELNUOVO,TOS,80-89,0,4,0,0,0,4,0,4,0,4,Toscana,ITI1
2021-01-04,COMIRNATY Vaccino a mRNA contro COVID-19,312A4I,Covid19 - RSA CASA OTTAVINA CASTELNUOVO,TOS,90+,0,2,0,0,0,2,0,2,0,2,Toscana,ITI1
2021-01-04,COMIRNATY Vaccino a mRNA contro COVID-19,40911A,COVID19 - Dip. Prevenzione Ruffolo Siena,TOS,30-39,0,1,0,1,0,0,0,1,0,1,Toscana,ITI1
2021-01-04,COMIRNATY Vaccino a mRNA contro COVID-19,40911A,COVID19 - Dip. Prevenzione Ruffolo Siena,TOS,40-49,1,1,0,2,0,0,0,2,0,2,Toscana,ITI1
2021-01-04,COMIRNATY Vaccino a mRNA contro COVID-19,40911A,COVID19 - Dip. Prevenzione Ruffolo Siena,TOS,50-59,4,1,0,5,0,0,0,5,0,5,Toscana,ITI1
2021-01-04,COMIRNATY Vaccino a mRNA contro COVID-19,40911A,COVID19 - Dip. Prevenzione Ruffolo Siena,TOS,60-69,2,0,0,1,0,1,0,2,0,2,Toscana,ITI1
2021-01-04,COMIRNATY Vaccino a mRNA contro COVID-19,40911A,COVID19 - Dip. Prevenzione Ruffolo Siena,TOS,70-79,4,0,0,0,0,4,0,4,0,4,Toscana,ITI1
2021-01-04,COMIRNATY Vaccino a mRNA contro COVID-19,40911A,COVID19 - Dip. Prevenzione Ruffolo Siena,TOS,80-89,2,7,0,0,0,9,0,9,0,9,Toscana,ITI1
2021-01-04,COMIRNATY Vaccino a mRNA contro COVID-19,40911A,COVID19 - Dip. Prevenzione Ruffolo Siena,TOS,90+,3,10,0,0,0,13,0,13,0,13,Toscana,ITI1
2021-01-04,COMIRNATY Vaccino a mRNA contro COVID-19,ND,Dip.Prevenzione PISA - ISP,TOS,40-49,0,3,0,3,0,0,0,3,0,3,Toscana,ITI1
2021-01-04,COMIRNATY Vaccino a mRNA contro COVID-19,ND,Dip.Prevenzione PISA - ISP,TOS,50-59,0,1,0,1,0,0,0,1,0,1,Toscana,ITI1
2021-01-04,COMIRNATY Vaccino a mRNA contro COVID-19,ND,Dip.Prevenzione PISA - ISP,TOS,70-79,0,2,0,0,0,2,0,2,0,2,Toscana,ITI1
2021-01-04,COMIRNATY Vaccino a mRNA contro COVID-19,ND,Dip.Prevenzione PISA - ISP,TOS,80-89,0,4,0,0,0,4,0,4,0,4,Toscana,ITI1
2021-01-04,COMIRNATY Vaccino a mRNA contro COVID-19,ND,Dip.Prevenzione PISA - ISP,TOS,90+,0,5,0,0,0,5,0,5,0,5,Toscana,ITI1
2021-01-05,COMIRNATY Vaccino a mRNA contro COVID-19,00134I,FONDAZIONE TURATI GAVINANA,TOS,20-29,0,1,0,1,0,0,0,1,0,1,Toscana,ITI1
2021-01-05,COMIRNATY Vaccino a mRNA contro COVID-19,090601,Covid 19 - Ospedale S.Antonio Abate di Fivizzano,TOS,30-39,0,2,0,2,0,0,0,2,0,2,Toscana,ITI1
2021-01-05,COMIRNATY Vaccino a mRNA contro COVID-19,090601,Covid 19 - Ospedale S.Antonio Abate di Fivizzano,TOS,40-49,5,4,0,9,0,0,0,9,0,9,Toscana,ITI1
2021-01-05,COMIRNATY Vaccino a mRNA contro COVID-19,090601,Covid 19 - Ospedale S.Antonio Abate di Fivizzano,TOS,50-59,0,7,0,7,0,0,0,7,0,7,Toscana,ITI1
2021-01-05,COMIRNATY Vaccino a mRNA contro COVID-19,090602,Covid 19 - Nuovo Ospedale Apuane,TOS,16-19,1,0,0,1,0,0,0,1,0,1,Toscana,ITI1
2021-01-05,COMIRNATY Vaccino a mRNA contro COVID-19,090602,Covid 19 - Nuovo Ospedale Apuane,TOS,20-29,0,8,0,8,0,0,0,8,0,8,Toscana,ITI1
2021-01-05,COMIRNATY Vaccino a mRNA contro COVID-19,090602,Covid 19 - Nuovo Ospedale Apuane,TOS,30-39,9,18,0,27,0,0,0,27,0,27,Toscana,ITI1
2021-01-05,COMIRNATY Vaccino a mRNA contro COVID-19,090602,Covid 19 - Nuovo Ospedale Apuane,TOS,40-49,9,17,0,26,0,0,0,26,0,26,Toscana,ITI1
2021-01-05,COMIRNATY Vaccino a mRNA contro COVID-19,090602,Covid 19 - Nuovo Ospedale Apuane,TOS,50-59,14,29,0,43,0,0,0,43,0,43,Toscana,ITI1
2021-01-05,COMIRNATY Vaccino a mRNA contro COVID-19,090602,Covid 19 - Nuovo Ospedale Apuane,TOS,60-69,7,8,0,15,0,0,0,15,0,15,Toscana,ITI1
2021-01-05,COMIRNATY Vaccino a mRNA contro COVID-19,090604,Covid 19 - Ospedale San Luca di  Lucca,TOS,20-29,7,8,0,15,0,0,0,15,0,15,Toscana,ITI1
2021-01-05,COMIRNATY Vaccino a mRNA contro COVID-19,090604,Covid 19 - Ospedale San Luca di  Lucca,TOS,30-39,10,21,0,31,0,0,0,31,0,31,Toscana,ITI1
2021-01-05,COMIRNATY Vaccino a mRNA contro COVID-19,090604,Covid 19 - Ospedale San Luca di  Lucca,TOS,40-49,8,24,0,32,0,0,0,32,0,32,Toscana,ITI1
2021-01-05,COMIRNATY Vaccino a mRNA contro COVID-19,090604,Covid 19 - Ospedale San Luca di  Lucca,TOS,50-59,13,22,0,35,0,0,0,35,0,35,Toscana,ITI1
2021-01-05,COMIRNATY Vaccino a mRNA contro COVID-19,090604,Covid 19 - Ospedale San Luca di  Lucca,TOS,60-69,12,12,0,24,0,0,0,24,0,24,Toscana,ITI1
2021-01-05,COMIRNATY Vaccino a mRNA contro COVID-19,090604,Covid 19 - Ospedale San Luca di  Lucca,TOS,70-79,1,0,0,1,0,0,0,1,0,1,Toscana,ITI1
2021-01-05,COMIRNATY Vaccino a mRNA contro COVID-19,090606,COVID19 - Ospedale San Iacopo,TOS,20-29,3,7,0,10,0,0,0,10,0,10,Toscana,ITI1
2021-01-05,COMIRNATY Vaccino a mRNA contro COVID-19,090606,COVID19 - Ospedale San Iacopo,TOS,30-39,12,27,0,39,0,0,0,39,0,39,Toscana,ITI1
2021-01-05,COMIRNATY Vaccino a mRNA contro COVID-19,090606,COVID19 - Ospedale San Iacopo,TOS,40-49,12,29,0,41,0,0,0,41,0,41,Toscana,ITI1
2021-01-05,COMIRNATY Vaccino a mRNA contro COVID-19,090606,COVID19 - Ospedale San Iacopo,TOS,50-59,13,34,0,47,0,0,0,47,0,47,Toscana,ITI1
2021-01-05,COMIRNATY Vaccino a mRNA contro COVID-19,090606,COVID19 - Ospedale San Iacopo,TOS,60-69,15,12,0,21,0,6,0,27,0,27,Toscana,ITI1
2021-01-05,COMIRNATY Vaccino a mRNA contro COVID-19,090606,COVID19 - Ospedale San Iacopo,TOS,70-79,12,6,0,1,0,17,0,18,0,18,Toscana,ITI1
2021-01-05,COMIRNATY Vaccino a mRNA contro COVID-19,090606,COVID19 - Ospedale San Iacopo,TOS,80-89,8,26,0,0,0,34,0,34,0,34,Toscana,ITI1
2021-01-05,COMIRNATY Vaccino a mRNA contro COVID-19,090606,COVID19 - Ospedale San Iacopo,TOS,90+,3,19,0,0,0,22,0,22,0,22,Toscana,ITI1
2021-01-05,COMIRNATY Vaccino a mRNA contro COVID-19,090607,COVID19 - Ospedale SS.Cosma e Damiano,TOS,20-29,1,4,0,5,0,0,0,5,0,5,Toscana,ITI1
2021-01-05,COMIRNATY Vaccino a mRNA contro COVID-19,090607,COVID19 - Ospedale SS.Cosma e Damiano,TOS,30-39,4,6,0,10,0,0,0,10,0,10,Toscana,ITI1
2021-01-05,COMIRNATY Vaccino a mRNA contro COVID-19,090607,COVID19 - Ospedale SS.Cosma e Damiano,TOS,40-49,4,5,0,9,0,0,0,9,0,9,Toscana,ITI1
2021-01-05,COMIRNATY Vaccino a mRNA contro COVID-19,090607,COVID19 - Ospedale SS.Cosma e Damiano,TOS,50-59,4,13,0,17,0,0,0,17,0,17,Toscana,ITI1
2021-01-05,COMIRNATY Vaccino a mRNA contro COVID-19,090607,COVID19 - Ospedale SS.Cosma e Damiano,TOS,60-69,2,5,0,7,0,0,0,7,0,7,Toscana,ITI1
2021-01-05,COMIRNATY Vaccino a mRNA contro COVID-19,090608,COVID19 - Ospedale Santo Stefano,TOS,20-29,4,8,0,12,0,0,0,12,0,12,Toscana,ITI1
2021-01-05,COMIRNATY Vaccino a mRNA contro COVID-19,090608,COVID19 - Ospedale Santo Stefano,TOS,30-39,21,33,0,54,0,0,0,54,0,54,Toscana,ITI1
2021-01-05,COMIRNATY Vaccino a mRNA contro COVID-19,090608,COVID19 - Ospedale Santo Stefano,TOS,40-49,15,28,0,42,0,1,0,43,0,43,Toscana,ITI1
2021-01-05,COMIRNATY Vaccino a mRNA contro COVID-19,090608,COVID19 - Ospedale Santo Stefano,TOS,50-59,8,26,0,34,0,0,0,34,0,34,Toscana,ITI1
2021-01-05,COMIRNATY Vaccino a mRNA contro COVID-19,090608,COVID19 - Ospedale Santo Stefano,TOS,60-69,3,4,0,7,0,0,0,7,0,7,Toscana,ITI1
2021-01-05,COMIRNATY Vaccino a mRNA contro COVID-19,090609,Covid 19 - Ospedale S.Maria Maddalena di Volterra,TOS,20-29,2,2,0,3,1,0,0,4,0,4,Toscana,ITI1
2021-01-05,COMIRNATY Vaccino a mRNA contro COVID-19,090609,Covid 19 - Ospedale S.Maria Maddalena di Volterra,TOS,30-39,0,5,0,5,0,0,0,5,0,5,Toscana,ITI1
2021-01-05,COMIRNATY Vaccino a mRNA contro COVID-19,090609,Covid 19 - Ospedale S.Maria Maddalena di Volterra,TOS,40-49,4,3,0,7,0,0,0,7,0,7,Toscana,ITI1
2021-01-05,COMIRNATY Vaccino a mRNA contro COVID-19,090609,Covid 19 - Ospedale S.Maria Maddalena di Volterra,TOS,50-59,4,5,0,9,0,0,0,9,0,9,Toscana,ITI1
2021-01-05,COMIRNATY Vaccino a mRNA contro COVID-19,090609,Covid 19 - Ospedale S.Maria Maddalena di Volterra,TOS,60-69,2,3,0,4,1,0,0,5,0,5,Toscana,ITI1
2021-01-05,COMIRNATY Vaccino a mRNA contro COVID-19,090610,Covid 19 - Ospedale F.Lotti di Pontedera,TOS,20-29,3,4,0,6,0,1,0,7,0,7,Toscana,ITI1
2021-01-05,COMIRNATY Vaccino a mRNA contro COVID-19,090610,Covid 19 - Ospedale F.Lotti di Pontedera,TOS,30-39,6,5,0,11,0,0,0,11,0,11,Toscana,ITI1
2021-01-05,COMIRNATY Vaccino a mRNA contro COVID-19,090610,Covid 19 - Ospedale F.Lotti di Pontedera,TOS,40-49,4,18,0,22,0,0,0,22,0,22,Toscana,ITI1
2021-01-05,COMIRNATY Vaccino a mRNA contro COVID-19,090610,Covid 19 - Ospedale F.Lotti di Pontedera,TOS,50-59,4,7,0,11,0,0,0,11,0,11,Toscana,ITI1
2021-01-05,COMIRNATY Vaccino a mRNA contro COVID-19,090610,Covid 19 - Ospedale F.Lotti di Pontedera,TOS,60-69,2,6,0,8,0,0,0,8,0,8,Toscana,ITI1
2021-01-05,COMIRNATY Vaccino a mRNA contro COVID-19,090610,Covid 19 - Ospedale F.Lotti di Pontedera,TOS,70-79,0,1,0,1,0,0,0,1,0,1,Toscana,ITI1
2021-01-05,COMIRNATY Vaccino a mRNA contro COVID-19,090613,Covid 19 - Ospedali Riuniti di Livorno,TOS,20-29,8,17,0,25,0,0,0,25,0,25,Toscana,ITI1
2021-01-05,COMIRNATY Vaccino a mRNA contro COVID-19,090613,Covid 19 - Ospedali Riuniti di Livorno,TOS,30-39,8,22,0,30,0,0,0,30,0,30,Toscana,ITI1
2021-01-05,COMIRNATY Vaccino a mRNA contro COVID-19,090613,Covid 19 - Ospedali Riuniti di Livorno,TOS,40-49,10,30,0,40,0,0,0,40,0,40,Toscana,ITI1
2021-01-05,COMIRNATY Vaccino a mRNA contro COVID-19,090613,Covid 19 - Ospedali Riuniti di Livorno,TOS,50-59,13,42,0,55,0,0,0,55,0,55,Toscana,ITI1
2021-01-05,COMIRNATY Vaccino a mRNA contro COVID-19,090613,Covid 19 - Ospedali Riuniti di Livorno,TOS,60-69,12,18,0,30,0,0,0,30,0,30,Toscana,ITI1
2021-01-05,COMIRNATY Vaccino a mRNA contro COVID-19,090614,Covid 19 - Ospedale Civile di Piombino,TOS,20-29,1,2,0,3,0,0,0,3,0,3,Toscana,ITI1
2021-01-05,COMIRNATY Vaccino a mRNA contro COVID-19,090614,Covid 19 - Ospedale Civile di Piombino,TOS,30-39,2,4,0,6,0,0,0,6,0,6,Toscana,ITI1
2021-01-05,COMIRNATY Vaccino a mRNA contro COVID-19,090614,Covid 19 - Ospedale Civile di Piombino,TOS,40-49,0,5,0,5,0,0,0,5,0,5,Toscana,ITI1
2021-01-05,COMIRNATY Vaccino a mRNA contro COVID-19,090614,Covid 19 - Ospedale Civile di Piombino,TOS,50-59,4,6,0,10,0,0,0,10,0,10,Toscana,ITI1
2021-01-05,COMIRNATY Vaccino a mRNA contro COVID-19,090614,Covid 19 - Ospedale Civile di Piombino,TOS,60-69,2,3,0,5,0,0,0,5,0,5,Toscana,ITI1
2021-01-05,COMIRNATY Vaccino a mRNA contro COVID-19,090614,Covid 19 - Ospedale Civile di Piombino,TOS,70-79,1,0,0,1,0,0,0,1,0,1,Toscana,ITI1
2021-01-05,COMIRNATY Vaccino a mRNA contro COVID-19,090615,Covid 19 - Ospedale Civile di Portoferraio,TOS,20-29,1,6,0,7,0,0,0,7,0,7,Toscana,ITI1
2021-01-05,COMIRNATY Vaccino a mRNA contro COVID-19,090615,Covid 19 - Ospedale Civile di Portoferraio,TOS,30-39,1,3,0,4,0,0,0,4,0,4,Toscana,ITI1
2021-01-05,COMIRNATY Vaccino a mRNA contro COVID-19,090615,Covid 19 - Ospedale Civile di Portoferraio,TOS,40-49,3,1,0,4,0,0,0,4,0,4,Toscana,ITI1
2021-01-05,COMIRNATY Vaccino a mRNA contro COVID-19,090615,Covid 19 - Ospedale Civile di Portoferraio,TOS,50-59,4,9,0,13,0,0,0,13,0,13,Toscana,ITI1
2021-01-05,COMIRNATY Vaccino a mRNA contro COVID-19,090615,Covid 19 - Ospedale Civile di Portoferraio,TOS,60-69,2,0,0,2,0,0,0,2,0,2,Toscana,ITI1
2021-01-05,COMIRNATY Vaccino a mRNA contro COVID-19,090618,COVID19 - Ospedale del Bibbiena,TOS,20-29,0,3,0,3,0,0,0,3,0,3,Toscana,ITI1
2021-01-05,COMIRNATY Vaccino a mRNA contro COVID-19,090618,COVID19 - Ospedale del Bibbiena,TOS,30-39,2,3,0,5,0,0,0,5,0,5,Toscana,ITI1
2021-01-05,COMIRNATY Vaccino a mRNA contro COVID-19,090618,COVID19 - Ospedale del Bibbiena,TOS,40-49,6,11,0,17,0,0,0,17,0,17,Toscana,ITI1
2021-01-05,COMIRNATY Vaccino a mRNA contro COVID-19,090618,COVID19 - Ospedale del Bibbiena,TOS,50-59,4,24,0,28,0,0,0,28,0,28,Toscana,ITI1
2021-01-05,COMIRNATY Vaccino a mRNA contro COVID-19,090618,COVID19 - Ospedale del Bibbiena,TOS,60-69,3,4,0,7,0,0,0,7,0,7,Toscana,ITI1
2021-01-05,COMIRNATY Vaccino a mRNA contro COVID-19,090619,COVID19 - Ospedale Valtiberina Sansepolcro,TOS,20-29,0,11,0,11,0,0,0,11,0,11,Toscana,ITI1
2021-01-05,COMIRNATY Vaccino a mRNA contro COVID-19,090619,COVID19 - Ospedale Valtiberina Sansepolcro,TOS,30-39,3,5,0,8,0,0,0,8,0,8,Toscana,ITI1
2021-01-05,COMIRNATY Vaccino a mRNA contro COVID-19,090619,COVID19 - Ospedale Valtiberina Sansepolcro,TOS,40-49,1,12,0,13,0,0,0,13,0,13,Toscana,ITI1
2021-01-05,COMIRNATY Vaccino a mRNA contro COVID-19,090619,COVID19 - Ospedale Valtiberina Sansepolcro,TOS,50-59,5,14,0,19,0,0,0,19,0,19,Toscana,ITI1
2021-01-05,COMIRNATY Vaccino a mRNA contro COVID-19,090619,COVID19 - Ospedale Valtiberina Sansepolcro,TOS,60-69,5,4,0,9,0,0,0,9,0,9,Toscana,ITI1
2021-01-05,COMIRNATY Vaccino a mRNA contro COVID-19,090624,COVID19 - Ospedale di Orbetello,TOS,20-29,0,1,0,1,0,0,0,1,0,1,Toscana,ITI1
2021-01-05,COMIRNATY Vaccino a mRNA contro COVID-19,090624,COVID19 - Ospedale di Orbetello,TOS,40-49,1,2,0,3,0,0,0,3,0,3,Toscana,ITI1
2021-01-05,COMIRNATY Vaccino a mRNA contro COVID-19,090624,COVID19 - Ospedale di Orbetello,TOS,50-59,1,1,0,2,0,0,0,2,0,2,Toscana,ITI1
2021-01-05,COMIRNATY Vaccino a mRNA contro COVID-19,090624,COVID19 - Ospedale di Orbetello,TOS,60-69,2,0,0,2,0,0,0,2,0,2,Toscana,ITI1
2021-01-05,COMIRNATY Vaccino a mRNA contro COVID-19,090626,COVID19 - Ospedale di Grosseto,TOS,20-29,6,7,1,13,0,0,0,13,0,13,Toscana,ITI1
2021-01-05,COMIRNATY Vaccino a mRNA contro COVID-19,090626,COVID19 - Ospedale di Grosseto,TOS,30-39,15,22,1,37,0,0,0,37,0,37,Toscana,ITI1
2021-01-05,COMIRNATY Vaccino a mRNA contro COVID-19,090626,COVID19 - Ospedale di Grosseto,TOS,40-49,18,31,1,49,0,0,0,49,0,49,Toscana,ITI1
2021-01-05,COMIRNATY Vaccino a mRNA contro COVID-19,090626,COVID19 - Ospedale di Grosseto,TOS,50-59,18,30,1,47,0,0,1,48,0,48,Toscana,ITI1
2021-01-05,COMIRNATY Vaccino a mRNA contro COVID-19,090626,COVID19 - Ospedale di Grosseto,TOS,60-69,12,6,1,18,0,0,0,18,0,18,Toscana,ITI1
2021-01-05,COMIRNATY Vaccino a mRNA contro COVID-19,090626,COVID19 - Ospedale di Grosseto,TOS,70-79,2,0,1,2,0,0,0,2,0,2,Toscana,ITI1
2021-01-05,COMIRNATY Vaccino a mRNA contro COVID-19,090627,COVID19 - Ospedale Mugello,TOS,20-29,0,3,0,3,0,0,0,3,0,3,Toscana,ITI1
2021-01-05,COMIRNATY Vaccino a mRNA contro COVID-19,090627,COVID19 - Ospedale Mugello,TOS,30-39,3,9,0,12,0,0,0,12,0,12,Toscana,ITI1
2021-01-05,COMIRNATY Vaccino a mRNA contro COVID-19,090627,COVID19 - Ospedale Mugello,TOS,40-49,4,15,0,19,0,0,0,19,0,19,Toscana,ITI1
2021-01-05,COMIRNATY Vaccino a mRNA contro COVID-19,090627,COVID19 - Ospedale Mugello,TOS,50-59,2,8,0,10,0,0,0,10,0,10,Toscana,ITI1
2021-01-05,COMIRNATY Vaccino a mRNA contro COVID-19,090627,COVID19 - Ospedale Mugello,TOS,60-69,2,2,0,4,0,0,0,4,0,4,Toscana,ITI1
2021-01-05,COMIRNATY Vaccino a mRNA contro COVID-19,090629,COVID19 - Ospedale SS. Maria Annunziata,TOS,20-29,3,21,0,24,0,0,0,24,0,24,Toscana,ITI1
2021-01-05,COMIRNATY Vaccino a mRNA contro COVID-19,090629,COVID19 - Ospedale SS. Maria Annunziata,TOS,30-39,11,23,0,33,1,0,0,34,0,34,Toscana,ITI1
2021-01-05,COMIRNATY Vaccino a mRNA contro COVID-19,090629,COVID19 - Ospedale SS. Maria Annunziata,TOS,40-49,13,26,0,38,1,0,0,39,0,39,Toscana,ITI1
2021-01-05,COMIRNATY Vaccino a mRNA contro COVID-19,090629,COVID19 - Ospedale SS. Maria Annunziata,TOS,50-59,10,30,0,39,1,0,0,40,0,40,Toscana,ITI1
2021-01-05,COMIRNATY Vaccino a mRNA contro COVID-19,090629,COVID19 - Ospedale SS. Maria Annunziata,TOS,60-69,5,5,0,10,0,0,0,10,0,10,Toscana,ITI1
2021-01-05,COMIRNATY Vaccino a mRNA contro COVID-19,090629,COVID19 - Ospedale SS. Maria Annunziata,TOS,70-79,1,1,0,2,0,0,0,2,0,2,Toscana,ITI1
2021-01-05,COMIRNATY Vaccino a mRNA contro COVID-19,090632,COVID19 - Ospedale Santa Maria Nuova,TOS,20-29,5,7,0,12,0,0,0,12,0,12,Toscana,ITI1
2021-01-05,COMIRNATY Vaccino a mRNA contro COVID-19,090632,COVID19 - Ospedale Santa Maria Nuova,TOS,30-39,6,19,0,25,0,0,0,25,0,25,Toscana,ITI1
2021-01-05,COMIRNATY Vaccino a mRNA contro COVID-19,090632,COVID19 - Ospedale Santa Maria Nuova,TOS,40-49,8,18,0,26,0,0,0,26,0,26,Toscana,ITI1
2021-01-05,COMIRNATY Vaccino a mRNA contro COVID-19,090632,COVID19 - Ospedale Santa Maria Nuova,TOS,50-59,8,18,0,26,0,0,0,26,0,26,Toscana,ITI1
2021-01-05,COMIRNATY Vaccino a mRNA contro COVID-19,090632,COVID19 - Ospedale Santa Maria Nuova,TOS,60-69,7,10,0,17,0,0,0,17,0,17,Toscana,ITI1
2021-01-05,COMIRNATY Vaccino a mRNA contro COVID-19,090632,COVID19 - Ospedale Santa Maria Nuova,TOS,70-79,1,0,0,1,0,0,0,1,0,1,Toscana,ITI1
2021-01-05,COMIRNATY Vaccino a mRNA contro COVID-19,090639,COVID19 - Ospedale di Nottola Montepulciano,TOS,20-29,2,3,0,5,0,0,0,5,0,5,Toscana,ITI1
2021-01-05,COMIRNATY Vaccino a mRNA contro COVID-19,090639,COVID19 - Ospedale di Nottola Montepulciano,TOS,30-39,3,9,0,12,0,0,0,12,0,12,Toscana,ITI1
2021-01-05,COMIRNATY Vaccino a mRNA contro COVID-19,090639,COVID19 - Ospedale di Nottola Montepulciano,TOS,40-49,5,13,0,18,0,0,0,18,0,18,Toscana,ITI1
2021-01-05,COMIRNATY Vaccino a mRNA contro COVID-19,090639,COVID19 - Ospedale di Nottola Montepulciano,TOS,50-59,13,18,0,31,0,0,0,31,0,31,Toscana,ITI1
2021-01-05,COMIRNATY Vaccino a mRNA contro COVID-19,090639,COVID19 - Ospedale di Nottola Montepulciano,TOS,60-69,0,7,0,7,0,0,0,7,0,7,Toscana,ITI1
2021-01-05,COMIRNATY Vaccino a mRNA contro COVID-19,090640,Covid 19 - Ospedale Unico Versilia,TOS,20-29,0,9,0,9,0,0,0,9,0,9,Toscana,ITI1
2021-01-05,COMIRNATY Vaccino a mRNA contro COVID-19,090640,Covid 19 - Ospedale Unico Versilia,TOS,30-39,9,21,0,30,0,0,0,30,0,30,Toscana,ITI1
2021-01-05,COMIRNATY Vaccino a mRNA contro COVID-19,090640,Covid 19 - Ospedale Unico Versilia,TOS,40-49,10,32,0,42,0,0,0,42,0,42,Toscana,ITI1
2021-01-05,COMIRNATY Vaccino a mRNA contro COVID-19,090640,Covid 19 - Ospedale Unico Versilia,TOS,50-59,11,25,0,36,0,0,0,36,0,36,Toscana,ITI1
2021-01-05,COMIRNATY Vaccino a mRNA contro COVID-19,090640,Covid 19 - Ospedale Unico Versilia,TOS,60-69,10,4,0,14,0,0,0,14,0,14,Toscana,ITI1
2021-01-05,COMIRNATY Vaccino a mRNA contro COVID-19,090641,COVID19 - Ospedale La Gruccia Montevarchi,TOS,20-29,4,7,1,11,0,0,0,11,0,11,Toscana,ITI1
2021-01-05,COMIRNATY Vaccino a mRNA contro COVID-19,090641,COVID19 - Ospedale La Gruccia Montevarchi,TOS,30-39,8,15,1,22,0,0,1,23,0,23,Toscana,ITI1
2021-01-05,COMIRNATY Vaccino a mRNA contro COVID-19,090641,COVID19 - Ospedale La Gruccia Montevarchi,TOS,40-49,4,18,1,22,0,0,0,22,0,22,Toscana,ITI1
2021-01-05,COMIRNATY Vaccino a mRNA contro COVID-19,090641,COVID19 - Ospedale La Gruccia Montevarchi,TOS,50-59,7,23,1,30,0,0,0,30,0,30,Toscana,ITI1
2021-01-05,COMIRNATY Vaccino a mRNA contro COVID-19,090641,COVID19 - Ospedale La Gruccia Montevarchi,TOS,60-69,6,4,1,10,0,0,0,10,0,10,Toscana,ITI1
2021-01-05,COMIRNATY Vaccino a mRNA contro COVID-19,090643,COVID19 - Ospedale S. Margherita Cortona,TOS,20-29,3,6,0,9,0,0,0,9,0,9,Toscana,ITI1
2021-01-05,COMIRNATY Vaccino a mRNA contro COVID-19,090643,COVID19 - Ospedale S. Margherita Cortona,TOS,30-39,4,5,0,9,0,0,0,9,0,9,Toscana,ITI1
2021-01-05,COMIRNATY Vaccino a mRNA contro COVID-19,090643,COVID19 - Ospedale S. Margherita Cortona,TOS,40-49,3,12,0,15,0,0,0,15,0,15,Toscana,ITI1
2021-01-05,COMIRNATY Vaccino a mRNA contro COVID-19,090643,COVID19 - Ospedale S. Margherita Cortona,TOS,50-59,3,13,0,16,0,0,0,16,0,16,Toscana,ITI1
2021-01-05,COMIRNATY Vaccino a mRNA contro COVID-19,090643,COVID19 - Ospedale S. Margherita Cortona,TOS,60-69,3,2,0,5,0,0,0,5,0,5,Toscana,ITI1
2021-01-05,COMIRNATY Vaccino a mRNA contro COVID-19,090901,COVID19 - AOU Pisana,TOS,16-19,2,9,0,11,0,0,0,11,0,11,Toscana,ITI1
2021-01-05,COMIRNATY Vaccino a mRNA contro COVID-19,090901,COVID19 - AOU Pisana,TOS,20-29,77,145,0,222,0,0,0,222,0,222,Toscana,ITI1
2021-01-05,COMIRNATY Vaccino a mRNA contro COVID-19,090901,COVID19 - AOU Pisana,TOS,30-39,47,79,0,126,0,0,0,126,0,126,Toscana,ITI1
2021-01-05,COMIRNATY Vaccino a mRNA contro COVID-19,090901,COVID19 - AOU Pisana,TOS,40-49,34,52,0,86,0,0,0,86,0,86,Toscana,ITI1
2021-01-05,COMIRNATY Vaccino a mRNA contro COVID-19,090901,COVID19 - AOU Pisana,TOS,50-59,30,72,0,101,1,0,0,102,0,102,Toscana,ITI1
2021-01-05,COMIRNATY Vaccino a mRNA contro COVID-19,090901,COVID19 - AOU Pisana,TOS,60-69,24,16,0,40,0,0,0,40,0,40,Toscana,ITI1
2021-01-05,COMIRNATY Vaccino a mRNA contro COVID-19,090902,COVID19 - AOU Senese,TOS,20-29,35,56,0,90,0,1,0,91,0,91,Toscana,ITI1
2021-01-05,COMIRNATY Vaccino a mRNA contro COVID-19,090902,COVID19 - AOU Senese,TOS,30-39,33,42,0,73,0,2,0,75,0,75,Toscana,ITI1
2021-01-05,COMIRNATY Vaccino a mRNA contro COVID-19,090902,COVID19 - AOU Senese,TOS,40-49,20,44,0,64,0,0,0,64,0,64,Toscana,ITI1
2021-01-05,COMIRNATY Vaccino a mRNA contro COVID-19,090902,COVID19 - AOU Senese,TOS,50-59,15,46,0,60,0,1,0,61,0,61,Toscana,ITI1
2021-01-05,COMIRNATY Vaccino a mRNA contro COVID-19,090902,COVID19 - AOU Senese,TOS,60-69,9,16,0,25,0,0,0,25,0,25,Toscana,ITI1
2021-01-05,COMIRNATY Vaccino a mRNA contro COVID-19,090902,COVID19 - AOU Senese,TOS,70-79,1,0,0,1,0,0,0,1,0,1,Toscana,ITI1
2021-01-05,COMIRNATY Vaccino a mRNA contro COVID-19,090903,COVID19 - AOU Careggi - CTO,TOS,16-19,1,3,0,4,0,0,0,4,0,4,Toscana,ITI1
2021-01-05,COMIRNATY Vaccino a mRNA contro COVID-19,090903,COVID19 - AOU Careggi - CTO,TOS,20-29,100,165,0,265,0,0,0,265,0,265,Toscana,ITI1
2021-01-05,COMIRNATY Vaccino a mRNA contro COVID-19,090903,COVID19 - AOU Careggi - CTO,TOS,30-39,62,70,0,132,0,0,0,132,0,132,Toscana,ITI1
2021-01-05,COMIRNATY Vaccino a mRNA contro COVID-19,090903,COVID19 - AOU Careggi - CTO,TOS,40-49,43,89,0,131,0,1,0,132,0,132,Toscana,ITI1
2021-01-05,COMIRNATY Vaccino a mRNA contro COVID-19,090903,COVID19 - AOU Careggi - CTO,TOS,50-59,41,103,0,144,0,0,0,144,0,144,Toscana,ITI1
2021-01-05,COMIRNATY Vaccino a mRNA contro COVID-19,090903,COVID19 - AOU Careggi - CTO,TOS,60-69,38,34,0,72,0,0,0,72,0,72,Toscana,ITI1
2021-01-05,COMIRNATY Vaccino a mRNA contro COVID-19,090903,COVID19 - AOU Careggi - CTO,TOS,70-79,3,1,0,4,0,0,0,4,0,4,Toscana,ITI1
2021-01-05,COMIRNATY Vaccino a mRNA contro COVID-19,090904,COVID19 - Ospedale AOU Meyer,TOS,20-29,5,11,0,16,0,0,0,16,0,16,Toscana,ITI1
2021-01-05,COMIRNATY Vaccino a mRNA contro COVID-19,090904,COVID19 - Ospedale AOU Meyer,TOS,30-39,10,25,0,35,0,0,0,35,0,35,Toscana,ITI1
2021-01-05,COMIRNATY Vaccino a mRNA contro COVID-19,090904,COVID19 - Ospedale AOU Meyer,TOS,40-49,14,21,0,35,0,0,0,35,0,35,Toscana,ITI1
2021-01-05,COMIRNATY Vaccino a mRNA contro COVID-19,090904,COVID19 - Ospedale AOU Meyer,TOS,50-59,5,16,0,21,0,0,0,21,0,21,Toscana,ITI1
2021-01-05,COMIRNATY Vaccino a mRNA contro COVID-19,090904,COVID19 - Ospedale AOU Meyer,TOS,60-69,3,4,0,7,0,0,0,7,0,7,Toscana,ITI1
2021-01-05,COMIRNATY Vaccino a mRNA contro COVID-19,090907,Covid19 - FTGM Pisa San Cataldo,TOS,16-19,0,1,0,1,0,0,0,1,0,1,Toscana,ITI1
2021-01-05,COMIRNATY Vaccino a mRNA contro COVID-19,090907,Covid19 - FTGM Pisa San Cataldo,TOS,20-29,3,3,0,6,0,0,0,6,0,6,Toscana,ITI1
2021-01-05,COMIRNATY Vaccino a mRNA contro COVID-19,090907,Covid19 - FTGM Pisa San Cataldo,TOS,30-39,8,11,0,19,0,0,0,19,0,19,Toscana,ITI1
2021-01-05,COMIRNATY Vaccino a mRNA contro COVID-19,090907,Covid19 - FTGM Pisa San Cataldo,TOS,40-49,8,10,0,18,0,0,0,18,0,18,Toscana,ITI1
2021-01-05,COMIRNATY Vaccino a mRNA contro COVID-19,090907,Covid19 - FTGM Pisa San Cataldo,TOS,50-59,5,11,0,16,0,0,0,16,0,16,Toscana,ITI1
2021-01-05,COMIRNATY Vaccino a mRNA contro COVID-19,090907,Covid19 - FTGM Pisa San Cataldo,TOS,60-69,9,6,0,15,0,0,0,15,0,15,Toscana,ITI1
2021-01-05,COMIRNATY Vaccino a mRNA contro COVID-19,090907,Covid19 - FTGM Pisa San Cataldo,TOS,70-79,1,0,0,1,0,0,0,1,0,1,Toscana,ITI1
2021-01-05,COMIRNATY Vaccino a mRNA contro COVID-19,090907,Covid19 - FTGM Pisa San Cataldo,TOS,80-89,1,0,0,1,0,0,0,1,0,1,Toscana,ITI1
2021-01-05,COMIRNATY Vaccino a mRNA contro COVID-19,10314I,RSA  PIA CASA,TOS,40-49,0,2,0,2,0,0,0,2,0,2,Toscana,ITI1
2021-01-05,COMIRNATY Vaccino a mRNA contro COVID-19,10314I,RSA  PIA CASA,TOS,50-59,0,3,0,3,0,0,0,3,0,3,Toscana,ITI1
2021-01-05,COMIRNATY Vaccino a mRNA contro COVID-19,10314I,RSA  PIA CASA,TOS,60-69,6,1,0,0,0,7,0,7,0,7,Toscana,ITI1
2021-01-05,COMIRNATY Vaccino a mRNA contro COVID-19,10314I,RSA  PIA CASA,TOS,70-79,8,6,0,0,0,14,0,14,0,14,Toscana,ITI1
2021-01-05,COMIRNATY Vaccino a mRNA contro COVID-19,10314I,RSA  PIA CASA,TOS,80-89,3,19,0,0,0,22,0,22,0,22,Toscana,ITI1
2021-01-05,COMIRNATY Vaccino a mRNA contro COVID-19,10314I,RSA  PIA CASA,TOS,90+,1,11,0,0,0,12,0,12,0,12,Toscana,ITI1
2021-01-05,COMIRNATY Vaccino a mRNA contro COVID-19,10384I,Covid19 - RSA DOTT. ROBERTO NOBILI,TOS,20-29,0,1,0,1,0,0,0,1,0,1,Toscana,ITI1
2021-01-05,COMIRNATY Vaccino a mRNA contro COVID-19,10384I,Covid19 - RSA DOTT. ROBERTO NOBILI,TOS,40-49,0,2,0,2,0,0,0,2,0,2,Toscana,ITI1
2021-01-05,COMIRNATY Vaccino a mRNA contro COVID-19,10384I,Covid19 - RSA DOTT. ROBERTO NOBILI,TOS,50-59,0,2,0,2,0,0,0,2,0,2,Toscana,ITI1
2021-01-05,COMIRNATY Vaccino a mRNA contro COVID-19,10384I,Covid19 - RSA DOTT. ROBERTO NOBILI,TOS,60-69,1,0,0,0,0,1,0,1,0,1,Toscana,ITI1
2021-01-05,COMIRNATY Vaccino a mRNA contro COVID-19,10384I,Covid19 - RSA DOTT. ROBERTO NOBILI,TOS,70-79,3,1,0,0,0,4,0,4,0,4,Toscana,ITI1
2021-01-05,COMIRNATY Vaccino a mRNA contro COVID-19,10384I,Covid19 - RSA DOTT. ROBERTO NOBILI,TOS,80-89,2,3,0,0,0,5,0,5,0,5,Toscana,ITI1
2021-01-05,COMIRNATY Vaccino a mRNA contro COVID-19,10384I,Covid19 - RSA DOTT. ROBERTO NOBILI,TOS,90+,0,3,0,0,0,3,0,3,0,3,Toscana,ITI1
2021-01-05,COMIRNATY Vaccino a mRNA contro COVID-19,11012E,COVID19 - Ospedale San Giuseppe,TOS,20-29,6,10,0,16,0,0,0,16,0,16,Toscana,ITI1
2021-01-05,COMIRNATY Vaccino a mRNA contro COVID-19,11012E,COVID19 - Ospedale San Giuseppe,TOS,30-39,14,19,0,33,0,0,0,33,0,33,Toscana,ITI1
2021-01-05,COMIRNATY Vaccino a mRNA contro COVID-19,11012E,COVID19 - Ospedale San Giuseppe,TOS,40-49,11,31,0,42,0,0,0,42,0,42,Toscana,ITI1
2021-01-05,COMIRNATY Vaccino a mRNA contro COVID-19,11012E,COVID19 - Ospedale San Giuseppe,TOS,50-59,19,39,0,57,0,1,0,58,0,58,Toscana,ITI1
2021-01-05,COMIRNATY Vaccino a mRNA contro COVID-19,11012E,COVID19 - Ospedale San Giuseppe,TOS,60-69,13,9,0,19,0,3,0,22,0,22,Toscana,ITI1
2021-01-05,COMIRNATY Vaccino a mRNA contro COVID-19,11012E,COVID19 - Ospedale San Giuseppe,TOS,70-79,4,3,0,0,0,7,0,7,0,7,Toscana,ITI1
2021-01-05,COMIRNATY Vaccino a mRNA contro COVID-19,11012E,COVID19 - Ospedale San Giuseppe,TOS,80-89,5,10,0,0,0,15,0,15,0,15,Toscana,ITI1
2021-01-05,COMIRNATY Vaccino a mRNA contro COVID-19,11012E,COVID19 - Ospedale San Giuseppe,TOS,90+,3,20,0,0,0,23,0,23,0,23,Toscana,ITI1
2021-01-05,COMIRNATY Vaccino a mRNA contro COVID-19,11151A,Covid 19 - Ospedale S.Antonio Abate di Pontremoli,TOS,30-39,1,0,0,1,0,0,0,1,0,1,Toscana,ITI1
2021-01-05,COMIRNATY Vaccino a mRNA contro COVID-19,11151A,Covid 19 - Ospedale S.Antonio Abate di Pontremoli,TOS,40-49,2,2,0,4,0,0,0,4,0,4,Toscana,ITI1
2021-01-05,COMIRNATY Vaccino a mRNA contro COVID-19,11151A,Covid 19 - Ospedale S.Antonio Abate di Pontremoli,TOS,50-59,8,11,0,16,1,2,0,19,0,19,Toscana,ITI1
2021-01-05,COMIRNATY Vaccino a mRNA contro COVID-19,11151A,Covid 19 - Ospedale S.Antonio Abate di Pontremoli,TOS,60-69,3,0,0,1,0,2,0,3,0,3,Toscana,ITI1
2021-01-05,COMIRNATY Vaccino a mRNA contro COVID-19,11151A,Covid 19 - Ospedale S.Antonio Abate di Pontremoli,TOS,70-79,4,5,0,0,0,9,0,9,0,9,Toscana,ITI1
2021-01-05,COMIRNATY Vaccino a mRNA contro COVID-19,11151A,Covid 19 - Ospedale S.Antonio Abate di Pontremoli,TOS,80-89,4,11,0,0,1,14,0,15,0,15,Toscana,ITI1
2021-01-05,COMIRNATY Vaccino a mRNA contro COVID-19,11151A,Covid 19 - Ospedale S.Antonio Abate di Pontremoli,TOS,90+,1,14,0,0,0,15,0,15,0,15,Toscana,ITI1
2021-01-05,COMIRNATY Vaccino a mRNA contro COVID-19,12274I,RSA LA VILLA SPA CARAVAGGIO,TOS,20-29,0,2,0,2,0,0,0,2,0,2,Toscana,ITI1
2021-01-05,COMIRNATY Vaccino a mRNA contro COVID-19,12274I,RSA LA VILLA SPA CARAVAGGIO,TOS,40-49,1,4,0,4,0,1,0,5,0,5,Toscana,ITI1
2021-01-05,COMIRNATY Vaccino a mRNA contro COVID-19,12274I,RSA LA VILLA SPA CARAVAGGIO,TOS,50-59,0,3,0,3,0,0,0,3,0,3,Toscana,ITI1
2021-01-05,COMIRNATY Vaccino a mRNA contro COVID-19,12274I,RSA LA VILLA SPA CARAVAGGIO,TOS,60-69,2,1,0,0,0,3,0,3,0,3,Toscana,ITI1
2021-01-05,COMIRNATY Vaccino a mRNA contro COVID-19,12274I,RSA LA VILLA SPA CARAVAGGIO,TOS,70-79,4,4,0,0,0,8,0,8,0,8,Toscana,ITI1
2021-01-05,COMIRNATY Vaccino a mRNA contro COVID-19,12274I,RSA LA VILLA SPA CARAVAGGIO,TOS,80-89,6,21,0,0,0,27,0,27,0,27,Toscana,ITI1
2021-01-05,COMIRNATY Vaccino a mRNA contro COVID-19,12274I,RSA LA VILLA SPA CARAVAGGIO,TOS,90+,2,17,0,0,0,19,0,19,0,19,Toscana,ITI1
2021-01-05,COMIRNATY Vaccino a mRNA contro COVID-19,12714I,RSA FRANCESCO BOTTAI,TOS,20-29,0,1,0,1,0,0,0,1,0,1,Toscana,ITI1
2021-01-05,COMIRNATY Vaccino a mRNA contro COVID-19,12714I,RSA FRANCESCO BOTTAI,TOS,30-39,0,3,0,3,0,0,0,3,0,3,Toscana,ITI1
2021-01-05,COMIRNATY Vaccino a mRNA contro COVID-19,12714I,RSA FRANCESCO BOTTAI,TOS,40-49,0,2,0,2,0,0,0,2,0,2,Toscana,ITI1
2021-01-05,COMIRNATY Vaccino a mRNA contro COVID-19,12714I,RSA FRANCESCO BOTTAI,TOS,50-59,1,3,0,4,0,0,0,4,0,4,Toscana,ITI1
2021-01-05,COMIRNATY Vaccino a mRNA contro COVID-19,12714I,RSA FRANCESCO BOTTAI,TOS,60-69,2,1,0,0,0,3,0,3,0,3,Toscana,ITI1
2021-01-05,COMIRNATY Vaccino a mRNA contro COVID-19,12714I,RSA FRANCESCO BOTTAI,TOS,70-79,3,3,0,0,0,6,0,6,0,6,Toscana,ITI1
2021-01-05,COMIRNATY Vaccino a mRNA contro COVID-19,12714I,RSA FRANCESCO BOTTAI,TOS,80-89,11,10,0,0,0,21,0,21,0,21,Toscana,ITI1
2021-01-05,COMIRNATY Vaccino a mRNA contro COVID-19,12714I,RSA FRANCESCO BOTTAI,TOS,90+,1,21,0,0,0,22,0,22,0,22,Toscana,ITI1
2021-01-05,COMIRNATY Vaccino a mRNA contro COVID-19,13021A,COVID19 - Ospedale S.Giovanni di Dio,TOS,20-29,8,19,0,27,0,0,0,27,0,27,Toscana,ITI1
2021-01-05,COMIRNATY Vaccino a mRNA contro COVID-19,13021A,COVID19 - Ospedale S.Giovanni di Dio,TOS,30-39,12,32,0,44,0,0,0,44,0,44,Toscana,ITI1
2021-01-05,COMIRNATY Vaccino a mRNA contro COVID-19,13021A,COVID19 - Ospedale S.Giovanni di Dio,TOS,40-49,12,28,0,39,0,1,0,40,0,40,Toscana,ITI1
2021-01-05,COMIRNATY Vaccino a mRNA contro COVID-19,13021A,COVID19 - Ospedale S.Giovanni di Dio,TOS,50-59,15,42,0,47,0,10,0,57,0,57,Toscana,ITI1
2021-01-05,COMIRNATY Vaccino a mRNA contro COVID-19,13021A,COVID19 - Ospedale S.Giovanni di Dio,TOS,60-69,12,17,0,15,0,14,0,29,0,29,Toscana,ITI1
2021-01-05,COMIRNATY Vaccino a mRNA contro COVID-19,13021A,COVID19 - Ospedale S.Giovanni di Dio,TOS,70-79,9,10,0,1,0,18,0,19,0,19,Toscana,ITI1
2021-01-05,COMIRNATY Vaccino a mRNA contro COVID-19,13021A,COVID19 - Ospedale S.Giovanni di Dio,TOS,80-89,11,24,0,0,0,35,0,35,0,35,Toscana,ITI1
2021-01-05,COMIRNATY Vaccino a mRNA contro COVID-19,13021A,COVID19 - Ospedale S.Giovanni di Dio,TOS,90+,4,26,0,1,0,29,0,30,0,30,Toscana,ITI1
2021-01-05,COMIRNATY Vaccino a mRNA contro COVID-19,16121A,Covid 19 - Ospedale Civile di Cecina,TOS,20-29,1,1,0,2,0,0,0,2,0,2,Toscana,ITI1
2021-01-05,COMIRNATY Vaccino a mRNA contro COVID-19,16121A,Covid 19 - Ospedale Civile di Cecina,TOS,30-39,0,2,0,2,0,0,0,2,0,2,Toscana,ITI1
2021-01-05,COMIRNATY Vaccino a mRNA contro COVID-19,16121A,Covid 19 - Ospedale Civile di Cecina,TOS,40-49,3,3,0,6,0,0,0,6,0,6,Toscana,ITI1
2021-01-05,COMIRNATY Vaccino a mRNA contro COVID-19,16121A,Covid 19 - Ospedale Civile di Cecina,TOS,50-59,5,11,0,16,0,0,0,16,0,16,Toscana,ITI1
2021-01-05,COMIRNATY Vaccino a mRNA contro COVID-19,16121A,Covid 19 - Ospedale Civile di Cecina,TOS,60-69,3,1,0,4,0,0,0,4,0,4,Toscana,ITI1
2021-01-05,COMIRNATY Vaccino a mRNA contro COVID-19,20014I,RSA MARTINI SANTA CROCE,TOS,30-39,1,1,0,2,0,0,0,2,0,2,Toscana,ITI1
2021-01-05,COMIRNATY Vaccino a mRNA contro COVID-19,20014I,RSA MARTINI SANTA CROCE,TOS,40-49,0,3,0,2,0,1,0,3,0,3,Toscana,ITI1
2021-01-05,COMIRNATY Vaccino a mRNA contro COVID-19,20014I,RSA MARTINI SANTA CROCE,TOS,50-59,0,2,0,2,0,0,0,2,0,2,Toscana,ITI1
2021-01-05,COMIRNATY Vaccino a mRNA contro COVID-19,20014I,RSA MARTINI SANTA CROCE,TOS,60-69,0,1,0,0,0,1,0,1,0,1,Toscana,ITI1
2021-01-05,COMIRNATY Vaccino a mRNA contro COVID-19,20014I,RSA MARTINI SANTA CROCE,TOS,70-79,1,0,0,0,0,1,0,1,0,1,Toscana,ITI1
2021-01-05,COMIRNATY Vaccino a mRNA contro COVID-19,20014I,RSA MARTINI SANTA CROCE,TOS,80-89,6,2,0,0,0,8,0,8,0,8,Toscana,ITI1
2021-01-05,COMIRNATY Vaccino a mRNA contro COVID-19,20014I,RSA MARTINI SANTA CROCE,TOS,90+,2,3,0,0,0,5,0,5,0,5,Toscana,ITI1
2021-01-05,COMIRNATY Vaccino a mRNA contro COVID-19,20924I,R.S.A. CENTRO RES.LE SACRO CUO,TOS,60-69,1,1,0,0,0,2,0,2,0,2,Toscana,ITI1
2021-01-05,COMIRNATY Vaccino a mRNA contro COVID-19,20924I,R.S.A. CENTRO RES.LE SACRO CUO,TOS,70-79,0,4,0,0,0,4,0,4,0,4,Toscana,ITI1
2021-01-05,COMIRNATY Vaccino a mRNA contro COVID-19,20924I,R.S.A. CENTRO RES.LE SACRO CUO,TOS,80-89,4,16,0,0,0,20,0,20,0,20,Toscana,ITI1
2021-01-05,COMIRNATY Vaccino a mRNA contro COVID-19,20924I,R.S.A. CENTRO RES.LE SACRO CUO,TOS,90+,3,12,0,0,0,15,0,15,0,15,Toscana,ITI1
2021-01-05,COMIRNATY Vaccino a mRNA contro COVID-19,21791A,COVID19 - FTGM OPA Massa,TOS,20-29,6,18,0,24,0,0,0,24,0,24,Toscana,ITI1
2021-01-05,COMIRNATY Vaccino a mRNA contro COVID-19,21791A,COVID19 - FTGM OPA Massa,TOS,30-39,18,15,0,33,0,0,0,33,0,33,Toscana,ITI1
2021-01-05,COMIRNATY Vaccino a mRNA contro COVID-19,21791A,COVID19 - FTGM OPA Massa,TOS,40-49,5,19,0,24,0,0,0,24,0,24,Toscana,ITI1
2021-01-05,COMIRNATY Vaccino a mRNA contro COVID-19,21791A,COVID19 - FTGM OPA Massa,TOS,50-59,9,18,0,27,0,0,0,27,0,27,Toscana,ITI1
2021-01-05,COMIRNATY Vaccino a mRNA contro COVID-19,21791A,COVID19 - FTGM OPA Massa,TOS,60-69,5,1,0,6,0,0,0,6,0,6,Toscana,ITI1
2021-01-05,COMIRNATY Vaccino a mRNA contro COVID-19,22064I,R.S.A. RESIDENZA COSTA D'ARGEN,TOS,40-49,2,0,0,0,0,2,0,2,0,2,Toscana,ITI1
2021-01-05,COMIRNATY Vaccino a mRNA contro COVID-19,22064I,R.S.A. RESIDENZA COSTA D'ARGEN,TOS,60-69,0,1,0,0,0,1,0,1,0,1,Toscana,ITI1
2021-01-05,COMIRNATY Vaccino a mRNA contro COVID-19,22064I,R.S.A. RESIDENZA COSTA D'ARGEN,TOS,70-79,1,2,0,0,0,3,0,3,0,3,Toscana,ITI1
2021-01-05,COMIRNATY Vaccino a mRNA contro COVID-19,22064I,R.S.A. RESIDENZA COSTA D'ARGEN,TOS,80-89,2,6,0,0,0,8,0,8,0,8,Toscana,ITI1
2021-01-05,COMIRNATY Vaccino a mRNA contro COVID-19,22064I,R.S.A. RESIDENZA COSTA D'ARGEN,TOS,90+,1,6,0,0,0,7,0,7,0,7,Toscana,ITI1
2021-01-05,COMIRNATY Vaccino a mRNA contro COVID-19,220O4I,RSA PARROCCHIA SAN FREDIANO,TOS,20-29,0,1,0,1,0,0,0,1,0,1,Toscana,ITI1
2021-01-05,COMIRNATY Vaccino a mRNA contro COVID-19,220O4I,RSA PARROCCHIA SAN FREDIANO,TOS,30-39,0,1,0,1,0,0,0,1,0,1,Toscana,ITI1
2021-01-05,COMIRNATY Vaccino a mRNA contro COVID-19,220O4I,RSA PARROCCHIA SAN FREDIANO,TOS,50-59,0,1,0,1,0,0,0,1,0,1,Toscana,ITI1
2021-01-05,COMIRNATY Vaccino a mRNA contro COVID-19,220O4I,RSA PARROCCHIA SAN FREDIANO,TOS,70-79,1,1,0,0,0,2,0,2,0,2,Toscana,ITI1
2021-01-05,COMIRNATY Vaccino a mRNA contro COVID-19,220O4I,RSA PARROCCHIA SAN FREDIANO,TOS,80-89,1,3,0,1,0,3,0,4,0,4,Toscana,ITI1
2021-01-05,COMIRNATY Vaccino a mRNA contro COVID-19,220O4I,RSA PARROCCHIA SAN FREDIANO,TOS,90+,0,3,0,0,0,3,0,3,0,3,Toscana,ITI1
2021-01-05,COMIRNATY Vaccino a mRNA contro COVID-19,22391A,PRESIDIO AVENZA,TOS,40-49,1,1,0,1,0,1,0,2,0,2,Toscana,ITI1
2021-01-05,COMIRNATY Vaccino a mRNA contro COVID-19,22391A,PRESIDIO AVENZA,TOS,50-59,2,2,0,4,0,0,0,4,0,4,Toscana,ITI1
2021-01-05,COMIRNATY Vaccino a mRNA contro COVID-19,22391A,PRESIDIO AVENZA,TOS,60-69,2,0,0,1,0,1,0,2,0,2,Toscana,ITI1
2021-01-05,COMIRNATY Vaccino a mRNA contro COVID-19,22391A,PRESIDIO AVENZA,TOS,70-79,2,0,0,0,0,2,0,2,0,2,Toscana,ITI1
2021-01-05,COMIRNATY Vaccino a mRNA contro COVID-19,22391A,PRESIDIO AVENZA,TOS,80-89,4,4,0,0,0,8,0,8,0,8,Toscana,ITI1
2021-01-05,COMIRNATY Vaccino a mRNA contro COVID-19,22391A,PRESIDIO AVENZA,TOS,90+,2,4,0,0,0,6,0,6,0,6,Toscana,ITI1
2021-01-05,COMIRNATY Vaccino a mRNA contro COVID-19,23524I,RSA SINALUNGA,TOS,30-39,0,1,0,1,0,0,0,1,0,1,Toscana,ITI1
2021-01-05,COMIRNATY Vaccino a mRNA contro COVID-19,23524I,RSA SINALUNGA,TOS,50-59,0,1,0,1,0,0,0,1,0,1,Toscana,ITI1
2021-01-05,COMIRNATY Vaccino a mRNA contro COVID-19,23524I,RSA SINALUNGA,TOS,60-69,1,0,0,0,0,1,0,1,0,1,Toscana,ITI1
2021-01-05,COMIRNATY Vaccino a mRNA contro COVID-19,23524I,RSA SINALUNGA,TOS,70-79,4,6,0,0,0,10,0,10,0,10,Toscana,ITI1
2021-01-05,COMIRNATY Vaccino a mRNA contro COVID-19,23524I,RSA SINALUNGA,TOS,80-89,3,11,0,0,0,14,0,14,0,14,Toscana,ITI1
2021-01-05,COMIRNATY Vaccino a mRNA contro COVID-19,23524I,RSA SINALUNGA,TOS,90+,0,10,0,0,0,10,0,10,0,10,Toscana,ITI1
2021-01-05,COMIRNATY Vaccino a mRNA contro COVID-19,33534I,RSA  S. RITA,TOS,20-29,0,1,0,1,0,0,0,1,0,1,Toscana,ITI1
2021-01-05,COMIRNATY Vaccino a mRNA contro COVID-19,33534I,RSA  S. RITA,TOS,30-39,0,1,0,0,0,1,0,1,0,1,Toscana,ITI1
2021-01-05,COMIRNATY Vaccino a mRNA contro COVID-19,33534I,RSA  S. RITA,TOS,60-69,2,3,0,0,0,5,0,5,0,5,Toscana,ITI1
2021-01-05,COMIRNATY Vaccino a mRNA contro COVID-19,33534I,RSA  S. RITA,TOS,70-79,4,5,0,1,0,8,0,9,0,9,Toscana,ITI1
2021-01-05,COMIRNATY Vaccino a mRNA contro COVID-19,33534I,RSA  S. RITA,TOS,80-89,5,6,0,0,0,11,0,11,0,11,Toscana,ITI1
2021-01-05,COMIRNATY Vaccino a mRNA contro COVID-19,33534I,RSA  S. RITA,TOS,90+,0,9,0,0,0,9,0,9,0,9,Toscana,ITI1
2021-01-05,COMIRNATY Vaccino a mRNA contro COVID-19,48514I,R.S.A. S.PERTINI,TOS,20-29,0,1,0,1,0,0,0,1,0,1,Toscana,ITI1
2021-01-05,COMIRNATY Vaccino a mRNA contro COVID-19,48514I,R.S.A. S.PERTINI,TOS,30-39,0,1,0,1,0,0,0,1,0,1,Toscana,ITI1
2021-01-05,COMIRNATY Vaccino a mRNA contro COVID-19,48514I,R.S.A. S.PERTINI,TOS,40-49,0,2,0,2,0,0,0,2,0,2,Toscana,ITI1
2021-01-05,COMIRNATY Vaccino a mRNA contro COVID-19,48514I,R.S.A. S.PERTINI,TOS,50-59,0,4,0,3,0,1,0,4,0,4,Toscana,ITI1
2021-01-05,COMIRNATY Vaccino a mRNA contro COVID-19,48514I,R.S.A. S.PERTINI,TOS,60-69,3,3,0,2,0,4,0,6,0,6,Toscana,ITI1
2021-01-05,COMIRNATY Vaccino a mRNA contro COVID-19,48514I,R.S.A. S.PERTINI,TOS,70-79,4,2,0,0,0,6,0,6,0,6,Toscana,ITI1
2021-01-05,COMIRNATY Vaccino a mRNA contro COVID-19,48514I,R.S.A. S.PERTINI,TOS,80-89,4,9,0,0,0,13,0,13,0,13,Toscana,ITI1
2021-01-05,COMIRNATY Vaccino a mRNA contro COVID-19,48514I,R.S.A. S.PERTINI,TOS,90+,3,6,0,1,0,8,0,9,0,9,Toscana,ITI1
2021-01-05,COMIRNATY Vaccino a mRNA contro COVID-19,49324I,RSA LA PIAGGIARELLA,TOS,40-49,0,1,0,1,0,0,0,1,0,1,Toscana,ITI1
2021-01-05,COMIRNATY Vaccino a mRNA contro COVID-19,49324I,RSA LA PIAGGIARELLA,TOS,50-59,0,1,0,1,0,0,0,1,0,1,Toscana,ITI1
2021-01-05,COMIRNATY Vaccino a mRNA contro COVID-19,49324I,RSA LA PIAGGIARELLA,TOS,70-79,0,1,0,0,0,1,0,1,0,1,Toscana,ITI1
2021-01-05,COMIRNATY Vaccino a mRNA contro COVID-19,49324I,RSA LA PIAGGIARELLA,TOS,80-89,2,7,0,0,0,9,0,9,0,9,Toscana,ITI1
2021-01-05,COMIRNATY Vaccino a mRNA contro COVID-19,49324I,RSA LA PIAGGIARELLA,TOS,90+,0,6,0,0,0,6,0,6,0,6,Toscana,ITI1
2021-01-05,COMIRNATY Vaccino a mRNA contro COVID-19,51314I,RSA  BELVEDERE,TOS,20-29,0,1,0,1,0,0,0,1,0,1,Toscana,ITI1
2021-01-05,COMIRNATY Vaccino a mRNA contro COVID-19,51314I,RSA  BELVEDERE,TOS,50-59,0,2,0,2,0,0,0,2,0,2,Toscana,ITI1
2021-01-05,COMIRNATY Vaccino a mRNA contro COVID-19,51314I,RSA  BELVEDERE,TOS,60-69,0,1,0,0,0,1,0,1,0,1,Toscana,ITI1
2021-01-05,COMIRNATY Vaccino a mRNA contro COVID-19,51314I,RSA  BELVEDERE,TOS,70-79,0,3,0,0,0,3,0,3,0,3,Toscana,ITI1
2021-01-05,COMIRNATY Vaccino a mRNA contro COVID-19,51314I,RSA  BELVEDERE,TOS,80-89,8,10,0,0,0,18,0,18,0,18,Toscana,ITI1
2021-01-05,COMIRNATY Vaccino a mRNA contro COVID-19,51314I,RSA  BELVEDERE,TOS,90+,3,20,0,0,0,23,0,23,0,23,Toscana,ITI1
2021-01-05,COMIRNATY Vaccino a mRNA contro COVID-19,80024I,CASA SERENA MEZZANA RESIDENZIA,TOS,50-59,1,0,0,0,0,1,0,1,0,1,Toscana,ITI1
2021-01-05,COMIRNATY Vaccino a mRNA contro COVID-19,80024I,CASA SERENA MEZZANA RESIDENZIA,TOS,70-79,0,1,0,0,0,1,0,1,0,1,Toscana,ITI1
2021-01-05,COMIRNATY Vaccino a mRNA contro COVID-19,80024I,CASA SERENA MEZZANA RESIDENZIA,TOS,80-89,0,5,0,0,0,5,0,5,0,5,Toscana,ITI1
2021-01-05,COMIRNATY Vaccino a mRNA contro COVID-19,80024I,CASA SERENA MEZZANA RESIDENZIA,TOS,90+,0,3,0,0,0,3,0,3,0,3,Toscana,ITI1
2021-01-05,COMIRNATY Vaccino a mRNA contro COVID-19,80034I,CASA SANTA MARIA DELLA PIETA',TOS,60-69,0,1,0,0,0,1,0,1,0,1,Toscana,ITI1
2021-01-05,COMIRNATY Vaccino a mRNA contro COVID-19,80034I,CASA SANTA MARIA DELLA PIETA',TOS,70-79,1,0,0,0,0,1,0,1,0,1,Toscana,ITI1
2021-01-05,COMIRNATY Vaccino a mRNA contro COVID-19,80034I,CASA SANTA MARIA DELLA PIETA',TOS,80-89,1,7,0,0,0,8,0,8,0,8,Toscana,ITI1
2021-01-05,COMIRNATY Vaccino a mRNA contro COVID-19,80034I,CASA SANTA MARIA DELLA PIETA',TOS,90+,1,20,0,0,0,21,0,21,0,21,Toscana,ITI1
2021-01-05,COMIRNATY Vaccino a mRNA contro COVID-19,80064I,LA MAGNOLIA SRL V.S.TERESA,TOS,60-69,0,1,0,1,0,0,0,1,0,1,Toscana,ITI1
2021-01-05,COMIRNATY Vaccino a mRNA contro COVID-19,80064I,LA MAGNOLIA SRL V.S.TERESA,TOS,80-89,1,3,0,1,0,3,0,4,0,4,Toscana,ITI1
2021-01-05,COMIRNATY Vaccino a mRNA contro COVID-19,80064I,LA MAGNOLIA SRL V.S.TERESA,TOS,90+,0,1,0,0,0,1,0,1,0,1,Toscana,ITI1
2021-01-05,COMIRNATY Vaccino a mRNA contro COVID-19,80134I,CASA DI RIPOSO JOLE SPA,TOS,20-29,0,1,0,1,0,0,0,1,0,1,Toscana,ITI1
2021-01-05,COMIRNATY Vaccino a mRNA contro COVID-19,80134I,CASA DI RIPOSO JOLE SPA,TOS,30-39,0,1,0,1,0,0,0,1,0,1,Toscana,ITI1
2021-01-05,COMIRNATY Vaccino a mRNA contro COVID-19,80134I,CASA DI RIPOSO JOLE SPA,TOS,40-49,0,3,0,3,0,0,0,3,0,3,Toscana,ITI1
2021-01-05,COMIRNATY Vaccino a mRNA contro COVID-19,80134I,CASA DI RIPOSO JOLE SPA,TOS,50-59,0,1,0,1,0,0,0,1,0,1,Toscana,ITI1
2021-01-05,COMIRNATY Vaccino a mRNA contro COVID-19,80134I,CASA DI RIPOSO JOLE SPA,TOS,60-69,1,3,0,1,0,3,0,4,0,4,Toscana,ITI1
2021-01-05,COMIRNATY Vaccino a mRNA contro COVID-19,80134I,CASA DI RIPOSO JOLE SPA,TOS,70-79,4,6,0,0,0,10,0,10,0,10,Toscana,ITI1
2021-01-05,COMIRNATY Vaccino a mRNA contro COVID-19,80134I,CASA DI RIPOSO JOLE SPA,TOS,80-89,4,15,0,0,0,19,0,19,0,19,Toscana,ITI1
2021-01-05,COMIRNATY Vaccino a mRNA contro COVID-19,80134I,CASA DI RIPOSO JOLE SPA,TOS,90+,4,11,0,0,0,15,0,15,0,15,Toscana,ITI1
2021-01-05,COMIRNATY Vaccino a mRNA contro COVID-19,90154I,VILLA SAN BIAGIO,TOS,20-29,0,2,0,2,0,0,0,2,0,2,Toscana,ITI1
2021-01-05,COMIRNATY Vaccino a mRNA contro COVID-19,90154I,VILLA SAN BIAGIO,TOS,40-49,0,3,0,3,0,0,0,3,0,3,Toscana,ITI1
2021-01-05,COMIRNATY Vaccino a mRNA contro COVID-19,90154I,VILLA SAN BIAGIO,TOS,50-59,1,1,0,1,0,1,0,2,0,2,Toscana,ITI1
2021-01-05,COMIRNATY Vaccino a mRNA contro COVID-19,90154I,VILLA SAN BIAGIO,TOS,60-69,3,2,0,1,0,4,0,5,0,5,Toscana,ITI1
2021-01-05,COMIRNATY Vaccino a mRNA contro COVID-19,90154I,VILLA SAN BIAGIO,TOS,70-79,1,2,0,0,0,3,0,3,0,3,Toscana,ITI1
2021-01-05,COMIRNATY Vaccino a mRNA contro COVID-19,90154I,VILLA SAN BIAGIO,TOS,80-89,0,5,0,0,0,5,0,5,0,5,Toscana,ITI1
2021-01-05,COMIRNATY Vaccino a mRNA contro COVID-19,90154I,VILLA SAN BIAGIO,TOS,90+,1,1,0,0,0,2,0,2,0,2,Toscana,ITI1
2021-01-05,COMIRNATY Vaccino a mRNA contro COVID-19,90174I,NUOVA VILLA DI RIO,TOS,30-39,1,1,0,2,0,0,0,2,0,2,Toscana,ITI1
2021-01-05,COMIRNATY Vaccino a mRNA contro COVID-19,90174I,NUOVA VILLA DI RIO,TOS,40-49,0,3,0,2,1,0,0,3,0,3,Toscana,ITI1
2021-01-05,COMIRNATY Vaccino a mRNA contro COVID-19,90174I,NUOVA VILLA DI RIO,TOS,70-79,1,2,0,0,0,3,0,3,0,3,Toscana,ITI1
2021-01-05,COMIRNATY Vaccino a mRNA contro COVID-19,90174I,NUOVA VILLA DI RIO,TOS,80-89,2,1,0,0,0,3,0,3,0,3,Toscana,ITI1
2021-01-05,COMIRNATY Vaccino a mRNA contro COVID-19,90174I,NUOVA VILLA DI RIO,TOS,90+,1,0,0,0,0,1,0,1,0,1,Toscana,ITI1
2021-01-05,COMIRNATY Vaccino a mRNA contro COVID-19,ND,RSA Cottolengo,TOS,50-59,1,0,0,0,0,1,0,1,0,1,Toscana,ITI1
2021-01-05,COMIRNATY Vaccino a mRNA contro COVID-19,ND,RSA Cottolengo,TOS,60-69,1,3,0,0,0,4,0,4,0,4,Toscana,ITI1
2021-01-05,COMIRNATY Vaccino a mRNA contro COVID-19,ND,RSA Cottolengo,TOS,70-79,4,4,0,0,0,8,0,8,0,8,Toscana,ITI1
2021-01-05,COMIRNATY Vaccino a mRNA contro COVID-19,ND,RSA Cottolengo,TOS,80-89,3,7,0,0,0,10,0,10,0,10,Toscana,ITI1
2021-01-05,COMIRNATY Vaccino a mRNA contro COVID-19,ND,RSA Cottolengo,TOS,90+,1,5,0,1,0,5,0,6,0,6,Toscana,ITI1
2021-01-05,COMIRNATY Vaccino a mRNA contro COVID-19,S1224L,CAP ISTITUTO MARIA REDDITI,TOS,40-49,1,0,0,0,0,1,0,1,0,1,Toscana,ITI1
2021-01-05,COMIRNATY Vaccino a mRNA contro COVID-19,S1224L,CAP ISTITUTO MARIA REDDITI,TOS,50-59,1,0,0,0,0,1,0,1,0,1,Toscana,ITI1
2021-01-05,COMIRNATY Vaccino a mRNA contro COVID-19,S1224L,CAP ISTITUTO MARIA REDDITI,TOS,60-69,1,0,0,0,0,1,0,1,0,1,Toscana,ITI1
2021-01-05,COMIRNATY Vaccino a mRNA contro COVID-19,U0024I,RSA LA PERLA,TOS,30-39,0,3,0,3,0,0,0,3,0,3,Toscana,ITI1
2021-01-05,COMIRNATY Vaccino a mRNA contro COVID-19,U0024I,RSA LA PERLA,TOS,40-49,0,1,0,1,0,0,0,1,0,1,Toscana,ITI1
2021-01-05,COMIRNATY Vaccino a mRNA contro COVID-19,U0024I,RSA LA PERLA,TOS,50-59,0,2,0,2,0,0,0,2,0,2,Toscana,ITI1
2021-01-05,COMIRNATY Vaccino a mRNA contro COVID-19,U0024I,RSA LA PERLA,TOS,60-69,0,1,0,0,0,1,0,1,0,1,Toscana,ITI1
2021-01-05,COMIRNATY Vaccino a mRNA contro COVID-19,U0024I,RSA LA PERLA,TOS,70-79,1,1,0,0,0,2,0,2,0,2,Toscana,ITI1
2021-01-05,COMIRNATY Vaccino a mRNA contro COVID-19,U0024I,RSA LA PERLA,TOS,80-89,0,2,0,0,0,2,0,2,0,2,Toscana,ITI1
2021-01-05,COMIRNATY Vaccino a mRNA contro COVID-19,U0024I,RSA LA PERLA,TOS,90+,0,1,0,0,0,1,0,1,0,1,Toscana,ITI1
2021-01-06,COMIRNATY Vaccino a mRNA contro COVID-19,02484I,CASA DI RIPOSO SAN DOMENICO,TOS,50-59,1,1,0,0,0,2,0,2,0,2,Toscana,ITI1
2021-01-06,COMIRNATY Vaccino a mRNA contro COVID-19,02484I,CASA DI RIPOSO SAN DOMENICO,TOS,60-69,4,0,0,0,0,4,0,4,0,4,Toscana,ITI1
2021-01-06,COMIRNATY Vaccino a mRNA contro COVID-19,02484I,CASA DI RIPOSO SAN DOMENICO,TOS,70-79,4,0,0,0,0,4,0,4,0,4,Toscana,ITI1
2021-01-06,COMIRNATY Vaccino a mRNA contro COVID-19,02484I,CASA DI RIPOSO SAN DOMENICO,TOS,80-89,3,1,0,0,0,4,0,4,0,4,Toscana,ITI1
2021-01-06,COMIRNATY Vaccino a mRNA contro COVID-19,02484I,CASA DI RIPOSO SAN DOMENICO,TOS,90+,0,4,0,0,0,4,0,4,0,4,Toscana,ITI1
2021-01-06,COMIRNATY Vaccino a mRNA contro COVID-19,090602,Covid 19 - Nuovo Ospedale Apuane,TOS,16-19,0,1,0,1,0,0,0,1,0,1,Toscana,ITI1
2021-01-06,COMIRNATY Vaccino a mRNA contro COVID-19,090602,Covid 19 - Nuovo Ospedale Apuane,TOS,20-29,3,17,0,20,0,0,0,20,0,20,Toscana,ITI1
2021-01-06,COMIRNATY Vaccino a mRNA contro COVID-19,090602,Covid 19 - Nuovo Ospedale Apuane,TOS,30-39,11,28,0,39,0,0,0,39,0,39,Toscana,ITI1
2021-01-06,COMIRNATY Vaccino a mRNA contro COVID-19,090602,Covid 19 - Nuovo Ospedale Apuane,TOS,40-49,9,34,0,43,0,0,0,43,0,43,Toscana,ITI1
2021-01-06,COMIRNATY Vaccino a mRNA contro COVID-19,090602,Covid 19 - Nuovo Ospedale Apuane,TOS,50-59,15,52,0,66,0,1,0,67,0,67,Toscana,ITI1
2021-01-06,COMIRNATY Vaccino a mRNA contro COVID-19,090602,Covid 19 - Nuovo Ospedale Apuane,TOS,60-69,7,18,0,25,0,0,0,25,0,25,Toscana,ITI1
2021-01-06,COMIRNATY Vaccino a mRNA contro COVID-19,090602,Covid 19 - Nuovo Ospedale Apuane,TOS,70-79,3,0,0,3,0,0,0,3,0,3,Toscana,ITI1
2021-01-06,COMIRNATY Vaccino a mRNA contro COVID-19,090604,Covid 19 - Ospedale San Luca di  Lucca,TOS,20-29,7,18,0,24,1,0,0,25,0,25,Toscana,ITI1
2021-01-06,COMIRNATY Vaccino a mRNA contro COVID-19,090604,Covid 19 - Ospedale San Luca di  Lucca,TOS,30-39,14,19,0,33,0,0,0,33,0,33,Toscana,ITI1
2021-01-06,COMIRNATY Vaccino a mRNA contro COVID-19,090604,Covid 19 - Ospedale San Luca di  Lucca,TOS,40-49,7,26,0,33,0,0,0,33,0,33,Toscana,ITI1
2021-01-06,COMIRNATY Vaccino a mRNA contro COVID-19,090604,Covid 19 - Ospedale San Luca di  Lucca,TOS,50-59,7,28,0,35,0,0,0,35,0,35,Toscana,ITI1
2021-01-06,COMIRNATY Vaccino a mRNA contro COVID-19,090604,Covid 19 - Ospedale San Luca di  Lucca,TOS,60-69,6,4,0,10,0,0,0,10,0,10,Toscana,ITI1
2021-01-06,COMIRNATY Vaccino a mRNA contro COVID-19,090604,Covid 19 - Ospedale San Luca di  Lucca,TOS,70-79,2,0,0,2,0,0,0,2,0,2,Toscana,ITI1
2021-01-06,COMIRNATY Vaccino a mRNA contro COVID-19,090606,COVID19 - Ospedale San Iacopo,TOS,20-29,9,19,0,28,0,0,0,28,0,28,Toscana,ITI1
2021-01-06,COMIRNATY Vaccino a mRNA contro COVID-19,090606,COVID19 - Ospedale San Iacopo,TOS,30-39,7,18,0,25,0,0,0,25,0,25,Toscana,ITI1
2021-01-06,COMIRNATY Vaccino a mRNA contro COVID-19,090606,COVID19 - Ospedale San Iacopo,TOS,40-49,9,35,0,44,0,0,0,44,0,44,Toscana,ITI1
2021-01-06,COMIRNATY Vaccino a mRNA contro COVID-19,090606,COVID19 - Ospedale San Iacopo,TOS,50-59,12,32,0,44,0,0,0,44,0,44,Toscana,ITI1
2021-01-06,COMIRNATY Vaccino a mRNA contro COVID-19,090606,COVID19 - Ospedale San Iacopo,TOS,60-69,8,9,0,17,0,0,0,17,0,17,Toscana,ITI1
2021-01-06,COMIRNATY Vaccino a mRNA contro COVID-19,090606,COVID19 - Ospedale San Iacopo,TOS,70-79,2,0,0,2,0,0,0,2,0,2,Toscana,ITI1
2021-01-06,COMIRNATY Vaccino a mRNA contro COVID-19,090607,COVID19 - Ospedale SS.Cosma e Damiano,TOS,20-29,2,3,0,5,0,0,0,5,0,5,Toscana,ITI1
2021-01-06,COMIRNATY Vaccino a mRNA contro COVID-19,090607,COVID19 - Ospedale SS.Cosma e Damiano,TOS,30-39,1,5,0,6,0,0,0,6,0,6,Toscana,ITI1
2021-01-06,COMIRNATY Vaccino a mRNA contro COVID-19,090607,COVID19 - Ospedale SS.Cosma e Damiano,TOS,40-49,5,13,0,18,0,0,0,18,0,18,Toscana,ITI1
2021-01-06,COMIRNATY Vaccino a mRNA contro COVID-19,090607,COVID19 - Ospedale SS.Cosma e Damiano,TOS,50-59,3,12,0,15,0,0,0,15,0,15,Toscana,ITI1
2021-01-06,COMIRNATY Vaccino a mRNA contro COVID-19,090607,COVID19 - Ospedale SS.Cosma e Damiano,TOS,60-69,2,2,0,4,0,0,0,4,0,4,Toscana,ITI1
2021-01-06,COMIRNATY Vaccino a mRNA contro COVID-19,090608,COVID19 - Ospedale Santo Stefano,TOS,20-29,7,14,0,21,0,0,0,21,0,21,Toscana,ITI1
2021-01-06,COMIRNATY Vaccino a mRNA contro COVID-19,090608,COVID19 - Ospedale Santo Stefano,TOS,30-39,14,26,0,40,0,0,0,40,0,40,Toscana,ITI1
2021-01-06,COMIRNATY Vaccino a mRNA contro COVID-19,090608,COVID19 - Ospedale Santo Stefano,TOS,40-49,12,20,0,32,0,0,0,32,0,32,Toscana,ITI1
2021-01-06,COMIRNATY Vaccino a mRNA contro COVID-19,090608,COVID19 - Ospedale Santo Stefano,TOS,50-59,10,24,0,34,0,0,0,34,0,34,Toscana,ITI1
2021-01-06,COMIRNATY Vaccino a mRNA contro COVID-19,090608,COVID19 - Ospedale Santo Stefano,TOS,60-69,7,13,0,20,0,0,0,20,0,20,Toscana,ITI1
2021-01-06,COMIRNATY Vaccino a mRNA contro COVID-19,090608,COVID19 - Ospedale Santo Stefano,TOS,70-79,3,0,0,3,0,0,0,3,0,3,Toscana,ITI1
2021-01-06,COMIRNATY Vaccino a mRNA contro COVID-19,090608,COVID19 - Ospedale Santo Stefano,TOS,80-89,0,1,0,1,0,0,0,1,0,1,Toscana,ITI1
2021-01-06,COMIRNATY Vaccino a mRNA contro COVID-19,090610,Covid 19 - Ospedale F.Lotti di Pontedera,TOS,20-29,2,10,0,12,0,0,0,12,0,12,Toscana,ITI1
2021-01-06,COMIRNATY Vaccino a mRNA contro COVID-19,090610,Covid 19 - Ospedale F.Lotti di Pontedera,TOS,30-39,2,4,0,5,0,1,0,6,0,6,Toscana,ITI1
2021-01-06,COMIRNATY Vaccino a mRNA contro COVID-19,090610,Covid 19 - Ospedale F.Lotti di Pontedera,TOS,40-49,5,12,0,17,0,0,0,17,0,17,Toscana,ITI1
2021-01-06,COMIRNATY Vaccino a mRNA contro COVID-19,090610,Covid 19 - Ospedale F.Lotti di Pontedera,TOS,50-59,3,15,0,18,0,0,0,18,0,18,Toscana,ITI1
2021-01-06,COMIRNATY Vaccino a mRNA contro COVID-19,090610,Covid 19 - Ospedale F.Lotti di Pontedera,TOS,60-69,1,6,0,7,0,0,0,7,0,7,Toscana,ITI1
2021-01-06,COMIRNATY Vaccino a mRNA contro COVID-19,090613,Covid 19 - Ospedali Riuniti di Livorno,TOS,20-29,12,32,0,44,0,0,0,44,0,44,Toscana,ITI1
2021-01-06,COMIRNATY Vaccino a mRNA contro COVID-19,090613,Covid 19 - Ospedali Riuniti di Livorno,TOS,30-39,8,16,0,24,0,0,0,24,0,24,Toscana,ITI1
2021-01-06,COMIRNATY Vaccino a mRNA contro COVID-19,090613,Covid 19 - Ospedali Riuniti di Livorno,TOS,40-49,11,27,0,37,0,1,0,38,0,38,Toscana,ITI1
2021-01-06,COMIRNATY Vaccino a mRNA contro COVID-19,090613,Covid 19 - Ospedali Riuniti di Livorno,TOS,50-59,19,33,0,51,0,1,0,52,0,52,Toscana,ITI1
2021-01-06,COMIRNATY Vaccino a mRNA contro COVID-19,090613,Covid 19 - Ospedali Riuniti di Livorno,TOS,60-69,10,20,0,25,0,5,0,30,0,30,Toscana,ITI1
2021-01-06,COMIRNATY Vaccino a mRNA contro COVID-19,090613,Covid 19 - Ospedali Riuniti di Livorno,TOS,70-79,5,5,0,2,0,8,0,10,0,10,Toscana,ITI1
2021-01-06,COMIRNATY Vaccino a mRNA contro COVID-19,090613,Covid 19 - Ospedali Riuniti di Livorno,TOS,80-89,3,14,0,0,0,17,0,17,0,17,Toscana,ITI1
2021-01-06,COMIRNATY Vaccino a mRNA contro COVID-19,090613,Covid 19 - Ospedali Riuniti di Livorno,TOS,90+,0,16,0,0,0,16,0,16,0,16,Toscana,ITI1
2021-01-06,COMIRNATY Vaccino a mRNA contro COVID-19,090614,Covid 19 - Ospedale Civile di Piombino,TOS,20-29,2,4,0,6,0,0,0,6,0,6,Toscana,ITI1
2021-01-06,COMIRNATY Vaccino a mRNA contro COVID-19,090614,Covid 19 - Ospedale Civile di Piombino,TOS,30-39,2,0,0,2,0,0,0,2,0,2,Toscana,ITI1
2021-01-06,COMIRNATY Vaccino a mRNA contro COVID-19,090614,Covid 19 - Ospedale Civile di Piombino,TOS,40-49,0,6,0,6,0,0,0,6,0,6,Toscana,ITI1
2021-01-06,COMIRNATY Vaccino a mRNA contro COVID-19,090614,Covid 19 - Ospedale Civile di Piombino,TOS,50-59,2,8,0,10,0,0,0,10,0,10,Toscana,ITI1
2021-01-06,COMIRNATY Vaccino a mRNA contro COVID-19,090614,Covid 19 - Ospedale Civile di Piombino,TOS,60-69,3,3,0,6,0,0,0,6,0,6,Toscana,ITI1
2021-01-06,COMIRNATY Vaccino a mRNA contro COVID-19,090621,COVID19 - Ospedale di Arezzo,TOS,20-29,13,29,0,42,0,0,0,42,0,42,Toscana,ITI1
2021-01-06,COMIRNATY Vaccino a mRNA contro COVID-19,090621,COVID19 - Ospedale di Arezzo,TOS,30-39,16,30,0,46,0,0,0,46,0,46,Toscana,ITI1
2021-01-06,COMIRNATY Vaccino a mRNA contro COVID-19,090621,COVID19 - Ospedale di Arezzo,TOS,40-49,13,36,0,49,0,0,0,49,0,49,Toscana,ITI1
2021-01-06,COMIRNATY Vaccino a mRNA contro COVID-19,090621,COVID19 - Ospedale di Arezzo,TOS,50-59,12,32,0,44,0,0,0,44,0,44,Toscana,ITI1
2021-01-06,COMIRNATY Vaccino a mRNA contro COVID-19,090621,COVID19 - Ospedale di Arezzo,TOS,60-69,15,10,0,25,0,0,0,25,0,25,Toscana,ITI1
2021-01-06,COMIRNATY Vaccino a mRNA contro COVID-19,090621,COVID19 - Ospedale di Arezzo,TOS,70-79,5,0,0,5,0,0,0,5,0,5,Toscana,ITI1
2021-01-06,COMIRNATY Vaccino a mRNA contro COVID-19,090626,COVID19 - Ospedale di Grosseto,TOS,20-29,4,11,0,15,0,0,0,15,0,15,Toscana,ITI1
2021-01-06,COMIRNATY Vaccino a mRNA contro COVID-19,090626,COVID19 - Ospedale di Grosseto,TOS,30-39,11,27,0,38,0,0,0,38,0,38,Toscana,ITI1
2021-01-06,COMIRNATY Vaccino a mRNA contro COVID-19,090626,COVID19 - Ospedale di Grosseto,TOS,40-49,9,12,0,21,0,0,0,21,0,21,Toscana,ITI1
2021-01-06,COMIRNATY Vaccino a mRNA contro COVID-19,090626,COVID19 - Ospedale di Grosseto,TOS,50-59,12,33,0,45,0,0,0,45,0,45,Toscana,ITI1
2021-01-06,COMIRNATY Vaccino a mRNA contro COVID-19,090626,COVID19 - Ospedale di Grosseto,TOS,60-69,5,8,0,13,0,0,0,13,0,13,Toscana,ITI1
2021-01-06,COMIRNATY Vaccino a mRNA contro COVID-19,090627,COVID19 - Ospedale Mugello,TOS,20-29,4,9,0,13,0,0,0,13,0,13,Toscana,ITI1
2021-01-06,COMIRNATY Vaccino a mRNA contro COVID-19,090627,COVID19 - Ospedale Mugello,TOS,30-39,2,8,0,10,0,0,0,10,0,10,Toscana,ITI1
2021-01-06,COMIRNATY Vaccino a mRNA contro COVID-19,090627,COVID19 - Ospedale Mugello,TOS,40-49,2,22,0,24,0,0,0,24,0,24,Toscana,ITI1
2021-01-06,COMIRNATY Vaccino a mRNA contro COVID-19,090627,COVID19 - Ospedale Mugello,TOS,50-59,8,21,0,28,1,0,0,29,0,29,Toscana,ITI1
2021-01-06,COMIRNATY Vaccino a mRNA contro COVID-19,090627,COVID19 - Ospedale Mugello,TOS,60-69,4,4,0,7,1,0,0,8,0,8,Toscana,ITI1
2021-01-06,COMIRNATY Vaccino a mRNA contro COVID-19,090629,COVID19 - Ospedale SS. Maria Annunziata,TOS,20-29,12,16,0,27,0,1,0,28,0,28,Toscana,ITI1
2021-01-06,COMIRNATY Vaccino a mRNA contro COVID-19,090629,COVID19 - Ospedale SS. Maria Annunziata,TOS,30-39,9,22,0,31,0,0,0,31,0,31,Toscana,ITI1
2021-01-06,COMIRNATY Vaccino a mRNA contro COVID-19,090629,COVID19 - Ospedale SS. Maria Annunziata,TOS,40-49,11,27,0,38,0,0,0,38,0,38,Toscana,ITI1
2021-01-06,COMIRNATY Vaccino a mRNA contro COVID-19,090629,COVID19 - Ospedale SS. Maria Annunziata,TOS,50-59,11,21,0,32,0,0,0,32,0,32,Toscana,ITI1
2021-01-06,COMIRNATY Vaccino a mRNA contro COVID-19,090629,COVID19 - Ospedale SS. Maria Annunziata,TOS,60-69,4,8,0,11,1,0,0,12,0,12,Toscana,ITI1
2021-01-06,COMIRNATY Vaccino a mRNA contro COVID-19,090629,COVID19 - Ospedale SS. Maria Annunziata,TOS,70-79,2,1,0,3,0,0,0,3,0,3,Toscana,ITI1
2021-01-06,COMIRNATY Vaccino a mRNA contro COVID-19,090632,COVID19 - Ospedale Santa Maria Nuova,TOS,16-19,0,1,0,1,0,0,0,1,0,1,Toscana,ITI1
2021-01-06,COMIRNATY Vaccino a mRNA contro COVID-19,090632,COVID19 - Ospedale Santa Maria Nuova,TOS,20-29,1,10,0,11,0,0,0,11,0,11,Toscana,ITI1
2021-01-06,COMIRNATY Vaccino a mRNA contro COVID-19,090632,COVID19 - Ospedale Santa Maria Nuova,TOS,30-39,15,9,0,24,0,0,0,24,0,24,Toscana,ITI1
2021-01-06,COMIRNATY Vaccino a mRNA contro COVID-19,090632,COVID19 - Ospedale Santa Maria Nuova,TOS,40-49,9,37,0,46,0,0,0,46,0,46,Toscana,ITI1
2021-01-06,COMIRNATY Vaccino a mRNA contro COVID-19,090632,COVID19 - Ospedale Santa Maria Nuova,TOS,50-59,15,26,0,41,0,0,0,41,0,41,Toscana,ITI1
2021-01-06,COMIRNATY Vaccino a mRNA contro COVID-19,090632,COVID19 - Ospedale Santa Maria Nuova,TOS,60-69,10,12,0,22,0,0,0,22,0,22,Toscana,ITI1
2021-01-06,COMIRNATY Vaccino a mRNA contro COVID-19,090632,COVID19 - Ospedale Santa Maria Nuova,TOS,70-79,3,1,0,4,0,0,0,4,0,4,Toscana,ITI1
2021-01-06,COMIRNATY Vaccino a mRNA contro COVID-19,090639,COVID19 - Ospedale di Nottola Montepulciano,TOS,20-29,0,8,0,8,0,0,0,8,0,8,Toscana,ITI1
2021-01-06,COMIRNATY Vaccino a mRNA contro COVID-19,090639,COVID19 - Ospedale di Nottola Montepulciano,TOS,30-39,6,13,0,19,0,0,0,19,0,19,Toscana,ITI1
2021-01-06,COMIRNATY Vaccino a mRNA contro COVID-19,090639,COVID19 - Ospedale di Nottola Montepulciano,TOS,40-49,9,11,0,20,0,0,0,20,0,20,Toscana,ITI1
2021-01-06,COMIRNATY Vaccino a mRNA contro COVID-19,090639,COVID19 - Ospedale di Nottola Montepulciano,TOS,50-59,9,10,0,19,0,0,0,19,0,19,Toscana,ITI1
2021-01-06,COMIRNATY Vaccino a mRNA contro COVID-19,090639,COVID19 - Ospedale di Nottola Montepulciano,TOS,60-69,1,2,0,3,0,0,0,3,0,3,Toscana,ITI1
2021-01-06,COMIRNATY Vaccino a mRNA contro COVID-19,090639,COVID19 - Ospedale di Nottola Montepulciano,TOS,70-79,1,0,0,1,0,0,0,1,0,1,Toscana,ITI1
2021-01-06,COMIRNATY Vaccino a mRNA contro COVID-19,090640,Covid 19 - Ospedale Unico Versilia,TOS,20-29,3,21,0,24,0,0,0,24,0,24,Toscana,ITI1
2021-01-06,COMIRNATY Vaccino a mRNA contro COVID-19,090640,Covid 19 - Ospedale Unico Versilia,TOS,30-39,12,22,0,34,0,0,0,34,0,34,Toscana,ITI1
2021-01-06,COMIRNATY Vaccino a mRNA contro COVID-19,090640,Covid 19 - Ospedale Unico Versilia,TOS,40-49,14,25,0,39,0,0,0,39,0,39,Toscana,ITI1
2021-01-06,COMIRNATY Vaccino a mRNA contro COVID-19,090640,Covid 19 - Ospedale Unico Versilia,TOS,50-59,12,23,0,35,0,0,0,35,0,35,Toscana,ITI1
2021-01-06,COMIRNATY Vaccino a mRNA contro COVID-19,090640,Covid 19 - Ospedale Unico Versilia,TOS,60-69,11,6,0,17,0,0,0,17,0,17,Toscana,ITI1
2021-01-06,COMIRNATY Vaccino a mRNA contro COVID-19,090640,Covid 19 - Ospedale Unico Versilia,TOS,70-79,1,0,0,1,0,0,0,1,0,1,Toscana,ITI1
2021-01-06,COMIRNATY Vaccino a mRNA contro COVID-19,090641,COVID19 - Ospedale La Gruccia Montevarchi,TOS,16-19,0,1,0,1,0,0,0,1,0,1,Toscana,ITI1
2021-01-06,COMIRNATY Vaccino a mRNA contro COVID-19,090641,COVID19 - Ospedale La Gruccia Montevarchi,TOS,20-29,7,13,0,20,0,0,0,20,0,20,Toscana,ITI1
2021-01-06,COMIRNATY Vaccino a mRNA contro COVID-19,090641,COVID19 - Ospedale La Gruccia Montevarchi,TOS,30-39,1,11,0,12,0,0,0,12,0,12,Toscana,ITI1
2021-01-06,COMIRNATY Vaccino a mRNA contro COVID-19,090641,COVID19 - Ospedale La Gruccia Montevarchi,TOS,40-49,7,19,0,26,0,0,0,26,0,26,Toscana,ITI1
2021-01-06,COMIRNATY Vaccino a mRNA contro COVID-19,090641,COVID19 - Ospedale La Gruccia Montevarchi,TOS,50-59,6,22,0,28,0,0,0,28,0,28,Toscana,ITI1
2021-01-06,COMIRNATY Vaccino a mRNA contro COVID-19,090641,COVID19 - Ospedale La Gruccia Montevarchi,TOS,60-69,5,2,0,6,0,1,0,7,0,7,Toscana,ITI1
2021-01-06,COMIRNATY Vaccino a mRNA contro COVID-19,090641,COVID19 - Ospedale La Gruccia Montevarchi,TOS,70-79,1,0,0,1,0,0,0,1,0,1,Toscana,ITI1
2021-01-06,COMIRNATY Vaccino a mRNA contro COVID-19,090641,COVID19 - Ospedale La Gruccia Montevarchi,TOS,80-89,1,0,0,1,0,0,0,1,0,1,Toscana,ITI1
2021-01-06,COMIRNATY Vaccino a mRNA contro COVID-19,090901,COVID19 - AOU Pisana,TOS,16-19,2,8,1,10,0,0,0,10,0,10,Toscana,ITI1
2021-01-06,COMIRNATY Vaccino a mRNA contro COVID-19,090901,COVID19 - AOU Pisana,TOS,20-29,92,153,1,242,1,1,1,245,0,245,Toscana,ITI1
2021-01-06,COMIRNATY Vaccino a mRNA contro COVID-19,090901,COVID19 - AOU Pisana,TOS,30-39,37,61,1,97,1,0,0,98,0,98,Toscana,ITI1
2021-01-06,COMIRNATY Vaccino a mRNA contro COVID-19,090901,COVID19 - AOU Pisana,TOS,40-49,16,62,1,78,0,0,0,78,0,78,Toscana,ITI1
2021-01-06,COMIRNATY Vaccino a mRNA contro COVID-19,090901,COVID19 - AOU Pisana,TOS,50-59,27,63,1,89,1,0,0,90,0,90,Toscana,ITI1
2021-01-06,COMIRNATY Vaccino a mRNA contro COVID-19,090901,COVID19 - AOU Pisana,TOS,60-69,33,18,1,51,0,0,0,51,0,51,Toscana,ITI1
2021-01-06,COMIRNATY Vaccino a mRNA contro COVID-19,090901,COVID19 - AOU Pisana,TOS,70-79,4,0,1,4,0,0,0,4,0,4,Toscana,ITI1
2021-01-06,COMIRNATY Vaccino a mRNA contro COVID-19,090902,COVID19 - AOU Senese,TOS,16-19,2,0,0,2,0,0,0,2,0,2,Toscana,ITI1
2021-01-06,COMIRNATY Vaccino a mRNA contro COVID-19,090902,COVID19 - AOU Senese,TOS,20-29,12,19,0,31,0,0,0,31,0,31,Toscana,ITI1
2021-01-06,COMIRNATY Vaccino a mRNA contro COVID-19,090902,COVID19 - AOU Senese,TOS,30-39,13,26,0,39,0,0,0,39,0,39,Toscana,ITI1
2021-01-06,COMIRNATY Vaccino a mRNA contro COVID-19,090902,COVID19 - AOU Senese,TOS,40-49,10,10,0,20,0,0,0,20,0,20,Toscana,ITI1
2021-01-06,COMIRNATY Vaccino a mRNA contro COVID-19,090902,COVID19 - AOU Senese,TOS,50-59,5,14,0,19,0,0,0,19,0,19,Toscana,ITI1
2021-01-06,COMIRNATY Vaccino a mRNA contro COVID-19,090902,COVID19 - AOU Senese,TOS,60-69,2,6,0,8,0,0,0,8,0,8,Toscana,ITI1
2021-01-06,COMIRNATY Vaccino a mRNA contro COVID-19,090902,COVID19 - AOU Senese,TOS,70-79,1,0,0,1,0,0,0,1,0,1,Toscana,ITI1
2021-01-06,COMIRNATY Vaccino a mRNA contro COVID-19,090903,COVID19 - AOU Careggi - CTO,TOS,16-19,0,2,0,2,0,0,0,2,0,2,Toscana,ITI1
2021-01-06,COMIRNATY Vaccino a mRNA contro COVID-19,090903,COVID19 - AOU Careggi - CTO,TOS,20-29,111,206,0,316,0,1,0,317,0,317,Toscana,ITI1
2021-01-06,COMIRNATY Vaccino a mRNA contro COVID-19,090903,COVID19 - AOU Careggi - CTO,TOS,30-39,37,66,0,103,0,0,0,103,0,103,Toscana,ITI1
2021-01-06,COMIRNATY Vaccino a mRNA contro COVID-19,090903,COVID19 - AOU Careggi - CTO,TOS,40-49,32,65,0,97,0,0,0,97,0,97,Toscana,ITI1
2021-01-06,COMIRNATY Vaccino a mRNA contro COVID-19,090903,COVID19 - AOU Careggi - CTO,TOS,50-59,38,107,0,145,0,0,0,145,0,145,Toscana,ITI1
2021-01-06,COMIRNATY Vaccino a mRNA contro COVID-19,090903,COVID19 - AOU Careggi - CTO,TOS,60-69,26,21,0,47,0,0,0,47,0,47,Toscana,ITI1
2021-01-06,COMIRNATY Vaccino a mRNA contro COVID-19,090903,COVID19 - AOU Careggi - CTO,TOS,70-79,2,0,0,2,0,0,0,2,0,2,Toscana,ITI1
2021-01-06,COMIRNATY Vaccino a mRNA contro COVID-19,090904,COVID19 - Ospedale AOU Meyer,TOS,20-29,5,8,0,13,0,0,0,13,0,13,Toscana,ITI1
2021-01-06,COMIRNATY Vaccino a mRNA contro COVID-19,090904,COVID19 - Ospedale AOU Meyer,TOS,30-39,8,29,0,37,0,0,0,37,0,37,Toscana,ITI1
2021-01-06,COMIRNATY Vaccino a mRNA contro COVID-19,090904,COVID19 - Ospedale AOU Meyer,TOS,40-49,6,17,0,23,0,0,0,23,0,23,Toscana,ITI1
2021-01-06,COMIRNATY Vaccino a mRNA contro COVID-19,090904,COVID19 - Ospedale AOU Meyer,TOS,50-59,6,18,0,24,0,0,0,24,0,24,Toscana,ITI1
2021-01-06,COMIRNATY Vaccino a mRNA contro COVID-19,090904,COVID19 - Ospedale AOU Meyer,TOS,60-69,4,6,0,10,0,0,0,10,0,10,Toscana,ITI1
2021-01-06,COMIRNATY Vaccino a mRNA contro COVID-19,090904,COVID19 - Ospedale AOU Meyer,TOS,70-79,1,0,0,1,0,0,0,1,0,1,Toscana,ITI1
2021-01-06,COMIRNATY Vaccino a mRNA contro COVID-19,11012E,COVID19 - Ospedale San Giuseppe,TOS,20-29,7,12,0,19,0,0,0,19,0,19,Toscana,ITI1
2021-01-06,COMIRNATY Vaccino a mRNA contro COVID-19,11012E,COVID19 - Ospedale San Giuseppe,TOS,30-39,14,22,0,36,0,0,0,36,0,36,Toscana,ITI1
2021-01-06,COMIRNATY Vaccino a mRNA contro COVID-19,11012E,COVID19 - Ospedale San Giuseppe,TOS,40-49,7,35,0,41,0,1,0,42,0,42,Toscana,ITI1
2021-01-06,COMIRNATY Vaccino a mRNA contro COVID-19,11012E,COVID19 - Ospedale San Giuseppe,TOS,50-59,10,36,0,44,0,2,0,46,0,46,Toscana,ITI1
2021-01-06,COMIRNATY Vaccino a mRNA contro COVID-19,11012E,COVID19 - Ospedale San Giuseppe,TOS,60-69,8,10,0,14,0,4,0,18,0,18,Toscana,ITI1
2021-01-06,COMIRNATY Vaccino a mRNA contro COVID-19,11012E,COVID19 - Ospedale San Giuseppe,TOS,70-79,3,4,0,1,0,6,0,7,0,7,Toscana,ITI1
2021-01-06,COMIRNATY Vaccino a mRNA contro COVID-19,11012E,COVID19 - Ospedale San Giuseppe,TOS,80-89,5,9,0,0,0,14,0,14,0,14,Toscana,ITI1
2021-01-06,COMIRNATY Vaccino a mRNA contro COVID-19,11012E,COVID19 - Ospedale San Giuseppe,TOS,90+,1,9,0,0,0,10,0,10,0,10,Toscana,ITI1
2021-01-06,COMIRNATY Vaccino a mRNA contro COVID-19,12064I,R.S.A. G. FALUSI,TOS,20-29,2,0,0,2,0,0,0,2,0,2,Toscana,ITI1
2021-01-06,COMIRNATY Vaccino a mRNA contro COVID-19,12064I,R.S.A. G. FALUSI,TOS,40-49,1,3,0,4,0,0,0,4,0,4,Toscana,ITI1
2021-01-06,COMIRNATY Vaccino a mRNA contro COVID-19,12064I,R.S.A. G. FALUSI,TOS,50-59,0,2,0,2,0,0,0,2,0,2,Toscana,ITI1
2021-01-06,COMIRNATY Vaccino a mRNA contro COVID-19,12064I,R.S.A. G. FALUSI,TOS,60-69,2,1,0,0,0,3,0,3,0,3,Toscana,ITI1
2021-01-06,COMIRNATY Vaccino a mRNA contro COVID-19,12064I,R.S.A. G. FALUSI,TOS,70-79,5,16,0,0,0,21,0,21,0,21,Toscana,ITI1
2021-01-06,COMIRNATY Vaccino a mRNA contro COVID-19,12064I,R.S.A. G. FALUSI,TOS,80-89,5,15,0,0,0,20,0,20,0,20,Toscana,ITI1
2021-01-06,COMIRNATY Vaccino a mRNA contro COVID-19,12064I,R.S.A. G. FALUSI,TOS,90+,0,13,0,1,0,12,0,13,0,13,Toscana,ITI1
2021-01-06,COMIRNATY Vaccino a mRNA contro COVID-19,12084I,"RSA \""CASA   MAIANI\""",TOS,30-39,0,1,0,1,0,0,0,1,0,1,Toscana,ITI1
2021-01-06,COMIRNATY Vaccino a mRNA contro COVID-19,12084I,"RSA \""CASA   MAIANI\""",TOS,40-49,0,1,0,1,0,0,0,1,0,1,Toscana,ITI1
2021-01-06,COMIRNATY Vaccino a mRNA contro COVID-19,12084I,"RSA \""CASA   MAIANI\""",TOS,50-59,1,3,0,3,0,1,0,4,0,4,Toscana,ITI1
2021-01-06,COMIRNATY Vaccino a mRNA contro COVID-19,12084I,"RSA \""CASA   MAIANI\""",TOS,60-69,1,1,0,1,0,1,0,2,0,2,Toscana,ITI1
2021-01-06,COMIRNATY Vaccino a mRNA contro COVID-19,12084I,"RSA \""CASA   MAIANI\""",TOS,70-79,3,2,0,0,0,5,0,5,0,5,Toscana,ITI1
2021-01-06,COMIRNATY Vaccino a mRNA contro COVID-19,12084I,"RSA \""CASA   MAIANI\""",TOS,80-89,1,2,0,0,0,3,0,3,0,3,Toscana,ITI1
2021-01-06,COMIRNATY Vaccino a mRNA contro COVID-19,12084I,"RSA \""CASA   MAIANI\""",TOS,90+,1,5,0,0,0,6,0,6,0,6,Toscana,ITI1
2021-01-06,COMIRNATY Vaccino a mRNA contro COVID-19,12184I,Covid19 - RSA FIVIZZANO,TOS,30-39,1,0,0,1,0,0,0,1,0,1,Toscana,ITI1
2021-01-06,COMIRNATY Vaccino a mRNA contro COVID-19,12184I,Covid19 - RSA FIVIZZANO,TOS,40-49,0,1,0,1,0,0,0,1,0,1,Toscana,ITI1
2021-01-06,COMIRNATY Vaccino a mRNA contro COVID-19,12184I,Covid19 - RSA FIVIZZANO,TOS,50-59,1,1,0,1,0,1,0,2,0,2,Toscana,ITI1
2021-01-06,COMIRNATY Vaccino a mRNA contro COVID-19,12184I,Covid19 - RSA FIVIZZANO,TOS,60-69,1,2,0,0,0,3,0,3,0,3,Toscana,ITI1
2021-01-06,COMIRNATY Vaccino a mRNA contro COVID-19,12184I,Covid19 - RSA FIVIZZANO,TOS,70-79,3,0,0,0,0,3,0,3,0,3,Toscana,ITI1
2021-01-06,COMIRNATY Vaccino a mRNA contro COVID-19,12184I,Covid19 - RSA FIVIZZANO,TOS,80-89,0,1,0,0,0,1,0,1,0,1,Toscana,ITI1
2021-01-06,COMIRNATY Vaccino a mRNA contro COVID-19,12184I,Covid19 - RSA FIVIZZANO,TOS,90+,0,1,0,0,0,1,0,1,0,1,Toscana,ITI1
2021-01-06,COMIRNATY Vaccino a mRNA contro COVID-19,122I4I,RSA MADONNA DEL SOCCORSO,TOS,40-49,0,1,0,1,0,0,0,1,0,1,Toscana,ITI1
2021-01-06,COMIRNATY Vaccino a mRNA contro COVID-19,122I4I,RSA MADONNA DEL SOCCORSO,TOS,50-59,1,0,0,0,0,1,0,1,0,1,Toscana,ITI1
2021-01-06,COMIRNATY Vaccino a mRNA contro COVID-19,122I4I,RSA MADONNA DEL SOCCORSO,TOS,60-69,0,1,0,1,0,0,0,1,0,1,Toscana,ITI1
2021-01-06,COMIRNATY Vaccino a mRNA contro COVID-19,122I4I,RSA MADONNA DEL SOCCORSO,TOS,80-89,6,4,0,0,0,10,0,10,0,10,Toscana,ITI1
2021-01-06,COMIRNATY Vaccino a mRNA contro COVID-19,122I4I,RSA MADONNA DEL SOCCORSO,TOS,90+,2,3,0,0,0,5,0,5,0,5,Toscana,ITI1
2021-01-06,COMIRNATY Vaccino a mRNA contro COVID-19,13021A,COVID19 - Ospedale S.Giovanni di Dio,TOS,20-29,10,29,0,38,0,1,0,39,0,39,Toscana,ITI1
2021-01-06,COMIRNATY Vaccino a mRNA contro COVID-19,13021A,COVID19 - Ospedale S.Giovanni di Dio,TOS,30-39,21,28,0,46,0,3,0,49,0,49,Toscana,ITI1
2021-01-06,COMIRNATY Vaccino a mRNA contro COVID-19,13021A,COVID19 - Ospedale S.Giovanni di Dio,TOS,40-49,23,38,0,50,0,11,0,61,0,61,Toscana,ITI1
2021-01-06,COMIRNATY Vaccino a mRNA contro COVID-19,13021A,COVID19 - Ospedale S.Giovanni di Dio,TOS,50-59,18,38,0,50,0,6,0,56,0,56,Toscana,ITI1
2021-01-06,COMIRNATY Vaccino a mRNA contro COVID-19,13021A,COVID19 - Ospedale S.Giovanni di Dio,TOS,60-69,14,14,0,26,0,2,0,28,0,28,Toscana,ITI1
2021-01-06,COMIRNATY Vaccino a mRNA contro COVID-19,13021A,COVID19 - Ospedale S.Giovanni di Dio,TOS,70-79,2,1,0,2,0,1,0,3,0,3,Toscana,ITI1
2021-01-06,COMIRNATY Vaccino a mRNA contro COVID-19,13344I,Covid19 - RSA LA FONTANA D'ORO,TOS,30-39,1,1,0,2,0,0,0,2,0,2,Toscana,ITI1
2021-01-06,COMIRNATY Vaccino a mRNA contro COVID-19,13344I,Covid19 - RSA LA FONTANA D'ORO,TOS,40-49,0,1,0,0,1,0,0,1,0,1,Toscana,ITI1
2021-01-06,COMIRNATY Vaccino a mRNA contro COVID-19,13344I,Covid19 - RSA LA FONTANA D'ORO,TOS,70-79,1,2,0,0,0,3,0,3,0,3,Toscana,ITI1
2021-01-06,COMIRNATY Vaccino a mRNA contro COVID-19,13344I,Covid19 - RSA LA FONTANA D'ORO,TOS,80-89,3,7,0,0,0,10,0,10,0,10,Toscana,ITI1
2021-01-06,COMIRNATY Vaccino a mRNA contro COVID-19,13344I,Covid19 - RSA LA FONTANA D'ORO,TOS,90+,2,0,0,0,0,2,0,2,0,2,Toscana,ITI1
2021-01-06,COMIRNATY Vaccino a mRNA contro COVID-19,16121A,Covid 19 - Ospedale Civile di Cecina,TOS,20-29,0,1,0,1,0,0,0,1,0,1,Toscana,ITI1
2021-01-06,COMIRNATY Vaccino a mRNA contro COVID-19,16121A,Covid 19 - Ospedale Civile di Cecina,TOS,30-39,3,4,0,7,0,0,0,7,0,7,Toscana,ITI1
2021-01-06,COMIRNATY Vaccino a mRNA contro COVID-19,16121A,Covid 19 - Ospedale Civile di Cecina,TOS,40-49,1,7,0,7,0,1,0,8,0,8,Toscana,ITI1
2021-01-06,COMIRNATY Vaccino a mRNA contro COVID-19,16121A,Covid 19 - Ospedale Civile di Cecina,TOS,50-59,0,10,0,10,0,0,0,10,0,10,Toscana,ITI1
2021-01-06,COMIRNATY Vaccino a mRNA contro COVID-19,16121A,Covid 19 - Ospedale Civile di Cecina,TOS,60-69,2,1,0,3,0,0,0,3,0,3,Toscana,ITI1
2021-01-06,COMIRNATY Vaccino a mRNA contro COVID-19,16121A,Covid 19 - Ospedale Civile di Cecina,TOS,70-79,1,0,0,1,0,0,0,1,0,1,Toscana,ITI1
2021-01-06,COMIRNATY Vaccino a mRNA contro COVID-19,224H4I,RSA CASCIANA TERME,TOS,20-29,1,0,0,1,0,0,0,1,0,1,Toscana,ITI1
2021-01-06,COMIRNATY Vaccino a mRNA contro COVID-19,224H4I,RSA CASCIANA TERME,TOS,40-49,0,3,0,3,0,0,0,3,0,3,Toscana,ITI1
2021-01-06,COMIRNATY Vaccino a mRNA contro COVID-19,224H4I,RSA CASCIANA TERME,TOS,50-59,0,1,0,1,0,0,0,1,0,1,Toscana,ITI1
2021-01-06,COMIRNATY Vaccino a mRNA contro COVID-19,224H4I,RSA CASCIANA TERME,TOS,70-79,1,2,0,0,0,3,0,3,0,3,Toscana,ITI1
2021-01-06,COMIRNATY Vaccino a mRNA contro COVID-19,224H4I,RSA CASCIANA TERME,TOS,80-89,1,1,0,0,0,2,0,2,0,2,Toscana,ITI1
2021-01-06,COMIRNATY Vaccino a mRNA contro COVID-19,224H4I,RSA CASCIANA TERME,TOS,90+,0,2,0,0,0,2,0,2,0,2,Toscana,ITI1
2021-01-06,COMIRNATY Vaccino a mRNA contro COVID-19,41254I,RSA VILLA PIZZETTI,TOS,20-29,0,1,0,1,0,0,0,1,0,1,Toscana,ITI1
2021-01-06,COMIRNATY Vaccino a mRNA contro COVID-19,41254I,RSA VILLA PIZZETTI,TOS,30-39,1,0,0,1,0,0,0,1,0,1,Toscana,ITI1
2021-01-06,COMIRNATY Vaccino a mRNA contro COVID-19,41254I,RSA VILLA PIZZETTI,TOS,40-49,0,2,0,2,0,0,0,2,0,2,Toscana,ITI1
2021-01-06,COMIRNATY Vaccino a mRNA contro COVID-19,41254I,RSA VILLA PIZZETTI,TOS,50-59,0,1,0,1,0,0,0,1,0,1,Toscana,ITI1
2021-01-06,COMIRNATY Vaccino a mRNA contro COVID-19,41254I,RSA VILLA PIZZETTI,TOS,60-69,1,2,0,1,0,2,0,3,0,3,Toscana,ITI1
2021-01-06,COMIRNATY Vaccino a mRNA contro COVID-19,41254I,RSA VILLA PIZZETTI,TOS,70-79,1,4,0,0,0,5,0,5,0,5,Toscana,ITI1
2021-01-06,COMIRNATY Vaccino a mRNA contro COVID-19,41254I,RSA VILLA PIZZETTI,TOS,80-89,2,13,0,0,0,15,0,15,0,15,Toscana,ITI1
2021-01-06,COMIRNATY Vaccino a mRNA contro COVID-19,41254I,RSA VILLA PIZZETTI,TOS,90+,0,8,0,0,0,8,0,8,0,8,Toscana,ITI1
2021-01-06,COMIRNATY Vaccino a mRNA contro COVID-19,46724I,RSA MONTALCINO,TOS,40-49,0,1,0,1,0,0,0,1,0,1,Toscana,ITI1
2021-01-06,COMIRNATY Vaccino a mRNA contro COVID-19,46724I,RSA MONTALCINO,TOS,50-59,0,3,0,1,1,1,0,3,0,3,Toscana,ITI1
2021-01-06,COMIRNATY Vaccino a mRNA contro COVID-19,46724I,RSA MONTALCINO,TOS,60-69,1,1,0,1,0,1,0,2,0,2,Toscana,ITI1
2021-01-06,COMIRNATY Vaccino a mRNA contro COVID-19,46724I,RSA MONTALCINO,TOS,70-79,2,5,0,0,0,7,0,7,0,7,Toscana,ITI1
2021-01-06,COMIRNATY Vaccino a mRNA contro COVID-19,46724I,RSA MONTALCINO,TOS,80-89,4,16,0,0,0,20,0,20,0,20,Toscana,ITI1
2021-01-06,COMIRNATY Vaccino a mRNA contro COVID-19,46724I,RSA MONTALCINO,TOS,90+,2,13,0,0,0,15,0,15,0,15,Toscana,ITI1
2021-01-06,COMIRNATY Vaccino a mRNA contro COVID-19,66704I,CASA DI RIPOSO ANNA LAPINI,TOS,50-59,0,1,0,1,0,0,0,1,0,1,Toscana,ITI1
2021-01-06,COMIRNATY Vaccino a mRNA contro COVID-19,66704I,CASA DI RIPOSO ANNA LAPINI,TOS,60-69,0,3,0,1,0,2,0,3,0,3,Toscana,ITI1
2021-01-06,COMIRNATY Vaccino a mRNA contro COVID-19,66704I,CASA DI RIPOSO ANNA LAPINI,TOS,70-79,0,4,0,0,0,4,0,4,0,4,Toscana,ITI1
2021-01-06,COMIRNATY Vaccino a mRNA contro COVID-19,66704I,CASA DI RIPOSO ANNA LAPINI,TOS,80-89,0,5,0,0,0,5,0,5,0,5,Toscana,ITI1
2021-01-06,COMIRNATY Vaccino a mRNA contro COVID-19,66704I,CASA DI RIPOSO ANNA LAPINI,TOS,90+,0,17,0,0,0,17,0,17,0,17,Toscana,ITI1
2021-01-06,COMIRNATY Vaccino a mRNA contro COVID-19,66714I,CASA DI RIPOSO GUIDI RAGGIO,TOS,30-39,0,1,0,1,0,0,0,1,0,1,Toscana,ITI1
2021-01-06,COMIRNATY Vaccino a mRNA contro COVID-19,66714I,CASA DI RIPOSO GUIDI RAGGIO,TOS,40-49,0,1,0,1,0,0,0,1,0,1,Toscana,ITI1
2021-01-06,COMIRNATY Vaccino a mRNA contro COVID-19,66714I,CASA DI RIPOSO GUIDI RAGGIO,TOS,70-79,0,2,0,0,0,2,0,2,0,2,Toscana,ITI1
2021-01-06,COMIRNATY Vaccino a mRNA contro COVID-19,66714I,CASA DI RIPOSO GUIDI RAGGIO,TOS,80-89,5,8,0,0,0,13,0,13,0,13,Toscana,ITI1
2021-01-06,COMIRNATY Vaccino a mRNA contro COVID-19,66714I,CASA DI RIPOSO GUIDI RAGGIO,TOS,90+,1,18,0,0,0,19,0,19,0,19,Toscana,ITI1
2021-01-06,COMIRNATY Vaccino a mRNA contro COVID-19,80234I,OP.PIA CAS. RIP. L. E G. VANNI,TOS,20-29,3,1,0,4,0,0,0,4,0,4,Toscana,ITI1
2021-01-06,COMIRNATY Vaccino a mRNA contro COVID-19,80234I,OP.PIA CAS. RIP. L. E G. VANNI,TOS,30-39,1,1,0,2,0,0,0,2,0,2,Toscana,ITI1
2021-01-06,COMIRNATY Vaccino a mRNA contro COVID-19,80234I,OP.PIA CAS. RIP. L. E G. VANNI,TOS,40-49,0,5,0,5,0,0,0,5,0,5,Toscana,ITI1
2021-01-06,COMIRNATY Vaccino a mRNA contro COVID-19,80234I,OP.PIA CAS. RIP. L. E G. VANNI,TOS,50-59,1,10,0,11,0,0,0,11,0,11,Toscana,ITI1
2021-01-06,COMIRNATY Vaccino a mRNA contro COVID-19,80234I,OP.PIA CAS. RIP. L. E G. VANNI,TOS,60-69,2,1,0,1,0,2,0,3,0,3,Toscana,ITI1
2021-01-06,COMIRNATY Vaccino a mRNA contro COVID-19,80234I,OP.PIA CAS. RIP. L. E G. VANNI,TOS,70-79,2,0,0,0,0,2,0,2,0,2,Toscana,ITI1
2021-01-06,COMIRNATY Vaccino a mRNA contro COVID-19,80234I,OP.PIA CAS. RIP. L. E G. VANNI,TOS,80-89,6,6,0,0,0,12,0,12,0,12,Toscana,ITI1
2021-01-06,COMIRNATY Vaccino a mRNA contro COVID-19,80234I,OP.PIA CAS. RIP. L. E G. VANNI,TOS,90+,1,14,0,0,0,15,0,15,0,15,Toscana,ITI1
2021-01-06,COMIRNATY Vaccino a mRNA contro COVID-19,90124I,ISTITUTO GIOTTO LA VILLA SPA,TOS,60-69,2,0,0,0,0,2,0,2,0,2,Toscana,ITI1
2021-01-06,COMIRNATY Vaccino a mRNA contro COVID-19,90124I,ISTITUTO GIOTTO LA VILLA SPA,TOS,70-79,1,8,0,0,0,9,0,9,0,9,Toscana,ITI1
2021-01-06,COMIRNATY Vaccino a mRNA contro COVID-19,90124I,ISTITUTO GIOTTO LA VILLA SPA,TOS,80-89,4,12,0,0,0,16,0,16,0,16,Toscana,ITI1
2021-01-06,COMIRNATY Vaccino a mRNA contro COVID-19,90124I,ISTITUTO GIOTTO LA VILLA SPA,TOS,90+,1,7,0,0,0,8,0,8,0,8,Toscana,ITI1
2021-01-06,COMIRNATY Vaccino a mRNA contro COVID-19,R0134I,RSA CASA DI MARTA RESIDENZIALE,TOS,20-29,2,0,0,2,0,0,0,2,0,2,Toscana,ITI1
2021-01-06,COMIRNATY Vaccino a mRNA contro COVID-19,R0134I,RSA CASA DI MARTA RESIDENZIALE,TOS,30-39,1,1,0,2,0,0,0,2,0,2,Toscana,ITI1
2021-01-06,COMIRNATY Vaccino a mRNA contro COVID-19,R0134I,RSA CASA DI MARTA RESIDENZIALE,TOS,40-49,1,3,0,4,0,0,0,4,0,4,Toscana,ITI1
2021-01-06,COMIRNATY Vaccino a mRNA contro COVID-19,R0134I,RSA CASA DI MARTA RESIDENZIALE,TOS,50-59,1,4,0,4,0,1,0,5,0,5,Toscana,ITI1
2021-01-06,COMIRNATY Vaccino a mRNA contro COVID-19,R0134I,RSA CASA DI MARTA RESIDENZIALE,TOS,60-69,1,1,0,1,0,1,0,2,0,2,Toscana,ITI1
2021-01-06,COMIRNATY Vaccino a mRNA contro COVID-19,R0134I,RSA CASA DI MARTA RESIDENZIALE,TOS,70-79,4,2,0,0,0,6,0,6,0,6,Toscana,ITI1
2021-01-06,COMIRNATY Vaccino a mRNA contro COVID-19,R0134I,RSA CASA DI MARTA RESIDENZIALE,TOS,80-89,1,5,0,0,0,6,0,6,0,6,Toscana,ITI1
2021-01-06,COMIRNATY Vaccino a mRNA contro COVID-19,R0134I,RSA CASA DI MARTA RESIDENZIALE,TOS,90+,2,3,0,0,0,5,0,5,0,5,Toscana,ITI1
2021-01-06,COMIRNATY Vaccino a mRNA contro COVID-19,S2024L,RDS il mulino,TOS,20-29,1,0,0,0,0,1,0,1,0,1,Toscana,ITI1
2021-01-06,COMIRNATY Vaccino a mRNA contro COVID-19,S2024L,RDS il mulino,TOS,30-39,1,2,0,0,0,3,0,3,0,3,Toscana,ITI1
2021-01-06,COMIRNATY Vaccino a mRNA contro COVID-19,S2024L,RDS il mulino,TOS,40-49,2,3,0,0,0,5,0,5,0,5,Toscana,ITI1
2021-01-06,COMIRNATY Vaccino a mRNA contro COVID-19,S2024L,RDS il mulino,TOS,50-59,3,4,0,0,0,7,0,7,0,7,Toscana,ITI1
2021-01-06,COMIRNATY Vaccino a mRNA contro COVID-19,S2024L,RDS il mulino,TOS,60-69,1,1,0,0,0,2,0,2,0,2,Toscana,ITI1
2021-01-07,COMIRNATY Vaccino a mRNA contro COVID-19,00134I,FONDAZIONE TURATI GAVINANA,TOS,20-29,1,1,0,1,0,1,0,2,0,2,Toscana,ITI1
2021-01-07,COMIRNATY Vaccino a mRNA contro COVID-19,00134I,FONDAZIONE TURATI GAVINANA,TOS,30-39,2,5,0,5,0,2,0,7,0,7,Toscana,ITI1
2021-01-07,COMIRNATY Vaccino a mRNA contro COVID-19,00134I,FONDAZIONE TURATI GAVINANA,TOS,40-49,8,8,0,3,0,13,0,16,0,16,Toscana,ITI1
2021-01-07,COMIRNATY Vaccino a mRNA contro COVID-19,00134I,FONDAZIONE TURATI GAVINANA,TOS,50-59,12,12,0,1,0,23,0,24,0,24,Toscana,ITI1
2021-01-07,COMIRNATY Vaccino a mRNA contro COVID-19,00134I,FONDAZIONE TURATI GAVINANA,TOS,60-69,2,4,0,1,0,5,0,6,0,6,Toscana,ITI1
2021-01-07,COMIRNATY Vaccino a mRNA contro COVID-19,00134I,FONDAZIONE TURATI GAVINANA,TOS,70-79,1,2,0,0,0,3,0,3,0,3,Toscana,ITI1
2021-01-07,COMIRNATY Vaccino a mRNA contro COVID-19,00134I,FONDAZIONE TURATI GAVINANA,TOS,80-89,0,2,0,0,0,2,0,2,0,2,Toscana,ITI1
2021-01-07,COMIRNATY Vaccino a mRNA contro COVID-19,090601,Covid 19 - Ospedale S.Antonio Abate di Fivizzano,TOS,20-29,0,2,0,2,0,0,0,2,0,2,Toscana,ITI1
2021-01-07,COMIRNATY Vaccino a mRNA contro COVID-19,090601,Covid 19 - Ospedale S.Antonio Abate di Fivizzano,TOS,30-39,0,3,0,3,0,0,0,3,0,3,Toscana,ITI1
2021-01-07,COMIRNATY Vaccino a mRNA contro COVID-19,090601,Covid 19 - Ospedale S.Antonio Abate di Fivizzano,TOS,40-49,1,5,0,6,0,0,0,6,0,6,Toscana,ITI1
2021-01-07,COMIRNATY Vaccino a mRNA contro COVID-19,090601,Covid 19 - Ospedale S.Antonio Abate di Fivizzano,TOS,50-59,4,11,0,15,0,0,0,15,0,15,Toscana,ITI1
2021-01-07,COMIRNATY Vaccino a mRNA contro COVID-19,090601,Covid 19 - Ospedale S.Antonio Abate di Fivizzano,TOS,60-69,0,4,0,4,0,0,0,4,0,4,Toscana,ITI1
2021-01-07,COMIRNATY Vaccino a mRNA contro COVID-19,090602,Covid 19 - Nuovo Ospedale Apuane,TOS,20-29,4,13,0,17,0,0,0,17,0,17,Toscana,ITI1
2021-01-07,COMIRNATY Vaccino a mRNA contro COVID-19,090602,Covid 19 - Nuovo Ospedale Apuane,TOS,30-39,9,21,0,30,0,0,0,30,0,30,Toscana,ITI1
2021-01-07,COMIRNATY Vaccino a mRNA contro COVID-19,090602,Covid 19 - Nuovo Ospedale Apuane,TOS,40-49,8,40,0,47,1,0,0,48,0,48,Toscana,ITI1
2021-01-07,COMIRNATY Vaccino a mRNA contro COVID-19,090602,Covid 19 - Nuovo Ospedale Apuane,TOS,50-59,15,50,0,65,0,0,0,65,0,65,Toscana,ITI1
2021-01-07,COMIRNATY Vaccino a mRNA contro COVID-19,090602,Covid 19 - Nuovo Ospedale Apuane,TOS,60-69,12,26,0,38,0,0,0,38,0,38,Toscana,ITI1
2021-01-07,COMIRNATY Vaccino a mRNA contro COVID-19,090604,Covid 19 - Ospedale San Luca di  Lucca,TOS,20-29,6,21,0,27,0,0,0,27,0,27,Toscana,ITI1
2021-01-07,COMIRNATY Vaccino a mRNA contro COVID-19,090604,Covid 19 - Ospedale San Luca di  Lucca,TOS,30-39,10,15,0,25,0,0,0,25,0,25,Toscana,ITI1
2021-01-07,COMIRNATY Vaccino a mRNA contro COVID-19,090604,Covid 19 - Ospedale San Luca di  Lucca,TOS,40-49,8,41,0,49,0,0,0,49,0,49,Toscana,ITI1
2021-01-07,COMIRNATY Vaccino a mRNA contro COVID-19,090604,Covid 19 - Ospedale San Luca di  Lucca,TOS,50-59,17,57,0,74,0,0,0,74,0,74,Toscana,ITI1
2021-01-07,COMIRNATY Vaccino a mRNA contro COVID-19,090604,Covid 19 - Ospedale San Luca di  Lucca,TOS,60-69,7,15,0,22,0,0,0,22,0,22,Toscana,ITI1
2021-01-07,COMIRNATY Vaccino a mRNA contro COVID-19,090604,Covid 19 - Ospedale San Luca di  Lucca,TOS,70-79,1,0,0,1,0,0,0,1,0,1,Toscana,ITI1
2021-01-07,COMIRNATY Vaccino a mRNA contro COVID-19,090606,COVID19 - Ospedale San Iacopo,TOS,20-29,4,6,0,10,0,0,0,10,0,10,Toscana,ITI1
2021-01-07,COMIRNATY Vaccino a mRNA contro COVID-19,090606,COVID19 - Ospedale San Iacopo,TOS,30-39,4,18,0,22,0,0,0,22,0,22,Toscana,ITI1
2021-01-07,COMIRNATY Vaccino a mRNA contro COVID-19,090606,COVID19 - Ospedale San Iacopo,TOS,40-49,14,31,0,45,0,0,0,45,0,45,Toscana,ITI1
2021-01-07,COMIRNATY Vaccino a mRNA contro COVID-19,090606,COVID19 - Ospedale San Iacopo,TOS,50-59,5,47,0,51,1,0,0,52,0,52,Toscana,ITI1
2021-01-07,COMIRNATY Vaccino a mRNA contro COVID-19,090606,COVID19 - Ospedale San Iacopo,TOS,60-69,12,8,0,20,0,0,0,20,0,20,Toscana,ITI1
2021-01-07,COMIRNATY Vaccino a mRNA contro COVID-19,090606,COVID19 - Ospedale San Iacopo,TOS,70-79,0,1,0,1,0,0,0,1,0,1,Toscana,ITI1
2021-01-07,COMIRNATY Vaccino a mRNA contro COVID-19,090607,COVID19 - Ospedale SS.Cosma e Damiano,TOS,20-29,1,1,0,2,0,0,0,2,0,2,Toscana,ITI1
2021-01-07,COMIRNATY Vaccino a mRNA contro COVID-19,090607,COVID19 - Ospedale SS.Cosma e Damiano,TOS,30-39,2,5,0,7,0,0,0,7,0,7,Toscana,ITI1
2021-01-07,COMIRNATY Vaccino a mRNA contro COVID-19,090607,COVID19 - Ospedale SS.Cosma e Damiano,TOS,40-49,6,8,0,14,0,0,0,14,0,14,Toscana,ITI1
2021-01-07,COMIRNATY Vaccino a mRNA contro COVID-19,090607,COVID19 - Ospedale SS.Cosma e Damiano,TOS,50-59,4,11,0,15,0,0,0,15,0,15,Toscana,ITI1
2021-01-07,COMIRNATY Vaccino a mRNA contro COVID-19,090607,COVID19 - Ospedale SS.Cosma e Damiano,TOS,60-69,3,7,0,10,0,0,0,10,0,10,Toscana,ITI1
2021-01-07,COMIRNATY Vaccino a mRNA contro COVID-19,090608,COVID19 - Ospedale Santo Stefano,TOS,16-19,0,1,1,0,0,1,0,1,0,1,Toscana,ITI1
2021-01-07,COMIRNATY Vaccino a mRNA contro COVID-19,090608,COVID19 - Ospedale Santo Stefano,TOS,20-29,6,10,1,16,0,0,0,16,0,16,Toscana,ITI1
2021-01-07,COMIRNATY Vaccino a mRNA contro COVID-19,090608,COVID19 - Ospedale Santo Stefano,TOS,30-39,7,24,1,30,0,1,0,31,0,31,Toscana,ITI1
2021-01-07,COMIRNATY Vaccino a mRNA contro COVID-19,090608,COVID19 - Ospedale Santo Stefano,TOS,40-49,14,35,1,48,0,1,0,49,0,49,Toscana,ITI1
2021-01-07,COMIRNATY Vaccino a mRNA contro COVID-19,090608,COVID19 - Ospedale Santo Stefano,TOS,50-59,18,30,1,42,0,5,1,48,0,48,Toscana,ITI1
2021-01-07,COMIRNATY Vaccino a mRNA contro COVID-19,090608,COVID19 - Ospedale Santo Stefano,TOS,60-69,7,11,1,18,0,0,0,18,0,18,Toscana,ITI1
2021-01-07,COMIRNATY Vaccino a mRNA contro COVID-19,090609,Covid 19 - Ospedale S.Maria Maddalena di Volterra,TOS,20-29,3,5,0,8,0,0,0,8,0,8,Toscana,ITI1
2021-01-07,COMIRNATY Vaccino a mRNA contro COVID-19,090609,Covid 19 - Ospedale S.Maria Maddalena di Volterra,TOS,30-39,4,7,0,11,0,0,0,11,0,11,Toscana,ITI1
2021-01-07,COMIRNATY Vaccino a mRNA contro COVID-19,090609,Covid 19 - Ospedale S.Maria Maddalena di Volterra,TOS,40-49,4,14,0,18,0,0,0,18,0,18,Toscana,ITI1
2021-01-07,COMIRNATY Vaccino a mRNA contro COVID-19,090609,Covid 19 - Ospedale S.Maria Maddalena di Volterra,TOS,50-59,5,16,0,21,0,0,0,21,0,21,Toscana,ITI1
2021-01-07,COMIRNATY Vaccino a mRNA contro COVID-19,090609,Covid 19 - Ospedale S.Maria Maddalena di Volterra,TOS,60-69,2,4,0,6,0,0,0,6,0,6,Toscana,ITI1
2021-01-07,COMIRNATY Vaccino a mRNA contro COVID-19,090609,Covid 19 - Ospedale S.Maria Maddalena di Volterra,TOS,70-79,0,1,0,1,0,0,0,1,0,1,Toscana,ITI1
2021-01-07,COMIRNATY Vaccino a mRNA contro COVID-19,090609,Covid 19 - Ospedale S.Maria Maddalena di Volterra,TOS,90+,0,1,0,1,0,0,0,1,0,1,Toscana,ITI1
2021-01-07,COMIRNATY Vaccino a mRNA contro COVID-19,090610,Covid 19 - Ospedale F.Lotti di Pontedera,TOS,20-29,0,8,0,8,0,0,0,8,0,8,Toscana,ITI1
2021-01-07,COMIRNATY Vaccino a mRNA contro COVID-19,090610,Covid 19 - Ospedale F.Lotti di Pontedera,TOS,30-39,6,13,0,19,0,0,0,19,0,19,Toscana,ITI1
2021-01-07,COMIRNATY Vaccino a mRNA contro COVID-19,090610,Covid 19 - Ospedale F.Lotti di Pontedera,TOS,40-49,6,23,0,29,0,0,0,29,0,29,Toscana,ITI1
2021-01-07,COMIRNATY Vaccino a mRNA contro COVID-19,090610,Covid 19 - Ospedale F.Lotti di Pontedera,TOS,50-59,4,11,0,15,0,0,0,15,0,15,Toscana,ITI1
2021-01-07,COMIRNATY Vaccino a mRNA contro COVID-19,090610,Covid 19 - Ospedale F.Lotti di Pontedera,TOS,60-69,6,7,0,13,0,0,0,13,0,13,Toscana,ITI1
2021-01-07,COMIRNATY Vaccino a mRNA contro COVID-19,090613,Covid 19 - Ospedali Riuniti di Livorno,TOS,20-29,5,29,0,34,0,0,0,34,0,34,Toscana,ITI1
2021-01-07,COMIRNATY Vaccino a mRNA contro COVID-19,090613,Covid 19 - Ospedali Riuniti di Livorno,TOS,30-39,11,21,0,32,0,0,0,32,0,32,Toscana,ITI1
2021-01-07,COMIRNATY Vaccino a mRNA contro COVID-19,090613,Covid 19 - Ospedali Riuniti di Livorno,TOS,40-49,13,36,0,49,0,0,0,49,0,49,Toscana,ITI1
2021-01-07,COMIRNATY Vaccino a mRNA contro COVID-19,090613,Covid 19 - Ospedali Riuniti di Livorno,TOS,50-59,23,70,0,93,0,0,0,93,0,93,Toscana,ITI1
2021-01-07,COMIRNATY Vaccino a mRNA contro COVID-19,090613,Covid 19 - Ospedali Riuniti di Livorno,TOS,60-69,12,19,0,31,0,0,0,31,0,31,Toscana,ITI1
2021-01-07,COMIRNATY Vaccino a mRNA contro COVID-19,090613,Covid 19 - Ospedali Riuniti di Livorno,TOS,70-79,1,0,0,1,0,0,0,1,0,1,Toscana,ITI1
2021-01-07,COMIRNATY Vaccino a mRNA contro COVID-19,090614,Covid 19 - Ospedale Civile di Piombino,TOS,20-29,1,1,0,2,0,0,0,2,0,2,Toscana,ITI1
2021-01-07,COMIRNATY Vaccino a mRNA contro COVID-19,090614,Covid 19 - Ospedale Civile di Piombino,TOS,30-39,1,2,0,3,0,0,0,3,0,3,Toscana,ITI1
2021-01-07,COMIRNATY Vaccino a mRNA contro COVID-19,090614,Covid 19 - Ospedale Civile di Piombino,TOS,40-49,5,12,0,17,0,0,0,17,0,17,Toscana,ITI1
2021-01-07,COMIRNATY Vaccino a mRNA contro COVID-19,090614,Covid 19 - Ospedale Civile di Piombino,TOS,50-59,8,22,0,30,0,0,0,30,0,30,Toscana,ITI1
2021-01-07,COMIRNATY Vaccino a mRNA contro COVID-19,090614,Covid 19 - Ospedale Civile di Piombino,TOS,60-69,2,7,0,9,0,0,0,9,0,9,Toscana,ITI1
2021-01-07,COMIRNATY Vaccino a mRNA contro COVID-19,090619,COVID19 - Ospedale Valtiberina Sansepolcro,TOS,20-29,2,5,0,7,0,0,0,7,0,7,Toscana,ITI1
2021-01-07,COMIRNATY Vaccino a mRNA contro COVID-19,090619,COVID19 - Ospedale Valtiberina Sansepolcro,TOS,30-39,3,10,0,13,0,0,0,13,0,13,Toscana,ITI1
2021-01-07,COMIRNATY Vaccino a mRNA contro COVID-19,090619,COVID19 - Ospedale Valtiberina Sansepolcro,TOS,40-49,7,12,0,19,0,0,0,19,0,19,Toscana,ITI1
2021-01-07,COMIRNATY Vaccino a mRNA contro COVID-19,090619,COVID19 - Ospedale Valtiberina Sansepolcro,TOS,50-59,6,17,0,23,0,0,0,23,0,23,Toscana,ITI1
2021-01-07,COMIRNATY Vaccino a mRNA contro COVID-19,090619,COVID19 - Ospedale Valtiberina Sansepolcro,TOS,60-69,5,5,0,10,0,0,0,10,0,10,Toscana,ITI1
2021-01-07,COMIRNATY Vaccino a mRNA contro COVID-19,090621,COVID19 - Ospedale di Arezzo,TOS,20-29,10,22,0,32,0,0,0,32,0,32,Toscana,ITI1
2021-01-07,COMIRNATY Vaccino a mRNA contro COVID-19,090621,COVID19 - Ospedale di Arezzo,TOS,30-39,12,32,0,44,0,0,0,44,0,44,Toscana,ITI1
2021-01-07,COMIRNATY Vaccino a mRNA contro COVID-19,090621,COVID19 - Ospedale di Arezzo,TOS,40-49,16,55,0,71,0,0,0,71,0,71,Toscana,ITI1
2021-01-07,COMIRNATY Vaccino a mRNA contro COVID-19,090621,COVID19 - Ospedale di Arezzo,TOS,50-59,9,41,0,50,0,0,0,50,0,50,Toscana,ITI1
2021-01-07,COMIRNATY Vaccino a mRNA contro COVID-19,090621,COVID19 - Ospedale di Arezzo,TOS,60-69,8,9,0,17,0,0,0,17,0,17,Toscana,ITI1
2021-01-07,COMIRNATY Vaccino a mRNA contro COVID-19,090621,COVID19 - Ospedale di Arezzo,TOS,70-79,2,0,0,2,0,0,0,2,0,2,Toscana,ITI1
2021-01-07,COMIRNATY Vaccino a mRNA contro COVID-19,090623,COVID19 - Ospedale S.Andrea Massa Marittima,TOS,20-29,0,4,0,4,0,0,0,4,0,4,Toscana,ITI1
2021-01-07,COMIRNATY Vaccino a mRNA contro COVID-19,090623,COVID19 - Ospedale S.Andrea Massa Marittima,TOS,30-39,1,5,0,6,0,0,0,6,0,6,Toscana,ITI1
2021-01-07,COMIRNATY Vaccino a mRNA contro COVID-19,090623,COVID19 - Ospedale S.Andrea Massa Marittima,TOS,40-49,8,9,0,17,0,0,0,17,0,17,Toscana,ITI1
2021-01-07,COMIRNATY Vaccino a mRNA contro COVID-19,090623,COVID19 - Ospedale S.Andrea Massa Marittima,TOS,50-59,4,16,0,19,1,0,0,20,0,20,Toscana,ITI1
2021-01-07,COMIRNATY Vaccino a mRNA contro COVID-19,090623,COVID19 - Ospedale S.Andrea Massa Marittima,TOS,60-69,3,6,0,9,0,0,0,9,0,9,Toscana,ITI1
2021-01-07,COMIRNATY Vaccino a mRNA contro COVID-19,090626,COVID19 - Ospedale di Grosseto,TOS,20-29,3,13,0,16,0,0,0,16,0,16,Toscana,ITI1
2021-01-07,COMIRNATY Vaccino a mRNA contro COVID-19,090626,COVID19 - Ospedale di Grosseto,TOS,30-39,13,20,0,33,0,0,0,33,0,33,Toscana,ITI1
2021-01-07,COMIRNATY Vaccino a mRNA contro COVID-19,090626,COVID19 - Ospedale di Grosseto,TOS,40-49,15,32,0,46,0,1,0,47,0,47,Toscana,ITI1
2021-01-07,COMIRNATY Vaccino a mRNA contro COVID-19,090626,COVID19 - Ospedale di Grosseto,TOS,50-59,17,33,0,50,0,0,0,50,0,50,Toscana,ITI1
2021-01-07,COMIRNATY Vaccino a mRNA contro COVID-19,090626,COVID19 - Ospedale di Grosseto,TOS,60-69,8,14,0,22,0,0,0,22,0,22,Toscana,ITI1
2021-01-07,COMIRNATY Vaccino a mRNA contro COVID-19,090627,COVID19 - Ospedale Mugello,TOS,20-29,4,2,0,2,0,4,0,6,0,6,Toscana,ITI1
2021-01-07,COMIRNATY Vaccino a mRNA contro COVID-19,090627,COVID19 - Ospedale Mugello,TOS,30-39,1,4,0,3,0,2,0,5,0,5,Toscana,ITI1
2021-01-07,COMIRNATY Vaccino a mRNA contro COVID-19,090627,COVID19 - Ospedale Mugello,TOS,40-49,5,8,0,9,0,4,0,13,0,13,Toscana,ITI1
2021-01-07,COMIRNATY Vaccino a mRNA contro COVID-19,090627,COVID19 - Ospedale Mugello,TOS,50-59,8,9,0,6,0,11,0,17,0,17,Toscana,ITI1
2021-01-07,COMIRNATY Vaccino a mRNA contro COVID-19,090627,COVID19 - Ospedale Mugello,TOS,60-69,2,2,0,0,0,4,0,4,0,4,Toscana,ITI1
2021-01-07,COMIRNATY Vaccino a mRNA contro COVID-19,090627,COVID19 - Ospedale Mugello,TOS,70-79,0,3,0,1,0,2,0,3,0,3,Toscana,ITI1
2021-01-07,COMIRNATY Vaccino a mRNA contro COVID-19,090629,COVID19 - Ospedale SS. Maria Annunziata,TOS,20-29,4,9,0,13,0,0,0,13,0,13,Toscana,ITI1
2021-01-07,COMIRNATY Vaccino a mRNA contro COVID-19,090629,COVID19 - Ospedale SS. Maria Annunziata,TOS,30-39,10,17,0,26,1,0,0,27,0,27,Toscana,ITI1
2021-01-07,COMIRNATY Vaccino a mRNA contro COVID-19,090629,COVID19 - Ospedale SS. Maria Annunziata,TOS,40-49,11,34,0,44,1,0,0,45,0,45,Toscana,ITI1
2021-01-07,COMIRNATY Vaccino a mRNA contro COVID-19,090629,COVID19 - Ospedale SS. Maria Annunziata,TOS,50-59,7,34,0,41,0,0,0,41,0,41,Toscana,ITI1
2021-01-07,COMIRNATY Vaccino a mRNA contro COVID-19,090629,COVID19 - Ospedale SS. Maria Annunziata,TOS,60-69,8,13,0,20,1,0,0,21,0,21,Toscana,ITI1
2021-01-07,COMIRNATY Vaccino a mRNA contro COVID-19,090629,COVID19 - Ospedale SS. Maria Annunziata,TOS,70-79,1,1,0,2,0,0,0,2,0,2,Toscana,ITI1
2021-01-07,COMIRNATY Vaccino a mRNA contro COVID-19,090629,COVID19 - Ospedale SS. Maria Annunziata,TOS,80-89,0,1,0,1,0,0,0,1,0,1,Toscana,ITI1
2021-01-07,COMIRNATY Vaccino a mRNA contro COVID-19,090632,COVID19 - Ospedale Santa Maria Nuova,TOS,20-29,7,7,0,14,0,0,0,14,0,14,Toscana,ITI1
2021-01-07,COMIRNATY Vaccino a mRNA contro COVID-19,090632,COVID19 - Ospedale Santa Maria Nuova,TOS,30-39,7,11,0,18,0,0,0,18,0,18,Toscana,ITI1
2021-01-07,COMIRNATY Vaccino a mRNA contro COVID-19,090632,COVID19 - Ospedale Santa Maria Nuova,TOS,40-49,3,15,0,18,0,0,0,18,0,18,Toscana,ITI1
2021-01-07,COMIRNATY Vaccino a mRNA contro COVID-19,090632,COVID19 - Ospedale Santa Maria Nuova,TOS,50-59,7,22,0,29,0,0,0,29,0,29,Toscana,ITI1
2021-01-07,COMIRNATY Vaccino a mRNA contro COVID-19,090632,COVID19 - Ospedale Santa Maria Nuova,TOS,60-69,8,9,0,17,0,0,0,17,0,17,Toscana,ITI1
2021-01-07,COMIRNATY Vaccino a mRNA contro COVID-19,090632,COVID19 - Ospedale Santa Maria Nuova,TOS,70-79,1,0,0,1,0,0,0,1,0,1,Toscana,ITI1
2021-01-07,COMIRNATY Vaccino a mRNA contro COVID-19,090637,COVID19 - Ospedale Amiata Val d'Orcia  Abbadia San Salvatore,TOS,30-39,0,2,0,2,0,0,0,2,0,2,Toscana,ITI1
2021-01-07,COMIRNATY Vaccino a mRNA contro COVID-19,090637,COVID19 - Ospedale Amiata Val d'Orcia  Abbadia San Salvatore,TOS,40-49,2,2,0,4,0,0,0,4,0,4,Toscana,ITI1
2021-01-07,COMIRNATY Vaccino a mRNA contro COVID-19,090637,COVID19 - Ospedale Amiata Val d'Orcia  Abbadia San Salvatore,TOS,50-59,2,3,0,5,0,0,0,5,0,5,Toscana,ITI1
2021-01-07,COMIRNATY Vaccino a mRNA contro COVID-19,090637,COVID19 - Ospedale Amiata Val d'Orcia  Abbadia San Salvatore,TOS,60-69,0,1,0,1,0,0,0,1,0,1,Toscana,ITI1
2021-01-07,COMIRNATY Vaccino a mRNA contro COVID-19,090639,COVID19 - Ospedale di Nottola Montepulciano,TOS,20-29,2,10,0,12,0,0,0,12,0,12,Toscana,ITI1
2021-01-07,COMIRNATY Vaccino a mRNA contro COVID-19,090639,COVID19 - Ospedale di Nottola Montepulciano,TOS,30-39,6,9,0,15,0,0,0,15,0,15,Toscana,ITI1
2021-01-07,COMIRNATY Vaccino a mRNA contro COVID-19,090639,COVID19 - Ospedale di Nottola Montepulciano,TOS,40-49,9,23,0,32,0,0,0,32,0,32,Toscana,ITI1
2021-01-07,COMIRNATY Vaccino a mRNA contro COVID-19,090639,COVID19 - Ospedale di Nottola Montepulciano,TOS,50-59,8,22,0,30,0,0,0,30,0,30,Toscana,ITI1
2021-01-07,COMIRNATY Vaccino a mRNA contro COVID-19,090639,COVID19 - Ospedale di Nottola Montepulciano,TOS,60-69,5,5,0,10,0,0,0,10,0,10,Toscana,ITI1
2021-01-07,COMIRNATY Vaccino a mRNA contro COVID-19,090640,Covid 19 - Ospedale Unico Versilia,TOS,16-19,1,0,0,1,0,0,0,1,0,1,Toscana,ITI1
2021-01-07,COMIRNATY Vaccino a mRNA contro COVID-19,090640,Covid 19 - Ospedale Unico Versilia,TOS,20-29,7,12,0,19,0,0,0,19,0,19,Toscana,ITI1
2021-01-07,COMIRNATY Vaccino a mRNA contro COVID-19,090640,Covid 19 - Ospedale Unico Versilia,TOS,30-39,8,13,0,21,0,0,0,21,0,21,Toscana,ITI1
2021-01-07,COMIRNATY Vaccino a mRNA contro COVID-19,090640,Covid 19 - Ospedale Unico Versilia,TOS,40-49,11,44,0,54,0,1,0,55,0,55,Toscana,ITI1
2021-01-07,COMIRNATY Vaccino a mRNA contro COVID-19,090640,Covid 19 - Ospedale Unico Versilia,TOS,50-59,19,65,0,84,0,0,0,84,0,84,Toscana,ITI1
2021-01-07,COMIRNATY Vaccino a mRNA contro COVID-19,090640,Covid 19 - Ospedale Unico Versilia,TOS,60-69,13,8,0,21,0,0,0,21,0,21,Toscana,ITI1
2021-01-07,COMIRNATY Vaccino a mRNA contro COVID-19,090640,Covid 19 - Ospedale Unico Versilia,TOS,70-79,2,0,0,2,0,0,0,2,0,2,Toscana,ITI1
2021-01-07,COMIRNATY Vaccino a mRNA contro COVID-19,090641,COVID19 - Ospedale La Gruccia Montevarchi,TOS,20-29,2,7,0,9,0,0,0,9,0,9,Toscana,ITI1
2021-01-07,COMIRNATY Vaccino a mRNA contro COVID-19,090641,COVID19 - Ospedale La Gruccia Montevarchi,TOS,30-39,6,21,0,24,3,0,0,27,0,27,Toscana,ITI1
2021-01-07,COMIRNATY Vaccino a mRNA contro COVID-19,090641,COVID19 - Ospedale La Gruccia Montevarchi,TOS,40-49,4,10,0,13,1,0,0,14,0,14,Toscana,ITI1
2021-01-07,COMIRNATY Vaccino a mRNA contro COVID-19,090641,COVID19 - Ospedale La Gruccia Montevarchi,TOS,50-59,6,28,0,34,0,0,0,34,0,34,Toscana,ITI1
2021-01-07,COMIRNATY Vaccino a mRNA contro COVID-19,090641,COVID19 - Ospedale La Gruccia Montevarchi,TOS,60-69,5,7,0,11,1,0,0,12,0,12,Toscana,ITI1
2021-01-07,COMIRNATY Vaccino a mRNA contro COVID-19,090901,COVID19 - AOU Pisana,TOS,16-19,4,16,0,20,0,0,0,20,0,20,Toscana,ITI1
2021-01-07,COMIRNATY Vaccino a mRNA contro COVID-19,090901,COVID19 - AOU Pisana,TOS,20-29,81,208,0,289,0,0,0,289,0,289,Toscana,ITI1
2021-01-07,COMIRNATY Vaccino a mRNA contro COVID-19,090901,COVID19 - AOU Pisana,TOS,30-39,35,92,0,126,1,0,0,127,0,127,Toscana,ITI1
2021-01-07,COMIRNATY Vaccino a mRNA contro COVID-19,090901,COVID19 - AOU Pisana,TOS,40-49,42,123,0,162,2,1,0,165,0,165,Toscana,ITI1
2021-01-07,COMIRNATY Vaccino a mRNA contro COVID-19,090901,COVID19 - AOU Pisana,TOS,50-59,57,137,0,192,2,0,0,194,0,194,Toscana,ITI1
2021-01-07,COMIRNATY Vaccino a mRNA contro COVID-19,090901,COVID19 - AOU Pisana,TOS,60-69,31,41,0,72,0,0,0,72,0,72,Toscana,ITI1
2021-01-07,COMIRNATY Vaccino a mRNA contro COVID-19,090901,COVID19 - AOU Pisana,TOS,70-79,3,0,0,3,0,0,0,3,0,3,Toscana,ITI1
2021-01-07,COMIRNATY Vaccino a mRNA contro COVID-19,090902,COVID19 - AOU Senese,TOS,20-29,24,31,0,55,0,0,0,55,0,55,Toscana,ITI1
2021-01-07,COMIRNATY Vaccino a mRNA contro COVID-19,090902,COVID19 - AOU Senese,TOS,30-39,25,47,0,72,0,0,0,72,0,72,Toscana,ITI1
2021-01-07,COMIRNATY Vaccino a mRNA contro COVID-19,090902,COVID19 - AOU Senese,TOS,40-49,22,47,0,68,0,1,0,69,0,69,Toscana,ITI1
2021-01-07,COMIRNATY Vaccino a mRNA contro COVID-19,090902,COVID19 - AOU Senese,TOS,50-59,21,70,0,91,0,0,0,91,0,91,Toscana,ITI1
2021-01-07,COMIRNATY Vaccino a mRNA contro COVID-19,090902,COVID19 - AOU Senese,TOS,60-69,12,13,0,25,0,0,0,25,0,25,Toscana,ITI1
2021-01-07,COMIRNATY Vaccino a mRNA contro COVID-19,090903,COVID19 - AOU Careggi - CTO,TOS,16-19,0,5,0,5,0,0,0,5,0,5,Toscana,ITI1
2021-01-07,COMIRNATY Vaccino a mRNA contro COVID-19,090903,COVID19 - AOU Careggi - CTO,TOS,20-29,96,200,0,295,0,1,0,296,0,296,Toscana,ITI1
2021-01-07,COMIRNATY Vaccino a mRNA contro COVID-19,090903,COVID19 - AOU Careggi - CTO,TOS,30-39,64,100,0,162,2,0,0,164,0,164,Toscana,ITI1
2021-01-07,COMIRNATY Vaccino a mRNA contro COVID-19,090903,COVID19 - AOU Careggi - CTO,TOS,40-49,39,133,0,172,0,0,0,172,0,172,Toscana,ITI1
2021-01-07,COMIRNATY Vaccino a mRNA contro COVID-19,090903,COVID19 - AOU Careggi - CTO,TOS,50-59,67,169,0,233,2,1,0,236,0,236,Toscana,ITI1
2021-01-07,COMIRNATY Vaccino a mRNA contro COVID-19,090903,COVID19 - AOU Careggi - CTO,TOS,60-69,35,59,0,92,1,1,0,94,0,94,Toscana,ITI1
2021-01-07,COMIRNATY Vaccino a mRNA contro COVID-19,090903,COVID19 - AOU Careggi - CTO,TOS,70-79,1,2,0,3,0,0,0,3,0,3,Toscana,ITI1
2021-01-07,COMIRNATY Vaccino a mRNA contro COVID-19,090904,COVID19 - Ospedale AOU Meyer,TOS,20-29,6,12,0,18,0,0,0,18,0,18,Toscana,ITI1
2021-01-07,COMIRNATY Vaccino a mRNA contro COVID-19,090904,COVID19 - Ospedale AOU Meyer,TOS,30-39,11,46,0,57,0,0,0,57,0,57,Toscana,ITI1
2021-01-07,COMIRNATY Vaccino a mRNA contro COVID-19,090904,COVID19 - Ospedale AOU Meyer,TOS,40-49,10,30,0,40,0,0,0,40,0,40,Toscana,ITI1
2021-01-07,COMIRNATY Vaccino a mRNA contro COVID-19,090904,COVID19 - Ospedale AOU Meyer,TOS,50-59,9,23,0,32,0,0,0,32,0,32,Toscana,ITI1
2021-01-07,COMIRNATY Vaccino a mRNA contro COVID-19,090904,COVID19 - Ospedale AOU Meyer,TOS,60-69,4,9,0,13,0,0,0,13,0,13,Toscana,ITI1
2021-01-07,COMIRNATY Vaccino a mRNA contro COVID-19,090904,COVID19 - Ospedale AOU Meyer,TOS,80-89,1,0,0,1,0,0,0,1,0,1,Toscana,ITI1
2021-01-07,COMIRNATY Vaccino a mRNA contro COVID-19,10264I,RSA CENTRO ANZIANI MONTE SAN Q,TOS,40-49,0,4,0,4,0,0,0,4,0,4,Toscana,ITI1
2021-01-07,COMIRNATY Vaccino a mRNA contro COVID-19,10264I,RSA CENTRO ANZIANI MONTE SAN Q,TOS,50-59,1,1,0,2,0,0,0,2,0,2,Toscana,ITI1
2021-01-07,COMIRNATY Vaccino a mRNA contro COVID-19,10264I,RSA CENTRO ANZIANI MONTE SAN Q,TOS,60-69,1,0,0,1,0,0,0,1,0,1,Toscana,ITI1
2021-01-07,COMIRNATY Vaccino a mRNA contro COVID-19,10264I,RSA CENTRO ANZIANI MONTE SAN Q,TOS,70-79,2,2,0,0,0,4,0,4,0,4,Toscana,ITI1
2021-01-07,COMIRNATY Vaccino a mRNA contro COVID-19,10264I,RSA CENTRO ANZIANI MONTE SAN Q,TOS,90+,0,1,0,0,0,1,0,1,0,1,Toscana,ITI1
2021-01-07,COMIRNATY Vaccino a mRNA contro COVID-19,10334I,Covi19 - RSA PAOLI PUCCETTI,TOS,30-39,0,1,0,1,0,0,0,1,0,1,Toscana,ITI1
2021-01-07,COMIRNATY Vaccino a mRNA contro COVID-19,10334I,Covi19 - RSA PAOLI PUCCETTI,TOS,50-59,0,2,0,2,0,0,0,2,0,2,Toscana,ITI1
2021-01-07,COMIRNATY Vaccino a mRNA contro COVID-19,10334I,Covi19 - RSA PAOLI PUCCETTI,TOS,60-69,1,1,0,0,0,2,0,2,0,2,Toscana,ITI1
2021-01-07,COMIRNATY Vaccino a mRNA contro COVID-19,10334I,Covi19 - RSA PAOLI PUCCETTI,TOS,70-79,0,1,0,0,0,1,0,1,0,1,Toscana,ITI1
2021-01-07,COMIRNATY Vaccino a mRNA contro COVID-19,10334I,Covi19 - RSA PAOLI PUCCETTI,TOS,80-89,2,0,0,0,0,2,0,2,0,2,Toscana,ITI1
2021-01-07,COMIRNATY Vaccino a mRNA contro COVID-19,10334I,Covi19 - RSA PAOLI PUCCETTI,TOS,90+,0,4,0,0,0,4,0,4,0,4,Toscana,ITI1
2021-01-07,COMIRNATY Vaccino a mRNA contro COVID-19,11012E,COVID19 - Ospedale San Giuseppe,TOS,20-29,3,13,0,16,0,0,0,16,0,16,Toscana,ITI1
2021-01-07,COMIRNATY Vaccino a mRNA contro COVID-19,11012E,COVID19 - Ospedale San Giuseppe,TOS,30-39,8,24,0,32,0,0,0,32,0,32,Toscana,ITI1
2021-01-07,COMIRNATY Vaccino a mRNA contro COVID-19,11012E,COVID19 - Ospedale San Giuseppe,TOS,40-49,11,43,0,52,0,2,0,54,0,54,Toscana,ITI1
2021-01-07,COMIRNATY Vaccino a mRNA contro COVID-19,11012E,COVID19 - Ospedale San Giuseppe,TOS,50-59,13,35,0,48,0,0,0,48,0,48,Toscana,ITI1
2021-01-07,COMIRNATY Vaccino a mRNA contro COVID-19,11012E,COVID19 - Ospedale San Giuseppe,TOS,60-69,6,11,0,16,0,1,0,17,0,17,Toscana,ITI1
2021-01-07,COMIRNATY Vaccino a mRNA contro COVID-19,11151A,Covid 19 - Ospedale S.Antonio Abate di Pontremoli,TOS,30-39,0,1,0,1,0,0,0,1,0,1,Toscana,ITI1
2021-01-07,COMIRNATY Vaccino a mRNA contro COVID-19,11151A,Covid 19 - Ospedale S.Antonio Abate di Pontremoli,TOS,40-49,0,4,0,4,0,0,0,4,0,4,Toscana,ITI1
2021-01-07,COMIRNATY Vaccino a mRNA contro COVID-19,11151A,Covid 19 - Ospedale S.Antonio Abate di Pontremoli,TOS,50-59,2,11,0,13,0,0,0,13,0,13,Toscana,ITI1
2021-01-07,COMIRNATY Vaccino a mRNA contro COVID-19,11151A,Covid 19 - Ospedale S.Antonio Abate di Pontremoli,TOS,60-69,2,4,0,6,0,0,0,6,0,6,Toscana,ITI1
2021-01-07,COMIRNATY Vaccino a mRNA contro COVID-19,121S4I,RSA VILLA SANTA CATERINA,TOS,30-39,1,1,0,2,0,0,0,2,0,2,Toscana,ITI1
2021-01-07,COMIRNATY Vaccino a mRNA contro COVID-19,121S4I,RSA VILLA SANTA CATERINA,TOS,70-79,0,1,0,0,0,1,0,1,0,1,Toscana,ITI1
2021-01-07,COMIRNATY Vaccino a mRNA contro COVID-19,121S4I,RSA VILLA SANTA CATERINA,TOS,80-89,0,5,0,0,0,5,0,5,0,5,Toscana,ITI1
2021-01-07,COMIRNATY Vaccino a mRNA contro COVID-19,121S4I,RSA VILLA SANTA CATERINA,TOS,90+,1,3,0,0,0,4,0,4,0,4,Toscana,ITI1
2021-01-07,COMIRNATY Vaccino a mRNA contro COVID-19,13021A,COVID19 - Ospedale S.Giovanni di Dio,TOS,20-29,3,22,0,25,0,0,0,25,0,25,Toscana,ITI1
2021-01-07,COMIRNATY Vaccino a mRNA contro COVID-19,13021A,COVID19 - Ospedale S.Giovanni di Dio,TOS,30-39,12,24,0,35,1,0,0,36,0,36,Toscana,ITI1
2021-01-07,COMIRNATY Vaccino a mRNA contro COVID-19,13021A,COVID19 - Ospedale S.Giovanni di Dio,TOS,40-49,7,39,0,46,0,0,0,46,0,46,Toscana,ITI1
2021-01-07,COMIRNATY Vaccino a mRNA contro COVID-19,13021A,COVID19 - Ospedale S.Giovanni di Dio,TOS,50-59,4,38,0,40,0,2,0,42,0,42,Toscana,ITI1
2021-01-07,COMIRNATY Vaccino a mRNA contro COVID-19,13021A,COVID19 - Ospedale S.Giovanni di Dio,TOS,60-69,5,12,0,15,0,2,0,17,0,17,Toscana,ITI1
2021-01-07,COMIRNATY Vaccino a mRNA contro COVID-19,13021A,COVID19 - Ospedale S.Giovanni di Dio,TOS,70-79,3,1,0,2,0,2,0,4,0,4,Toscana,ITI1
2021-01-07,COMIRNATY Vaccino a mRNA contro COVID-19,13021A,COVID19 - Ospedale S.Giovanni di Dio,TOS,80-89,1,12,0,0,0,13,0,13,0,13,Toscana,ITI1
2021-01-07,COMIRNATY Vaccino a mRNA contro COVID-19,13021A,COVID19 - Ospedale S.Giovanni di Dio,TOS,90+,0,2,0,0,0,2,0,2,0,2,Toscana,ITI1
2021-01-07,COMIRNATY Vaccino a mRNA contro COVID-19,13204I,Covid19 - RSA  MICHELANGELO Aulla,TOS,20-29,0,1,0,1,0,0,0,1,0,1,Toscana,ITI1
2021-01-07,COMIRNATY Vaccino a mRNA contro COVID-19,13204I,Covid19 - RSA  MICHELANGELO Aulla,TOS,30-39,1,0,0,0,0,1,0,1,0,1,Toscana,ITI1
2021-01-07,COMIRNATY Vaccino a mRNA contro COVID-19,13204I,Covid19 - RSA  MICHELANGELO Aulla,TOS,40-49,0,1,0,0,0,1,0,1,0,1,Toscana,ITI1
2021-01-07,COMIRNATY Vaccino a mRNA contro COVID-19,13204I,Covid19 - RSA  MICHELANGELO Aulla,TOS,50-59,1,0,0,0,0,1,0,1,0,1,Toscana,ITI1
2021-01-07,COMIRNATY Vaccino a mRNA contro COVID-19,13204I,Covid19 - RSA  MICHELANGELO Aulla,TOS,60-69,1,0,0,0,0,1,0,1,0,1,Toscana,ITI1
2021-01-07,COMIRNATY Vaccino a mRNA contro COVID-19,13204I,Covid19 - RSA  MICHELANGELO Aulla,TOS,70-79,1,0,0,0,0,1,0,1,0,1,Toscana,ITI1
2021-01-07,COMIRNATY Vaccino a mRNA contro COVID-19,13244I,Covid19 - RSA VILLA ANGELA,TOS,70-79,1,1,0,0,0,2,0,2,0,2,Toscana,ITI1
2021-01-07,COMIRNATY Vaccino a mRNA contro COVID-19,13244I,Covid19 - RSA VILLA ANGELA,TOS,80-89,0,5,0,0,0,5,0,5,0,5,Toscana,ITI1
2021-01-07,COMIRNATY Vaccino a mRNA contro COVID-19,13244I,Covid19 - RSA VILLA ANGELA,TOS,90+,4,1,0,0,0,5,0,5,0,5,Toscana,ITI1
2021-01-07,COMIRNATY Vaccino a mRNA contro COVID-19,13584I,CENTRO EGIZIANO GIGLIOLI A.P.S,TOS,40-49,0,3,0,3,0,0,0,3,0,3,Toscana,ITI1
2021-01-07,COMIRNATY Vaccino a mRNA contro COVID-19,13584I,CENTRO EGIZIANO GIGLIOLI A.P.S,TOS,50-59,2,5,0,6,0,1,0,7,0,7,Toscana,ITI1
2021-01-07,COMIRNATY Vaccino a mRNA contro COVID-19,13584I,CENTRO EGIZIANO GIGLIOLI A.P.S,TOS,60-69,3,4,0,3,0,4,0,7,0,7,Toscana,ITI1
2021-01-07,COMIRNATY Vaccino a mRNA contro COVID-19,13584I,CENTRO EGIZIANO GIGLIOLI A.P.S,TOS,70-79,3,3,0,0,0,6,0,6,0,6,Toscana,ITI1
2021-01-07,COMIRNATY Vaccino a mRNA contro COVID-19,13584I,CENTRO EGIZIANO GIGLIOLI A.P.S,TOS,80-89,2,16,0,0,0,18,0,18,0,18,Toscana,ITI1
2021-01-07,COMIRNATY Vaccino a mRNA contro COVID-19,13584I,CENTRO EGIZIANO GIGLIOLI A.P.S,TOS,90+,3,16,0,0,0,19,0,19,0,19,Toscana,ITI1
2021-01-07,COMIRNATY Vaccino a mRNA contro COVID-19,13614I,CASA ALBERGO PER ANZIANI,TOS,30-39,1,0,0,1,0,0,0,1,0,1,Toscana,ITI1
2021-01-07,COMIRNATY Vaccino a mRNA contro COVID-19,13614I,CASA ALBERGO PER ANZIANI,TOS,50-59,0,1,0,1,0,0,0,1,0,1,Toscana,ITI1
2021-01-07,COMIRNATY Vaccino a mRNA contro COVID-19,13614I,CASA ALBERGO PER ANZIANI,TOS,70-79,5,0,0,0,0,5,0,5,0,5,Toscana,ITI1
2021-01-07,COMIRNATY Vaccino a mRNA contro COVID-19,13614I,CASA ALBERGO PER ANZIANI,TOS,80-89,1,4,0,0,0,5,0,5,0,5,Toscana,ITI1
2021-01-07,COMIRNATY Vaccino a mRNA contro COVID-19,13614I,CASA ALBERGO PER ANZIANI,TOS,90+,1,4,0,0,0,5,0,5,0,5,Toscana,ITI1
2021-01-07,COMIRNATY Vaccino a mRNA contro COVID-19,16121A,Covid 19 - Ospedale Civile di Cecina,TOS,20-29,0,3,0,3,0,0,0,3,0,3,Toscana,ITI1
2021-01-07,COMIRNATY Vaccino a mRNA contro COVID-19,16121A,Covid 19 - Ospedale Civile di Cecina,TOS,30-39,1,7,0,8,0,0,0,8,0,8,Toscana,ITI1
2021-01-07,COMIRNATY Vaccino a mRNA contro COVID-19,16121A,Covid 19 - Ospedale Civile di Cecina,TOS,40-49,3,9,0,12,0,0,0,12,0,12,Toscana,ITI1
2021-01-07,COMIRNATY Vaccino a mRNA contro COVID-19,16121A,Covid 19 - Ospedale Civile di Cecina,TOS,50-59,4,24,0,28,0,0,0,28,0,28,Toscana,ITI1
2021-01-07,COMIRNATY Vaccino a mRNA contro COVID-19,16121A,Covid 19 - Ospedale Civile di Cecina,TOS,60-69,5,4,0,9,0,0,0,9,0,9,Toscana,ITI1
2021-01-07,COMIRNATY Vaccino a mRNA contro COVID-19,20894I,RSA CASA DEI NONNI C/O EX OSPE,TOS,30-39,0,1,0,0,1,0,0,1,0,1,Toscana,ITI1
2021-01-07,COMIRNATY Vaccino a mRNA contro COVID-19,20894I,RSA CASA DEI NONNI C/O EX OSPE,TOS,50-59,0,1,0,0,1,0,0,1,0,1,Toscana,ITI1
2021-01-07,COMIRNATY Vaccino a mRNA contro COVID-19,20894I,RSA CASA DEI NONNI C/O EX OSPE,TOS,60-69,0,1,0,0,0,1,0,1,0,1,Toscana,ITI1
2021-01-07,COMIRNATY Vaccino a mRNA contro COVID-19,20894I,RSA CASA DEI NONNI C/O EX OSPE,TOS,70-79,0,3,0,0,0,3,0,3,0,3,Toscana,ITI1
2021-01-07,COMIRNATY Vaccino a mRNA contro COVID-19,20894I,RSA CASA DEI NONNI C/O EX OSPE,TOS,80-89,0,2,0,0,0,2,0,2,0,2,Toscana,ITI1
2021-01-07,COMIRNATY Vaccino a mRNA contro COVID-19,21301A,COVID19 - Ospedale F. Petruccioli Pitigliano,TOS,20-29,0,6,0,5,1,0,0,6,0,6,Toscana,ITI1
2021-01-07,COMIRNATY Vaccino a mRNA contro COVID-19,21301A,COVID19 - Ospedale F. Petruccioli Pitigliano,TOS,30-39,3,2,0,5,0,0,0,5,0,5,Toscana,ITI1
2021-01-07,COMIRNATY Vaccino a mRNA contro COVID-19,21301A,COVID19 - Ospedale F. Petruccioli Pitigliano,TOS,40-49,3,6,0,9,0,0,0,9,0,9,Toscana,ITI1
2021-01-07,COMIRNATY Vaccino a mRNA contro COVID-19,21301A,COVID19 - Ospedale F. Petruccioli Pitigliano,TOS,50-59,7,6,0,13,0,0,0,13,0,13,Toscana,ITI1
2021-01-07,COMIRNATY Vaccino a mRNA contro COVID-19,21301A,COVID19 - Ospedale F. Petruccioli Pitigliano,TOS,60-69,4,5,0,8,1,0,0,9,0,9,Toscana,ITI1
2021-01-07,COMIRNATY Vaccino a mRNA contro COVID-19,220S4I,R.S.A. ISTITUTO S.GIUSEPPE,TOS,30-39,0,1,0,1,0,0,0,1,0,1,Toscana,ITI1
2021-01-07,COMIRNATY Vaccino a mRNA contro COVID-19,220S4I,R.S.A. ISTITUTO S.GIUSEPPE,TOS,50-59,0,1,0,1,0,0,0,1,0,1,Toscana,ITI1
2021-01-07,COMIRNATY Vaccino a mRNA contro COVID-19,220S4I,R.S.A. ISTITUTO S.GIUSEPPE,TOS,60-69,1,0,0,0,0,1,0,1,0,1,Toscana,ITI1
2021-01-07,COMIRNATY Vaccino a mRNA contro COVID-19,220S4I,R.S.A. ISTITUTO S.GIUSEPPE,TOS,70-79,1,2,0,0,0,3,0,3,0,3,Toscana,ITI1
2021-01-07,COMIRNATY Vaccino a mRNA contro COVID-19,220S4I,R.S.A. ISTITUTO S.GIUSEPPE,TOS,80-89,4,6,0,0,0,10,0,10,0,10,Toscana,ITI1
2021-01-07,COMIRNATY Vaccino a mRNA contro COVID-19,220S4I,R.S.A. ISTITUTO S.GIUSEPPE,TOS,90+,0,2,0,0,0,2,0,2,0,2,Toscana,ITI1
2021-01-07,COMIRNATY Vaccino a mRNA contro COVID-19,221I4I,RSA GIAMPIERI,TOS,60-69,2,0,0,0,0,2,0,2,0,2,Toscana,ITI1
2021-01-07,COMIRNATY Vaccino a mRNA contro COVID-19,221I4I,RSA GIAMPIERI,TOS,70-79,3,3,0,1,0,5,0,6,0,6,Toscana,ITI1
2021-01-07,COMIRNATY Vaccino a mRNA contro COVID-19,221I4I,RSA GIAMPIERI,TOS,80-89,2,13,0,0,0,15,0,15,0,15,Toscana,ITI1
2021-01-07,COMIRNATY Vaccino a mRNA contro COVID-19,221I4I,RSA GIAMPIERI,TOS,90+,4,15,0,0,0,19,0,19,0,19,Toscana,ITI1
2021-01-07,COMIRNATY Vaccino a mRNA contro COVID-19,22391A,PRESIDIO AVENZA,TOS,16-19,1,0,0,0,0,1,0,1,0,1,Toscana,ITI1
2021-01-07,COMIRNATY Vaccino a mRNA contro COVID-19,22391A,PRESIDIO AVENZA,TOS,20-29,1,2,0,0,0,3,0,3,0,3,Toscana,ITI1
2021-01-07,COMIRNATY Vaccino a mRNA contro COVID-19,22391A,PRESIDIO AVENZA,TOS,30-39,1,1,0,1,0,1,0,2,0,2,Toscana,ITI1
2021-01-07,COMIRNATY Vaccino a mRNA contro COVID-19,22391A,PRESIDIO AVENZA,TOS,40-49,0,1,0,1,0,0,0,1,0,1,Toscana,ITI1
2021-01-07,COMIRNATY Vaccino a mRNA contro COVID-19,22391A,PRESIDIO AVENZA,TOS,50-59,3,1,0,1,0,3,0,4,0,4,Toscana,ITI1
2021-01-07,COMIRNATY Vaccino a mRNA contro COVID-19,22391A,PRESIDIO AVENZA,TOS,60-69,0,1,0,1,0,0,0,1,0,1,Toscana,ITI1
2021-01-07,COMIRNATY Vaccino a mRNA contro COVID-19,23224I,CASA RIPOSO COMUNALE EX-ONPI,TOS,40-49,1,0,0,0,0,1,0,1,0,1,Toscana,ITI1
2021-01-07,COMIRNATY Vaccino a mRNA contro COVID-19,23224I,CASA RIPOSO COMUNALE EX-ONPI,TOS,50-59,1,4,0,3,0,2,0,5,0,5,Toscana,ITI1
2021-01-07,COMIRNATY Vaccino a mRNA contro COVID-19,23224I,CASA RIPOSO COMUNALE EX-ONPI,TOS,60-69,2,0,0,0,0,2,0,2,0,2,Toscana,ITI1
2021-01-07,COMIRNATY Vaccino a mRNA contro COVID-19,23224I,CASA RIPOSO COMUNALE EX-ONPI,TOS,70-79,1,3,0,0,0,4,0,4,0,4,Toscana,ITI1
2021-01-07,COMIRNATY Vaccino a mRNA contro COVID-19,23224I,CASA RIPOSO COMUNALE EX-ONPI,TOS,80-89,5,13,0,1,0,17,0,18,0,18,Toscana,ITI1
2021-01-07,COMIRNATY Vaccino a mRNA contro COVID-19,23224I,CASA RIPOSO COMUNALE EX-ONPI,TOS,90+,4,2,0,0,0,6,0,6,0,6,Toscana,ITI1
2021-01-07,COMIRNATY Vaccino a mRNA contro COVID-19,25024I,RSA REGINA MUNDI,TOS,50-59,0,1,0,1,0,0,0,1,0,1,Toscana,ITI1
2021-01-07,COMIRNATY Vaccino a mRNA contro COVID-19,25024I,RSA REGINA MUNDI,TOS,80-89,0,5,0,0,0,5,0,5,0,5,Toscana,ITI1
2021-01-07,COMIRNATY Vaccino a mRNA contro COVID-19,25024I,RSA REGINA MUNDI,TOS,90+,1,5,0,0,0,6,0,6,0,6,Toscana,ITI1
2021-01-07,COMIRNATY Vaccino a mRNA contro COVID-19,321I4I,Covid19 - RSA SANTA CHIARA VOLTERRA,TOS,50-59,1,0,0,0,0,1,0,1,0,1,Toscana,ITI1
2021-01-07,COMIRNATY Vaccino a mRNA contro COVID-19,321I4I,Covid19 - RSA SANTA CHIARA VOLTERRA,TOS,60-69,2,0,0,0,0,2,0,2,0,2,Toscana,ITI1
2021-01-07,COMIRNATY Vaccino a mRNA contro COVID-19,321I4I,Covid19 - RSA SANTA CHIARA VOLTERRA,TOS,70-79,1,3,0,0,0,4,0,4,0,4,Toscana,ITI1
2021-01-07,COMIRNATY Vaccino a mRNA contro COVID-19,321I4I,Covid19 - RSA SANTA CHIARA VOLTERRA,TOS,80-89,2,8,0,0,0,10,0,10,0,10,Toscana,ITI1
2021-01-07,COMIRNATY Vaccino a mRNA contro COVID-19,321I4I,Covid19 - RSA SANTA CHIARA VOLTERRA,TOS,90+,3,4,0,0,0,7,0,7,0,7,Toscana,ITI1
2021-01-07,COMIRNATY Vaccino a mRNA contro COVID-19,33414L,RSD ISTI. PER ADULTI INABILI VILLA MIMOSA,TOS,16-19,1,1,0,0,0,2,0,2,0,2,Toscana,ITI1
2021-01-07,COMIRNATY Vaccino a mRNA contro COVID-19,33414L,RSD ISTI. PER ADULTI INABILI VILLA MIMOSA,TOS,20-29,1,0,0,0,0,1,0,1,0,1,Toscana,ITI1
2021-01-07,COMIRNATY Vaccino a mRNA contro COVID-19,33414L,RSD ISTI. PER ADULTI INABILI VILLA MIMOSA,TOS,30-39,4,0,0,0,0,4,0,4,0,4,Toscana,ITI1
2021-01-07,COMIRNATY Vaccino a mRNA contro COVID-19,33414L,RSD ISTI. PER ADULTI INABILI VILLA MIMOSA,TOS,40-49,4,2,0,0,0,6,0,6,0,6,Toscana,ITI1
2021-01-07,COMIRNATY Vaccino a mRNA contro COVID-19,33414L,RSD ISTI. PER ADULTI INABILI VILLA MIMOSA,TOS,50-59,2,0,0,0,0,2,0,2,0,2,Toscana,ITI1
2021-01-07,COMIRNATY Vaccino a mRNA contro COVID-19,33414L,RSD ISTI. PER ADULTI INABILI VILLA MIMOSA,TOS,60-69,3,0,0,0,0,3,0,3,0,3,Toscana,ITI1
2021-01-07,COMIRNATY Vaccino a mRNA contro COVID-19,40911A,COVID19 - Dip. Prevenzione Ruffolo Siena,TOS,30-39,0,1,0,1,0,0,0,1,0,1,Toscana,ITI1
2021-01-07,COMIRNATY Vaccino a mRNA contro COVID-19,42274I,RSA FERRUCCI,TOS,20-29,1,0,0,1,0,0,0,1,0,1,Toscana,ITI1
2021-01-07,COMIRNATY Vaccino a mRNA contro COVID-19,42274I,RSA FERRUCCI,TOS,30-39,2,0,0,0,1,1,0,2,0,2,Toscana,ITI1
2021-01-07,COMIRNATY Vaccino a mRNA contro COVID-19,42274I,RSA FERRUCCI,TOS,40-49,1,2,0,1,0,2,0,3,0,3,Toscana,ITI1
2021-01-07,COMIRNATY Vaccino a mRNA contro COVID-19,42274I,RSA FERRUCCI,TOS,50-59,4,5,0,2,2,5,0,9,0,9,Toscana,ITI1
2021-01-07,COMIRNATY Vaccino a mRNA contro COVID-19,42274I,RSA FERRUCCI,TOS,60-69,4,10,0,1,2,11,0,14,0,14,Toscana,ITI1
2021-01-07,COMIRNATY Vaccino a mRNA contro COVID-19,42274I,RSA FERRUCCI,TOS,70-79,5,5,0,0,0,10,0,10,0,10,Toscana,ITI1
2021-01-07,COMIRNATY Vaccino a mRNA contro COVID-19,42274I,RSA FERRUCCI,TOS,80-89,6,18,0,0,0,24,0,24,0,24,Toscana,ITI1
2021-01-07,COMIRNATY Vaccino a mRNA contro COVID-19,42274I,RSA FERRUCCI,TOS,90+,0,15,0,0,0,15,0,15,0,15,Toscana,ITI1
2021-01-07,COMIRNATY Vaccino a mRNA contro COVID-19,42714I,RSA CASA DI MICHELE,TOS,50-59,1,0,0,1,0,0,0,1,0,1,Toscana,ITI1
2021-01-07,COMIRNATY Vaccino a mRNA contro COVID-19,42714I,RSA CASA DI MICHELE,TOS,60-69,1,2,0,2,0,1,0,3,0,3,Toscana,ITI1
2021-01-07,COMIRNATY Vaccino a mRNA contro COVID-19,42714I,RSA CASA DI MICHELE,TOS,80-89,0,3,0,0,0,3,0,3,0,3,Toscana,ITI1
2021-01-07,COMIRNATY Vaccino a mRNA contro COVID-19,42714I,RSA CASA DI MICHELE,TOS,90+,0,5,0,0,0,5,0,5,0,5,Toscana,ITI1
2021-01-07,COMIRNATY Vaccino a mRNA contro COVID-19,46151A,CSS Portoferraio,TOS,20-29,2,5,0,7,0,0,0,7,0,7,Toscana,ITI1
2021-01-07,COMIRNATY Vaccino a mRNA contro COVID-19,46151A,CSS Portoferraio,TOS,30-39,2,2,0,4,0,0,0,4,0,4,Toscana,ITI1
2021-01-07,COMIRNATY Vaccino a mRNA contro COVID-19,46151A,CSS Portoferraio,TOS,40-49,1,6,0,7,0,0,0,7,0,7,Toscana,ITI1
2021-01-07,COMIRNATY Vaccino a mRNA contro COVID-19,46151A,CSS Portoferraio,TOS,50-59,4,2,0,6,0,0,0,6,0,6,Toscana,ITI1
2021-01-07,COMIRNATY Vaccino a mRNA contro COVID-19,46151A,CSS Portoferraio,TOS,60-69,4,2,0,6,0,0,0,6,0,6,Toscana,ITI1
2021-01-07,COMIRNATY Vaccino a mRNA contro COVID-19,46324I,R.S.A. VILLA CHIGI,TOS,20-29,0,1,0,1,0,0,0,1,0,1,Toscana,ITI1
2021-01-07,COMIRNATY Vaccino a mRNA contro COVID-19,46324I,R.S.A. VILLA CHIGI,TOS,30-39,0,1,0,1,0,0,0,1,0,1,Toscana,ITI1
2021-01-07,COMIRNATY Vaccino a mRNA contro COVID-19,46324I,R.S.A. VILLA CHIGI,TOS,40-49,0,1,0,1,0,0,0,1,0,1,Toscana,ITI1
2021-01-07,COMIRNATY Vaccino a mRNA contro COVID-19,46324I,R.S.A. VILLA CHIGI,TOS,50-59,1,1,0,2,0,0,0,2,0,2,Toscana,ITI1
2021-01-07,COMIRNATY Vaccino a mRNA contro COVID-19,46324I,R.S.A. VILLA CHIGI,TOS,60-69,0,3,0,3,0,0,0,3,0,3,Toscana,ITI1
2021-01-07,COMIRNATY Vaccino a mRNA contro COVID-19,46324I,R.S.A. VILLA CHIGI,TOS,70-79,1,3,0,0,0,4,0,4,0,4,Toscana,ITI1
2021-01-07,COMIRNATY Vaccino a mRNA contro COVID-19,46324I,R.S.A. VILLA CHIGI,TOS,80-89,7,8,0,0,0,15,0,15,0,15,Toscana,ITI1
2021-01-07,COMIRNATY Vaccino a mRNA contro COVID-19,46324I,R.S.A. VILLA CHIGI,TOS,90+,4,10,0,0,0,14,0,14,0,14,Toscana,ITI1
2021-01-07,COMIRNATY Vaccino a mRNA contro COVID-19,46624I,R.S.A. ASILO V. BORGHERI,TOS,40-49,0,1,0,1,0,0,0,1,0,1,Toscana,ITI1
2021-01-07,COMIRNATY Vaccino a mRNA contro COVID-19,46624I,R.S.A. ASILO V. BORGHERI,TOS,50-59,1,2,0,3,0,0,0,3,0,3,Toscana,ITI1
2021-01-07,COMIRNATY Vaccino a mRNA contro COVID-19,46624I,R.S.A. ASILO V. BORGHERI,TOS,60-69,3,3,0,2,0,4,0,6,0,6,Toscana,ITI1
2021-01-07,COMIRNATY Vaccino a mRNA contro COVID-19,46624I,R.S.A. ASILO V. BORGHERI,TOS,70-79,1,3,0,0,0,4,0,4,0,4,Toscana,ITI1
2021-01-07,COMIRNATY Vaccino a mRNA contro COVID-19,46624I,R.S.A. ASILO V. BORGHERI,TOS,80-89,6,11,0,1,0,16,0,17,0,17,Toscana,ITI1
2021-01-07,COMIRNATY Vaccino a mRNA contro COVID-19,46624I,R.S.A. ASILO V. BORGHERI,TOS,90+,2,8,0,0,0,10,0,10,0,10,Toscana,ITI1
2021-01-07,COMIRNATY Vaccino a mRNA contro COVID-19,60884I,RSA L'ULIVETO COOP SOCIALE LIB,TOS,20-29,0,1,0,1,0,0,0,1,0,1,Toscana,ITI1
2021-01-07,COMIRNATY Vaccino a mRNA contro COVID-19,60884I,RSA L'ULIVETO COOP SOCIALE LIB,TOS,30-39,0,3,0,3,0,0,0,3,0,3,Toscana,ITI1
2021-01-07,COMIRNATY Vaccino a mRNA contro COVID-19,60884I,RSA L'ULIVETO COOP SOCIALE LIB,TOS,40-49,1,4,0,4,0,1,0,5,0,5,Toscana,ITI1
2021-01-07,COMIRNATY Vaccino a mRNA contro COVID-19,60884I,RSA L'ULIVETO COOP SOCIALE LIB,TOS,50-59,0,4,0,2,0,2,0,4,0,4,Toscana,ITI1
2021-01-07,COMIRNATY Vaccino a mRNA contro COVID-19,60884I,RSA L'ULIVETO COOP SOCIALE LIB,TOS,60-69,1,3,0,1,0,3,0,4,0,4,Toscana,ITI1
2021-01-07,COMIRNATY Vaccino a mRNA contro COVID-19,60884I,RSA L'ULIVETO COOP SOCIALE LIB,TOS,70-79,2,1,0,0,0,3,0,3,0,3,Toscana,ITI1
2021-01-07,COMIRNATY Vaccino a mRNA contro COVID-19,60884I,RSA L'ULIVETO COOP SOCIALE LIB,TOS,80-89,4,13,0,0,0,17,0,17,0,17,Toscana,ITI1
2021-01-07,COMIRNATY Vaccino a mRNA contro COVID-19,60884I,RSA L'ULIVETO COOP SOCIALE LIB,TOS,90+,4,13,0,0,0,17,0,17,0,17,Toscana,ITI1
2021-01-07,COMIRNATY Vaccino a mRNA contro COVID-19,61464I,RSA MADONNA DELLE GRAZIE,TOS,20-29,0,2,0,2,0,0,0,2,0,2,Toscana,ITI1
2021-01-07,COMIRNATY Vaccino a mRNA contro COVID-19,61464I,RSA MADONNA DELLE GRAZIE,TOS,50-59,0,1,0,1,0,0,0,1,0,1,Toscana,ITI1
2021-01-07,COMIRNATY Vaccino a mRNA contro COVID-19,61464I,RSA MADONNA DELLE GRAZIE,TOS,60-69,0,1,0,1,0,0,0,1,0,1,Toscana,ITI1
2021-01-07,COMIRNATY Vaccino a mRNA contro COVID-19,61464I,RSA MADONNA DELLE GRAZIE,TOS,70-79,0,1,0,0,0,1,0,1,0,1,Toscana,ITI1
2021-01-07,COMIRNATY Vaccino a mRNA contro COVID-19,61464I,RSA MADONNA DELLE GRAZIE,TOS,80-89,0,1,0,0,0,1,0,1,0,1,Toscana,ITI1
2021-01-07,COMIRNATY Vaccino a mRNA contro COVID-19,66964I,IST. OPERA PLACCI,TOS,30-39,0,1,0,1,0,0,0,1,0,1,Toscana,ITI1
2021-01-07,COMIRNATY Vaccino a mRNA contro COVID-19,66964I,IST. OPERA PLACCI,TOS,40-49,0,3,0,3,0,0,0,3,0,3,Toscana,ITI1
2021-01-07,COMIRNATY Vaccino a mRNA contro COVID-19,66964I,IST. OPERA PLACCI,TOS,50-59,0,2,0,1,0,1,0,2,0,2,Toscana,ITI1
2021-01-07,COMIRNATY Vaccino a mRNA contro COVID-19,66964I,IST. OPERA PLACCI,TOS,60-69,1,2,0,1,0,2,0,3,0,3,Toscana,ITI1
2021-01-07,COMIRNATY Vaccino a mRNA contro COVID-19,66964I,IST. OPERA PLACCI,TOS,80-89,0,2,0,0,0,2,0,2,0,2,Toscana,ITI1
2021-01-07,COMIRNATY Vaccino a mRNA contro COVID-19,66964I,IST. OPERA PLACCI,TOS,90+,0,1,0,0,0,1,0,1,0,1,Toscana,ITI1
2021-01-07,COMIRNATY Vaccino a mRNA contro COVID-19,80114I,ANTONIO RICCI RESIDENZIALE,TOS,60-69,0,1,0,0,0,1,0,1,0,1,Toscana,ITI1
2021-01-07,COMIRNATY Vaccino a mRNA contro COVID-19,80114I,ANTONIO RICCI RESIDENZIALE,TOS,70-79,1,1,0,0,0,2,0,2,0,2,Toscana,ITI1
2021-01-07,COMIRNATY Vaccino a mRNA contro COVID-19,80114I,ANTONIO RICCI RESIDENZIALE,TOS,80-89,0,7,0,0,0,7,0,7,0,7,Toscana,ITI1
2021-01-07,COMIRNATY Vaccino a mRNA contro COVID-19,80114I,ANTONIO RICCI RESIDENZIALE,TOS,90+,0,5,0,0,0,5,0,5,0,5,Toscana,ITI1
2021-01-07,COMIRNATY Vaccino a mRNA contro COVID-19,80354I,A.S.P.CENTRO RESID.L.MARTELLI/,TOS,20-29,1,2,0,3,0,0,0,3,0,3,Toscana,ITI1
2021-01-07,COMIRNATY Vaccino a mRNA contro COVID-19,80354I,A.S.P.CENTRO RESID.L.MARTELLI/,TOS,30-39,1,1,0,2,0,0,0,2,0,2,Toscana,ITI1
2021-01-07,COMIRNATY Vaccino a mRNA contro COVID-19,80354I,A.S.P.CENTRO RESID.L.MARTELLI/,TOS,40-49,1,1,0,2,0,0,0,2,0,2,Toscana,ITI1
2021-01-07,COMIRNATY Vaccino a mRNA contro COVID-19,80354I,A.S.P.CENTRO RESID.L.MARTELLI/,TOS,50-59,4,6,0,4,0,6,0,10,0,10,Toscana,ITI1
2021-01-07,COMIRNATY Vaccino a mRNA contro COVID-19,80354I,A.S.P.CENTRO RESID.L.MARTELLI/,TOS,60-69,1,3,0,1,0,3,0,4,0,4,Toscana,ITI1
2021-01-07,COMIRNATY Vaccino a mRNA contro COVID-19,80354I,A.S.P.CENTRO RESID.L.MARTELLI/,TOS,70-79,2,3,0,0,0,5,0,5,0,5,Toscana,ITI1
2021-01-07,COMIRNATY Vaccino a mRNA contro COVID-19,80354I,A.S.P.CENTRO RESID.L.MARTELLI/,TOS,80-89,5,13,0,0,0,18,0,18,0,18,Toscana,ITI1
2021-01-07,COMIRNATY Vaccino a mRNA contro COVID-19,80354I,A.S.P.CENTRO RESID.L.MARTELLI/,TOS,90+,1,15,0,0,0,16,0,16,0,16,Toscana,ITI1
2021-01-07,COMIRNATY Vaccino a mRNA contro COVID-19,M3014M,Covid19 - ANFAS Monteverde,TOS,30-39,2,2,0,1,0,3,0,4,0,4,Toscana,ITI1
2021-01-07,COMIRNATY Vaccino a mRNA contro COVID-19,M3014M,Covid19 - ANFAS Monteverde,TOS,40-49,4,3,0,2,0,5,0,7,0,7,Toscana,ITI1
2021-01-07,COMIRNATY Vaccino a mRNA contro COVID-19,M3014M,Covid19 - ANFAS Monteverde,TOS,50-59,6,2,0,1,0,7,0,8,0,8,Toscana,ITI1
2021-01-07,COMIRNATY Vaccino a mRNA contro COVID-19,M3014M,Covid19 - ANFAS Monteverde,TOS,60-69,1,3,0,1,0,3,0,4,0,4,Toscana,ITI1
2021-01-07,COMIRNATY Vaccino a mRNA contro COVID-19,ND,"R.S.A. Privato Sociale e Onlus CASA DELL'AMICIZIA S.AGNESE PER ANZIANI ""S. AGNESE",TOS,40-49,0,1,0,1,0,0,0,1,0,1,Toscana,ITI1
2021-01-07,COMIRNATY Vaccino a mRNA contro COVID-19,ND,"R.S.A. Privato Sociale e Onlus CASA DELL'AMICIZIA S.AGNESE PER ANZIANI ""S. AGNESE",TOS,80-89,1,2,0,0,0,3,0,3,0,3,Toscana,ITI1
2021-01-07,COMIRNATY Vaccino a mRNA contro COVID-19,ND,"R.S.A. Privato Sociale e Onlus CASA DELL'AMICIZIA S.AGNESE PER ANZIANI ""S. AGNESE",TOS,90+,1,6,0,0,0,7,0,7,0,7,Toscana,ITI1
2021-01-07,COMIRNATY Vaccino a mRNA contro COVID-19,V0054I,RSA VILLA MARIA LIDO DI CAMAIO,TOS,70-79,1,0,0,0,0,1,0,1,0,1,Toscana,ITI1
2021-01-07,COMIRNATY Vaccino a mRNA contro COVID-19,V0054I,RSA VILLA MARIA LIDO DI CAMAIO,TOS,80-89,0,3,0,0,0,3,0,3,0,3,Toscana,ITI1
2021-01-07,COMIRNATY Vaccino a mRNA contro COVID-19,V0054I,RSA VILLA MARIA LIDO DI CAMAIO,TOS,90+,0,4,0,0,0,4,0,4,0,4,Toscana,ITI1
2021-01-08,COMIRNATY Vaccino a mRNA contro COVID-19,01024I,RSA VILLA CHIARA,TOS,40-49,1,0,0,0,0,1,0,1,0,1,Toscana,ITI1
2021-01-08,COMIRNATY Vaccino a mRNA contro COVID-19,01024I,RSA VILLA CHIARA,TOS,50-59,1,1,0,1,0,1,0,2,0,2,Toscana,ITI1
2021-01-08,COMIRNATY Vaccino a mRNA contro COVID-19,01024I,RSA VILLA CHIARA,TOS,60-69,0,1,0,0,0,1,0,1,0,1,Toscana,ITI1
2021-01-08,COMIRNATY Vaccino a mRNA contro COVID-19,01024I,RSA VILLA CHIARA,TOS,70-79,1,1,0,0,0,2,0,2,0,2,Toscana,ITI1
2021-01-08,COMIRNATY Vaccino a mRNA contro COVID-19,01024I,RSA VILLA CHIARA,TOS,80-89,2,12,0,0,0,14,0,14,0,14,Toscana,ITI1
2021-01-08,COMIRNATY Vaccino a mRNA contro COVID-19,01024I,RSA VILLA CHIARA,TOS,90+,0,14,0,0,0,14,0,14,0,14,Toscana,ITI1
2021-01-08,COMIRNATY Vaccino a mRNA contro COVID-19,03002D,Covid 19 - Ospedale S.Francesco di Barga,TOS,20-29,1,5,0,6,0,0,0,6,0,6,Toscana,ITI1
2021-01-08,COMIRNATY Vaccino a mRNA contro COVID-19,03002D,Covid 19 - Ospedale S.Francesco di Barga,TOS,30-39,0,7,0,7,0,0,0,7,0,7,Toscana,ITI1
2021-01-08,COMIRNATY Vaccino a mRNA contro COVID-19,03002D,Covid 19 - Ospedale S.Francesco di Barga,TOS,40-49,0,10,0,10,0,0,0,10,0,10,Toscana,ITI1
2021-01-08,COMIRNATY Vaccino a mRNA contro COVID-19,03002D,Covid 19 - Ospedale S.Francesco di Barga,TOS,50-59,4,25,0,29,0,0,0,29,0,29,Toscana,ITI1
2021-01-08,COMIRNATY Vaccino a mRNA contro COVID-19,03002D,Covid 19 - Ospedale S.Francesco di Barga,TOS,60-69,2,6,0,8,0,0,0,8,0,8,Toscana,ITI1
2021-01-08,COMIRNATY Vaccino a mRNA contro COVID-19,05424I,Covid19 - RSA ARCOBALENO,TOS,30-39,1,0,0,1,0,0,0,1,0,1,Toscana,ITI1
2021-01-08,COMIRNATY Vaccino a mRNA contro COVID-19,05424I,Covid19 - RSA ARCOBALENO,TOS,40-49,1,3,0,4,0,0,0,4,0,4,Toscana,ITI1
2021-01-08,COMIRNATY Vaccino a mRNA contro COVID-19,05424I,Covid19 - RSA ARCOBALENO,TOS,50-59,2,2,0,3,0,1,0,4,0,4,Toscana,ITI1
2021-01-08,COMIRNATY Vaccino a mRNA contro COVID-19,05424I,Covid19 - RSA ARCOBALENO,TOS,60-69,0,1,0,1,0,0,0,1,0,1,Toscana,ITI1
2021-01-08,COMIRNATY Vaccino a mRNA contro COVID-19,06104I,RSA IL SOLE,TOS,80-89,1,0,0,0,0,1,0,1,0,1,Toscana,ITI1
2021-01-08,COMIRNATY Vaccino a mRNA contro COVID-19,090602,Covid 19 - Nuovo Ospedale Apuane,TOS,20-29,6,15,0,19,2,0,0,21,0,21,Toscana,ITI1
2021-01-08,COMIRNATY Vaccino a mRNA contro COVID-19,090602,Covid 19 - Nuovo Ospedale Apuane,TOS,30-39,4,20,0,24,0,0,0,24,0,24,Toscana,ITI1
2021-01-08,COMIRNATY Vaccino a mRNA contro COVID-19,090602,Covid 19 - Nuovo Ospedale Apuane,TOS,40-49,8,41,0,49,0,0,0,49,0,49,Toscana,ITI1
2021-01-08,COMIRNATY Vaccino a mRNA contro COVID-19,090602,Covid 19 - Nuovo Ospedale Apuane,TOS,50-59,9,56,0,65,0,0,0,65,0,65,Toscana,ITI1
2021-01-08,COMIRNATY Vaccino a mRNA contro COVID-19,090602,Covid 19 - Nuovo Ospedale Apuane,TOS,60-69,10,27,0,37,0,0,0,37,0,37,Toscana,ITI1
2021-01-08,COMIRNATY Vaccino a mRNA contro COVID-19,090602,Covid 19 - Nuovo Ospedale Apuane,TOS,70-79,1,0,0,1,0,0,0,1,0,1,Toscana,ITI1
2021-01-08,COMIRNATY Vaccino a mRNA contro COVID-19,090603,Covid 19 - Ospedale Santa Croce in Garfagnana,TOS,20-29,2,9,0,11,0,0,0,11,0,11,Toscana,ITI1
2021-01-08,COMIRNATY Vaccino a mRNA contro COVID-19,090603,Covid 19 - Ospedale Santa Croce in Garfagnana,TOS,30-39,1,1,0,2,0,0,0,2,0,2,Toscana,ITI1
2021-01-08,COMIRNATY Vaccino a mRNA contro COVID-19,090603,Covid 19 - Ospedale Santa Croce in Garfagnana,TOS,40-49,1,10,0,11,0,0,0,11,0,11,Toscana,ITI1
2021-01-08,COMIRNATY Vaccino a mRNA contro COVID-19,090603,Covid 19 - Ospedale Santa Croce in Garfagnana,TOS,50-59,7,19,0,26,0,0,0,26,0,26,Toscana,ITI1
2021-01-08,COMIRNATY Vaccino a mRNA contro COVID-19,090603,Covid 19 - Ospedale Santa Croce in Garfagnana,TOS,60-69,4,6,0,10,0,0,0,10,0,10,Toscana,ITI1
2021-01-08,COMIRNATY Vaccino a mRNA contro COVID-19,090604,Covid 19 - Ospedale San Luca di  Lucca,TOS,20-29,7,33,0,40,0,0,0,40,0,40,Toscana,ITI1
2021-01-08,COMIRNATY Vaccino a mRNA contro COVID-19,090604,Covid 19 - Ospedale San Luca di  Lucca,TOS,30-39,11,20,0,31,0,0,0,31,0,31,Toscana,ITI1
2021-01-08,COMIRNATY Vaccino a mRNA contro COVID-19,090604,Covid 19 - Ospedale San Luca di  Lucca,TOS,40-49,7,35,0,41,1,0,0,42,0,42,Toscana,ITI1
2021-01-08,COMIRNATY Vaccino a mRNA contro COVID-19,090604,Covid 19 - Ospedale San Luca di  Lucca,TOS,50-59,7,50,0,57,0,0,0,57,0,57,Toscana,ITI1
2021-01-08,COMIRNATY Vaccino a mRNA contro COVID-19,090604,Covid 19 - Ospedale San Luca di  Lucca,TOS,60-69,8,14,0,22,0,0,0,22,0,22,Toscana,ITI1
2021-01-08,COMIRNATY Vaccino a mRNA contro COVID-19,090604,Covid 19 - Ospedale San Luca di  Lucca,TOS,70-79,2,2,0,4,0,0,0,4,0,4,Toscana,ITI1
2021-01-08,COMIRNATY Vaccino a mRNA contro COVID-19,090606,COVID19 - Ospedale San Iacopo,TOS,20-29,1,11,0,12,0,0,0,12,0,12,Toscana,ITI1
2021-01-08,COMIRNATY Vaccino a mRNA contro COVID-19,090606,COVID19 - Ospedale San Iacopo,TOS,30-39,8,17,0,25,0,0,0,25,0,25,Toscana,ITI1
2021-01-08,COMIRNATY Vaccino a mRNA contro COVID-19,090606,COVID19 - Ospedale San Iacopo,TOS,40-49,6,38,0,44,0,0,0,44,0,44,Toscana,ITI1
2021-01-08,COMIRNATY Vaccino a mRNA contro COVID-19,090606,COVID19 - Ospedale San Iacopo,TOS,50-59,13,45,0,58,0,0,0,58,0,58,Toscana,ITI1
2021-01-08,COMIRNATY Vaccino a mRNA contro COVID-19,090606,COVID19 - Ospedale San Iacopo,TOS,60-69,3,7,0,10,0,0,0,10,0,10,Toscana,ITI1
2021-01-08,COMIRNATY Vaccino a mRNA contro COVID-19,090607,COVID19 - Ospedale SS.Cosma e Damiano,TOS,20-29,1,6,0,7,0,0,0,7,0,7,Toscana,ITI1
2021-01-08,COMIRNATY Vaccino a mRNA contro COVID-19,090607,COVID19 - Ospedale SS.Cosma e Damiano,TOS,40-49,2,9,0,11,0,0,0,11,0,11,Toscana,ITI1
2021-01-08,COMIRNATY Vaccino a mRNA contro COVID-19,090607,COVID19 - Ospedale SS.Cosma e Damiano,TOS,50-59,6,17,0,23,0,0,0,23,0,23,Toscana,ITI1
2021-01-08,COMIRNATY Vaccino a mRNA contro COVID-19,090607,COVID19 - Ospedale SS.Cosma e Damiano,TOS,60-69,1,5,0,6,0,0,0,6,0,6,Toscana,ITI1
2021-01-08,COMIRNATY Vaccino a mRNA contro COVID-19,090607,COVID19 - Ospedale SS.Cosma e Damiano,TOS,70-79,1,0,0,1,0,0,0,1,0,1,Toscana,ITI1
2021-01-08,COMIRNATY Vaccino a mRNA contro COVID-19,090608,COVID19 - Ospedale Santo Stefano,TOS,20-29,1,8,0,9,0,0,0,9,0,9,Toscana,ITI1
2021-01-08,COMIRNATY Vaccino a mRNA contro COVID-19,090608,COVID19 - Ospedale Santo Stefano,TOS,30-39,8,33,0,38,0,3,0,41,0,41,Toscana,ITI1
2021-01-08,COMIRNATY Vaccino a mRNA contro COVID-19,090608,COVID19 - Ospedale Santo Stefano,TOS,40-49,10,36,0,42,0,4,0,46,0,46,Toscana,ITI1
2021-01-08,COMIRNATY Vaccino a mRNA contro COVID-19,090608,COVID19 - Ospedale Santo Stefano,TOS,50-59,11,33,0,41,0,3,0,44,0,44,Toscana,ITI1
2021-01-08,COMIRNATY Vaccino a mRNA contro COVID-19,090608,COVID19 - Ospedale Santo Stefano,TOS,60-69,10,11,0,17,0,4,0,21,0,21,Toscana,ITI1
2021-01-08,COMIRNATY Vaccino a mRNA contro COVID-19,090608,COVID19 - Ospedale Santo Stefano,TOS,70-79,0,2,0,2,0,0,0,2,0,2,Toscana,ITI1
2021-01-08,COMIRNATY Vaccino a mRNA contro COVID-19,090608,COVID19 - Ospedale Santo Stefano,TOS,80-89,0,1,0,1,0,0,0,1,0,1,Toscana,ITI1
2021-01-08,COMIRNATY Vaccino a mRNA contro COVID-19,090609,Covid 19 - Ospedale S.Maria Maddalena di Volterra,TOS,20-29,2,1,0,3,0,0,0,3,0,3,Toscana,ITI1
2021-01-08,COMIRNATY Vaccino a mRNA contro COVID-19,090609,Covid 19 - Ospedale S.Maria Maddalena di Volterra,TOS,30-39,4,7,0,11,0,0,0,11,0,11,Toscana,ITI1
2021-01-08,COMIRNATY Vaccino a mRNA contro COVID-19,090609,Covid 19 - Ospedale S.Maria Maddalena di Volterra,TOS,40-49,7,8,0,15,0,0,0,15,0,15,Toscana,ITI1
2021-01-08,COMIRNATY Vaccino a mRNA contro COVID-19,090609,Covid 19 - Ospedale S.Maria Maddalena di Volterra,TOS,50-59,4,19,0,23,0,0,0,23,0,23,Toscana,ITI1
2021-01-08,COMIRNATY Vaccino a mRNA contro COVID-19,090609,Covid 19 - Ospedale S.Maria Maddalena di Volterra,TOS,60-69,3,5,0,8,0,0,0,8,0,8,Toscana,ITI1
2021-01-08,COMIRNATY Vaccino a mRNA contro COVID-19,090610,Covid 19 - Ospedale F.Lotti di Pontedera,TOS,20-29,2,12,0,14,0,0,0,14,0,14,Toscana,ITI1
2021-01-08,COMIRNATY Vaccino a mRNA contro COVID-19,090610,Covid 19 - Ospedale F.Lotti di Pontedera,TOS,30-39,3,9,0,12,0,0,0,12,0,12,Toscana,ITI1
2021-01-08,COMIRNATY Vaccino a mRNA contro COVID-19,090610,Covid 19 - Ospedale F.Lotti di Pontedera,TOS,40-49,4,16,0,20,0,0,0,20,0,20,Toscana,ITI1
2021-01-08,COMIRNATY Vaccino a mRNA contro COVID-19,090610,Covid 19 - Ospedale F.Lotti di Pontedera,TOS,50-59,7,24,0,31,0,0,0,31,0,31,Toscana,ITI1
2021-01-08,COMIRNATY Vaccino a mRNA contro COVID-19,090610,Covid 19 - Ospedale F.Lotti di Pontedera,TOS,60-69,3,3,0,6,0,0,0,6,0,6,Toscana,ITI1
2021-01-08,COMIRNATY Vaccino a mRNA contro COVID-19,090610,Covid 19 - Ospedale F.Lotti di Pontedera,TOS,80-89,1,0,0,1,0,0,0,1,0,1,Toscana,ITI1
2021-01-08,COMIRNATY Vaccino a mRNA contro COVID-19,090613,Covid 19 - Ospedali Riuniti di Livorno,TOS,20-29,6,27,0,33,0,0,0,33,0,33,Toscana,ITI1
2021-01-08,COMIRNATY Vaccino a mRNA contro COVID-19,090613,Covid 19 - Ospedali Riuniti di Livorno,TOS,30-39,6,29,0,34,0,1,0,35,0,35,Toscana,ITI1
2021-01-08,COMIRNATY Vaccino a mRNA contro COVID-19,090613,Covid 19 - Ospedali Riuniti di Livorno,TOS,40-49,9,43,0,52,0,0,0,52,0,52,Toscana,ITI1
2021-01-08,COMIRNATY Vaccino a mRNA contro COVID-19,090613,Covid 19 - Ospedali Riuniti di Livorno,TOS,50-59,25,59,0,84,0,0,0,84,0,84,Toscana,ITI1
2021-01-08,COMIRNATY Vaccino a mRNA contro COVID-19,090613,Covid 19 - Ospedali Riuniti di Livorno,TOS,60-69,19,20,0,37,0,2,0,39,0,39,Toscana,ITI1
2021-01-08,COMIRNATY Vaccino a mRNA contro COVID-19,090613,Covid 19 - Ospedali Riuniti di Livorno,TOS,70-79,2,3,0,0,0,5,0,5,0,5,Toscana,ITI1
2021-01-08,COMIRNATY Vaccino a mRNA contro COVID-19,090613,Covid 19 - Ospedali Riuniti di Livorno,TOS,80-89,0,9,0,0,0,9,0,9,0,9,Toscana,ITI1
2021-01-08,COMIRNATY Vaccino a mRNA contro COVID-19,090613,Covid 19 - Ospedali Riuniti di Livorno,TOS,90+,0,7,0,0,0,7,0,7,0,7,Toscana,ITI1
2021-01-08,COMIRNATY Vaccino a mRNA contro COVID-19,090618,COVID19 - Ospedale del Bibbiena,TOS,20-29,1,2,0,3,0,0,0,3,0,3,Toscana,ITI1
2021-01-08,COMIRNATY Vaccino a mRNA contro COVID-19,090618,COVID19 - Ospedale del Bibbiena,TOS,30-39,0,1,0,1,0,0,0,1,0,1,Toscana,ITI1
2021-01-08,COMIRNATY Vaccino a mRNA contro COVID-19,090618,COVID19 - Ospedale del Bibbiena,TOS,40-49,2,9,0,11,0,0,0,11,0,11,Toscana,ITI1
2021-01-08,COMIRNATY Vaccino a mRNA contro COVID-19,090618,COVID19 - Ospedale del Bibbiena,TOS,50-59,3,9,0,12,0,0,0,12,0,12,Toscana,ITI1
2021-01-08,COMIRNATY Vaccino a mRNA contro COVID-19,090618,COVID19 - Ospedale del Bibbiena,TOS,60-69,1,2,0,3,0,0,0,3,0,3,Toscana,ITI1
2021-01-08,COMIRNATY Vaccino a mRNA contro COVID-19,090621,COVID19 - Ospedale di Arezzo,TOS,20-29,7,25,0,32,0,0,0,32,0,32,Toscana,ITI1
2021-01-08,COMIRNATY Vaccino a mRNA contro COVID-19,090621,COVID19 - Ospedale di Arezzo,TOS,30-39,11,35,0,46,0,0,0,46,0,46,Toscana,ITI1
2021-01-08,COMIRNATY Vaccino a mRNA contro COVID-19,090621,COVID19 - Ospedale di Arezzo,TOS,40-49,22,53,0,75,0,0,0,75,0,75,Toscana,ITI1
2021-01-08,COMIRNATY Vaccino a mRNA contro COVID-19,090621,COVID19 - Ospedale di Arezzo,TOS,50-59,8,41,0,49,0,0,0,49,0,49,Toscana,ITI1
2021-01-08,COMIRNATY Vaccino a mRNA contro COVID-19,090621,COVID19 - Ospedale di Arezzo,TOS,60-69,10,14,0,23,0,1,0,24,0,24,Toscana,ITI1
2021-01-08,COMIRNATY Vaccino a mRNA contro COVID-19,090621,COVID19 - Ospedale di Arezzo,TOS,70-79,1,1,0,2,0,0,0,2,0,2,Toscana,ITI1
2021-01-08,COMIRNATY Vaccino a mRNA contro COVID-19,090623,COVID19 - Ospedale S.Andrea Massa Marittima,TOS,30-39,0,3,0,3,0,0,0,3,0,3,Toscana,ITI1
2021-01-08,COMIRNATY Vaccino a mRNA contro COVID-19,090623,COVID19 - Ospedale S.Andrea Massa Marittima,TOS,40-49,1,9,0,10,0,0,0,10,0,10,Toscana,ITI1
2021-01-08,COMIRNATY Vaccino a mRNA contro COVID-19,090623,COVID19 - Ospedale S.Andrea Massa Marittima,TOS,50-59,6,13,0,19,0,0,0,19,0,19,Toscana,ITI1
2021-01-08,COMIRNATY Vaccino a mRNA contro COVID-19,090623,COVID19 - Ospedale S.Andrea Massa Marittima,TOS,60-69,2,2,0,4,0,0,0,4,0,4,Toscana,ITI1
2021-01-08,COMIRNATY Vaccino a mRNA contro COVID-19,090625,COVID19 - Ospedale Amiata Castel del Piano,TOS,20-29,2,2,0,4,0,0,0,4,0,4,Toscana,ITI1
2021-01-08,COMIRNATY Vaccino a mRNA contro COVID-19,090625,COVID19 - Ospedale Amiata Castel del Piano,TOS,30-39,3,6,0,9,0,0,0,9,0,9,Toscana,ITI1
2021-01-08,COMIRNATY Vaccino a mRNA contro COVID-19,090625,COVID19 - Ospedale Amiata Castel del Piano,TOS,40-49,1,8,0,9,0,0,0,9,0,9,Toscana,ITI1
2021-01-08,COMIRNATY Vaccino a mRNA contro COVID-19,090625,COVID19 - Ospedale Amiata Castel del Piano,TOS,50-59,3,7,0,10,0,0,0,10,0,10,Toscana,ITI1
2021-01-08,COMIRNATY Vaccino a mRNA contro COVID-19,090625,COVID19 - Ospedale Amiata Castel del Piano,TOS,60-69,1,3,0,4,0,0,0,4,0,4,Toscana,ITI1
2021-01-08,COMIRNATY Vaccino a mRNA contro COVID-19,090626,COVID19 - Ospedale di Grosseto,TOS,20-29,2,8,0,10,0,0,0,10,0,10,Toscana,ITI1
2021-01-08,COMIRNATY Vaccino a mRNA contro COVID-19,090626,COVID19 - Ospedale di Grosseto,TOS,30-39,12,23,0,35,0,0,0,35,0,35,Toscana,ITI1
2021-01-08,COMIRNATY Vaccino a mRNA contro COVID-19,090626,COVID19 - Ospedale di Grosseto,TOS,40-49,14,26,0,40,0,0,0,40,0,40,Toscana,ITI1
2021-01-08,COMIRNATY Vaccino a mRNA contro COVID-19,090626,COVID19 - Ospedale di Grosseto,TOS,50-59,15,35,0,50,0,0,0,50,0,50,Toscana,ITI1
2021-01-08,COMIRNATY Vaccino a mRNA contro COVID-19,090626,COVID19 - Ospedale di Grosseto,TOS,60-69,6,14,0,20,0,0,0,20,0,20,Toscana,ITI1
2021-01-08,COMIRNATY Vaccino a mRNA contro COVID-19,090627,COVID19 - Ospedale Mugello,TOS,20-29,0,1,0,1,0,0,0,1,0,1,Toscana,ITI1
2021-01-08,COMIRNATY Vaccino a mRNA contro COVID-19,090627,COVID19 - Ospedale Mugello,TOS,30-39,1,9,0,9,1,0,0,10,0,10,Toscana,ITI1
2021-01-08,COMIRNATY Vaccino a mRNA contro COVID-19,090627,COVID19 - Ospedale Mugello,TOS,40-49,2,15,0,16,1,0,0,17,0,17,Toscana,ITI1
2021-01-08,COMIRNATY Vaccino a mRNA contro COVID-19,090627,COVID19 - Ospedale Mugello,TOS,50-59,0,15,0,13,2,0,0,15,0,15,Toscana,ITI1
2021-01-08,COMIRNATY Vaccino a mRNA contro COVID-19,090627,COVID19 - Ospedale Mugello,TOS,60-69,3,2,0,5,0,0,0,5,0,5,Toscana,ITI1
2021-01-08,COMIRNATY Vaccino a mRNA contro COVID-19,090629,COVID19 - Ospedale SS. Maria Annunziata,TOS,20-29,4,7,0,11,0,0,0,11,0,11,Toscana,ITI1
2021-01-08,COMIRNATY Vaccino a mRNA contro COVID-19,090629,COVID19 - Ospedale SS. Maria Annunziata,TOS,30-39,11,29,0,37,1,2,0,40,0,40,Toscana,ITI1
2021-01-08,COMIRNATY Vaccino a mRNA contro COVID-19,090629,COVID19 - Ospedale SS. Maria Annunziata,TOS,40-49,15,28,0,40,1,2,0,43,0,43,Toscana,ITI1
2021-01-08,COMIRNATY Vaccino a mRNA contro COVID-19,090629,COVID19 - Ospedale SS. Maria Annunziata,TOS,50-59,12,38,0,43,2,5,0,50,0,50,Toscana,ITI1
2021-01-08,COMIRNATY Vaccino a mRNA contro COVID-19,090629,COVID19 - Ospedale SS. Maria Annunziata,TOS,60-69,6,8,0,11,3,0,0,14,0,14,Toscana,ITI1
2021-01-08,COMIRNATY Vaccino a mRNA contro COVID-19,090629,COVID19 - Ospedale SS. Maria Annunziata,TOS,70-79,1,0,0,1,0,0,0,1,0,1,Toscana,ITI1
2021-01-08,COMIRNATY Vaccino a mRNA contro COVID-19,090632,COVID19 - Ospedale Santa Maria Nuova,TOS,20-29,4,9,0,13,0,0,0,13,0,13,Toscana,ITI1
2021-01-08,COMIRNATY Vaccino a mRNA contro COVID-19,090632,COVID19 - Ospedale Santa Maria Nuova,TOS,30-39,6,7,0,13,0,0,0,13,0,13,Toscana,ITI1
2021-01-08,COMIRNATY Vaccino a mRNA contro COVID-19,090632,COVID19 - Ospedale Santa Maria Nuova,TOS,40-49,8,15,0,23,0,0,0,23,0,23,Toscana,ITI1
2021-01-08,COMIRNATY Vaccino a mRNA contro COVID-19,090632,COVID19 - Ospedale Santa Maria Nuova,TOS,50-59,7,28,0,35,0,0,0,35,0,35,Toscana,ITI1
2021-01-08,COMIRNATY Vaccino a mRNA contro COVID-19,090632,COVID19 - Ospedale Santa Maria Nuova,TOS,60-69,5,12,0,17,0,0,0,17,0,17,Toscana,ITI1
2021-01-08,COMIRNATY Vaccino a mRNA contro COVID-19,090632,COVID19 - Ospedale Santa Maria Nuova,TOS,80-89,1,0,0,1,0,0,0,1,0,1,Toscana,ITI1
2021-01-08,COMIRNATY Vaccino a mRNA contro COVID-19,090637,COVID19 - Ospedale Amiata Val d'Orcia  Abbadia San Salvatore,TOS,30-39,1,2,0,3,0,0,0,3,0,3,Toscana,ITI1
2021-01-08,COMIRNATY Vaccino a mRNA contro COVID-19,090637,COVID19 - Ospedale Amiata Val d'Orcia  Abbadia San Salvatore,TOS,40-49,1,2,0,3,0,0,0,3,0,3,Toscana,ITI1
2021-01-08,COMIRNATY Vaccino a mRNA contro COVID-19,090637,COVID19 - Ospedale Amiata Val d'Orcia  Abbadia San Salvatore,TOS,50-59,2,2,0,4,0,0,0,4,0,4,Toscana,ITI1
2021-01-08,COMIRNATY Vaccino a mRNA contro COVID-19,090637,COVID19 - Ospedale Amiata Val d'Orcia  Abbadia San Salvatore,TOS,60-69,2,0,0,2,0,0,0,2,0,2,Toscana,ITI1
2021-01-08,COMIRNATY Vaccino a mRNA contro COVID-19,090639,COVID19 - Ospedale di Nottola Montepulciano,TOS,20-29,3,7,1,10,0,0,0,10,0,10,Toscana,ITI1
2021-01-08,COMIRNATY Vaccino a mRNA contro COVID-19,090639,COVID19 - Ospedale di Nottola Montepulciano,TOS,30-39,3,11,1,14,0,0,0,14,0,14,Toscana,ITI1
2021-01-08,COMIRNATY Vaccino a mRNA contro COVID-19,090639,COVID19 - Ospedale di Nottola Montepulciano,TOS,40-49,2,22,1,24,0,0,0,24,0,24,Toscana,ITI1
2021-01-08,COMIRNATY Vaccino a mRNA contro COVID-19,090639,COVID19 - Ospedale di Nottola Montepulciano,TOS,50-59,7,25,1,32,0,0,0,32,0,32,Toscana,ITI1
2021-01-08,COMIRNATY Vaccino a mRNA contro COVID-19,090639,COVID19 - Ospedale di Nottola Montepulciano,TOS,60-69,9,6,1,14,0,0,1,15,0,15,Toscana,ITI1
2021-01-08,COMIRNATY Vaccino a mRNA contro COVID-19,090640,Covid 19 - Ospedale Unico Versilia,TOS,20-29,4,21,0,25,0,0,0,25,0,25,Toscana,ITI1
2021-01-08,COMIRNATY Vaccino a mRNA contro COVID-19,090640,Covid 19 - Ospedale Unico Versilia,TOS,30-39,12,22,0,33,1,0,0,34,0,34,Toscana,ITI1
2021-01-08,COMIRNATY Vaccino a mRNA contro COVID-19,090640,Covid 19 - Ospedale Unico Versilia,TOS,40-49,9,40,0,48,1,0,0,49,0,49,Toscana,ITI1
2021-01-08,COMIRNATY Vaccino a mRNA contro COVID-19,090640,Covid 19 - Ospedale Unico Versilia,TOS,50-59,15,55,0,65,4,1,0,70,0,70,Toscana,ITI1
2021-01-08,COMIRNATY Vaccino a mRNA contro COVID-19,090640,Covid 19 - Ospedale Unico Versilia,TOS,60-69,10,15,0,24,0,1,0,25,0,25,Toscana,ITI1
2021-01-08,COMIRNATY Vaccino a mRNA contro COVID-19,090640,Covid 19 - Ospedale Unico Versilia,TOS,70-79,7,1,0,4,0,4,0,8,0,8,Toscana,ITI1
2021-01-08,COMIRNATY Vaccino a mRNA contro COVID-19,090640,Covid 19 - Ospedale Unico Versilia,TOS,80-89,2,4,0,0,0,6,0,6,0,6,Toscana,ITI1
2021-01-08,COMIRNATY Vaccino a mRNA contro COVID-19,090640,Covid 19 - Ospedale Unico Versilia,TOS,90+,0,4,0,0,0,4,0,4,0,4,Toscana,ITI1
2021-01-08,COMIRNATY Vaccino a mRNA contro COVID-19,090641,COVID19 - Ospedale La Gruccia Montevarchi,TOS,20-29,1,5,0,6,0,0,0,6,0,6,Toscana,ITI1
2021-01-08,COMIRNATY Vaccino a mRNA contro COVID-19,090641,COVID19 - Ospedale La Gruccia Montevarchi,TOS,30-39,7,17,0,24,0,0,0,24,0,24,Toscana,ITI1
2021-01-08,COMIRNATY Vaccino a mRNA contro COVID-19,090641,COVID19 - Ospedale La Gruccia Montevarchi,TOS,40-49,1,19,0,19,1,0,0,20,0,20,Toscana,ITI1
2021-01-08,COMIRNATY Vaccino a mRNA contro COVID-19,090641,COVID19 - Ospedale La Gruccia Montevarchi,TOS,50-59,6,30,0,35,1,0,0,36,0,36,Toscana,ITI1
2021-01-08,COMIRNATY Vaccino a mRNA contro COVID-19,090641,COVID19 - Ospedale La Gruccia Montevarchi,TOS,60-69,4,6,0,10,0,0,0,10,0,10,Toscana,ITI1
2021-01-08,COMIRNATY Vaccino a mRNA contro COVID-19,090901,COVID19 - AOU Pisana,TOS,16-19,5,18,2,23,0,0,0,23,0,23,Toscana,ITI1
2021-01-08,COMIRNATY Vaccino a mRNA contro COVID-19,090901,COVID19 - AOU Pisana,TOS,20-29,108,251,2,358,0,0,1,359,0,359,Toscana,ITI1
2021-01-08,COMIRNATY Vaccino a mRNA contro COVID-19,090901,COVID19 - AOU Pisana,TOS,30-39,54,101,2,151,2,1,1,155,0,155,Toscana,ITI1
2021-01-08,COMIRNATY Vaccino a mRNA contro COVID-19,090901,COVID19 - AOU Pisana,TOS,40-49,32,78,2,108,2,0,0,110,0,110,Toscana,ITI1
2021-01-08,COMIRNATY Vaccino a mRNA contro COVID-19,090901,COVID19 - AOU Pisana,TOS,50-59,48,107,2,153,1,1,0,155,0,155,Toscana,ITI1
2021-01-08,COMIRNATY Vaccino a mRNA contro COVID-19,090901,COVID19 - AOU Pisana,TOS,60-69,22,31,2,53,0,0,0,53,0,53,Toscana,ITI1
2021-01-08,COMIRNATY Vaccino a mRNA contro COVID-19,090901,COVID19 - AOU Pisana,TOS,70-79,1,0,2,1,0,0,0,1,0,1,Toscana,ITI1
2021-01-08,COMIRNATY Vaccino a mRNA contro COVID-19,090902,COVID19 - AOU Senese,TOS,20-29,21,50,0,71,0,0,0,71,0,71,Toscana,ITI1
2021-01-08,COMIRNATY Vaccino a mRNA contro COVID-19,090902,COVID19 - AOU Senese,TOS,30-39,17,42,0,59,0,0,0,59,0,59,Toscana,ITI1
2021-01-08,COMIRNATY Vaccino a mRNA contro COVID-19,090902,COVID19 - AOU Senese,TOS,40-49,11,51,0,62,0,0,0,62,0,62,Toscana,ITI1
2021-01-08,COMIRNATY Vaccino a mRNA contro COVID-19,090902,COVID19 - AOU Senese,TOS,50-59,11,49,0,59,0,1,0,60,0,60,Toscana,ITI1
2021-01-08,COMIRNATY Vaccino a mRNA contro COVID-19,090902,COVID19 - AOU Senese,TOS,60-69,10,16,0,26,0,0,0,26,0,26,Toscana,ITI1
2021-01-08,COMIRNATY Vaccino a mRNA contro COVID-19,090902,COVID19 - AOU Senese,TOS,70-79,2,1,0,3,0,0,0,3,0,3,Toscana,ITI1
2021-01-08,COMIRNATY Vaccino a mRNA contro COVID-19,090903,COVID19 - AOU Careggi - CTO,TOS,16-19,1,0,0,1,0,0,0,1,0,1,Toscana,ITI1
2021-01-08,COMIRNATY Vaccino a mRNA contro COVID-19,090903,COVID19 - AOU Careggi - CTO,TOS,20-29,164,297,0,460,0,1,0,461,0,461,Toscana,ITI1
2021-01-08,COMIRNATY Vaccino a mRNA contro COVID-19,090903,COVID19 - AOU Careggi - CTO,TOS,30-39,46,82,0,127,0,1,0,128,0,128,Toscana,ITI1
2021-01-08,COMIRNATY Vaccino a mRNA contro COVID-19,090903,COVID19 - AOU Careggi - CTO,TOS,40-49,27,107,0,134,0,0,0,134,0,134,Toscana,ITI1
2021-01-08,COMIRNATY Vaccino a mRNA contro COVID-19,090903,COVID19 - AOU Careggi - CTO,TOS,50-59,41,159,0,197,3,0,0,200,0,200,Toscana,ITI1
2021-01-08,COMIRNATY Vaccino a mRNA contro COVID-19,090903,COVID19 - AOU Careggi - CTO,TOS,60-69,25,44,0,68,0,1,0,69,0,69,Toscana,ITI1
2021-01-08,COMIRNATY Vaccino a mRNA contro COVID-19,090903,COVID19 - AOU Careggi - CTO,TOS,70-79,1,1,0,2,0,0,0,2,0,2,Toscana,ITI1
2021-01-08,COMIRNATY Vaccino a mRNA contro COVID-19,090904,COVID19 - Ospedale AOU Meyer,TOS,20-29,5,18,0,23,0,0,0,23,0,23,Toscana,ITI1
2021-01-08,COMIRNATY Vaccino a mRNA contro COVID-19,090904,COVID19 - Ospedale AOU Meyer,TOS,30-39,9,39,0,48,0,0,0,48,0,48,Toscana,ITI1
2021-01-08,COMIRNATY Vaccino a mRNA contro COVID-19,090904,COVID19 - Ospedale AOU Meyer,TOS,40-49,9,39,0,48,0,0,0,48,0,48,Toscana,ITI1
2021-01-08,COMIRNATY Vaccino a mRNA contro COVID-19,090904,COVID19 - Ospedale AOU Meyer,TOS,50-59,8,26,0,34,0,0,0,34,0,34,Toscana,ITI1
2021-01-08,COMIRNATY Vaccino a mRNA contro COVID-19,090904,COVID19 - Ospedale AOU Meyer,TOS,60-69,3,5,0,8,0,0,0,8,0,8,Toscana,ITI1
2021-01-08,COMIRNATY Vaccino a mRNA contro COVID-19,090907,Covid19 - FTGM Pisa San Cataldo,TOS,20-29,2,3,0,5,0,0,0,5,0,5,Toscana,ITI1
2021-01-08,COMIRNATY Vaccino a mRNA contro COVID-19,090907,Covid19 - FTGM Pisa San Cataldo,TOS,30-39,6,15,0,21,0,0,0,21,0,21,Toscana,ITI1
2021-01-08,COMIRNATY Vaccino a mRNA contro COVID-19,090907,Covid19 - FTGM Pisa San Cataldo,TOS,40-49,12,17,0,29,0,0,0,29,0,29,Toscana,ITI1
2021-01-08,COMIRNATY Vaccino a mRNA contro COVID-19,090907,Covid19 - FTGM Pisa San Cataldo,TOS,50-59,3,17,0,20,0,0,0,20,0,20,Toscana,ITI1
2021-01-08,COMIRNATY Vaccino a mRNA contro COVID-19,090907,Covid19 - FTGM Pisa San Cataldo,TOS,60-69,3,6,0,9,0,0,0,9,0,9,Toscana,ITI1
2021-01-08,COMIRNATY Vaccino a mRNA contro COVID-19,11012E,COVID19 - Ospedale San Giuseppe,TOS,20-29,1,8,0,9,0,0,0,9,0,9,Toscana,ITI1
2021-01-08,COMIRNATY Vaccino a mRNA contro COVID-19,11012E,COVID19 - Ospedale San Giuseppe,TOS,30-39,6,18,0,24,0,0,0,24,0,24,Toscana,ITI1
2021-01-08,COMIRNATY Vaccino a mRNA contro COVID-19,11012E,COVID19 - Ospedale San Giuseppe,TOS,40-49,6,29,0,35,0,0,0,35,0,35,Toscana,ITI1
2021-01-08,COMIRNATY Vaccino a mRNA contro COVID-19,11012E,COVID19 - Ospedale San Giuseppe,TOS,50-59,9,55,0,64,0,0,0,64,0,64,Toscana,ITI1
2021-01-08,COMIRNATY Vaccino a mRNA contro COVID-19,11012E,COVID19 - Ospedale San Giuseppe,TOS,60-69,8,10,0,18,0,0,0,18,0,18,Toscana,ITI1
2021-01-08,COMIRNATY Vaccino a mRNA contro COVID-19,11151A,Covid 19 - Ospedale S.Antonio Abate di Pontremoli,TOS,20-29,0,1,0,1,0,0,0,1,0,1,Toscana,ITI1
2021-01-08,COMIRNATY Vaccino a mRNA contro COVID-19,11151A,Covid 19 - Ospedale S.Antonio Abate di Pontremoli,TOS,30-39,1,2,0,3,0,0,0,3,0,3,Toscana,ITI1
2021-01-08,COMIRNATY Vaccino a mRNA contro COVID-19,11151A,Covid 19 - Ospedale S.Antonio Abate di Pontremoli,TOS,40-49,2,6,0,8,0,0,0,8,0,8,Toscana,ITI1
2021-01-08,COMIRNATY Vaccino a mRNA contro COVID-19,11151A,Covid 19 - Ospedale S.Antonio Abate di Pontremoli,TOS,50-59,1,8,0,9,0,0,0,9,0,9,Toscana,ITI1
2021-01-08,COMIRNATY Vaccino a mRNA contro COVID-19,11151A,Covid 19 - Ospedale S.Antonio Abate di Pontremoli,TOS,60-69,0,3,0,3,0,0,0,3,0,3,Toscana,ITI1
2021-01-08,COMIRNATY Vaccino a mRNA contro COVID-19,12034I,R.S.A. MARINA DI LEVANTE,TOS,20-29,1,0,0,1,0,0,0,1,0,1,Toscana,ITI1
2021-01-08,COMIRNATY Vaccino a mRNA contro COVID-19,12034I,R.S.A. MARINA DI LEVANTE,TOS,40-49,0,1,0,1,0,0,0,1,0,1,Toscana,ITI1
2021-01-08,COMIRNATY Vaccino a mRNA contro COVID-19,12034I,R.S.A. MARINA DI LEVANTE,TOS,50-59,1,0,0,1,0,0,0,1,0,1,Toscana,ITI1
2021-01-08,COMIRNATY Vaccino a mRNA contro COVID-19,12034I,R.S.A. MARINA DI LEVANTE,TOS,60-69,0,1,0,0,0,1,0,1,0,1,Toscana,ITI1
2021-01-08,COMIRNATY Vaccino a mRNA contro COVID-19,12034I,R.S.A. MARINA DI LEVANTE,TOS,70-79,4,2,0,0,0,6,0,6,0,6,Toscana,ITI1
2021-01-08,COMIRNATY Vaccino a mRNA contro COVID-19,12034I,R.S.A. MARINA DI LEVANTE,TOS,80-89,0,1,0,0,0,1,0,1,0,1,Toscana,ITI1
2021-01-08,COMIRNATY Vaccino a mRNA contro COVID-19,12034I,R.S.A. MARINA DI LEVANTE,TOS,90+,1,0,0,0,0,1,0,1,0,1,Toscana,ITI1
2021-01-08,COMIRNATY Vaccino a mRNA contro COVID-19,12194I,Covid19 - RSA PONTREMOLI,TOS,40-49,1,1,0,0,1,1,0,2,0,2,Toscana,ITI1
2021-01-08,COMIRNATY Vaccino a mRNA contro COVID-19,12194I,Covid19 - RSA PONTREMOLI,TOS,50-59,1,1,0,0,1,1,0,2,0,2,Toscana,ITI1
2021-01-08,COMIRNATY Vaccino a mRNA contro COVID-19,12194I,Covid19 - RSA PONTREMOLI,TOS,60-69,1,0,0,0,0,1,0,1,0,1,Toscana,ITI1
2021-01-08,COMIRNATY Vaccino a mRNA contro COVID-19,12194I,Covid19 - RSA PONTREMOLI,TOS,70-79,1,2,0,0,0,3,0,3,0,3,Toscana,ITI1
2021-01-08,COMIRNATY Vaccino a mRNA contro COVID-19,12194I,Covid19 - RSA PONTREMOLI,TOS,80-89,1,3,0,0,0,4,0,4,0,4,Toscana,ITI1
2021-01-08,COMIRNATY Vaccino a mRNA contro COVID-19,123E4I,R.S.A OPERA CARDINALE MAFFI,TOS,40-49,0,1,0,0,0,1,0,1,0,1,Toscana,ITI1
2021-01-08,COMIRNATY Vaccino a mRNA contro COVID-19,123E4I,R.S.A OPERA CARDINALE MAFFI,TOS,50-59,2,2,0,0,0,4,0,4,0,4,Toscana,ITI1
2021-01-08,COMIRNATY Vaccino a mRNA contro COVID-19,123E4I,R.S.A OPERA CARDINALE MAFFI,TOS,60-69,4,4,0,1,0,7,0,8,0,8,Toscana,ITI1
2021-01-08,COMIRNATY Vaccino a mRNA contro COVID-19,123E4I,R.S.A OPERA CARDINALE MAFFI,TOS,70-79,4,7,0,0,0,11,0,11,0,11,Toscana,ITI1
2021-01-08,COMIRNATY Vaccino a mRNA contro COVID-19,123E4I,R.S.A OPERA CARDINALE MAFFI,TOS,80-89,4,12,0,0,0,16,0,16,0,16,Toscana,ITI1
2021-01-08,COMIRNATY Vaccino a mRNA contro COVID-19,123E4I,R.S.A OPERA CARDINALE MAFFI,TOS,90+,0,7,0,0,0,7,0,7,0,7,Toscana,ITI1
2021-01-08,COMIRNATY Vaccino a mRNA contro COVID-19,13021A,COVID19 - Ospedale S.Giovanni di Dio,TOS,20-29,8,15,0,23,0,0,0,23,0,23,Toscana,ITI1
2021-01-08,COMIRNATY Vaccino a mRNA contro COVID-19,13021A,COVID19 - Ospedale S.Giovanni di Dio,TOS,30-39,12,30,0,41,0,1,0,42,0,42,Toscana,ITI1
2021-01-08,COMIRNATY Vaccino a mRNA contro COVID-19,13021A,COVID19 - Ospedale S.Giovanni di Dio,TOS,40-49,9,36,0,43,0,2,0,45,0,45,Toscana,ITI1
2021-01-08,COMIRNATY Vaccino a mRNA contro COVID-19,13021A,COVID19 - Ospedale S.Giovanni di Dio,TOS,50-59,8,32,0,39,0,1,0,40,0,40,Toscana,ITI1
2021-01-08,COMIRNATY Vaccino a mRNA contro COVID-19,13021A,COVID19 - Ospedale S.Giovanni di Dio,TOS,60-69,7,5,0,12,0,0,0,12,0,12,Toscana,ITI1
2021-01-08,COMIRNATY Vaccino a mRNA contro COVID-19,13021A,COVID19 - Ospedale S.Giovanni di Dio,TOS,70-79,2,0,0,2,0,0,0,2,0,2,Toscana,ITI1
2021-01-08,COMIRNATY Vaccino a mRNA contro COVID-19,13021A,COVID19 - Ospedale S.Giovanni di Dio,TOS,80-89,0,3,0,0,0,3,0,3,0,3,Toscana,ITI1
2021-01-08,COMIRNATY Vaccino a mRNA contro COVID-19,13594I,CASA DI RIPOSO S.M. MISERICORD,TOS,50-59,0,2,0,1,0,1,0,2,0,2,Toscana,ITI1
2021-01-08,COMIRNATY Vaccino a mRNA contro COVID-19,13594I,CASA DI RIPOSO S.M. MISERICORD,TOS,60-69,1,3,0,1,0,3,0,4,0,4,Toscana,ITI1
2021-01-08,COMIRNATY Vaccino a mRNA contro COVID-19,13594I,CASA DI RIPOSO S.M. MISERICORD,TOS,70-79,3,2,0,0,0,5,0,5,0,5,Toscana,ITI1
2021-01-08,COMIRNATY Vaccino a mRNA contro COVID-19,13594I,CASA DI RIPOSO S.M. MISERICORD,TOS,80-89,4,11,0,0,0,15,0,15,0,15,Toscana,ITI1
2021-01-08,COMIRNATY Vaccino a mRNA contro COVID-19,13594I,CASA DI RIPOSO S.M. MISERICORD,TOS,90+,3,12,0,0,0,15,0,15,0,15,Toscana,ITI1
2021-01-08,COMIRNATY Vaccino a mRNA contro COVID-19,14574I,RSA LA COLLINELLA MONTAIONE,TOS,50-59,0,3,0,2,1,0,0,3,0,3,Toscana,ITI1
2021-01-08,COMIRNATY Vaccino a mRNA contro COVID-19,14574I,RSA LA COLLINELLA MONTAIONE,TOS,60-69,1,0,0,0,0,1,0,1,0,1,Toscana,ITI1
2021-01-08,COMIRNATY Vaccino a mRNA contro COVID-19,14574I,RSA LA COLLINELLA MONTAIONE,TOS,70-79,2,1,0,0,0,3,0,3,0,3,Toscana,ITI1
2021-01-08,COMIRNATY Vaccino a mRNA contro COVID-19,14574I,RSA LA COLLINELLA MONTAIONE,TOS,80-89,1,7,0,0,0,8,0,8,0,8,Toscana,ITI1
2021-01-08,COMIRNATY Vaccino a mRNA contro COVID-19,14574I,RSA LA COLLINELLA MONTAIONE,TOS,90+,1,8,0,0,0,9,0,9,0,9,Toscana,ITI1
2021-01-08,COMIRNATY Vaccino a mRNA contro COVID-19,16121A,Covid 19 - Ospedale Civile di Cecina,TOS,20-29,1,4,0,5,0,0,0,5,0,5,Toscana,ITI1
2021-01-08,COMIRNATY Vaccino a mRNA contro COVID-19,16121A,Covid 19 - Ospedale Civile di Cecina,TOS,30-39,4,12,0,16,0,0,0,16,0,16,Toscana,ITI1
2021-01-08,COMIRNATY Vaccino a mRNA contro COVID-19,16121A,Covid 19 - Ospedale Civile di Cecina,TOS,40-49,1,14,0,15,0,0,0,15,0,15,Toscana,ITI1
2021-01-08,COMIRNATY Vaccino a mRNA contro COVID-19,16121A,Covid 19 - Ospedale Civile di Cecina,TOS,50-59,3,14,0,17,0,0,0,17,0,17,Toscana,ITI1
2021-01-08,COMIRNATY Vaccino a mRNA contro COVID-19,16121A,Covid 19 - Ospedale Civile di Cecina,TOS,60-69,5,2,0,7,0,0,0,7,0,7,Toscana,ITI1
2021-01-08,COMIRNATY Vaccino a mRNA contro COVID-19,18214I,RSA S. ROMUALDO,TOS,20-29,1,0,0,1,0,0,0,1,0,1,Toscana,ITI1
2021-01-08,COMIRNATY Vaccino a mRNA contro COVID-19,18214I,RSA S. ROMUALDO,TOS,50-59,0,3,0,2,0,1,0,3,0,3,Toscana,ITI1
2021-01-08,COMIRNATY Vaccino a mRNA contro COVID-19,18214I,RSA S. ROMUALDO,TOS,70-79,0,1,0,0,0,1,0,1,0,1,Toscana,ITI1
2021-01-08,COMIRNATY Vaccino a mRNA contro COVID-19,18214I,RSA S. ROMUALDO,TOS,80-89,5,5,0,0,0,10,0,10,0,10,Toscana,ITI1
2021-01-08,COMIRNATY Vaccino a mRNA contro COVID-19,18214I,RSA S. ROMUALDO,TOS,90+,3,6,0,0,0,9,0,9,0,9,Toscana,ITI1
2021-01-08,COMIRNATY Vaccino a mRNA contro COVID-19,20894I,RSA CASA DEI NONNI C/O EX OSPE,TOS,70-79,0,1,0,0,0,1,0,1,0,1,Toscana,ITI1
2021-01-08,COMIRNATY Vaccino a mRNA contro COVID-19,20894I,RSA CASA DEI NONNI C/O EX OSPE,TOS,90+,0,1,0,0,0,1,0,1,0,1,Toscana,ITI1
2021-01-08,COMIRNATY Vaccino a mRNA contro COVID-19,21624I,RSA  A. FANFANI  BADIA TEDALDA,TOS,40-49,0,2,0,2,0,0,0,2,0,2,Toscana,ITI1
2021-01-08,COMIRNATY Vaccino a mRNA contro COVID-19,21624I,RSA  A. FANFANI  BADIA TEDALDA,TOS,60-69,1,0,0,1,0,0,0,1,0,1,Toscana,ITI1
2021-01-08,COMIRNATY Vaccino a mRNA contro COVID-19,21624I,RSA  A. FANFANI  BADIA TEDALDA,TOS,70-79,1,1,0,0,0,2,0,2,0,2,Toscana,ITI1
2021-01-08,COMIRNATY Vaccino a mRNA contro COVID-19,21624I,RSA  A. FANFANI  BADIA TEDALDA,TOS,80-89,1,3,0,0,0,4,0,4,0,4,Toscana,ITI1
2021-01-08,COMIRNATY Vaccino a mRNA contro COVID-19,21624I,RSA  A. FANFANI  BADIA TEDALDA,TOS,90+,1,2,0,0,0,3,0,3,0,3,Toscana,ITI1
2021-01-08,COMIRNATY Vaccino a mRNA contro COVID-19,21791A,COVID19 - FTGM OPA Massa,TOS,20-29,7,12,0,19,0,0,0,19,0,19,Toscana,ITI1
2021-01-08,COMIRNATY Vaccino a mRNA contro COVID-19,21791A,COVID19 - FTGM OPA Massa,TOS,30-39,10,25,0,35,0,0,0,35,0,35,Toscana,ITI1
2021-01-08,COMIRNATY Vaccino a mRNA contro COVID-19,21791A,COVID19 - FTGM OPA Massa,TOS,40-49,10,15,0,24,0,1,0,25,0,25,Toscana,ITI1
2021-01-08,COMIRNATY Vaccino a mRNA contro COVID-19,21791A,COVID19 - FTGM OPA Massa,TOS,50-59,6,25,0,31,0,0,0,31,0,31,Toscana,ITI1
2021-01-08,COMIRNATY Vaccino a mRNA contro COVID-19,21791A,COVID19 - FTGM OPA Massa,TOS,60-69,6,4,0,10,0,0,0,10,0,10,Toscana,ITI1
2021-01-08,COMIRNATY Vaccino a mRNA contro COVID-19,30614L,RSA PODERE MODELLO,TOS,20-29,2,1,0,1,0,2,0,3,0,3,Toscana,ITI1
2021-01-08,COMIRNATY Vaccino a mRNA contro COVID-19,30614L,RSA PODERE MODELLO,TOS,30-39,6,0,0,0,0,6,0,6,0,6,Toscana,ITI1
2021-01-08,COMIRNATY Vaccino a mRNA contro COVID-19,30614L,RSA PODERE MODELLO,TOS,40-49,10,1,0,0,0,11,0,11,0,11,Toscana,ITI1
2021-01-08,COMIRNATY Vaccino a mRNA contro COVID-19,30614L,RSA PODERE MODELLO,TOS,50-59,9,2,0,0,0,11,0,11,0,11,Toscana,ITI1
2021-01-08,COMIRNATY Vaccino a mRNA contro COVID-19,30614L,RSA PODERE MODELLO,TOS,60-69,5,0,0,0,0,5,0,5,0,5,Toscana,ITI1
2021-01-08,COMIRNATY Vaccino a mRNA contro COVID-19,321I4I,Covid19 - RSA SANTA CHIARA VOLTERRA,TOS,50-59,0,1,0,1,0,0,0,1,0,1,Toscana,ITI1
2021-01-08,COMIRNATY Vaccino a mRNA contro COVID-19,321I4I,Covid19 - RSA SANTA CHIARA VOLTERRA,TOS,60-69,2,1,0,1,0,2,0,3,0,3,Toscana,ITI1
2021-01-08,COMIRNATY Vaccino a mRNA contro COVID-19,321I4I,Covid19 - RSA SANTA CHIARA VOLTERRA,TOS,80-89,0,1,0,0,0,1,0,1,0,1,Toscana,ITI1
2021-01-08,COMIRNATY Vaccino a mRNA contro COVID-19,321I4I,Covid19 - RSA SANTA CHIARA VOLTERRA,TOS,90+,0,1,0,0,0,1,0,1,0,1,Toscana,ITI1
2021-01-08,COMIRNATY Vaccino a mRNA contro COVID-19,322G4I,Covid19 - RSA SACRO CUORE,TOS,50-59,0,1,0,1,0,0,0,1,0,1,Toscana,ITI1
2021-01-08,COMIRNATY Vaccino a mRNA contro COVID-19,322G4I,Covid19 - RSA SACRO CUORE,TOS,60-69,0,1,0,0,0,1,0,1,0,1,Toscana,ITI1
2021-01-08,COMIRNATY Vaccino a mRNA contro COVID-19,322G4I,Covid19 - RSA SACRO CUORE,TOS,80-89,0,3,0,0,0,3,0,3,0,3,Toscana,ITI1
2021-01-08,COMIRNATY Vaccino a mRNA contro COVID-19,322G4I,Covid19 - RSA SACRO CUORE,TOS,90+,0,7,0,0,0,7,0,7,0,7,Toscana,ITI1
2021-01-08,COMIRNATY Vaccino a mRNA contro COVID-19,40911A,COVID19 - Dip. Prevenzione Ruffolo Siena,TOS,20-29,1,0,0,1,0,0,0,1,0,1,Toscana,ITI1
2021-01-08,COMIRNATY Vaccino a mRNA contro COVID-19,40911A,COVID19 - Dip. Prevenzione Ruffolo Siena,TOS,40-49,1,2,0,3,0,0,0,3,0,3,Toscana,ITI1
2021-01-08,COMIRNATY Vaccino a mRNA contro COVID-19,40911A,COVID19 - Dip. Prevenzione Ruffolo Siena,TOS,50-59,0,1,0,1,0,0,0,1,0,1,Toscana,ITI1
2021-01-08,COMIRNATY Vaccino a mRNA contro COVID-19,46151A,CSS Portoferraio,TOS,30-39,0,1,0,1,0,0,0,1,0,1,Toscana,ITI1
2021-01-08,COMIRNATY Vaccino a mRNA contro COVID-19,46151A,CSS Portoferraio,TOS,40-49,2,5,0,7,0,0,0,7,0,7,Toscana,ITI1
2021-01-08,COMIRNATY Vaccino a mRNA contro COVID-19,46151A,CSS Portoferraio,TOS,50-59,2,5,0,7,0,0,0,7,0,7,Toscana,ITI1
2021-01-08,COMIRNATY Vaccino a mRNA contro COVID-19,46151A,CSS Portoferraio,TOS,60-69,2,1,0,1,0,2,0,3,0,3,Toscana,ITI1
2021-01-08,COMIRNATY Vaccino a mRNA contro COVID-19,46151A,CSS Portoferraio,TOS,70-79,4,2,0,1,0,5,0,6,0,6,Toscana,ITI1
2021-01-08,COMIRNATY Vaccino a mRNA contro COVID-19,46151A,CSS Portoferraio,TOS,80-89,1,2,0,1,0,2,0,3,0,3,Toscana,ITI1
2021-01-08,COMIRNATY Vaccino a mRNA contro COVID-19,46151A,CSS Portoferraio,TOS,90+,1,2,0,0,0,3,0,3,0,3,Toscana,ITI1
2021-01-08,COMIRNATY Vaccino a mRNA contro COVID-19,46214I,R.S.A. S. FRANCESCO,TOS,60-69,1,2,0,1,0,2,0,3,0,3,Toscana,ITI1
2021-01-08,COMIRNATY Vaccino a mRNA contro COVID-19,46214I,R.S.A. S. FRANCESCO,TOS,80-89,1,5,0,0,0,6,0,6,0,6,Toscana,ITI1
2021-01-08,COMIRNATY Vaccino a mRNA contro COVID-19,46214I,R.S.A. S. FRANCESCO,TOS,90+,0,4,0,0,0,4,0,4,0,4,Toscana,ITI1
2021-01-08,COMIRNATY Vaccino a mRNA contro COVID-19,60984I,CASA DI RIPOSO IL GIGNORO,TOS,30-39,0,1,0,0,1,0,0,1,0,1,Toscana,ITI1
2021-01-08,COMIRNATY Vaccino a mRNA contro COVID-19,60984I,CASA DI RIPOSO IL GIGNORO,TOS,50-59,4,1,0,0,0,5,0,5,0,5,Toscana,ITI1
2021-01-08,COMIRNATY Vaccino a mRNA contro COVID-19,60984I,CASA DI RIPOSO IL GIGNORO,TOS,60-69,4,1,0,0,0,5,0,5,0,5,Toscana,ITI1
2021-01-08,COMIRNATY Vaccino a mRNA contro COVID-19,60984I,CASA DI RIPOSO IL GIGNORO,TOS,70-79,11,5,0,0,0,16,0,16,0,16,Toscana,ITI1
2021-01-08,COMIRNATY Vaccino a mRNA contro COVID-19,60984I,CASA DI RIPOSO IL GIGNORO,TOS,80-89,8,11,0,0,0,19,0,19,0,19,Toscana,ITI1
2021-01-08,COMIRNATY Vaccino a mRNA contro COVID-19,60984I,CASA DI RIPOSO IL GIGNORO,TOS,90+,1,7,0,0,0,8,0,8,0,8,Toscana,ITI1
2021-01-08,COMIRNATY Vaccino a mRNA contro COVID-19,61014I,CASA PAOLO VI,TOS,70-79,1,2,0,0,0,3,0,3,0,3,Toscana,ITI1
2021-01-08,COMIRNATY Vaccino a mRNA contro COVID-19,61014I,CASA PAOLO VI,TOS,80-89,4,14,0,1,0,17,0,18,0,18,Toscana,ITI1
2021-01-08,COMIRNATY Vaccino a mRNA contro COVID-19,61014I,CASA PAOLO VI,TOS,90+,2,7,0,0,0,9,0,9,0,9,Toscana,ITI1
2021-01-08,COMIRNATY Vaccino a mRNA contro COVID-19,80024I,CASA SERENA MEZZANA RESIDENZIA,TOS,50-59,0,1,0,1,0,0,0,1,0,1,Toscana,ITI1
2021-01-08,COMIRNATY Vaccino a mRNA contro COVID-19,80024I,CASA SERENA MEZZANA RESIDENZIA,TOS,60-69,1,1,0,0,0,2,0,2,0,2,Toscana,ITI1
2021-01-08,COMIRNATY Vaccino a mRNA contro COVID-19,80024I,CASA SERENA MEZZANA RESIDENZIA,TOS,70-79,1,1,0,0,0,2,0,2,0,2,Toscana,ITI1
2021-01-08,COMIRNATY Vaccino a mRNA contro COVID-19,80024I,CASA SERENA MEZZANA RESIDENZIA,TOS,80-89,2,4,0,0,0,6,0,6,0,6,Toscana,ITI1
2021-01-08,COMIRNATY Vaccino a mRNA contro COVID-19,80024I,CASA SERENA MEZZANA RESIDENZIA,TOS,90+,1,3,0,0,0,4,0,4,0,4,Toscana,ITI1
2021-01-08,COMIRNATY Vaccino a mRNA contro COVID-19,80354I,A.S.P.CENTRO RESID.L.MARTELLI/,TOS,40-49,0,1,0,1,0,0,0,1,0,1,Toscana,ITI1
2021-01-08,COMIRNATY Vaccino a mRNA contro COVID-19,80354I,A.S.P.CENTRO RESID.L.MARTELLI/,TOS,60-69,1,0,0,0,0,1,0,1,0,1,Toscana,ITI1
2021-01-08,COMIRNATY Vaccino a mRNA contro COVID-19,80354I,A.S.P.CENTRO RESID.L.MARTELLI/,TOS,70-79,2,4,0,0,0,6,0,6,0,6,Toscana,ITI1
2021-01-08,COMIRNATY Vaccino a mRNA contro COVID-19,80354I,A.S.P.CENTRO RESID.L.MARTELLI/,TOS,80-89,4,14,0,0,0,18,0,18,0,18,Toscana,ITI1
2021-01-08,COMIRNATY Vaccino a mRNA contro COVID-19,80354I,A.S.P.CENTRO RESID.L.MARTELLI/,TOS,90+,0,8,0,0,0,8,0,8,0,8,Toscana,ITI1
2021-01-08,COMIRNATY Vaccino a mRNA contro COVID-19,90094I,CASA DI RIPOSO SS.ANNUNZIATA,TOS,30-39,0,1,0,1,0,0,0,1,0,1,Toscana,ITI1
2021-01-08,COMIRNATY Vaccino a mRNA contro COVID-19,90094I,CASA DI RIPOSO SS.ANNUNZIATA,TOS,40-49,1,1,0,2,0,0,0,2,0,2,Toscana,ITI1
2021-01-08,COMIRNATY Vaccino a mRNA contro COVID-19,90094I,CASA DI RIPOSO SS.ANNUNZIATA,TOS,50-59,0,2,0,1,0,1,0,2,0,2,Toscana,ITI1
2021-01-08,COMIRNATY Vaccino a mRNA contro COVID-19,90094I,CASA DI RIPOSO SS.ANNUNZIATA,TOS,90+,0,1,0,0,0,1,0,1,0,1,Toscana,ITI1
2021-01-08,COMIRNATY Vaccino a mRNA contro COVID-19,90104I,VILLA LE ORTENSIE S.R.L.,TOS,30-39,0,1,0,1,0,0,0,1,0,1,Toscana,ITI1
2021-01-08,COMIRNATY Vaccino a mRNA contro COVID-19,90104I,VILLA LE ORTENSIE S.R.L.,TOS,40-49,0,5,0,5,0,0,0,5,0,5,Toscana,ITI1
2021-01-08,COMIRNATY Vaccino a mRNA contro COVID-19,90104I,VILLA LE ORTENSIE S.R.L.,TOS,50-59,0,2,0,1,0,1,0,2,0,2,Toscana,ITI1
2021-01-08,COMIRNATY Vaccino a mRNA contro COVID-19,90104I,VILLA LE ORTENSIE S.R.L.,TOS,60-69,3,0,0,0,0,3,0,3,0,3,Toscana,ITI1
2021-01-08,COMIRNATY Vaccino a mRNA contro COVID-19,90104I,VILLA LE ORTENSIE S.R.L.,TOS,80-89,3,3,0,0,0,6,0,6,0,6,Toscana,ITI1
2021-01-08,COMIRNATY Vaccino a mRNA contro COVID-19,90104I,VILLA LE ORTENSIE S.R.L.,TOS,90+,2,5,0,0,0,7,0,7,0,7,Toscana,ITI1
2021-01-08,COMIRNATY Vaccino a mRNA contro COVID-19,L0134I,Covid19 - RSA ISTITUTO SANTA CATERINA,TOS,70-79,0,3,0,0,0,3,0,3,0,3,Toscana,ITI1
2021-01-08,COMIRNATY Vaccino a mRNA contro COVID-19,L0134I,Covid19 - RSA ISTITUTO SANTA CATERINA,TOS,80-89,0,14,0,0,0,14,0,14,0,14,Toscana,ITI1
2021-01-08,COMIRNATY Vaccino a mRNA contro COVID-19,L0134I,Covid19 - RSA ISTITUTO SANTA CATERINA,TOS,90+,0,14,0,0,0,14,0,14,0,14,Toscana,ITI1
2021-01-08,COMIRNATY Vaccino a mRNA contro COVID-19,M3024L,Covid19 - RSD Villa Versilia,TOS,20-29,0,1,0,0,0,1,0,1,0,1,Toscana,ITI1
2021-01-08,COMIRNATY Vaccino a mRNA contro COVID-19,M3024L,Covid19 - RSD Villa Versilia,TOS,30-39,1,4,0,3,0,2,0,5,0,5,Toscana,ITI1
2021-01-08,COMIRNATY Vaccino a mRNA contro COVID-19,M3024L,Covid19 - RSD Villa Versilia,TOS,40-49,3,5,0,2,0,6,0,8,0,8,Toscana,ITI1
2021-01-08,COMIRNATY Vaccino a mRNA contro COVID-19,M3024L,Covid19 - RSD Villa Versilia,TOS,50-59,1,2,0,0,0,3,0,3,0,3,Toscana,ITI1
2021-01-08,COMIRNATY Vaccino a mRNA contro COVID-19,M3024L,Covid19 - RSD Villa Versilia,TOS,70-79,0,1,0,0,0,1,0,1,0,1,Toscana,ITI1
2021-01-08,COMIRNATY Vaccino a mRNA contro COVID-19,U0064I,Covis19 - RSA ALBA SERENA,TOS,70-79,1,0,0,0,0,1,0,1,0,1,Toscana,ITI1
2021-01-09,COMIRNATY Vaccino a mRNA contro COVID-19,00274I,VILLONE PUCCINI  RESIDENZA SAN,TOS,30-39,0,2,0,2,0,0,0,2,0,2,Toscana,ITI1
2021-01-09,COMIRNATY Vaccino a mRNA contro COVID-19,00274I,VILLONE PUCCINI  RESIDENZA SAN,TOS,40-49,0,4,0,4,0,0,0,4,0,4,Toscana,ITI1
2021-01-09,COMIRNATY Vaccino a mRNA contro COVID-19,00274I,VILLONE PUCCINI  RESIDENZA SAN,TOS,50-59,0,2,0,2,0,0,0,2,0,2,Toscana,ITI1
2021-01-09,COMIRNATY Vaccino a mRNA contro COVID-19,00274I,VILLONE PUCCINI  RESIDENZA SAN,TOS,70-79,1,0,0,0,0,1,0,1,0,1,Toscana,ITI1
2021-01-09,COMIRNATY Vaccino a mRNA contro COVID-19,00274I,VILLONE PUCCINI  RESIDENZA SAN,TOS,80-89,0,2,0,0,0,2,0,2,0,2,Toscana,ITI1
2021-01-09,COMIRNATY Vaccino a mRNA contro COVID-19,00294I,RSA DOMUS PACIS,TOS,20-29,0,2,0,2,0,0,0,2,0,2,Toscana,ITI1
2021-01-09,COMIRNATY Vaccino a mRNA contro COVID-19,00294I,RSA DOMUS PACIS,TOS,30-39,0,2,0,1,0,1,0,2,0,2,Toscana,ITI1
2021-01-09,COMIRNATY Vaccino a mRNA contro COVID-19,00294I,RSA DOMUS PACIS,TOS,40-49,2,3,0,0,0,5,0,5,0,5,Toscana,ITI1
2021-01-09,COMIRNATY Vaccino a mRNA contro COVID-19,00294I,RSA DOMUS PACIS,TOS,50-59,2,3,0,0,0,5,0,5,0,5,Toscana,ITI1
2021-01-09,COMIRNATY Vaccino a mRNA contro COVID-19,00294I,RSA DOMUS PACIS,TOS,60-69,1,4,0,0,0,5,0,5,0,5,Toscana,ITI1
2021-01-09,COMIRNATY Vaccino a mRNA contro COVID-19,00294I,RSA DOMUS PACIS,TOS,70-79,0,2,0,0,0,2,0,2,0,2,Toscana,ITI1
2021-01-09,COMIRNATY Vaccino a mRNA contro COVID-19,00294I,RSA DOMUS PACIS,TOS,80-89,6,7,0,0,0,13,0,13,0,13,Toscana,ITI1
2021-01-09,COMIRNATY Vaccino a mRNA contro COVID-19,00294I,RSA DOMUS PACIS,TOS,90+,0,2,0,0,0,2,0,2,0,2,Toscana,ITI1
2021-01-09,COMIRNATY Vaccino a mRNA contro COVID-19,090602,Covid 19 - Nuovo Ospedale Apuane,TOS,20-29,4,12,0,15,1,0,0,16,0,16,Toscana,ITI1
2021-01-09,COMIRNATY Vaccino a mRNA contro COVID-19,090602,Covid 19 - Nuovo Ospedale Apuane,TOS,30-39,5,8,0,13,0,0,0,13,0,13,Toscana,ITI1
2021-01-09,COMIRNATY Vaccino a mRNA contro COVID-19,090602,Covid 19 - Nuovo Ospedale Apuane,TOS,40-49,4,25,0,28,1,0,0,29,0,29,Toscana,ITI1
2021-01-09,COMIRNATY Vaccino a mRNA contro COVID-19,090602,Covid 19 - Nuovo Ospedale Apuane,TOS,50-59,5,17,0,22,0,0,0,22,0,22,Toscana,ITI1
2021-01-09,COMIRNATY Vaccino a mRNA contro COVID-19,090602,Covid 19 - Nuovo Ospedale Apuane,TOS,60-69,23,16,0,38,1,0,0,39,0,39,Toscana,ITI1
2021-01-09,COMIRNATY Vaccino a mRNA contro COVID-19,090602,Covid 19 - Nuovo Ospedale Apuane,TOS,70-79,1,0,0,1,0,0,0,1,0,1,Toscana,ITI1
2021-01-09,COMIRNATY Vaccino a mRNA contro COVID-19,090604,Covid 19 - Ospedale San Luca di  Lucca,TOS,20-29,1,13,0,14,0,0,0,14,0,14,Toscana,ITI1
2021-01-09,COMIRNATY Vaccino a mRNA contro COVID-19,090604,Covid 19 - Ospedale San Luca di  Lucca,TOS,30-39,8,9,0,17,0,0,0,17,0,17,Toscana,ITI1
2021-01-09,COMIRNATY Vaccino a mRNA contro COVID-19,090604,Covid 19 - Ospedale San Luca di  Lucca,TOS,40-49,14,25,0,35,4,0,0,39,0,39,Toscana,ITI1
2021-01-09,COMIRNATY Vaccino a mRNA contro COVID-19,090604,Covid 19 - Ospedale San Luca di  Lucca,TOS,50-59,7,27,0,34,0,0,0,34,0,34,Toscana,ITI1
2021-01-09,COMIRNATY Vaccino a mRNA contro COVID-19,090604,Covid 19 - Ospedale San Luca di  Lucca,TOS,60-69,22,13,0,34,1,0,0,35,0,35,Toscana,ITI1
2021-01-09,COMIRNATY Vaccino a mRNA contro COVID-19,090604,Covid 19 - Ospedale San Luca di  Lucca,TOS,70-79,1,1,0,1,0,1,0,2,0,2,Toscana,ITI1
2021-01-09,COMIRNATY Vaccino a mRNA contro COVID-19,090604,Covid 19 - Ospedale San Luca di  Lucca,TOS,80-89,0,4,0,0,0,4,0,4,0,4,Toscana,ITI1
2021-01-09,COMIRNATY Vaccino a mRNA contro COVID-19,090604,Covid 19 - Ospedale San Luca di  Lucca,TOS,90+,0,4,0,0,0,4,0,4,0,4,Toscana,ITI1
2021-01-09,COMIRNATY Vaccino a mRNA contro COVID-19,090606,COVID19 - Ospedale San Iacopo,TOS,16-19,0,1,0,0,1,0,0,1,0,1,Toscana,ITI1
2021-01-09,COMIRNATY Vaccino a mRNA contro COVID-19,090606,COVID19 - Ospedale San Iacopo,TOS,20-29,5,19,0,23,1,0,0,24,0,24,Toscana,ITI1
2021-01-09,COMIRNATY Vaccino a mRNA contro COVID-19,090606,COVID19 - Ospedale San Iacopo,TOS,30-39,13,12,0,25,0,0,0,25,0,25,Toscana,ITI1
2021-01-09,COMIRNATY Vaccino a mRNA contro COVID-19,090606,COVID19 - Ospedale San Iacopo,TOS,40-49,6,22,0,27,1,0,0,28,0,28,Toscana,ITI1
2021-01-09,COMIRNATY Vaccino a mRNA contro COVID-19,090606,COVID19 - Ospedale San Iacopo,TOS,50-59,12,25,0,37,0,0,0,37,0,37,Toscana,ITI1
2021-01-09,COMIRNATY Vaccino a mRNA contro COVID-19,090606,COVID19 - Ospedale San Iacopo,TOS,60-69,20,15,0,34,1,0,0,35,0,35,Toscana,ITI1
2021-01-09,COMIRNATY Vaccino a mRNA contro COVID-19,090606,COVID19 - Ospedale San Iacopo,TOS,70-79,2,1,0,2,1,0,0,3,0,3,Toscana,ITI1
2021-01-09,COMIRNATY Vaccino a mRNA contro COVID-19,090606,COVID19 - Ospedale San Iacopo,TOS,80-89,1,0,0,1,0,0,0,1,0,1,Toscana,ITI1
2021-01-09,COMIRNATY Vaccino a mRNA contro COVID-19,090607,COVID19 - Ospedale SS.Cosma e Damiano,TOS,20-29,1,4,0,5,0,0,0,5,0,5,Toscana,ITI1
2021-01-09,COMIRNATY Vaccino a mRNA contro COVID-19,090607,COVID19 - Ospedale SS.Cosma e Damiano,TOS,30-39,2,4,0,6,0,0,0,6,0,6,Toscana,ITI1
2021-01-09,COMIRNATY Vaccino a mRNA contro COVID-19,090607,COVID19 - Ospedale SS.Cosma e Damiano,TOS,40-49,2,9,0,11,0,0,0,11,0,11,Toscana,ITI1
2021-01-09,COMIRNATY Vaccino a mRNA contro COVID-19,090607,COVID19 - Ospedale SS.Cosma e Damiano,TOS,50-59,3,7,0,9,1,0,0,10,0,10,Toscana,ITI1
2021-01-09,COMIRNATY Vaccino a mRNA contro COVID-19,090607,COVID19 - Ospedale SS.Cosma e Damiano,TOS,60-69,9,7,0,16,0,0,0,16,0,16,Toscana,ITI1
2021-01-09,COMIRNATY Vaccino a mRNA contro COVID-19,090608,COVID19 - Ospedale Santo Stefano,TOS,20-29,8,7,1,15,0,0,0,15,0,15,Toscana,ITI1
2021-01-09,COMIRNATY Vaccino a mRNA contro COVID-19,090608,COVID19 - Ospedale Santo Stefano,TOS,30-39,7,20,1,27,0,0,0,27,0,27,Toscana,ITI1
2021-01-09,COMIRNATY Vaccino a mRNA contro COVID-19,090608,COVID19 - Ospedale Santo Stefano,TOS,40-49,16,27,1,43,0,0,0,43,0,43,Toscana,ITI1
2021-01-09,COMIRNATY Vaccino a mRNA contro COVID-19,090608,COVID19 - Ospedale Santo Stefano,TOS,50-59,5,18,1,22,0,0,1,23,0,23,Toscana,ITI1
2021-01-09,COMIRNATY Vaccino a mRNA contro COVID-19,090608,COVID19 - Ospedale Santo Stefano,TOS,60-69,23,17,1,40,0,0,0,40,0,40,Toscana,ITI1
2021-01-09,COMIRNATY Vaccino a mRNA contro COVID-19,090608,COVID19 - Ospedale Santo Stefano,TOS,70-79,2,0,1,2,0,0,0,2,0,2,Toscana,ITI1
2021-01-09,COMIRNATY Vaccino a mRNA contro COVID-19,090610,Covid 19 - Ospedale F.Lotti di Pontedera,TOS,20-29,4,10,0,14,0,0,0,14,0,14,Toscana,ITI1
2021-01-09,COMIRNATY Vaccino a mRNA contro COVID-19,090610,Covid 19 - Ospedale F.Lotti di Pontedera,TOS,30-39,8,12,0,20,0,0,0,20,0,20,Toscana,ITI1
2021-01-09,COMIRNATY Vaccino a mRNA contro COVID-19,090610,Covid 19 - Ospedale F.Lotti di Pontedera,TOS,40-49,5,7,0,12,0,0,0,12,0,12,Toscana,ITI1
2021-01-09,COMIRNATY Vaccino a mRNA contro COVID-19,090610,Covid 19 - Ospedale F.Lotti di Pontedera,TOS,50-59,4,13,0,16,0,1,0,17,0,17,Toscana,ITI1
2021-01-09,COMIRNATY Vaccino a mRNA contro COVID-19,090610,Covid 19 - Ospedale F.Lotti di Pontedera,TOS,60-69,14,11,0,25,0,0,0,25,0,25,Toscana,ITI1
2021-01-09,COMIRNATY Vaccino a mRNA contro COVID-19,090610,Covid 19 - Ospedale F.Lotti di Pontedera,TOS,70-79,1,0,0,1,0,0,0,1,0,1,Toscana,ITI1
2021-01-09,COMIRNATY Vaccino a mRNA contro COVID-19,090613,Covid 19 - Ospedali Riuniti di Livorno,TOS,16-19,0,1,0,1,0,0,0,1,0,1,Toscana,ITI1
2021-01-09,COMIRNATY Vaccino a mRNA contro COVID-19,090613,Covid 19 - Ospedali Riuniti di Livorno,TOS,20-29,2,9,0,10,0,1,0,11,0,11,Toscana,ITI1
2021-01-09,COMIRNATY Vaccino a mRNA contro COVID-19,090613,Covid 19 - Ospedali Riuniti di Livorno,TOS,30-39,1,11,0,12,0,0,0,12,0,12,Toscana,ITI1
2021-01-09,COMIRNATY Vaccino a mRNA contro COVID-19,090613,Covid 19 - Ospedali Riuniti di Livorno,TOS,40-49,10,15,0,25,0,0,0,25,0,25,Toscana,ITI1
2021-01-09,COMIRNATY Vaccino a mRNA contro COVID-19,090613,Covid 19 - Ospedali Riuniti di Livorno,TOS,50-59,4,23,0,27,0,0,0,27,0,27,Toscana,ITI1
2021-01-09,COMIRNATY Vaccino a mRNA contro COVID-19,090613,Covid 19 - Ospedali Riuniti di Livorno,TOS,60-69,29,14,0,43,0,0,0,43,0,43,Toscana,ITI1
2021-01-09,COMIRNATY Vaccino a mRNA contro COVID-19,090613,Covid 19 - Ospedali Riuniti di Livorno,TOS,70-79,1,0,0,1,0,0,0,1,0,1,Toscana,ITI1
2021-01-09,COMIRNATY Vaccino a mRNA contro COVID-19,090614,Covid 19 - Ospedale Civile di Piombino,TOS,20-29,1,1,0,2,0,0,0,2,0,2,Toscana,ITI1
2021-01-09,COMIRNATY Vaccino a mRNA contro COVID-19,090614,Covid 19 - Ospedale Civile di Piombino,TOS,30-39,3,1,0,4,0,0,0,4,0,4,Toscana,ITI1
2021-01-09,COMIRNATY Vaccino a mRNA contro COVID-19,090614,Covid 19 - Ospedale Civile di Piombino,TOS,40-49,1,5,0,6,0,0,0,6,0,6,Toscana,ITI1
2021-01-09,COMIRNATY Vaccino a mRNA contro COVID-19,090614,Covid 19 - Ospedale Civile di Piombino,TOS,50-59,1,8,0,9,0,0,0,9,0,9,Toscana,ITI1
2021-01-09,COMIRNATY Vaccino a mRNA contro COVID-19,090614,Covid 19 - Ospedale Civile di Piombino,TOS,60-69,4,4,0,8,0,0,0,8,0,8,Toscana,ITI1
2021-01-09,COMIRNATY Vaccino a mRNA contro COVID-19,090614,Covid 19 - Ospedale Civile di Piombino,TOS,70-79,1,0,0,1,0,0,0,1,0,1,Toscana,ITI1
2021-01-09,COMIRNATY Vaccino a mRNA contro COVID-19,090615,Covid 19 - Ospedale Civile di Portoferraio,TOS,30-39,2,4,0,6,0,0,0,6,0,6,Toscana,ITI1
2021-01-09,COMIRNATY Vaccino a mRNA contro COVID-19,090615,Covid 19 - Ospedale Civile di Portoferraio,TOS,40-49,1,5,0,6,0,0,0,6,0,6,Toscana,ITI1
2021-01-09,COMIRNATY Vaccino a mRNA contro COVID-19,090615,Covid 19 - Ospedale Civile di Portoferraio,TOS,50-59,3,6,0,9,0,0,0,9,0,9,Toscana,ITI1
2021-01-09,COMIRNATY Vaccino a mRNA contro COVID-19,090615,Covid 19 - Ospedale Civile di Portoferraio,TOS,60-69,6,3,0,9,0,0,0,9,0,9,Toscana,ITI1
2021-01-09,COMIRNATY Vaccino a mRNA contro COVID-19,090618,COVID19 - Ospedale del Bibbiena,TOS,20-29,0,5,0,5,0,0,0,5,0,5,Toscana,ITI1
2021-01-09,COMIRNATY Vaccino a mRNA contro COVID-19,090618,COVID19 - Ospedale del Bibbiena,TOS,40-49,1,4,0,5,0,0,0,5,0,5,Toscana,ITI1
2021-01-09,COMIRNATY Vaccino a mRNA contro COVID-19,090618,COVID19 - Ospedale del Bibbiena,TOS,50-59,1,9,0,10,0,0,0,10,0,10,Toscana,ITI1
2021-01-09,COMIRNATY Vaccino a mRNA contro COVID-19,090618,COVID19 - Ospedale del Bibbiena,TOS,60-69,5,5,0,10,0,0,0,10,0,10,Toscana,ITI1
2021-01-09,COMIRNATY Vaccino a mRNA contro COVID-19,090621,COVID19 - Ospedale di Arezzo,TOS,20-29,1,13,0,14,0,0,0,14,0,14,Toscana,ITI1
2021-01-09,COMIRNATY Vaccino a mRNA contro COVID-19,090621,COVID19 - Ospedale di Arezzo,TOS,30-39,11,21,0,31,1,0,0,32,0,32,Toscana,ITI1
2021-01-09,COMIRNATY Vaccino a mRNA contro COVID-19,090621,COVID19 - Ospedale di Arezzo,TOS,40-49,12,29,0,40,1,0,0,41,0,41,Toscana,ITI1
2021-01-09,COMIRNATY Vaccino a mRNA contro COVID-19,090621,COVID19 - Ospedale di Arezzo,TOS,50-59,11,34,0,43,2,0,0,45,0,45,Toscana,ITI1
2021-01-09,COMIRNATY Vaccino a mRNA contro COVID-19,090621,COVID19 - Ospedale di Arezzo,TOS,60-69,18,4,0,21,1,0,0,22,0,22,Toscana,ITI1
2021-01-09,COMIRNATY Vaccino a mRNA contro COVID-19,090621,COVID19 - Ospedale di Arezzo,TOS,70-79,2,0,0,2,0,0,0,2,0,2,Toscana,ITI1
2021-01-09,COMIRNATY Vaccino a mRNA contro COVID-19,090624,COVID19 - Ospedale di Orbetello,TOS,16-19,1,0,0,0,1,0,0,1,0,1,Toscana,ITI1
2021-01-09,COMIRNATY Vaccino a mRNA contro COVID-19,090624,COVID19 - Ospedale di Orbetello,TOS,20-29,7,5,0,7,5,0,0,12,0,12,Toscana,ITI1
2021-01-09,COMIRNATY Vaccino a mRNA contro COVID-19,090624,COVID19 - Ospedale di Orbetello,TOS,30-39,6,9,0,10,5,0,0,15,0,15,Toscana,ITI1
2021-01-09,COMIRNATY Vaccino a mRNA contro COVID-19,090624,COVID19 - Ospedale di Orbetello,TOS,40-49,5,18,0,20,3,0,0,23,0,23,Toscana,ITI1
2021-01-09,COMIRNATY Vaccino a mRNA contro COVID-19,090624,COVID19 - Ospedale di Orbetello,TOS,50-59,17,20,0,34,3,0,0,37,0,37,Toscana,ITI1
2021-01-09,COMIRNATY Vaccino a mRNA contro COVID-19,090624,COVID19 - Ospedale di Orbetello,TOS,60-69,23,13,0,29,7,0,0,36,0,36,Toscana,ITI1
2021-01-09,COMIRNATY Vaccino a mRNA contro COVID-19,090624,COVID19 - Ospedale di Orbetello,TOS,70-79,2,0,0,2,0,0,0,2,0,2,Toscana,ITI1
2021-01-09,COMIRNATY Vaccino a mRNA contro COVID-19,090627,COVID19 - Ospedale Mugello,TOS,20-29,4,4,0,8,0,0,0,8,0,8,Toscana,ITI1
2021-01-09,COMIRNATY Vaccino a mRNA contro COVID-19,090627,COVID19 - Ospedale Mugello,TOS,30-39,1,6,0,7,0,0,0,7,0,7,Toscana,ITI1
2021-01-09,COMIRNATY Vaccino a mRNA contro COVID-19,090627,COVID19 - Ospedale Mugello,TOS,40-49,3,6,0,7,2,0,0,9,0,9,Toscana,ITI1
2021-01-09,COMIRNATY Vaccino a mRNA contro COVID-19,090627,COVID19 - Ospedale Mugello,TOS,50-59,4,11,0,15,0,0,0,15,0,15,Toscana,ITI1
2021-01-09,COMIRNATY Vaccino a mRNA contro COVID-19,090627,COVID19 - Ospedale Mugello,TOS,60-69,4,5,0,8,0,1,0,9,0,9,Toscana,ITI1
2021-01-09,COMIRNATY Vaccino a mRNA contro COVID-19,090627,COVID19 - Ospedale Mugello,TOS,70-79,1,1,0,1,0,1,0,2,0,2,Toscana,ITI1
2021-01-09,COMIRNATY Vaccino a mRNA contro COVID-19,090627,COVID19 - Ospedale Mugello,TOS,80-89,0,8,0,1,0,7,0,8,0,8,Toscana,ITI1
2021-01-09,COMIRNATY Vaccino a mRNA contro COVID-19,090627,COVID19 - Ospedale Mugello,TOS,90+,0,8,0,0,0,8,0,8,0,8,Toscana,ITI1
2021-01-09,COMIRNATY Vaccino a mRNA contro COVID-19,090629,COVID19 - Ospedale SS. Maria Annunziata,TOS,20-29,8,12,0,20,0,0,0,20,0,20,Toscana,ITI1
2021-01-09,COMIRNATY Vaccino a mRNA contro COVID-19,090629,COVID19 - Ospedale SS. Maria Annunziata,TOS,30-39,11,13,0,24,0,0,0,24,0,24,Toscana,ITI1
2021-01-09,COMIRNATY Vaccino a mRNA contro COVID-19,090629,COVID19 - Ospedale SS. Maria Annunziata,TOS,40-49,11,20,0,30,1,0,0,31,0,31,Toscana,ITI1
2021-01-09,COMIRNATY Vaccino a mRNA contro COVID-19,090629,COVID19 - Ospedale SS. Maria Annunziata,TOS,50-59,8,20,0,27,1,0,0,28,0,28,Toscana,ITI1
2021-01-09,COMIRNATY Vaccino a mRNA contro COVID-19,090629,COVID19 - Ospedale SS. Maria Annunziata,TOS,60-69,20,24,0,44,0,0,0,44,0,44,Toscana,ITI1
2021-01-09,COMIRNATY Vaccino a mRNA contro COVID-19,090629,COVID19 - Ospedale SS. Maria Annunziata,TOS,70-79,2,0,0,2,0,0,0,2,0,2,Toscana,ITI1
2021-01-09,COMIRNATY Vaccino a mRNA contro COVID-19,090632,COVID19 - Ospedale Santa Maria Nuova,TOS,20-29,5,18,0,23,0,0,0,23,0,23,Toscana,ITI1
2021-01-09,COMIRNATY Vaccino a mRNA contro COVID-19,090632,COVID19 - Ospedale Santa Maria Nuova,TOS,30-39,7,10,0,17,0,0,0,17,0,17,Toscana,ITI1
2021-01-09,COMIRNATY Vaccino a mRNA contro COVID-19,090632,COVID19 - Ospedale Santa Maria Nuova,TOS,40-49,5,9,0,14,0,0,0,14,0,14,Toscana,ITI1
2021-01-09,COMIRNATY Vaccino a mRNA contro COVID-19,090632,COVID19 - Ospedale Santa Maria Nuova,TOS,50-59,6,8,0,14,0,0,0,14,0,14,Toscana,ITI1
2021-01-09,COMIRNATY Vaccino a mRNA contro COVID-19,090632,COVID19 - Ospedale Santa Maria Nuova,TOS,60-69,17,15,0,32,0,0,0,32,0,32,Toscana,ITI1
2021-01-09,COMIRNATY Vaccino a mRNA contro COVID-19,090632,COVID19 - Ospedale Santa Maria Nuova,TOS,70-79,2,0,0,2,0,0,0,2,0,2,Toscana,ITI1
2021-01-09,COMIRNATY Vaccino a mRNA contro COVID-19,090637,COVID19 - Ospedale Amiata Val d'Orcia  Abbadia San Salvatore,TOS,20-29,0,1,0,1,0,0,0,1,0,1,Toscana,ITI1
2021-01-09,COMIRNATY Vaccino a mRNA contro COVID-19,090637,COVID19 - Ospedale Amiata Val d'Orcia  Abbadia San Salvatore,TOS,30-39,2,1,0,3,0,0,0,3,0,3,Toscana,ITI1
2021-01-09,COMIRNATY Vaccino a mRNA contro COVID-19,090637,COVID19 - Ospedale Amiata Val d'Orcia  Abbadia San Salvatore,TOS,40-49,0,1,0,1,0,0,0,1,0,1,Toscana,ITI1
2021-01-09,COMIRNATY Vaccino a mRNA contro COVID-19,090637,COVID19 - Ospedale Amiata Val d'Orcia  Abbadia San Salvatore,TOS,50-59,0,2,0,2,0,0,0,2,0,2,Toscana,ITI1
2021-01-09,COMIRNATY Vaccino a mRNA contro COVID-19,090637,COVID19 - Ospedale Amiata Val d'Orcia  Abbadia San Salvatore,TOS,60-69,0,4,0,4,0,0,0,4,0,4,Toscana,ITI1
2021-01-09,COMIRNATY Vaccino a mRNA contro COVID-19,090637,COVID19 - Ospedale Amiata Val d'Orcia  Abbadia San Salvatore,TOS,70-79,1,0,0,1,0,0,0,1,0,1,Toscana,ITI1
2021-01-09,COMIRNATY Vaccino a mRNA contro COVID-19,090638,COVID19 - Ospedale di Campostaggia Poggibonsi,TOS,20-29,1,4,0,5,0,0,0,5,0,5,Toscana,ITI1
2021-01-09,COMIRNATY Vaccino a mRNA contro COVID-19,090638,COVID19 - Ospedale di Campostaggia Poggibonsi,TOS,30-39,8,15,0,20,0,3,0,23,0,23,Toscana,ITI1
2021-01-09,COMIRNATY Vaccino a mRNA contro COVID-19,090638,COVID19 - Ospedale di Campostaggia Poggibonsi,TOS,40-49,2,22,0,24,0,0,0,24,0,24,Toscana,ITI1
2021-01-09,COMIRNATY Vaccino a mRNA contro COVID-19,090638,COVID19 - Ospedale di Campostaggia Poggibonsi,TOS,50-59,11,30,0,39,0,2,0,41,0,41,Toscana,ITI1
2021-01-09,COMIRNATY Vaccino a mRNA contro COVID-19,090638,COVID19 - Ospedale di Campostaggia Poggibonsi,TOS,60-69,17,10,0,27,0,0,0,27,0,27,Toscana,ITI1
2021-01-09,COMIRNATY Vaccino a mRNA contro COVID-19,090639,COVID19 - Ospedale di Nottola Montepulciano,TOS,16-19,0,1,0,1,0,0,0,1,0,1,Toscana,ITI1
2021-01-09,COMIRNATY Vaccino a mRNA contro COVID-19,090639,COVID19 - Ospedale di Nottola Montepulciano,TOS,20-29,1,6,0,6,1,0,0,7,0,7,Toscana,ITI1
2021-01-09,COMIRNATY Vaccino a mRNA contro COVID-19,090639,COVID19 - Ospedale di Nottola Montepulciano,TOS,30-39,1,12,0,13,0,0,0,13,0,13,Toscana,ITI1
2021-01-09,COMIRNATY Vaccino a mRNA contro COVID-19,090639,COVID19 - Ospedale di Nottola Montepulciano,TOS,40-49,5,14,0,17,2,0,0,19,0,19,Toscana,ITI1
2021-01-09,COMIRNATY Vaccino a mRNA contro COVID-19,090639,COVID19 - Ospedale di Nottola Montepulciano,TOS,50-59,5,15,0,19,1,0,0,20,0,20,Toscana,ITI1
2021-01-09,COMIRNATY Vaccino a mRNA contro COVID-19,090639,COVID19 - Ospedale di Nottola Montepulciano,TOS,60-69,3,7,0,10,0,0,0,10,0,10,Toscana,ITI1
2021-01-09,COMIRNATY Vaccino a mRNA contro COVID-19,090639,COVID19 - Ospedale di Nottola Montepulciano,TOS,70-79,2,0,0,2,0,0,0,2,0,2,Toscana,ITI1
2021-01-09,COMIRNATY Vaccino a mRNA contro COVID-19,090640,Covid 19 - Ospedale Unico Versilia,TOS,20-29,1,10,0,11,0,0,0,11,0,11,Toscana,ITI1
2021-01-09,COMIRNATY Vaccino a mRNA contro COVID-19,090640,Covid 19 - Ospedale Unico Versilia,TOS,30-39,5,10,0,15,0,0,0,15,0,15,Toscana,ITI1
2021-01-09,COMIRNATY Vaccino a mRNA contro COVID-19,090640,Covid 19 - Ospedale Unico Versilia,TOS,40-49,3,16,0,19,0,0,0,19,0,19,Toscana,ITI1
2021-01-09,COMIRNATY Vaccino a mRNA contro COVID-19,090640,Covid 19 - Ospedale Unico Versilia,TOS,50-59,4,16,0,19,0,1,0,20,0,20,Toscana,ITI1
2021-01-09,COMIRNATY Vaccino a mRNA contro COVID-19,090640,Covid 19 - Ospedale Unico Versilia,TOS,60-69,16,10,0,25,0,1,0,26,0,26,Toscana,ITI1
2021-01-09,COMIRNATY Vaccino a mRNA contro COVID-19,090640,Covid 19 - Ospedale Unico Versilia,TOS,70-79,1,0,0,1,0,0,0,1,0,1,Toscana,ITI1
2021-01-09,COMIRNATY Vaccino a mRNA contro COVID-19,090640,Covid 19 - Ospedale Unico Versilia,TOS,90+,0,1,0,0,0,1,0,1,0,1,Toscana,ITI1
2021-01-09,COMIRNATY Vaccino a mRNA contro COVID-19,090641,COVID19 - Ospedale La Gruccia Montevarchi,TOS,20-29,5,12,0,15,2,0,0,17,0,17,Toscana,ITI1
2021-01-09,COMIRNATY Vaccino a mRNA contro COVID-19,090641,COVID19 - Ospedale La Gruccia Montevarchi,TOS,30-39,3,11,0,12,2,0,0,14,0,14,Toscana,ITI1
2021-01-09,COMIRNATY Vaccino a mRNA contro COVID-19,090641,COVID19 - Ospedale La Gruccia Montevarchi,TOS,40-49,4,24,0,27,1,0,0,28,0,28,Toscana,ITI1
2021-01-09,COMIRNATY Vaccino a mRNA contro COVID-19,090641,COVID19 - Ospedale La Gruccia Montevarchi,TOS,50-59,2,16,0,16,1,1,0,18,0,18,Toscana,ITI1
2021-01-09,COMIRNATY Vaccino a mRNA contro COVID-19,090641,COVID19 - Ospedale La Gruccia Montevarchi,TOS,60-69,7,10,0,17,0,0,0,17,0,17,Toscana,ITI1
2021-01-09,COMIRNATY Vaccino a mRNA contro COVID-19,090641,COVID19 - Ospedale La Gruccia Montevarchi,TOS,70-79,1,1,0,2,0,0,0,2,0,2,Toscana,ITI1
2021-01-09,COMIRNATY Vaccino a mRNA contro COVID-19,090901,COVID19 - AOU Pisana,TOS,16-19,0,5,0,5,0,0,0,5,0,5,Toscana,ITI1
2021-01-09,COMIRNATY Vaccino a mRNA contro COVID-19,090901,COVID19 - AOU Pisana,TOS,20-29,21,50,0,71,0,0,0,71,0,71,Toscana,ITI1
2021-01-09,COMIRNATY Vaccino a mRNA contro COVID-19,090901,COVID19 - AOU Pisana,TOS,30-39,17,33,0,49,1,0,0,50,0,50,Toscana,ITI1
2021-01-09,COMIRNATY Vaccino a mRNA contro COVID-19,090901,COVID19 - AOU Pisana,TOS,40-49,7,29,0,36,0,0,0,36,0,36,Toscana,ITI1
2021-01-09,COMIRNATY Vaccino a mRNA contro COVID-19,090901,COVID19 - AOU Pisana,TOS,50-59,15,32,0,47,0,0,0,47,0,47,Toscana,ITI1
2021-01-09,COMIRNATY Vaccino a mRNA contro COVID-19,090901,COVID19 - AOU Pisana,TOS,60-69,10,12,0,20,2,0,0,22,0,22,Toscana,ITI1
2021-01-09,COMIRNATY Vaccino a mRNA contro COVID-19,090901,COVID19 - AOU Pisana,TOS,70-79,2,0,0,2,0,0,0,2,0,2,Toscana,ITI1
2021-01-09,COMIRNATY Vaccino a mRNA contro COVID-19,090901,COVID19 - AOU Pisana,TOS,80-89,1,0,0,1,0,0,0,1,0,1,Toscana,ITI1
2021-01-09,COMIRNATY Vaccino a mRNA contro COVID-19,090902,COVID19 - AOU Senese,TOS,20-29,21,35,0,56,0,0,0,56,0,56,Toscana,ITI1
2021-01-09,COMIRNATY Vaccino a mRNA contro COVID-19,090902,COVID19 - AOU Senese,TOS,30-39,21,17,0,38,0,0,0,38,0,38,Toscana,ITI1
2021-01-09,COMIRNATY Vaccino a mRNA contro COVID-19,090902,COVID19 - AOU Senese,TOS,40-49,9,23,0,32,0,0,0,32,0,32,Toscana,ITI1
2021-01-09,COMIRNATY Vaccino a mRNA contro COVID-19,090902,COVID19 - AOU Senese,TOS,50-59,14,23,0,37,0,0,0,37,0,37,Toscana,ITI1
2021-01-09,COMIRNATY Vaccino a mRNA contro COVID-19,090902,COVID19 - AOU Senese,TOS,60-69,10,9,0,19,0,0,0,19,0,19,Toscana,ITI1
2021-01-09,COMIRNATY Vaccino a mRNA contro COVID-19,090902,COVID19 - AOU Senese,TOS,70-79,4,0,0,4,0,0,0,4,0,4,Toscana,ITI1
2021-01-09,COMIRNATY Vaccino a mRNA contro COVID-19,090903,COVID19 - AOU Careggi - CTO,TOS,16-19,19,48,0,66,1,0,0,67,0,67,Toscana,ITI1
2021-01-09,COMIRNATY Vaccino a mRNA contro COVID-19,090903,COVID19 - AOU Careggi - CTO,TOS,20-29,116,260,0,370,6,0,0,376,0,376,Toscana,ITI1
2021-01-09,COMIRNATY Vaccino a mRNA contro COVID-19,090903,COVID19 - AOU Careggi - CTO,TOS,30-39,41,44,0,74,11,0,0,85,0,85,Toscana,ITI1
2021-01-09,COMIRNATY Vaccino a mRNA contro COVID-19,090903,COVID19 - AOU Careggi - CTO,TOS,40-49,25,56,0,66,15,0,0,81,0,81,Toscana,ITI1
2021-01-09,COMIRNATY Vaccino a mRNA contro COVID-19,090903,COVID19 - AOU Careggi - CTO,TOS,50-59,37,63,0,87,13,0,0,100,0,100,Toscana,ITI1
2021-01-09,COMIRNATY Vaccino a mRNA contro COVID-19,090903,COVID19 - AOU Careggi - CTO,TOS,60-69,28,20,0,37,11,0,0,48,0,48,Toscana,ITI1
2021-01-09,COMIRNATY Vaccino a mRNA contro COVID-19,090903,COVID19 - AOU Careggi - CTO,TOS,70-79,13,1,0,9,5,0,0,14,0,14,Toscana,ITI1
2021-01-09,COMIRNATY Vaccino a mRNA contro COVID-19,090904,COVID19 - Ospedale AOU Meyer,TOS,20-29,5,10,0,15,0,0,0,15,0,15,Toscana,ITI1
2021-01-09,COMIRNATY Vaccino a mRNA contro COVID-19,090904,COVID19 - Ospedale AOU Meyer,TOS,30-39,5,23,0,28,0,0,0,28,0,28,Toscana,ITI1
2021-01-09,COMIRNATY Vaccino a mRNA contro COVID-19,090904,COVID19 - Ospedale AOU Meyer,TOS,40-49,2,25,0,27,0,0,0,27,0,27,Toscana,ITI1
2021-01-09,COMIRNATY Vaccino a mRNA contro COVID-19,090904,COVID19 - Ospedale AOU Meyer,TOS,50-59,5,23,0,28,0,0,0,28,0,28,Toscana,ITI1
2021-01-09,COMIRNATY Vaccino a mRNA contro COVID-19,090904,COVID19 - Ospedale AOU Meyer,TOS,60-69,7,7,0,14,0,0,0,14,0,14,Toscana,ITI1
2021-01-09,COMIRNATY Vaccino a mRNA contro COVID-19,090904,COVID19 - Ospedale AOU Meyer,TOS,70-79,2,0,0,2,0,0,0,2,0,2,Toscana,ITI1
2021-01-09,COMIRNATY Vaccino a mRNA contro COVID-19,090907,Covid19 - FTGM Pisa San Cataldo,TOS,20-29,1,7,0,7,1,0,0,8,0,8,Toscana,ITI1
2021-01-09,COMIRNATY Vaccino a mRNA contro COVID-19,090907,Covid19 - FTGM Pisa San Cataldo,TOS,30-39,7,17,0,23,0,1,0,24,0,24,Toscana,ITI1
2021-01-09,COMIRNATY Vaccino a mRNA contro COVID-19,090907,Covid19 - FTGM Pisa San Cataldo,TOS,40-49,6,19,0,25,0,0,0,25,0,25,Toscana,ITI1
2021-01-09,COMIRNATY Vaccino a mRNA contro COVID-19,090907,Covid19 - FTGM Pisa San Cataldo,TOS,50-59,2,13,0,14,1,0,0,15,0,15,Toscana,ITI1
2021-01-09,COMIRNATY Vaccino a mRNA contro COVID-19,090907,Covid19 - FTGM Pisa San Cataldo,TOS,60-69,2,9,0,11,0,0,0,11,0,11,Toscana,ITI1
2021-01-09,COMIRNATY Vaccino a mRNA contro COVID-19,090907,Covid19 - FTGM Pisa San Cataldo,TOS,70-79,0,1,0,1,0,0,0,1,0,1,Toscana,ITI1
2021-01-09,COMIRNATY Vaccino a mRNA contro COVID-19,10294I,Covid19 - RSA VILLA PASCOLI,TOS,30-39,1,1,0,2,0,0,0,2,0,2,Toscana,ITI1
2021-01-09,COMIRNATY Vaccino a mRNA contro COVID-19,10294I,Covid19 - RSA VILLA PASCOLI,TOS,40-49,0,9,0,9,0,0,0,9,0,9,Toscana,ITI1
2021-01-09,COMIRNATY Vaccino a mRNA contro COVID-19,10294I,Covid19 - RSA VILLA PASCOLI,TOS,50-59,1,0,0,1,0,0,0,1,0,1,Toscana,ITI1
2021-01-09,COMIRNATY Vaccino a mRNA contro COVID-19,10294I,Covid19 - RSA VILLA PASCOLI,TOS,60-69,3,3,0,1,0,5,0,6,0,6,Toscana,ITI1
2021-01-09,COMIRNATY Vaccino a mRNA contro COVID-19,10294I,Covid19 - RSA VILLA PASCOLI,TOS,70-79,1,5,0,0,0,6,0,6,0,6,Toscana,ITI1
2021-01-09,COMIRNATY Vaccino a mRNA contro COVID-19,10294I,Covid19 - RSA VILLA PASCOLI,TOS,80-89,2,11,0,0,0,13,0,13,0,13,Toscana,ITI1
2021-01-09,COMIRNATY Vaccino a mRNA contro COVID-19,10294I,Covid19 - RSA VILLA PASCOLI,TOS,90+,5,12,0,0,0,17,0,17,0,17,Toscana,ITI1
2021-01-09,COMIRNATY Vaccino a mRNA contro COVID-19,10304I,Covid19 - RSA BELVEDERE,TOS,30-39,0,1,0,1,0,0,0,1,0,1,Toscana,ITI1
2021-01-09,COMIRNATY Vaccino a mRNA contro COVID-19,10304I,Covid19 - RSA BELVEDERE,TOS,70-79,4,1,0,0,0,5,0,5,0,5,Toscana,ITI1
2021-01-09,COMIRNATY Vaccino a mRNA contro COVID-19,10304I,Covid19 - RSA BELVEDERE,TOS,80-89,3,1,0,0,0,4,0,4,0,4,Toscana,ITI1
2021-01-09,COMIRNATY Vaccino a mRNA contro COVID-19,10304I,Covid19 - RSA BELVEDERE,TOS,90+,1,1,0,0,0,2,0,2,0,2,Toscana,ITI1
2021-01-09,COMIRNATY Vaccino a mRNA contro COVID-19,11012E,COVID19 - Ospedale San Giuseppe,TOS,20-29,6,9,0,15,0,0,0,15,0,15,Toscana,ITI1
2021-01-09,COMIRNATY Vaccino a mRNA contro COVID-19,11012E,COVID19 - Ospedale San Giuseppe,TOS,30-39,5,8,0,12,1,0,0,13,0,13,Toscana,ITI1
2021-01-09,COMIRNATY Vaccino a mRNA contro COVID-19,11012E,COVID19 - Ospedale San Giuseppe,TOS,40-49,9,26,0,35,0,0,0,35,0,35,Toscana,ITI1
2021-01-09,COMIRNATY Vaccino a mRNA contro COVID-19,11012E,COVID19 - Ospedale San Giuseppe,TOS,50-59,10,29,0,39,0,0,0,39,0,39,Toscana,ITI1
2021-01-09,COMIRNATY Vaccino a mRNA contro COVID-19,11012E,COVID19 - Ospedale San Giuseppe,TOS,60-69,33,13,0,46,0,0,0,46,0,46,Toscana,ITI1
2021-01-09,COMIRNATY Vaccino a mRNA contro COVID-19,11012E,COVID19 - Ospedale San Giuseppe,TOS,70-79,1,1,0,2,0,0,0,2,0,2,Toscana,ITI1
2021-01-09,COMIRNATY Vaccino a mRNA contro COVID-19,11151A,Covid 19 - Ospedale S.Antonio Abate di Pontremoli,TOS,20-29,1,3,0,4,0,0,0,4,0,4,Toscana,ITI1
2021-01-09,COMIRNATY Vaccino a mRNA contro COVID-19,11151A,Covid 19 - Ospedale S.Antonio Abate di Pontremoli,TOS,30-39,2,2,0,4,0,0,0,4,0,4,Toscana,ITI1
2021-01-09,COMIRNATY Vaccino a mRNA contro COVID-19,11151A,Covid 19 - Ospedale S.Antonio Abate di Pontremoli,TOS,40-49,0,7,0,7,0,0,0,7,0,7,Toscana,ITI1
2021-01-09,COMIRNATY Vaccino a mRNA contro COVID-19,11151A,Covid 19 - Ospedale S.Antonio Abate di Pontremoli,TOS,50-59,1,7,0,8,0,0,0,8,0,8,Toscana,ITI1
2021-01-09,COMIRNATY Vaccino a mRNA contro COVID-19,11151A,Covid 19 - Ospedale S.Antonio Abate di Pontremoli,TOS,60-69,4,2,0,6,0,0,0,6,0,6,Toscana,ITI1
2021-01-09,COMIRNATY Vaccino a mRNA contro COVID-19,11151A,Covid 19 - Ospedale S.Antonio Abate di Pontremoli,TOS,70-79,1,0,0,1,0,0,0,1,0,1,Toscana,ITI1
2021-01-09,COMIRNATY Vaccino a mRNA contro COVID-19,122M4I,R.S.A. I POGGETTI,TOS,20-29,1,0,0,1,0,0,0,1,0,1,Toscana,ITI1
2021-01-09,COMIRNATY Vaccino a mRNA contro COVID-19,122M4I,R.S.A. I POGGETTI,TOS,30-39,1,1,0,2,0,0,0,2,0,2,Toscana,ITI1
2021-01-09,COMIRNATY Vaccino a mRNA contro COVID-19,122M4I,R.S.A. I POGGETTI,TOS,40-49,0,1,0,1,0,0,0,1,0,1,Toscana,ITI1
2021-01-09,COMIRNATY Vaccino a mRNA contro COVID-19,122M4I,R.S.A. I POGGETTI,TOS,60-69,4,3,0,0,0,7,0,7,0,7,Toscana,ITI1
2021-01-09,COMIRNATY Vaccino a mRNA contro COVID-19,122M4I,R.S.A. I POGGETTI,TOS,70-79,7,0,0,0,0,7,0,7,0,7,Toscana,ITI1
2021-01-09,COMIRNATY Vaccino a mRNA contro COVID-19,122M4I,R.S.A. I POGGETTI,TOS,80-89,3,8,0,0,0,11,0,11,0,11,Toscana,ITI1
2021-01-09,COMIRNATY Vaccino a mRNA contro COVID-19,122M4I,R.S.A. I POGGETTI,TOS,90+,2,3,0,0,0,5,0,5,0,5,Toscana,ITI1
2021-01-09,COMIRNATY Vaccino a mRNA contro COVID-19,13021A,COVID19 - Ospedale S.Giovanni di Dio,TOS,16-19,0,1,0,1,0,0,0,1,0,1,Toscana,ITI1
2021-01-09,COMIRNATY Vaccino a mRNA contro COVID-19,13021A,COVID19 - Ospedale S.Giovanni di Dio,TOS,20-29,15,18,0,32,0,1,0,33,0,33,Toscana,ITI1
2021-01-09,COMIRNATY Vaccino a mRNA contro COVID-19,13021A,COVID19 - Ospedale S.Giovanni di Dio,TOS,30-39,17,26,0,41,0,2,0,43,0,43,Toscana,ITI1
2021-01-09,COMIRNATY Vaccino a mRNA contro COVID-19,13021A,COVID19 - Ospedale S.Giovanni di Dio,TOS,40-49,4,22,0,21,0,5,0,26,0,26,Toscana,ITI1
2021-01-09,COMIRNATY Vaccino a mRNA contro COVID-19,13021A,COVID19 - Ospedale S.Giovanni di Dio,TOS,50-59,18,25,0,31,0,12,0,43,0,43,Toscana,ITI1
2021-01-09,COMIRNATY Vaccino a mRNA contro COVID-19,13021A,COVID19 - Ospedale S.Giovanni di Dio,TOS,60-69,28,19,0,32,0,15,0,47,0,47,Toscana,ITI1
2021-01-09,COMIRNATY Vaccino a mRNA contro COVID-19,13021A,COVID19 - Ospedale S.Giovanni di Dio,TOS,70-79,1,4,0,1,0,4,0,5,0,5,Toscana,ITI1
2021-01-09,COMIRNATY Vaccino a mRNA contro COVID-19,13054E,CASA MAGDALA,TOS,30-39,4,0,0,0,0,4,0,4,0,4,Toscana,ITI1
2021-01-09,COMIRNATY Vaccino a mRNA contro COVID-19,13054E,CASA MAGDALA,TOS,40-49,1,0,0,0,0,1,0,1,0,1,Toscana,ITI1
2021-01-09,COMIRNATY Vaccino a mRNA contro COVID-19,13054E,CASA MAGDALA,TOS,50-59,0,1,0,0,0,1,0,1,0,1,Toscana,ITI1
2021-01-09,COMIRNATY Vaccino a mRNA contro COVID-19,13054E,CASA MAGDALA,TOS,60-69,1,1,0,0,0,2,0,2,0,2,Toscana,ITI1
2021-01-09,COMIRNATY Vaccino a mRNA contro COVID-19,13334I,Covid19 - RSA SANATRIX,TOS,20-29,0,1,0,1,0,0,0,1,0,1,Toscana,ITI1
2021-01-09,COMIRNATY Vaccino a mRNA contro COVID-19,13334I,Covid19 - RSA SANATRIX,TOS,30-39,0,1,0,1,0,0,0,1,0,1,Toscana,ITI1
2021-01-09,COMIRNATY Vaccino a mRNA contro COVID-19,13334I,Covid19 - RSA SANATRIX,TOS,50-59,1,0,0,1,0,0,0,1,0,1,Toscana,ITI1
2021-01-09,COMIRNATY Vaccino a mRNA contro COVID-19,13334I,Covid19 - RSA SANATRIX,TOS,60-69,1,1,0,1,0,1,0,2,0,2,Toscana,ITI1
2021-01-09,COMIRNATY Vaccino a mRNA contro COVID-19,13334I,Covid19 - RSA SANATRIX,TOS,80-89,1,0,0,0,0,1,0,1,0,1,Toscana,ITI1
2021-01-09,COMIRNATY Vaccino a mRNA contro COVID-19,13614I,CASA DI RIPOSO GINO INCONTRI,TOS,50-59,0,1,0,1,0,0,0,1,0,1,Toscana,ITI1
2021-01-09,COMIRNATY Vaccino a mRNA contro COVID-19,13614I,CASA DI RIPOSO GINO INCONTRI,TOS,80-89,0,4,0,1,0,3,0,4,0,4,Toscana,ITI1
2021-01-09,COMIRNATY Vaccino a mRNA contro COVID-19,13624I,FONDAZIONE C.RESID. ANZIANI V.,TOS,50-59,0,1,0,0,0,1,0,1,0,1,Toscana,ITI1
2021-01-09,COMIRNATY Vaccino a mRNA contro COVID-19,13624I,FONDAZIONE C.RESID. ANZIANI V.,TOS,60-69,1,0,0,0,0,1,0,1,0,1,Toscana,ITI1
2021-01-09,COMIRNATY Vaccino a mRNA contro COVID-19,13624I,FONDAZIONE C.RESID. ANZIANI V.,TOS,70-79,1,1,0,0,0,2,0,2,0,2,Toscana,ITI1
2021-01-09,COMIRNATY Vaccino a mRNA contro COVID-19,13624I,FONDAZIONE C.RESID. ANZIANI V.,TOS,80-89,0,6,0,0,0,6,0,6,0,6,Toscana,ITI1
2021-01-09,COMIRNATY Vaccino a mRNA contro COVID-19,13624I,FONDAZIONE C.RESID. ANZIANI V.,TOS,90+,0,8,0,0,0,8,0,8,0,8,Toscana,ITI1
2021-01-09,COMIRNATY Vaccino a mRNA contro COVID-19,16121A,Covid 19 - Ospedale Civile di Cecina,TOS,20-29,2,4,0,6,0,0,0,6,0,6,Toscana,ITI1
2021-01-09,COMIRNATY Vaccino a mRNA contro COVID-19,16121A,Covid 19 - Ospedale Civile di Cecina,TOS,30-39,3,4,0,7,0,0,0,7,0,7,Toscana,ITI1
2021-01-09,COMIRNATY Vaccino a mRNA contro COVID-19,16121A,Covid 19 - Ospedale Civile di Cecina,TOS,40-49,4,6,0,10,0,0,0,10,0,10,Toscana,ITI1
2021-01-09,COMIRNATY Vaccino a mRNA contro COVID-19,16121A,Covid 19 - Ospedale Civile di Cecina,TOS,50-59,5,16,0,21,0,0,0,21,0,21,Toscana,ITI1
2021-01-09,COMIRNATY Vaccino a mRNA contro COVID-19,16121A,Covid 19 - Ospedale Civile di Cecina,TOS,60-69,7,8,0,15,0,0,0,15,0,15,Toscana,ITI1
2021-01-09,COMIRNATY Vaccino a mRNA contro COVID-19,16121A,Covid 19 - Ospedale Civile di Cecina,TOS,70-79,1,0,0,1,0,0,0,1,0,1,Toscana,ITI1
2021-01-09,COMIRNATY Vaccino a mRNA contro COVID-19,20064I,RSA PIO ISTITUTO CAMPANA,TOS,20-29,0,1,0,0,1,0,0,1,0,1,Toscana,ITI1
2021-01-09,COMIRNATY Vaccino a mRNA contro COVID-19,20064I,RSA PIO ISTITUTO CAMPANA,TOS,30-39,0,1,0,0,1,0,0,1,0,1,Toscana,ITI1
2021-01-09,COMIRNATY Vaccino a mRNA contro COVID-19,20064I,RSA PIO ISTITUTO CAMPANA,TOS,40-49,0,1,0,0,1,0,0,1,0,1,Toscana,ITI1
2021-01-09,COMIRNATY Vaccino a mRNA contro COVID-19,20064I,RSA PIO ISTITUTO CAMPANA,TOS,50-59,1,0,0,0,1,0,0,1,0,1,Toscana,ITI1
2021-01-09,COMIRNATY Vaccino a mRNA contro COVID-19,20064I,RSA PIO ISTITUTO CAMPANA,TOS,60-69,1,1,0,0,0,2,0,2,0,2,Toscana,ITI1
2021-01-09,COMIRNATY Vaccino a mRNA contro COVID-19,20064I,RSA PIO ISTITUTO CAMPANA,TOS,70-79,2,2,0,0,0,4,0,4,0,4,Toscana,ITI1
2021-01-09,COMIRNATY Vaccino a mRNA contro COVID-19,20064I,RSA PIO ISTITUTO CAMPANA,TOS,80-89,0,2,0,0,0,2,0,2,0,2,Toscana,ITI1
2021-01-09,COMIRNATY Vaccino a mRNA contro COVID-19,20064I,RSA PIO ISTITUTO CAMPANA,TOS,90+,1,3,0,0,0,4,0,4,0,4,Toscana,ITI1
2021-01-09,COMIRNATY Vaccino a mRNA contro COVID-19,21791A,COVID19 - FTGM OPA Massa,TOS,20-29,5,14,0,18,1,0,0,19,0,19,Toscana,ITI1
2021-01-09,COMIRNATY Vaccino a mRNA contro COVID-19,21791A,COVID19 - FTGM OPA Massa,TOS,30-39,9,20,0,25,4,0,0,29,0,29,Toscana,ITI1
2021-01-09,COMIRNATY Vaccino a mRNA contro COVID-19,21791A,COVID19 - FTGM OPA Massa,TOS,40-49,23,29,0,48,4,0,0,52,0,52,Toscana,ITI1
2021-01-09,COMIRNATY Vaccino a mRNA contro COVID-19,21791A,COVID19 - FTGM OPA Massa,TOS,50-59,9,38,0,44,3,0,0,47,0,47,Toscana,ITI1
2021-01-09,COMIRNATY Vaccino a mRNA contro COVID-19,21791A,COVID19 - FTGM OPA Massa,TOS,60-69,4,5,0,8,0,1,0,9,0,9,Toscana,ITI1
2021-01-09,COMIRNATY Vaccino a mRNA contro COVID-19,22444I,Covid19 - Casa di Riposo Villa Maria Regina,TOS,50-59,0,3,0,2,0,1,0,3,0,3,Toscana,ITI1
2021-01-09,COMIRNATY Vaccino a mRNA contro COVID-19,22444I,Covid19 - Casa di Riposo Villa Maria Regina,TOS,60-69,0,2,0,2,0,0,0,2,0,2,Toscana,ITI1
2021-01-09,COMIRNATY Vaccino a mRNA contro COVID-19,22444I,Covid19 - Casa di Riposo Villa Maria Regina,TOS,70-79,0,2,0,1,0,1,0,2,0,2,Toscana,ITI1
2021-01-09,COMIRNATY Vaccino a mRNA contro COVID-19,22444I,Covid19 - Casa di Riposo Villa Maria Regina,TOS,80-89,0,3,0,0,0,3,0,3,0,3,Toscana,ITI1
2021-01-09,COMIRNATY Vaccino a mRNA contro COVID-19,22444I,Covid19 - Casa di Riposo Villa Maria Regina,TOS,90+,0,9,0,0,0,9,0,9,0,9,Toscana,ITI1
2021-01-09,COMIRNATY Vaccino a mRNA contro COVID-19,29114I,RSA SESTINO G.BERTOZZI,TOS,40-49,0,2,0,1,1,0,0,2,0,2,Toscana,ITI1
2021-01-09,COMIRNATY Vaccino a mRNA contro COVID-19,29114I,RSA SESTINO G.BERTOZZI,TOS,50-59,1,1,0,2,0,0,0,2,0,2,Toscana,ITI1
2021-01-09,COMIRNATY Vaccino a mRNA contro COVID-19,29114I,RSA SESTINO G.BERTOZZI,TOS,60-69,0,1,0,0,0,1,0,1,0,1,Toscana,ITI1
2021-01-09,COMIRNATY Vaccino a mRNA contro COVID-19,29114I,RSA SESTINO G.BERTOZZI,TOS,70-79,3,1,0,0,0,4,0,4,0,4,Toscana,ITI1
2021-01-09,COMIRNATY Vaccino a mRNA contro COVID-19,29114I,RSA SESTINO G.BERTOZZI,TOS,80-89,1,4,0,0,0,5,0,5,0,5,Toscana,ITI1
2021-01-09,COMIRNATY Vaccino a mRNA contro COVID-19,29114I,RSA SESTINO G.BERTOZZI,TOS,90+,1,3,0,0,0,4,0,4,0,4,Toscana,ITI1
2021-01-09,COMIRNATY Vaccino a mRNA contro COVID-19,30714L,CAP C/O CASA DI PINOCCHIO,TOS,30-39,1,0,0,0,0,1,0,1,0,1,Toscana,ITI1
2021-01-09,COMIRNATY Vaccino a mRNA contro COVID-19,30714L,CAP C/O CASA DI PINOCCHIO,TOS,40-49,1,2,0,0,0,3,0,3,0,3,Toscana,ITI1
2021-01-09,COMIRNATY Vaccino a mRNA contro COVID-19,30714L,CAP C/O CASA DI PINOCCHIO,TOS,50-59,2,4,0,2,0,4,0,6,0,6,Toscana,ITI1
2021-01-09,COMIRNATY Vaccino a mRNA contro COVID-19,30714L,CAP C/O CASA DI PINOCCHIO,TOS,60-69,1,1,0,1,0,1,0,2,0,2,Toscana,ITI1
2021-01-09,COMIRNATY Vaccino a mRNA contro COVID-19,42284I,"R.S.A. \""LE SUGHERE\""",TOS,30-39,0,1,0,1,0,0,0,1,0,1,Toscana,ITI1
2021-01-09,COMIRNATY Vaccino a mRNA contro COVID-19,42284I,"R.S.A. \""LE SUGHERE\""",TOS,40-49,0,2,0,2,0,0,0,2,0,2,Toscana,ITI1
2021-01-09,COMIRNATY Vaccino a mRNA contro COVID-19,42284I,"R.S.A. \""LE SUGHERE\""",TOS,60-69,2,1,0,0,0,3,0,3,0,3,Toscana,ITI1
2021-01-09,COMIRNATY Vaccino a mRNA contro COVID-19,42284I,"R.S.A. \""LE SUGHERE\""",TOS,80-89,0,2,0,0,0,2,0,2,0,2,Toscana,ITI1
2021-01-09,COMIRNATY Vaccino a mRNA contro COVID-19,42284I,"R.S.A. \""LE SUGHERE\""",TOS,90+,1,3,0,0,0,4,0,4,0,4,Toscana,ITI1
2021-01-09,COMIRNATY Vaccino a mRNA contro COVID-19,46524I,R.S.A. P. FEDI,TOS,30-39,2,0,0,2,0,0,0,2,0,2,Toscana,ITI1
2021-01-09,COMIRNATY Vaccino a mRNA contro COVID-19,46524I,R.S.A. P. FEDI,TOS,40-49,0,1,0,1,0,0,0,1,0,1,Toscana,ITI1
2021-01-09,COMIRNATY Vaccino a mRNA contro COVID-19,46524I,R.S.A. P. FEDI,TOS,50-59,0,1,0,1,0,0,0,1,0,1,Toscana,ITI1
2021-01-09,COMIRNATY Vaccino a mRNA contro COVID-19,46524I,R.S.A. P. FEDI,TOS,60-69,0,1,0,1,0,0,0,1,0,1,Toscana,ITI1
2021-01-09,COMIRNATY Vaccino a mRNA contro COVID-19,46524I,R.S.A. P. FEDI,TOS,70-79,1,3,0,0,0,4,0,4,0,4,Toscana,ITI1
2021-01-09,COMIRNATY Vaccino a mRNA contro COVID-19,46524I,R.S.A. P. FEDI,TOS,80-89,5,10,0,0,0,15,0,15,0,15,Toscana,ITI1
2021-01-09,COMIRNATY Vaccino a mRNA contro COVID-19,46524I,R.S.A. P. FEDI,TOS,90+,2,9,0,0,0,11,0,11,0,11,Toscana,ITI1
2021-01-09,COMIRNATY Vaccino a mRNA contro COVID-19,49624I,R.S.A.QUISISANA SIENA,TOS,20-29,1,0,0,1,0,0,0,1,0,1,Toscana,ITI1
2021-01-09,COMIRNATY Vaccino a mRNA contro COVID-19,49624I,R.S.A.QUISISANA SIENA,TOS,30-39,1,1,0,2,0,0,0,2,0,2,Toscana,ITI1
2021-01-09,COMIRNATY Vaccino a mRNA contro COVID-19,49624I,R.S.A.QUISISANA SIENA,TOS,50-59,1,0,0,0,0,1,0,1,0,1,Toscana,ITI1
2021-01-09,COMIRNATY Vaccino a mRNA contro COVID-19,49624I,R.S.A.QUISISANA SIENA,TOS,70-79,2,2,0,0,0,4,0,4,0,4,Toscana,ITI1
2021-01-09,COMIRNATY Vaccino a mRNA contro COVID-19,49624I,R.S.A.QUISISANA SIENA,TOS,80-89,3,8,0,0,0,11,0,11,0,11,Toscana,ITI1
2021-01-09,COMIRNATY Vaccino a mRNA contro COVID-19,49624I,R.S.A.QUISISANA SIENA,TOS,90+,1,20,0,0,0,21,0,21,0,21,Toscana,ITI1
2021-01-09,COMIRNATY Vaccino a mRNA contro COVID-19,60944I,LA MERIDIANA,TOS,60-69,0,1,0,0,0,1,0,1,0,1,Toscana,ITI1
2021-01-09,COMIRNATY Vaccino a mRNA contro COVID-19,60944I,LA MERIDIANA,TOS,70-79,0,2,0,0,0,2,0,2,0,2,Toscana,ITI1
2021-01-09,COMIRNATY Vaccino a mRNA contro COVID-19,60944I,LA MERIDIANA,TOS,80-89,1,4,0,0,0,5,0,5,0,5,Toscana,ITI1
2021-01-09,COMIRNATY Vaccino a mRNA contro COVID-19,60944I,LA MERIDIANA,TOS,90+,1,5,0,0,0,6,0,6,0,6,Toscana,ITI1
2021-01-09,COMIRNATY Vaccino a mRNA contro COVID-19,60964I,LA CUPOLINA,TOS,40-49,2,1,0,1,0,2,0,3,0,3,Toscana,ITI1
2021-01-09,COMIRNATY Vaccino a mRNA contro COVID-19,60964I,LA CUPOLINA,TOS,50-59,0,1,0,1,0,0,0,1,0,1,Toscana,ITI1
2021-01-09,COMIRNATY Vaccino a mRNA contro COVID-19,60964I,LA CUPOLINA,TOS,60-69,5,3,0,1,0,7,0,8,0,8,Toscana,ITI1
2021-01-09,COMIRNATY Vaccino a mRNA contro COVID-19,60964I,LA CUPOLINA,TOS,70-79,2,1,0,0,0,3,0,3,0,3,Toscana,ITI1
2021-01-09,COMIRNATY Vaccino a mRNA contro COVID-19,60964I,LA CUPOLINA,TOS,80-89,3,3,0,0,0,6,0,6,0,6,Toscana,ITI1
2021-01-09,COMIRNATY Vaccino a mRNA contro COVID-19,60964I,LA CUPOLINA,TOS,90+,0,3,0,0,0,3,0,3,0,3,Toscana,ITI1
2021-01-09,COMIRNATY Vaccino a mRNA contro COVID-19,66974I,LE CASETTE,TOS,30-39,1,1,0,1,0,1,0,2,0,2,Toscana,ITI1
2021-01-09,COMIRNATY Vaccino a mRNA contro COVID-19,66974I,LE CASETTE,TOS,40-49,0,2,0,1,1,0,0,2,0,2,Toscana,ITI1
2021-01-09,COMIRNATY Vaccino a mRNA contro COVID-19,66974I,LE CASETTE,TOS,50-59,1,1,0,0,0,2,0,2,0,2,Toscana,ITI1
2021-01-09,COMIRNATY Vaccino a mRNA contro COVID-19,66974I,LE CASETTE,TOS,60-69,3,1,0,0,0,4,0,4,0,4,Toscana,ITI1
2021-01-09,COMIRNATY Vaccino a mRNA contro COVID-19,66974I,LE CASETTE,TOS,70-79,3,3,0,0,0,6,0,6,0,6,Toscana,ITI1
2021-01-09,COMIRNATY Vaccino a mRNA contro COVID-19,66974I,LE CASETTE,TOS,80-89,4,4,0,0,0,8,0,8,0,8,Toscana,ITI1
2021-01-09,COMIRNATY Vaccino a mRNA contro COVID-19,66974I,LE CASETTE,TOS,90+,4,6,0,0,0,10,0,10,0,10,Toscana,ITI1
2021-01-09,COMIRNATY Vaccino a mRNA contro COVID-19,80124I,R.S.A. VILLA AMELIA SRL,TOS,20-29,0,2,0,1,0,1,0,2,0,2,Toscana,ITI1
2021-01-09,COMIRNATY Vaccino a mRNA contro COVID-19,80124I,R.S.A. VILLA AMELIA SRL,TOS,30-39,0,2,0,2,0,0,0,2,0,2,Toscana,ITI1
2021-01-09,COMIRNATY Vaccino a mRNA contro COVID-19,80124I,R.S.A. VILLA AMELIA SRL,TOS,40-49,0,4,0,4,0,0,0,4,0,4,Toscana,ITI1
2021-01-09,COMIRNATY Vaccino a mRNA contro COVID-19,80124I,R.S.A. VILLA AMELIA SRL,TOS,50-59,1,5,0,5,0,1,0,6,0,6,Toscana,ITI1
2021-01-09,COMIRNATY Vaccino a mRNA contro COVID-19,80124I,R.S.A. VILLA AMELIA SRL,TOS,60-69,0,1,0,1,0,0,0,1,0,1,Toscana,ITI1
2021-01-09,COMIRNATY Vaccino a mRNA contro COVID-19,80124I,R.S.A. VILLA AMELIA SRL,TOS,70-79,1,5,0,0,0,6,0,6,0,6,Toscana,ITI1
2021-01-09,COMIRNATY Vaccino a mRNA contro COVID-19,80124I,R.S.A. VILLA AMELIA SRL,TOS,80-89,5,7,0,0,0,12,0,12,0,12,Toscana,ITI1
2021-01-09,COMIRNATY Vaccino a mRNA contro COVID-19,80124I,R.S.A. VILLA AMELIA SRL,TOS,90+,0,1,0,0,0,1,0,1,0,1,Toscana,ITI1
2021-01-09,COMIRNATY Vaccino a mRNA contro COVID-19,80264I,RSA ROSALIBRI,TOS,20-29,2,0,0,2,0,0,0,2,0,2,Toscana,ITI1
2021-01-09,COMIRNATY Vaccino a mRNA contro COVID-19,80264I,RSA ROSALIBRI,TOS,30-39,1,1,0,1,0,1,0,2,0,2,Toscana,ITI1
2021-01-09,COMIRNATY Vaccino a mRNA contro COVID-19,80264I,RSA ROSALIBRI,TOS,40-49,5,3,0,1,0,7,0,8,0,8,Toscana,ITI1
2021-01-09,COMIRNATY Vaccino a mRNA contro COVID-19,80264I,RSA ROSALIBRI,TOS,50-59,7,4,0,3,0,8,0,11,0,11,Toscana,ITI1
2021-01-09,COMIRNATY Vaccino a mRNA contro COVID-19,80264I,RSA ROSALIBRI,TOS,60-69,4,0,0,0,0,4,0,4,0,4,Toscana,ITI1
2021-01-09,COMIRNATY Vaccino a mRNA contro COVID-19,80264I,RSA ROSALIBRI,TOS,70-79,2,1,0,1,0,2,0,3,0,3,Toscana,ITI1
2021-01-09,COMIRNATY Vaccino a mRNA contro COVID-19,80424I,RSA NALDINI TORRIGIANI NUOVA G,TOS,60-69,0,2,0,0,0,2,0,2,0,2,Toscana,ITI1
2021-01-09,COMIRNATY Vaccino a mRNA contro COVID-19,80424I,RSA NALDINI TORRIGIANI NUOVA G,TOS,70-79,1,4,0,0,0,5,0,5,0,5,Toscana,ITI1
2021-01-09,COMIRNATY Vaccino a mRNA contro COVID-19,80424I,RSA NALDINI TORRIGIANI NUOVA G,TOS,80-89,6,10,0,0,0,16,0,16,0,16,Toscana,ITI1
2021-01-09,COMIRNATY Vaccino a mRNA contro COVID-19,80424I,RSA NALDINI TORRIGIANI NUOVA G,TOS,90+,0,7,0,0,0,7,0,7,0,7,Toscana,ITI1
2021-01-09,COMIRNATY Vaccino a mRNA contro COVID-19,90144I,RSA SAN GIUSEPPE - RONTA,TOS,30-39,0,1,0,1,0,0,0,1,0,1,Toscana,ITI1
2021-01-09,COMIRNATY Vaccino a mRNA contro COVID-19,90144I,RSA SAN GIUSEPPE - RONTA,TOS,50-59,1,3,0,4,0,0,0,4,0,4,Toscana,ITI1
2021-01-09,COMIRNATY Vaccino a mRNA contro COVID-19,90144I,RSA SAN GIUSEPPE - RONTA,TOS,90+,0,1,0,0,0,1,0,1,0,1,Toscana,ITI1
2021-01-09,COMIRNATY Vaccino a mRNA contro COVID-19,90224I,R.S.A. VILLA ERSILIA,TOS,20-29,1,0,0,1,0,0,0,1,0,1,Toscana,ITI1
2021-01-09,COMIRNATY Vaccino a mRNA contro COVID-19,90224I,R.S.A. VILLA ERSILIA,TOS,40-49,0,2,0,1,0,1,0,2,0,2,Toscana,ITI1
2021-01-09,COMIRNATY Vaccino a mRNA contro COVID-19,90224I,R.S.A. VILLA ERSILIA,TOS,50-59,0,1,0,1,0,0,0,1,0,1,Toscana,ITI1
2021-01-09,COMIRNATY Vaccino a mRNA contro COVID-19,90224I,R.S.A. VILLA ERSILIA,TOS,60-69,1,1,0,1,0,1,0,2,0,2,Toscana,ITI1
2021-01-09,COMIRNATY Vaccino a mRNA contro COVID-19,90224I,R.S.A. VILLA ERSILIA,TOS,70-79,0,3,0,0,0,3,0,3,0,3,Toscana,ITI1
2021-01-09,COMIRNATY Vaccino a mRNA contro COVID-19,90224I,R.S.A. VILLA ERSILIA,TOS,80-89,3,2,0,0,0,5,0,5,0,5,Toscana,ITI1
2021-01-09,COMIRNATY Vaccino a mRNA contro COVID-19,90224I,R.S.A. VILLA ERSILIA,TOS,90+,1,3,0,0,0,4,0,4,0,4,Toscana,ITI1
2021-01-09,COMIRNATY Vaccino a mRNA contro COVID-19,A1224I,RSA GUILLICHINI,TOS,20-29,0,1,0,1,0,0,0,1,0,1,Toscana,ITI1
2021-01-09,COMIRNATY Vaccino a mRNA contro COVID-19,A1224I,RSA GUILLICHINI,TOS,50-59,2,0,0,0,0,2,0,2,0,2,Toscana,ITI1
2021-01-09,COMIRNATY Vaccino a mRNA contro COVID-19,A1224I,RSA GUILLICHINI,TOS,70-79,6,0,0,0,0,6,0,6,0,6,Toscana,ITI1
2021-01-09,COMIRNATY Vaccino a mRNA contro COVID-19,A1224I,RSA GUILLICHINI,TOS,80-89,7,6,0,0,0,13,0,13,0,13,Toscana,ITI1
2021-01-09,COMIRNATY Vaccino a mRNA contro COVID-19,A1224I,RSA GUILLICHINI,TOS,90+,1,7,0,0,0,8,0,8,0,8,Toscana,ITI1
2021-01-09,COMIRNATY Vaccino a mRNA contro COVID-19,ND,CAP VILLA FUCINI,TOS,30-39,0,1,0,0,0,1,0,1,0,1,Toscana,ITI1
2021-01-09,COMIRNATY Vaccino a mRNA contro COVID-19,ND,CAP VILLA FUCINI,TOS,40-49,4,1,0,0,0,5,0,5,0,5,Toscana,ITI1
2021-01-09,COMIRNATY Vaccino a mRNA contro COVID-19,ND,CAP VILLA FUCINI,TOS,50-59,3,2,0,0,0,5,0,5,0,5,Toscana,ITI1
2021-01-09,COMIRNATY Vaccino a mRNA contro COVID-19,S1224L,CAP ISTITUTO MARIA REDDITI,TOS,30-39,0,2,0,0,0,2,0,2,0,2,Toscana,ITI1
2021-01-09,COMIRNATY Vaccino a mRNA contro COVID-19,S1224L,CAP ISTITUTO MARIA REDDITI,TOS,50-59,0,3,0,1,0,2,0,3,0,3,Toscana,ITI1
2021-01-09,COMIRNATY Vaccino a mRNA contro COVID-19,S1224L,CAP ISTITUTO MARIA REDDITI,TOS,60-69,1,0,0,0,0,1,0,1,0,1,Toscana,ITI1
2021-01-09,COMIRNATY Vaccino a mRNA contro COVID-19,U0124M,Covid19 - CAP L'aquilone,TOS,20-29,0,1,0,0,0,1,0,1,0,1,Toscana,ITI1
2021-01-09,COMIRNATY Vaccino a mRNA contro COVID-19,U0124M,Covid19 - CAP L'aquilone,TOS,40-49,0,2,0,1,0,1,0,2,0,2,Toscana,ITI1
2021-01-09,COMIRNATY Vaccino a mRNA contro COVID-19,U0124M,Covid19 - CAP L'aquilone,TOS,50-59,4,4,0,3,0,5,0,8,0,8,Toscana,ITI1
2021-01-09,COMIRNATY Vaccino a mRNA contro COVID-19,U0124M,Covid19 - CAP L'aquilone,TOS,60-69,0,1,0,1,0,0,0,1,0,1,Toscana,ITI1
2021-01-10,COMIRNATY Vaccino a mRNA contro COVID-19,02274I,R.S.A. STELLA,TOS,20-29,1,0,0,1,0,0,0,1,0,1,Toscana,ITI1
2021-01-10,COMIRNATY Vaccino a mRNA contro COVID-19,02274I,R.S.A. STELLA,TOS,30-39,0,1,0,1,0,0,0,1,0,1,Toscana,ITI1
2021-01-10,COMIRNATY Vaccino a mRNA contro COVID-19,02274I,R.S.A. STELLA,TOS,40-49,0,5,0,5,0,0,0,5,0,5,Toscana,ITI1
2021-01-10,COMIRNATY Vaccino a mRNA contro COVID-19,02274I,R.S.A. STELLA,TOS,50-59,2,4,0,6,0,0,0,6,0,6,Toscana,ITI1
2021-01-10,COMIRNATY Vaccino a mRNA contro COVID-19,02274I,R.S.A. STELLA,TOS,60-69,1,0,0,0,0,1,0,1,0,1,Toscana,ITI1
2021-01-10,COMIRNATY Vaccino a mRNA contro COVID-19,02274I,R.S.A. STELLA,TOS,70-79,1,3,0,1,0,3,0,4,0,4,Toscana,ITI1
2021-01-10,COMIRNATY Vaccino a mRNA contro COVID-19,02274I,R.S.A. STELLA,TOS,80-89,3,3,0,0,0,6,0,6,0,6,Toscana,ITI1
2021-01-10,COMIRNATY Vaccino a mRNA contro COVID-19,02274I,R.S.A. STELLA,TOS,90+,0,6,0,0,0,6,0,6,0,6,Toscana,ITI1
2021-01-10,COMIRNATY Vaccino a mRNA contro COVID-19,090606,COVID19 - Ospedale San Iacopo,TOS,20-29,7,12,1,18,1,0,0,19,0,19,Toscana,ITI1
2021-01-10,COMIRNATY Vaccino a mRNA contro COVID-19,090606,COVID19 - Ospedale San Iacopo,TOS,30-39,13,15,1,25,2,1,0,28,0,28,Toscana,ITI1
2021-01-10,COMIRNATY Vaccino a mRNA contro COVID-19,090606,COVID19 - Ospedale San Iacopo,TOS,40-49,7,19,1,22,4,0,0,26,0,26,Toscana,ITI1
2021-01-10,COMIRNATY Vaccino a mRNA contro COVID-19,090606,COVID19 - Ospedale San Iacopo,TOS,50-59,11,27,1,34,4,0,0,38,0,38,Toscana,ITI1
2021-01-10,COMIRNATY Vaccino a mRNA contro COVID-19,090606,COVID19 - Ospedale San Iacopo,TOS,60-69,24,8,1,29,2,0,1,32,0,32,Toscana,ITI1
2021-01-10,COMIRNATY Vaccino a mRNA contro COVID-19,090606,COVID19 - Ospedale San Iacopo,TOS,70-79,2,0,1,2,0,0,0,2,0,2,Toscana,ITI1
2021-01-10,COMIRNATY Vaccino a mRNA contro COVID-19,090606,COVID19 - Ospedale San Iacopo,TOS,80-89,1,0,1,0,1,0,0,1,0,1,Toscana,ITI1
2021-01-10,COMIRNATY Vaccino a mRNA contro COVID-19,090607,COVID19 - Ospedale SS.Cosma e Damiano,TOS,20-29,1,2,0,3,0,0,0,3,0,3,Toscana,ITI1
2021-01-10,COMIRNATY Vaccino a mRNA contro COVID-19,090607,COVID19 - Ospedale SS.Cosma e Damiano,TOS,30-39,1,5,0,5,1,0,0,6,0,6,Toscana,ITI1
2021-01-10,COMIRNATY Vaccino a mRNA contro COVID-19,090607,COVID19 - Ospedale SS.Cosma e Damiano,TOS,40-49,3,8,0,10,1,0,0,11,0,11,Toscana,ITI1
2021-01-10,COMIRNATY Vaccino a mRNA contro COVID-19,090607,COVID19 - Ospedale SS.Cosma e Damiano,TOS,50-59,4,13,0,14,3,0,0,17,0,17,Toscana,ITI1
2021-01-10,COMIRNATY Vaccino a mRNA contro COVID-19,090607,COVID19 - Ospedale SS.Cosma e Damiano,TOS,60-69,10,1,0,9,2,0,0,11,0,11,Toscana,ITI1
2021-01-10,COMIRNATY Vaccino a mRNA contro COVID-19,090608,COVID19 - Ospedale Santo Stefano,TOS,20-29,9,17,0,24,0,2,0,26,0,26,Toscana,ITI1
2021-01-10,COMIRNATY Vaccino a mRNA contro COVID-19,090608,COVID19 - Ospedale Santo Stefano,TOS,30-39,10,22,0,28,0,4,0,32,0,32,Toscana,ITI1
2021-01-10,COMIRNATY Vaccino a mRNA contro COVID-19,090608,COVID19 - Ospedale Santo Stefano,TOS,40-49,11,26,0,31,0,6,0,37,0,37,Toscana,ITI1
2021-01-10,COMIRNATY Vaccino a mRNA contro COVID-19,090608,COVID19 - Ospedale Santo Stefano,TOS,50-59,17,26,0,35,0,8,0,43,0,43,Toscana,ITI1
2021-01-10,COMIRNATY Vaccino a mRNA contro COVID-19,090608,COVID19 - Ospedale Santo Stefano,TOS,60-69,21,12,0,28,0,5,0,33,0,33,Toscana,ITI1
2021-01-10,COMIRNATY Vaccino a mRNA contro COVID-19,090608,COVID19 - Ospedale Santo Stefano,TOS,70-79,2,0,0,2,0,0,0,2,0,2,Toscana,ITI1
2021-01-10,COMIRNATY Vaccino a mRNA contro COVID-19,090613,Covid 19 - Ospedali Riuniti di Livorno,TOS,30-39,0,1,0,0,0,1,0,1,0,1,Toscana,ITI1
2021-01-10,COMIRNATY Vaccino a mRNA contro COVID-19,090613,Covid 19 - Ospedali Riuniti di Livorno,TOS,40-49,1,0,0,0,0,1,0,1,0,1,Toscana,ITI1
2021-01-10,COMIRNATY Vaccino a mRNA contro COVID-19,090613,Covid 19 - Ospedali Riuniti di Livorno,TOS,50-59,1,2,0,0,0,3,0,3,0,3,Toscana,ITI1
2021-01-10,COMIRNATY Vaccino a mRNA contro COVID-19,090613,Covid 19 - Ospedali Riuniti di Livorno,TOS,60-69,0,3,0,0,0,3,0,3,0,3,Toscana,ITI1
2021-01-10,COMIRNATY Vaccino a mRNA contro COVID-19,090613,Covid 19 - Ospedali Riuniti di Livorno,TOS,80-89,0,2,0,0,0,2,0,2,0,2,Toscana,ITI1
2021-01-10,COMIRNATY Vaccino a mRNA contro COVID-19,090613,Covid 19 - Ospedali Riuniti di Livorno,TOS,90+,1,0,0,0,0,1,0,1,0,1,Toscana,ITI1
2021-01-10,COMIRNATY Vaccino a mRNA contro COVID-19,090623,COVID19 - Ospedale S.Andrea Massa Marittima,TOS,60-69,1,0,0,0,0,1,0,1,0,1,Toscana,ITI1
2021-01-10,COMIRNATY Vaccino a mRNA contro COVID-19,090623,COVID19 - Ospedale S.Andrea Massa Marittima,TOS,80-89,1,1,0,0,0,2,0,2,0,2,Toscana,ITI1
2021-01-10,COMIRNATY Vaccino a mRNA contro COVID-19,090624,COVID19 - Ospedale di Orbetello,TOS,16-19,2,0,0,2,0,0,0,2,0,2,Toscana,ITI1
2021-01-10,COMIRNATY Vaccino a mRNA contro COVID-19,090624,COVID19 - Ospedale di Orbetello,TOS,20-29,2,5,0,7,0,0,0,7,0,7,Toscana,ITI1
2021-01-10,COMIRNATY Vaccino a mRNA contro COVID-19,090624,COVID19 - Ospedale di Orbetello,TOS,30-39,5,10,0,15,0,0,0,15,0,15,Toscana,ITI1
2021-01-10,COMIRNATY Vaccino a mRNA contro COVID-19,090624,COVID19 - Ospedale di Orbetello,TOS,40-49,1,13,0,14,0,0,0,14,0,14,Toscana,ITI1
2021-01-10,COMIRNATY Vaccino a mRNA contro COVID-19,090624,COVID19 - Ospedale di Orbetello,TOS,50-59,9,15,0,23,1,0,0,24,0,24,Toscana,ITI1
2021-01-10,COMIRNATY Vaccino a mRNA contro COVID-19,090624,COVID19 - Ospedale di Orbetello,TOS,60-69,11,12,0,23,0,0,0,23,0,23,Toscana,ITI1
2021-01-10,COMIRNATY Vaccino a mRNA contro COVID-19,090624,COVID19 - Ospedale di Orbetello,TOS,70-79,4,0,0,4,0,0,0,4,0,4,Toscana,ITI1
2021-01-10,COMIRNATY Vaccino a mRNA contro COVID-19,090627,COVID19 - Ospedale Mugello,TOS,20-29,0,9,0,9,0,0,0,9,0,9,Toscana,ITI1
2021-01-10,COMIRNATY Vaccino a mRNA contro COVID-19,090627,COVID19 - Ospedale Mugello,TOS,30-39,2,2,0,3,1,0,0,4,0,4,Toscana,ITI1
2021-01-10,COMIRNATY Vaccino a mRNA contro COVID-19,090627,COVID19 - Ospedale Mugello,TOS,40-49,4,4,0,7,1,0,0,8,0,8,Toscana,ITI1
2021-01-10,COMIRNATY Vaccino a mRNA contro COVID-19,090627,COVID19 - Ospedale Mugello,TOS,50-59,2,14,0,15,1,0,0,16,0,16,Toscana,ITI1
2021-01-10,COMIRNATY Vaccino a mRNA contro COVID-19,090627,COVID19 - Ospedale Mugello,TOS,60-69,3,8,0,10,1,0,0,11,0,11,Toscana,ITI1
2021-01-10,COMIRNATY Vaccino a mRNA contro COVID-19,090629,COVID19 - Ospedale SS. Maria Annunziata,TOS,16-19,2,0,0,1,1,0,0,2,0,2,Toscana,ITI1
2021-01-10,COMIRNATY Vaccino a mRNA contro COVID-19,090629,COVID19 - Ospedale SS. Maria Annunziata,TOS,20-29,2,16,0,16,2,0,0,18,0,18,Toscana,ITI1
2021-01-10,COMIRNATY Vaccino a mRNA contro COVID-19,090629,COVID19 - Ospedale SS. Maria Annunziata,TOS,30-39,10,10,0,18,2,0,0,20,0,20,Toscana,ITI1
2021-01-10,COMIRNATY Vaccino a mRNA contro COVID-19,090629,COVID19 - Ospedale SS. Maria Annunziata,TOS,40-49,2,18,0,17,3,0,0,20,0,20,Toscana,ITI1
2021-01-10,COMIRNATY Vaccino a mRNA contro COVID-19,090629,COVID19 - Ospedale SS. Maria Annunziata,TOS,50-59,10,29,0,31,7,1,0,39,0,39,Toscana,ITI1
2021-01-10,COMIRNATY Vaccino a mRNA contro COVID-19,090629,COVID19 - Ospedale SS. Maria Annunziata,TOS,60-69,26,20,0,42,4,0,0,46,0,46,Toscana,ITI1
2021-01-10,COMIRNATY Vaccino a mRNA contro COVID-19,090629,COVID19 - Ospedale SS. Maria Annunziata,TOS,70-79,2,2,0,2,2,0,0,4,0,4,Toscana,ITI1
2021-01-10,COMIRNATY Vaccino a mRNA contro COVID-19,090632,COVID19 - Ospedale Santa Maria Nuova,TOS,20-29,5,6,0,10,0,1,0,11,0,11,Toscana,ITI1
2021-01-10,COMIRNATY Vaccino a mRNA contro COVID-19,090632,COVID19 - Ospedale Santa Maria Nuova,TOS,30-39,9,12,0,21,0,0,0,21,0,21,Toscana,ITI1
2021-01-10,COMIRNATY Vaccino a mRNA contro COVID-19,090632,COVID19 - Ospedale Santa Maria Nuova,TOS,40-49,5,11,0,16,0,0,0,16,0,16,Toscana,ITI1
2021-01-10,COMIRNATY Vaccino a mRNA contro COVID-19,090632,COVID19 - Ospedale Santa Maria Nuova,TOS,50-59,8,8,0,15,0,1,0,16,0,16,Toscana,ITI1
2021-01-10,COMIRNATY Vaccino a mRNA contro COVID-19,090632,COVID19 - Ospedale Santa Maria Nuova,TOS,60-69,20,14,0,34,0,0,0,34,0,34,Toscana,ITI1
2021-01-10,COMIRNATY Vaccino a mRNA contro COVID-19,090632,COVID19 - Ospedale Santa Maria Nuova,TOS,70-79,3,1,0,4,0,0,0,4,0,4,Toscana,ITI1
2021-01-10,COMIRNATY Vaccino a mRNA contro COVID-19,090637,COVID19 - Ospedale Amiata Val d'Orcia  Abbadia San Salvatore,TOS,20-29,1,0,0,0,1,0,0,1,0,1,Toscana,ITI1
2021-01-10,COMIRNATY Vaccino a mRNA contro COVID-19,090637,COVID19 - Ospedale Amiata Val d'Orcia  Abbadia San Salvatore,TOS,40-49,2,1,0,2,1,0,0,3,0,3,Toscana,ITI1
2021-01-10,COMIRNATY Vaccino a mRNA contro COVID-19,090637,COVID19 - Ospedale Amiata Val d'Orcia  Abbadia San Salvatore,TOS,50-59,2,3,0,2,3,0,0,5,0,5,Toscana,ITI1
2021-01-10,COMIRNATY Vaccino a mRNA contro COVID-19,090637,COVID19 - Ospedale Amiata Val d'Orcia  Abbadia San Salvatore,TOS,60-69,2,1,0,3,0,0,0,3,0,3,Toscana,ITI1
2021-01-10,COMIRNATY Vaccino a mRNA contro COVID-19,090638,COVID19 - Ospedale di Campostaggia Poggibonsi,TOS,20-29,4,9,0,13,0,0,0,13,0,13,Toscana,ITI1
2021-01-10,COMIRNATY Vaccino a mRNA contro COVID-19,090638,COVID19 - Ospedale di Campostaggia Poggibonsi,TOS,30-39,0,6,0,6,0,0,0,6,0,6,Toscana,ITI1
2021-01-10,COMIRNATY Vaccino a mRNA contro COVID-19,090638,COVID19 - Ospedale di Campostaggia Poggibonsi,TOS,40-49,2,14,0,16,0,0,0,16,0,16,Toscana,ITI1
2021-01-10,COMIRNATY Vaccino a mRNA contro COVID-19,090638,COVID19 - Ospedale di Campostaggia Poggibonsi,TOS,50-59,0,20,0,20,0,0,0,20,0,20,Toscana,ITI1
2021-01-10,COMIRNATY Vaccino a mRNA contro COVID-19,090638,COVID19 - Ospedale di Campostaggia Poggibonsi,TOS,60-69,4,2,0,6,0,0,0,6,0,6,Toscana,ITI1
2021-01-10,COMIRNATY Vaccino a mRNA contro COVID-19,090639,COVID19 - Ospedale di Nottola Montepulciano,TOS,16-19,1,0,0,1,0,0,0,1,0,1,Toscana,ITI1
2021-01-10,COMIRNATY Vaccino a mRNA contro COVID-19,090639,COVID19 - Ospedale di Nottola Montepulciano,TOS,20-29,3,13,0,16,0,0,0,16,0,16,Toscana,ITI1
2021-01-10,COMIRNATY Vaccino a mRNA contro COVID-19,090639,COVID19 - Ospedale di Nottola Montepulciano,TOS,30-39,7,8,0,15,0,0,0,15,0,15,Toscana,ITI1
2021-01-10,COMIRNATY Vaccino a mRNA contro COVID-19,090639,COVID19 - Ospedale di Nottola Montepulciano,TOS,40-49,2,16,0,18,0,0,0,18,0,18,Toscana,ITI1
2021-01-10,COMIRNATY Vaccino a mRNA contro COVID-19,090639,COVID19 - Ospedale di Nottola Montepulciano,TOS,50-59,8,27,0,35,0,0,0,35,0,35,Toscana,ITI1
2021-01-10,COMIRNATY Vaccino a mRNA contro COVID-19,090639,COVID19 - Ospedale di Nottola Montepulciano,TOS,60-69,8,3,0,11,0,0,0,11,0,11,Toscana,ITI1
2021-01-10,COMIRNATY Vaccino a mRNA contro COVID-19,090640,Covid 19 - Ospedale Unico Versilia,TOS,60-69,1,3,0,0,1,3,0,4,0,4,Toscana,ITI1
2021-01-10,COMIRNATY Vaccino a mRNA contro COVID-19,090640,Covid 19 - Ospedale Unico Versilia,TOS,70-79,0,1,0,0,0,1,0,1,0,1,Toscana,ITI1
2021-01-10,COMIRNATY Vaccino a mRNA contro COVID-19,090640,Covid 19 - Ospedale Unico Versilia,TOS,80-89,1,2,0,0,0,3,0,3,0,3,Toscana,ITI1
2021-01-10,COMIRNATY Vaccino a mRNA contro COVID-19,090640,Covid 19 - Ospedale Unico Versilia,TOS,90+,1,3,0,0,0,4,0,4,0,4,Toscana,ITI1
2021-01-10,COMIRNATY Vaccino a mRNA contro COVID-19,090641,COVID19 - Ospedale La Gruccia Montevarchi,TOS,20-29,5,12,0,17,0,0,0,17,0,17,Toscana,ITI1
2021-01-10,COMIRNATY Vaccino a mRNA contro COVID-19,090641,COVID19 - Ospedale La Gruccia Montevarchi,TOS,30-39,9,16,0,24,1,0,0,25,0,25,Toscana,ITI1
2021-01-10,COMIRNATY Vaccino a mRNA contro COVID-19,090641,COVID19 - Ospedale La Gruccia Montevarchi,TOS,40-49,5,22,0,26,0,1,0,27,0,27,Toscana,ITI1
2021-01-10,COMIRNATY Vaccino a mRNA contro COVID-19,090641,COVID19 - Ospedale La Gruccia Montevarchi,TOS,50-59,10,24,0,34,0,0,0,34,0,34,Toscana,ITI1
2021-01-10,COMIRNATY Vaccino a mRNA contro COVID-19,090641,COVID19 - Ospedale La Gruccia Montevarchi,TOS,60-69,20,8,0,28,0,0,0,28,0,28,Toscana,ITI1
2021-01-10,COMIRNATY Vaccino a mRNA contro COVID-19,090641,COVID19 - Ospedale La Gruccia Montevarchi,TOS,70-79,1,0,0,1,0,0,0,1,0,1,Toscana,ITI1
2021-01-10,COMIRNATY Vaccino a mRNA contro COVID-19,090901,COVID19 - AOU Pisana,TOS,16-19,3,9,2,12,0,0,0,12,0,12,Toscana,ITI1
2021-01-10,COMIRNATY Vaccino a mRNA contro COVID-19,090901,COVID19 - AOU Pisana,TOS,20-29,56,91,2,137,9,0,1,147,0,147,Toscana,ITI1
2021-01-10,COMIRNATY Vaccino a mRNA contro COVID-19,090901,COVID19 - AOU Pisana,TOS,30-39,47,48,2,88,7,0,0,95,0,95,Toscana,ITI1
2021-01-10,COMIRNATY Vaccino a mRNA contro COVID-19,090901,COVID19 - AOU Pisana,TOS,40-49,47,64,2,105,5,1,0,111,0,111,Toscana,ITI1
2021-01-10,COMIRNATY Vaccino a mRNA contro COVID-19,090901,COVID19 - AOU Pisana,TOS,50-59,39,90,2,123,6,0,0,129,0,129,Toscana,ITI1
2021-01-10,COMIRNATY Vaccino a mRNA contro COVID-19,090901,COVID19 - AOU Pisana,TOS,60-69,53,37,2,82,8,0,0,90,0,90,Toscana,ITI1
2021-01-10,COMIRNATY Vaccino a mRNA contro COVID-19,090901,COVID19 - AOU Pisana,TOS,70-79,17,1,2,15,2,0,1,18,0,18,Toscana,ITI1
2021-01-10,COMIRNATY Vaccino a mRNA contro COVID-19,090901,COVID19 - AOU Pisana,TOS,80-89,0,3,2,1,2,0,0,3,0,3,Toscana,ITI1
2021-01-10,COMIRNATY Vaccino a mRNA contro COVID-19,090902,COVID19 - AOU Senese,TOS,16-19,4,4,0,8,0,0,0,8,0,8,Toscana,ITI1
2021-01-10,COMIRNATY Vaccino a mRNA contro COVID-19,090902,COVID19 - AOU Senese,TOS,20-29,36,50,0,86,0,0,0,86,0,86,Toscana,ITI1
2021-01-10,COMIRNATY Vaccino a mRNA contro COVID-19,090902,COVID19 - AOU Senese,TOS,30-39,27,40,0,67,0,0,0,67,0,67,Toscana,ITI1
2021-01-10,COMIRNATY Vaccino a mRNA contro COVID-19,090902,COVID19 - AOU Senese,TOS,40-49,23,41,0,64,0,0,0,64,0,64,Toscana,ITI1
2021-01-10,COMIRNATY Vaccino a mRNA contro COVID-19,090902,COVID19 - AOU Senese,TOS,50-59,24,50,0,74,0,0,0,74,0,74,Toscana,ITI1
2021-01-10,COMIRNATY Vaccino a mRNA contro COVID-19,090902,COVID19 - AOU Senese,TOS,60-69,24,24,0,48,0,0,0,48,0,48,Toscana,ITI1
2021-01-10,COMIRNATY Vaccino a mRNA contro COVID-19,090902,COVID19 - AOU Senese,TOS,70-79,10,1,0,11,0,0,0,11,0,11,Toscana,ITI1
2021-01-10,COMIRNATY Vaccino a mRNA contro COVID-19,090902,COVID19 - AOU Senese,TOS,80-89,1,0,0,1,0,0,0,1,0,1,Toscana,ITI1
2021-01-10,COMIRNATY Vaccino a mRNA contro COVID-19,11012E,COVID19 - Ospedale San Giuseppe,TOS,16-19,0,1,0,1,0,0,0,1,0,1,Toscana,ITI1
2021-01-10,COMIRNATY Vaccino a mRNA contro COVID-19,11012E,COVID19 - Ospedale San Giuseppe,TOS,20-29,6,14,0,20,0,0,0,20,0,20,Toscana,ITI1
2021-01-10,COMIRNATY Vaccino a mRNA contro COVID-19,11012E,COVID19 - Ospedale San Giuseppe,TOS,30-39,8,13,0,21,0,0,0,21,0,21,Toscana,ITI1
2021-01-10,COMIRNATY Vaccino a mRNA contro COVID-19,11012E,COVID19 - Ospedale San Giuseppe,TOS,40-49,16,20,0,36,0,0,0,36,0,36,Toscana,ITI1
2021-01-10,COMIRNATY Vaccino a mRNA contro COVID-19,11012E,COVID19 - Ospedale San Giuseppe,TOS,50-59,14,22,0,36,0,0,0,36,0,36,Toscana,ITI1
2021-01-10,COMIRNATY Vaccino a mRNA contro COVID-19,11012E,COVID19 - Ospedale San Giuseppe,TOS,60-69,22,10,0,32,0,0,0,32,0,32,Toscana,ITI1
2021-01-10,COMIRNATY Vaccino a mRNA contro COVID-19,11012E,COVID19 - Ospedale San Giuseppe,TOS,70-79,3,0,0,3,0,0,0,3,0,3,Toscana,ITI1
2021-01-10,COMIRNATY Vaccino a mRNA contro COVID-19,11012E,COVID19 - Ospedale San Giuseppe,TOS,80-89,1,0,0,1,0,0,0,1,0,1,Toscana,ITI1
2021-01-10,COMIRNATY Vaccino a mRNA contro COVID-19,12034I,R.S.A. MARINA DI LEVANTE,TOS,30-39,1,1,0,2,0,0,0,2,0,2,Toscana,ITI1
2021-01-10,COMIRNATY Vaccino a mRNA contro COVID-19,12034I,R.S.A. MARINA DI LEVANTE,TOS,40-49,1,0,0,1,0,0,0,1,0,1,Toscana,ITI1
2021-01-10,COMIRNATY Vaccino a mRNA contro COVID-19,12034I,R.S.A. MARINA DI LEVANTE,TOS,50-59,1,0,0,0,0,1,0,1,0,1,Toscana,ITI1
2021-01-10,COMIRNATY Vaccino a mRNA contro COVID-19,12034I,R.S.A. MARINA DI LEVANTE,TOS,60-69,2,1,0,1,0,2,0,3,0,3,Toscana,ITI1
2021-01-10,COMIRNATY Vaccino a mRNA contro COVID-19,12034I,R.S.A. MARINA DI LEVANTE,TOS,70-79,0,1,0,0,0,1,0,1,0,1,Toscana,ITI1
2021-01-10,COMIRNATY Vaccino a mRNA contro COVID-19,12034I,R.S.A. MARINA DI LEVANTE,TOS,80-89,2,3,0,0,0,5,0,5,0,5,Toscana,ITI1
2021-01-10,COMIRNATY Vaccino a mRNA contro COVID-19,12034I,R.S.A. MARINA DI LEVANTE,TOS,90+,0,2,0,0,0,2,0,2,0,2,Toscana,ITI1
2021-01-10,COMIRNATY Vaccino a mRNA contro COVID-19,12204I,Covid19 - RSA  NUOVI ORIZZONTI LOC.GROTT,TOS,40-49,0,2,0,1,1,0,0,2,0,2,Toscana,ITI1
2021-01-10,COMIRNATY Vaccino a mRNA contro COVID-19,12204I,Covid19 - RSA  NUOVI ORIZZONTI LOC.GROTT,TOS,50-59,0,3,0,1,2,0,0,3,0,3,Toscana,ITI1
2021-01-10,COMIRNATY Vaccino a mRNA contro COVID-19,12204I,Covid19 - RSA  NUOVI ORIZZONTI LOC.GROTT,TOS,60-69,1,0,0,0,0,1,0,1,0,1,Toscana,ITI1
2021-01-10,COMIRNATY Vaccino a mRNA contro COVID-19,12204I,Covid19 - RSA  NUOVI ORIZZONTI LOC.GROTT,TOS,80-89,0,5,0,0,0,5,0,5,0,5,Toscana,ITI1
2021-01-10,COMIRNATY Vaccino a mRNA contro COVID-19,12204I,Covid19 - RSA  NUOVI ORIZZONTI LOC.GROTT,TOS,90+,0,1,0,0,0,1,0,1,0,1,Toscana,ITI1
2021-01-10,COMIRNATY Vaccino a mRNA contro COVID-19,122N4I,R.S.A I REMAGGI,TOS,20-29,1,1,0,2,0,0,0,2,0,2,Toscana,ITI1
2021-01-10,COMIRNATY Vaccino a mRNA contro COVID-19,122N4I,R.S.A I REMAGGI,TOS,50-59,2,0,0,0,0,2,0,2,0,2,Toscana,ITI1
2021-01-10,COMIRNATY Vaccino a mRNA contro COVID-19,122N4I,R.S.A I REMAGGI,TOS,60-69,2,1,0,1,0,2,0,3,0,3,Toscana,ITI1
2021-01-10,COMIRNATY Vaccino a mRNA contro COVID-19,122N4I,R.S.A I REMAGGI,TOS,70-79,3,1,0,0,0,4,0,4,0,4,Toscana,ITI1
2021-01-10,COMIRNATY Vaccino a mRNA contro COVID-19,122N4I,R.S.A I REMAGGI,TOS,80-89,0,6,0,0,0,6,0,6,0,6,Toscana,ITI1
2021-01-10,COMIRNATY Vaccino a mRNA contro COVID-19,122N4I,R.S.A I REMAGGI,TOS,90+,0,1,0,0,0,1,0,1,0,1,Toscana,ITI1
2021-01-10,COMIRNATY Vaccino a mRNA contro COVID-19,13021A,COVID19 - Ospedale S.Giovanni di Dio,TOS,20-29,14,30,0,35,9,0,0,44,0,44,Toscana,ITI1
2021-01-10,COMIRNATY Vaccino a mRNA contro COVID-19,13021A,COVID19 - Ospedale S.Giovanni di Dio,TOS,30-39,12,27,0,30,9,0,0,39,0,39,Toscana,ITI1
2021-01-10,COMIRNATY Vaccino a mRNA contro COVID-19,13021A,COVID19 - Ospedale S.Giovanni di Dio,TOS,40-49,11,43,0,53,1,0,0,54,0,54,Toscana,ITI1
2021-01-10,COMIRNATY Vaccino a mRNA contro COVID-19,13021A,COVID19 - Ospedale S.Giovanni di Dio,TOS,50-59,15,64,0,77,2,0,0,79,0,79,Toscana,ITI1
2021-01-10,COMIRNATY Vaccino a mRNA contro COVID-19,13021A,COVID19 - Ospedale S.Giovanni di Dio,TOS,60-69,21,31,0,49,1,2,0,52,0,52,Toscana,ITI1
2021-01-10,COMIRNATY Vaccino a mRNA contro COVID-19,13021A,COVID19 - Ospedale S.Giovanni di Dio,TOS,70-79,2,6,0,2,3,3,0,8,0,8,Toscana,ITI1
2021-01-10,COMIRNATY Vaccino a mRNA contro COVID-19,13021A,COVID19 - Ospedale S.Giovanni di Dio,TOS,80-89,0,15,0,1,4,10,0,15,0,15,Toscana,ITI1
2021-01-10,COMIRNATY Vaccino a mRNA contro COVID-19,13021A,COVID19 - Ospedale S.Giovanni di Dio,TOS,90+,0,14,0,0,3,11,0,14,0,14,Toscana,ITI1
2021-01-10,COMIRNATY Vaccino a mRNA contro COVID-19,14244I,RSA LA CHIOCCIOLA (CONS. ZENIT,TOS,20-29,0,1,0,1,0,0,0,1,0,1,Toscana,ITI1
2021-01-10,COMIRNATY Vaccino a mRNA contro COVID-19,14244I,RSA LA CHIOCCIOLA (CONS. ZENIT,TOS,40-49,0,1,0,1,0,0,0,1,0,1,Toscana,ITI1
2021-01-10,COMIRNATY Vaccino a mRNA contro COVID-19,14244I,RSA LA CHIOCCIOLA (CONS. ZENIT,TOS,50-59,0,2,0,1,0,1,0,2,0,2,Toscana,ITI1
2021-01-10,COMIRNATY Vaccino a mRNA contro COVID-19,14244I,RSA LA CHIOCCIOLA (CONS. ZENIT,TOS,60-69,2,4,0,4,0,2,0,6,0,6,Toscana,ITI1
2021-01-10,COMIRNATY Vaccino a mRNA contro COVID-19,14244I,RSA LA CHIOCCIOLA (CONS. ZENIT,TOS,70-79,0,1,0,0,0,1,0,1,0,1,Toscana,ITI1
2021-01-10,COMIRNATY Vaccino a mRNA contro COVID-19,14244I,RSA LA CHIOCCIOLA (CONS. ZENIT,TOS,80-89,3,11,0,0,0,14,0,14,0,14,Toscana,ITI1
2021-01-10,COMIRNATY Vaccino a mRNA contro COVID-19,14244I,RSA LA CHIOCCIOLA (CONS. ZENIT,TOS,90+,1,4,0,0,0,5,0,5,0,5,Toscana,ITI1
2021-01-10,COMIRNATY Vaccino a mRNA contro COVID-19,150A1A,Casa Famiglia Marciana,TOS,16-19,1,0,0,0,0,1,0,1,0,1,Toscana,ITI1
2021-01-10,COMIRNATY Vaccino a mRNA contro COVID-19,150A1A,Casa Famiglia Marciana,TOS,20-29,0,1,0,0,0,1,0,1,0,1,Toscana,ITI1
2021-01-10,COMIRNATY Vaccino a mRNA contro COVID-19,150A1A,Casa Famiglia Marciana,TOS,30-39,0,1,0,1,0,0,0,1,0,1,Toscana,ITI1
2021-01-10,COMIRNATY Vaccino a mRNA contro COVID-19,150A1A,Casa Famiglia Marciana,TOS,40-49,2,0,0,0,0,2,0,2,0,2,Toscana,ITI1
2021-01-10,COMIRNATY Vaccino a mRNA contro COVID-19,150A1A,Casa Famiglia Marciana,TOS,50-59,4,0,0,0,0,4,0,4,0,4,Toscana,ITI1
2021-01-10,COMIRNATY Vaccino a mRNA contro COVID-19,150A1A,Casa Famiglia Marciana,TOS,60-69,3,0,0,1,0,2,0,3,0,3,Toscana,ITI1
2021-01-10,COMIRNATY Vaccino a mRNA contro COVID-19,20364I,RSA VILLA DEI FIORI,TOS,20-29,0,1,0,0,1,0,0,1,0,1,Toscana,ITI1
2021-01-10,COMIRNATY Vaccino a mRNA contro COVID-19,20364I,RSA VILLA DEI FIORI,TOS,40-49,0,3,0,0,3,0,0,3,0,3,Toscana,ITI1
2021-01-10,COMIRNATY Vaccino a mRNA contro COVID-19,20364I,RSA VILLA DEI FIORI,TOS,50-59,0,1,0,0,1,0,0,1,0,1,Toscana,ITI1
2021-01-10,COMIRNATY Vaccino a mRNA contro COVID-19,24134I,RSA LA MIMOSA (CONS. ZENIT),TOS,50-59,0,1,0,1,0,0,0,1,0,1,Toscana,ITI1
2021-01-10,COMIRNATY Vaccino a mRNA contro COVID-19,24134I,RSA LA MIMOSA (CONS. ZENIT),TOS,60-69,0,2,0,0,0,2,0,2,0,2,Toscana,ITI1
2021-01-10,COMIRNATY Vaccino a mRNA contro COVID-19,24134I,RSA LA MIMOSA (CONS. ZENIT),TOS,80-89,1,0,0,0,0,1,0,1,0,1,Toscana,ITI1
2021-01-10,COMIRNATY Vaccino a mRNA contro COVID-19,24134I,RSA LA MIMOSA (CONS. ZENIT),TOS,90+,0,2,0,0,0,2,0,2,0,2,Toscana,ITI1
2021-01-10,COMIRNATY Vaccino a mRNA contro COVID-19,40911A,COVID19 - Dip. Prevenzione Ruffolo Siena,TOS,20-29,3,5,0,8,0,0,0,8,0,8,Toscana,ITI1
2021-01-10,COMIRNATY Vaccino a mRNA contro COVID-19,40911A,COVID19 - Dip. Prevenzione Ruffolo Siena,TOS,30-39,9,8,0,17,0,0,0,17,0,17,Toscana,ITI1
2021-01-10,COMIRNATY Vaccino a mRNA contro COVID-19,40911A,COVID19 - Dip. Prevenzione Ruffolo Siena,TOS,40-49,2,10,0,12,0,0,0,12,0,12,Toscana,ITI1
2021-01-10,COMIRNATY Vaccino a mRNA contro COVID-19,40911A,COVID19 - Dip. Prevenzione Ruffolo Siena,TOS,50-59,6,13,0,18,0,1,0,19,0,19,Toscana,ITI1
2021-01-10,COMIRNATY Vaccino a mRNA contro COVID-19,40911A,COVID19 - Dip. Prevenzione Ruffolo Siena,TOS,60-69,17,10,0,27,0,0,0,27,0,27,Toscana,ITI1
2021-01-10,COMIRNATY Vaccino a mRNA contro COVID-19,48824I,R.S.A. G. CACCIALUPI,TOS,40-49,0,1,0,1,0,0,0,1,0,1,Toscana,ITI1
2021-01-10,COMIRNATY Vaccino a mRNA contro COVID-19,48824I,R.S.A. G. CACCIALUPI,TOS,50-59,1,1,0,0,0,2,0,2,0,2,Toscana,ITI1
2021-01-10,COMIRNATY Vaccino a mRNA contro COVID-19,48824I,R.S.A. G. CACCIALUPI,TOS,60-69,1,2,0,1,0,2,0,3,0,3,Toscana,ITI1
2021-01-10,COMIRNATY Vaccino a mRNA contro COVID-19,48824I,R.S.A. G. CACCIALUPI,TOS,70-79,1,2,0,0,0,3,0,3,0,3,Toscana,ITI1
2021-01-10,COMIRNATY Vaccino a mRNA contro COVID-19,48824I,R.S.A. G. CACCIALUPI,TOS,80-89,3,12,0,0,0,15,0,15,0,15,Toscana,ITI1
2021-01-10,COMIRNATY Vaccino a mRNA contro COVID-19,48824I,R.S.A. G. CACCIALUPI,TOS,90+,0,5,0,0,0,5,0,5,0,5,Toscana,ITI1
2021-01-10,COMIRNATY Vaccino a mRNA contro COVID-19,60914I,ISTITUTO LE MAGNOLIE,TOS,20-29,0,1,0,1,0,0,0,1,0,1,Toscana,ITI1
2021-01-10,COMIRNATY Vaccino a mRNA contro COVID-19,60914I,ISTITUTO LE MAGNOLIE,TOS,30-39,0,1,0,1,0,0,0,1,0,1,Toscana,ITI1
2021-01-10,COMIRNATY Vaccino a mRNA contro COVID-19,60914I,ISTITUTO LE MAGNOLIE,TOS,40-49,0,1,0,1,0,0,0,1,0,1,Toscana,ITI1
2021-01-10,COMIRNATY Vaccino a mRNA contro COVID-19,60914I,ISTITUTO LE MAGNOLIE,TOS,50-59,1,0,0,1,0,0,0,1,0,1,Toscana,ITI1
2021-01-10,COMIRNATY Vaccino a mRNA contro COVID-19,60914I,ISTITUTO LE MAGNOLIE,TOS,70-79,2,0,0,0,0,2,0,2,0,2,Toscana,ITI1
2021-01-10,COMIRNATY Vaccino a mRNA contro COVID-19,60914I,ISTITUTO LE MAGNOLIE,TOS,80-89,5,5,0,0,0,10,0,10,0,10,Toscana,ITI1
2021-01-10,COMIRNATY Vaccino a mRNA contro COVID-19,60914I,ISTITUTO LE MAGNOLIE,TOS,90+,3,3,0,0,0,6,0,6,0,6,Toscana,ITI1
2021-01-10,COMIRNATY Vaccino a mRNA contro COVID-19,80214I,S. MONICA DI PINI L.E C.,TOS,30-39,1,0,0,1,0,0,0,1,0,1,Toscana,ITI1
2021-01-10,COMIRNATY Vaccino a mRNA contro COVID-19,80214I,S. MONICA DI PINI L.E C.,TOS,50-59,0,1,0,1,0,0,0,1,0,1,Toscana,ITI1
2021-01-10,COMIRNATY Vaccino a mRNA contro COVID-19,80214I,S. MONICA DI PINI L.E C.,TOS,60-69,1,2,0,2,0,1,0,3,0,3,Toscana,ITI1
2021-01-10,COMIRNATY Vaccino a mRNA contro COVID-19,80214I,S. MONICA DI PINI L.E C.,TOS,70-79,0,1,0,0,0,1,0,1,0,1,Toscana,ITI1
2021-01-10,COMIRNATY Vaccino a mRNA contro COVID-19,80214I,S. MONICA DI PINI L.E C.,TOS,80-89,1,1,0,0,0,2,0,2,0,2,Toscana,ITI1
2021-01-10,COMIRNATY Vaccino a mRNA contro COVID-19,80214I,S. MONICA DI PINI L.E C.,TOS,90+,0,3,0,0,0,3,0,3,0,3,Toscana,ITI1
2021-01-10,COMIRNATY Vaccino a mRNA contro COVID-19,80224I,VILLA OLIMPIA DI PINI L. E C.,TOS,90+,0,1,0,0,0,1,0,1,0,1,Toscana,ITI1
2021-01-10,COMIRNATY Vaccino a mRNA contro COVID-19,90124I,ISTITUTO GIOTTO LA VILLA SPA,TOS,60-69,0,1,0,0,0,1,0,1,0,1,Toscana,ITI1
2021-01-10,COMIRNATY Vaccino a mRNA contro COVID-19,90124I,ISTITUTO GIOTTO LA VILLA SPA,TOS,70-79,2,0,0,0,0,2,0,2,0,2,Toscana,ITI1
2021-01-10,COMIRNATY Vaccino a mRNA contro COVID-19,90124I,ISTITUTO GIOTTO LA VILLA SPA,TOS,80-89,2,4,0,0,0,6,0,6,0,6,Toscana,ITI1
2021-01-10,COMIRNATY Vaccino a mRNA contro COVID-19,90124I,ISTITUTO GIOTTO LA VILLA SPA,TOS,90+,1,8,0,0,0,9,0,9,0,9,Toscana,ITI1
2021-01-10,COMIRNATY Vaccino a mRNA contro COVID-19,90134I,ISTITUTO S.FRANCESCO,TOS,20-29,0,1,0,1,0,0,0,1,0,1,Toscana,ITI1
2021-01-10,COMIRNATY Vaccino a mRNA contro COVID-19,90134I,ISTITUTO S.FRANCESCO,TOS,40-49,0,1,0,1,0,0,0,1,0,1,Toscana,ITI1
2021-01-10,COMIRNATY Vaccino a mRNA contro COVID-19,90134I,ISTITUTO S.FRANCESCO,TOS,50-59,2,2,0,1,0,3,0,4,0,4,Toscana,ITI1
2021-01-10,COMIRNATY Vaccino a mRNA contro COVID-19,90134I,ISTITUTO S.FRANCESCO,TOS,60-69,1,0,0,0,0,1,0,1,0,1,Toscana,ITI1
2021-01-10,COMIRNATY Vaccino a mRNA contro COVID-19,90134I,ISTITUTO S.FRANCESCO,TOS,70-79,3,3,0,0,0,6,0,6,0,6,Toscana,ITI1
2021-01-10,COMIRNATY Vaccino a mRNA contro COVID-19,90134I,ISTITUTO S.FRANCESCO,TOS,80-89,2,7,0,0,0,9,0,9,0,9,Toscana,ITI1
2021-01-10,COMIRNATY Vaccino a mRNA contro COVID-19,90134I,ISTITUTO S.FRANCESCO,TOS,90+,1,4,0,0,0,5,0,5,0,5,Toscana,ITI1
2021-01-10,COMIRNATY Vaccino a mRNA contro COVID-19,90234I,RSA BEATO ANGELICO,TOS,30-39,0,1,0,1,0,0,0,1,0,1,Toscana,ITI1
2021-01-10,COMIRNATY Vaccino a mRNA contro COVID-19,90234I,RSA BEATO ANGELICO,TOS,40-49,0,1,0,1,0,0,0,1,0,1,Toscana,ITI1
2021-01-10,COMIRNATY Vaccino a mRNA contro COVID-19,90234I,RSA BEATO ANGELICO,TOS,60-69,0,2,0,2,0,0,0,2,0,2,Toscana,ITI1
2021-01-10,COMIRNATY Vaccino a mRNA contro COVID-19,90234I,RSA BEATO ANGELICO,TOS,70-79,1,4,0,0,0,5,0,5,0,5,Toscana,ITI1
2021-01-10,COMIRNATY Vaccino a mRNA contro COVID-19,90234I,RSA BEATO ANGELICO,TOS,80-89,1,2,0,0,0,3,0,3,0,3,Toscana,ITI1
2021-01-10,COMIRNATY Vaccino a mRNA contro COVID-19,E3504M,CASA VERDE,TOS,16-19,0,1,0,0,0,1,0,1,0,1,Toscana,ITI1
2021-01-10,COMIRNATY Vaccino a mRNA contro COVID-19,E3504M,CASA VERDE,TOS,30-39,0,2,0,0,0,2,0,2,0,2,Toscana,ITI1
2021-01-10,COMIRNATY Vaccino a mRNA contro COVID-19,E3504M,CASA VERDE,TOS,40-49,1,1,0,1,0,1,0,2,0,2,Toscana,ITI1
2021-01-10,COMIRNATY Vaccino a mRNA contro COVID-19,E3504M,CASA VERDE,TOS,50-59,1,5,0,3,0,3,0,6,0,6,Toscana,ITI1
2021-01-10,COMIRNATY Vaccino a mRNA contro COVID-19,F0114I,RSA MASACCIO,TOS,30-39,1,0,0,1,0,0,0,1,0,1,Toscana,ITI1
2021-01-10,COMIRNATY Vaccino a mRNA contro COVID-19,F0114I,RSA MASACCIO,TOS,60-69,0,2,0,0,0,2,0,2,0,2,Toscana,ITI1
2021-01-10,COMIRNATY Vaccino a mRNA contro COVID-19,F0114I,RSA MASACCIO,TOS,70-79,1,1,0,0,0,2,0,2,0,2,Toscana,ITI1
2021-01-10,COMIRNATY Vaccino a mRNA contro COVID-19,F0114I,RSA MASACCIO,TOS,80-89,3,6,0,0,0,9,0,9,0,9,Toscana,ITI1
2021-01-10,COMIRNATY Vaccino a mRNA contro COVID-19,F0114I,RSA MASACCIO,TOS,90+,0,5,0,0,0,5,0,5,0,5,Toscana,ITI1
2021-01-10,COMIRNATY Vaccino a mRNA contro COVID-19,ND,CASA FAMIGLIA CARITAS,TOS,30-39,0,1,0,0,0,1,0,1,0,1,Toscana,ITI1
2021-01-10,COMIRNATY Vaccino a mRNA contro COVID-19,ND,CASA FAMIGLIA CARITAS,TOS,40-49,0,5,0,0,1,4,0,5,0,5,Toscana,ITI1
2021-01-10,COMIRNATY Vaccino a mRNA contro COVID-19,ND,CASA FAMIGLIA CARITAS,TOS,50-59,0,5,0,0,0,5,0,5,0,5,Toscana,ITI1
2021-01-10,COMIRNATY Vaccino a mRNA contro COVID-19,ND,CASA FAMIGLIA CARITAS,TOS,60-69,0,1,0,0,0,1,0,1,0,1,Toscana,ITI1
2021-01-10,COMIRNATY Vaccino a mRNA contro COVID-19,ND,Covid19 - RSA I Girasoli,TOS,30-39,0,2,0,0,0,2,0,2,0,2,Toscana,ITI1
2021-01-10,COMIRNATY Vaccino a mRNA contro COVID-19,ND,Covid19 - RSA I Girasoli,TOS,60-69,1,1,0,0,0,2,0,2,0,2,Toscana,ITI1
2021-01-10,COMIRNATY Vaccino a mRNA contro COVID-19,ND,Covid19 - RSA I Girasoli,TOS,70-79,2,4,0,0,0,6,0,6,0,6,Toscana,ITI1
2021-01-10,COMIRNATY Vaccino a mRNA contro COVID-19,ND,Covid19 - RSA I Girasoli,TOS,80-89,3,10,0,0,0,13,0,13,0,13,Toscana,ITI1
2021-01-10,COMIRNATY Vaccino a mRNA contro COVID-19,ND,Covid19 - RSA I Girasoli,TOS,90+,1,11,0,0,0,12,0,12,0,12,Toscana,ITI1
2021-01-10,COMIRNATY Vaccino a mRNA contro COVID-19,ND,RSA Figlie di Nazareth - Arcidosso,TOS,70-79,0,4,0,0,0,4,0,4,0,4,Toscana,ITI1
2021-01-10,COMIRNATY Vaccino a mRNA contro COVID-19,ND,RSA Figlie di Nazareth - Arcidosso,TOS,80-89,2,11,0,1,0,12,0,13,0,13,Toscana,ITI1
2021-01-10,COMIRNATY Vaccino a mRNA contro COVID-19,ND,RSA Figlie di Nazareth - Arcidosso,TOS,90+,2,23,0,0,0,25,0,25,0,25,Toscana,ITI1
2021-01-10,COMIRNATY Vaccino a mRNA contro COVID-19,ND,RSA MADONNA DEL SOCCORSO,TOS,30-39,0,1,0,1,0,0,0,1,0,1,Toscana,ITI1
2021-01-10,COMIRNATY Vaccino a mRNA contro COVID-19,ND,RSA MADONNA DEL SOCCORSO,TOS,40-49,1,1,0,2,0,0,0,2,0,2,Toscana,ITI1
2021-01-10,COMIRNATY Vaccino a mRNA contro COVID-19,ND,RSA MADONNA DEL SOCCORSO,TOS,50-59,0,1,0,1,0,0,0,1,0,1,Toscana,ITI1
2021-01-10,COMIRNATY Vaccino a mRNA contro COVID-19,ND,RSA MADONNA DEL SOCCORSO,TOS,70-79,1,1,0,0,0,2,0,2,0,2,Toscana,ITI1
2021-01-10,COMIRNATY Vaccino a mRNA contro COVID-19,ND,RSA MADONNA DEL SOCCORSO,TOS,80-89,1,3,0,0,0,4,0,4,0,4,Toscana,ITI1
2021-01-10,COMIRNATY Vaccino a mRNA contro COVID-19,ND,RSA MADONNA DEL SOCCORSO,TOS,90+,1,1,0,0,0,2,0,2,0,2,Toscana,ITI1
2021-01-11,COMIRNATY Vaccino a mRNA contro COVID-19,02484I,CASA DI RIPOSO SAN DOMENICO,TOS,20-29,0,1,0,1,0,0,0,1,0,1,Toscana,ITI1
2021-01-11,COMIRNATY Vaccino a mRNA contro COVID-19,02484I,CASA DI RIPOSO SAN DOMENICO,TOS,30-39,0,1,0,1,0,0,0,1,0,1,Toscana,ITI1
2021-01-11,COMIRNATY Vaccino a mRNA contro COVID-19,02484I,CASA DI RIPOSO SAN DOMENICO,TOS,50-59,0,3,0,2,0,1,0,3,0,3,Toscana,ITI1
2021-01-11,COMIRNATY Vaccino a mRNA contro COVID-19,02484I,CASA DI RIPOSO SAN DOMENICO,TOS,60-69,1,0,0,0,0,1,0,1,0,1,Toscana,ITI1
2021-01-11,COMIRNATY Vaccino a mRNA contro COVID-19,02484I,CASA DI RIPOSO SAN DOMENICO,TOS,70-79,3,3,0,0,0,6,0,6,0,6,Toscana,ITI1
2021-01-11,COMIRNATY Vaccino a mRNA contro COVID-19,02484I,CASA DI RIPOSO SAN DOMENICO,TOS,80-89,1,3,0,0,0,4,0,4,0,4,Toscana,ITI1
2021-01-11,COMIRNATY Vaccino a mRNA contro COVID-19,02484I,CASA DI RIPOSO SAN DOMENICO,TOS,90+,0,2,0,0,0,2,0,2,0,2,Toscana,ITI1
2021-01-11,COMIRNATY Vaccino a mRNA contro COVID-19,02604I,RSA VILLA BIANCA SERVICES,TOS,20-29,1,2,0,3,0,0,0,3,0,3,Toscana,ITI1
2021-01-11,COMIRNATY Vaccino a mRNA contro COVID-19,02604I,RSA VILLA BIANCA SERVICES,TOS,30-39,2,0,0,2,0,0,0,2,0,2,Toscana,ITI1
2021-01-11,COMIRNATY Vaccino a mRNA contro COVID-19,02604I,RSA VILLA BIANCA SERVICES,TOS,40-49,0,6,0,6,0,0,0,6,0,6,Toscana,ITI1
2021-01-11,COMIRNATY Vaccino a mRNA contro COVID-19,02604I,RSA VILLA BIANCA SERVICES,TOS,50-59,0,1,0,1,0,0,0,1,0,1,Toscana,ITI1
2021-01-11,COMIRNATY Vaccino a mRNA contro COVID-19,02604I,RSA VILLA BIANCA SERVICES,TOS,60-69,1,1,0,1,0,1,0,2,0,2,Toscana,ITI1
2021-01-11,COMIRNATY Vaccino a mRNA contro COVID-19,02604I,RSA VILLA BIANCA SERVICES,TOS,70-79,0,1,0,0,0,1,0,1,0,1,Toscana,ITI1
2021-01-11,COMIRNATY Vaccino a mRNA contro COVID-19,02604I,RSA VILLA BIANCA SERVICES,TOS,80-89,2,3,0,1,0,4,0,5,0,5,Toscana,ITI1
2021-01-11,COMIRNATY Vaccino a mRNA contro COVID-19,02604I,RSA VILLA BIANCA SERVICES,TOS,90+,0,4,0,0,0,4,0,4,0,4,Toscana,ITI1
2021-01-11,COMIRNATY Vaccino a mRNA contro COVID-19,03002D,Covid 19 - Ospedale S.Francesco di Barga,TOS,16-19,1,0,0,1,0,0,0,1,0,1,Toscana,ITI1
2021-01-11,COMIRNATY Vaccino a mRNA contro COVID-19,03002D,Covid 19 - Ospedale S.Francesco di Barga,TOS,20-29,1,0,0,1,0,0,0,1,0,1,Toscana,ITI1
2021-01-11,COMIRNATY Vaccino a mRNA contro COVID-19,03002D,Covid 19 - Ospedale S.Francesco di Barga,TOS,30-39,3,4,0,5,2,0,0,7,0,7,Toscana,ITI1
2021-01-11,COMIRNATY Vaccino a mRNA contro COVID-19,03002D,Covid 19 - Ospedale S.Francesco di Barga,TOS,40-49,3,3,0,6,0,0,0,6,0,6,Toscana,ITI1
2021-01-11,COMIRNATY Vaccino a mRNA contro COVID-19,03002D,Covid 19 - Ospedale S.Francesco di Barga,TOS,50-59,1,6,0,7,0,0,0,7,0,7,Toscana,ITI1
2021-01-11,COMIRNATY Vaccino a mRNA contro COVID-19,03002D,Covid 19 - Ospedale S.Francesco di Barga,TOS,60-69,2,5,0,7,0,0,0,7,0,7,Toscana,ITI1
2021-01-11,COMIRNATY Vaccino a mRNA contro COVID-19,03002D,Covid 19 - Ospedale S.Francesco di Barga,TOS,70-79,1,0,0,1,0,0,0,1,0,1,Toscana,ITI1
2021-01-11,COMIRNATY Vaccino a mRNA contro COVID-19,090601,Covid 19 - Ospedale S.Antonio Abate di Fivizzano,TOS,20-29,0,6,0,6,0,0,0,6,0,6,Toscana,ITI1
2021-01-11,COMIRNATY Vaccino a mRNA contro COVID-19,090601,Covid 19 - Ospedale S.Antonio Abate di Fivizzano,TOS,30-39,3,10,0,13,0,0,0,13,0,13,Toscana,ITI1
2021-01-11,COMIRNATY Vaccino a mRNA contro COVID-19,090601,Covid 19 - Ospedale S.Antonio Abate di Fivizzano,TOS,40-49,0,10,0,10,0,0,0,10,0,10,Toscana,ITI1
2021-01-11,COMIRNATY Vaccino a mRNA contro COVID-19,090601,Covid 19 - Ospedale S.Antonio Abate di Fivizzano,TOS,50-59,4,9,0,13,0,0,0,13,0,13,Toscana,ITI1
2021-01-11,COMIRNATY Vaccino a mRNA contro COVID-19,090601,Covid 19 - Ospedale S.Antonio Abate di Fivizzano,TOS,60-69,3,2,0,5,0,0,0,5,0,5,Toscana,ITI1
2021-01-11,COMIRNATY Vaccino a mRNA contro COVID-19,090601,Covid 19 - Ospedale S.Antonio Abate di Fivizzano,TOS,70-79,0,1,0,1,0,0,0,1,0,1,Toscana,ITI1
2021-01-11,COMIRNATY Vaccino a mRNA contro COVID-19,090602,Covid 19 - Nuovo Ospedale Apuane,TOS,20-29,12,17,0,28,1,0,0,29,0,29,Toscana,ITI1
2021-01-11,COMIRNATY Vaccino a mRNA contro COVID-19,090602,Covid 19 - Nuovo Ospedale Apuane,TOS,30-39,10,23,0,33,0,0,0,33,0,33,Toscana,ITI1
2021-01-11,COMIRNATY Vaccino a mRNA contro COVID-19,090602,Covid 19 - Nuovo Ospedale Apuane,TOS,40-49,14,30,0,41,3,0,0,44,0,44,Toscana,ITI1
2021-01-11,COMIRNATY Vaccino a mRNA contro COVID-19,090602,Covid 19 - Nuovo Ospedale Apuane,TOS,50-59,14,39,0,52,1,0,0,53,0,53,Toscana,ITI1
2021-01-11,COMIRNATY Vaccino a mRNA contro COVID-19,090602,Covid 19 - Nuovo Ospedale Apuane,TOS,60-69,20,17,0,37,0,0,0,37,0,37,Toscana,ITI1
2021-01-11,COMIRNATY Vaccino a mRNA contro COVID-19,090602,Covid 19 - Nuovo Ospedale Apuane,TOS,70-79,2,0,0,2,0,0,0,2,0,2,Toscana,ITI1
2021-01-11,COMIRNATY Vaccino a mRNA contro COVID-19,090603,Covid 19 - Ospedale Santa Croce in Garfagnana,TOS,20-29,4,3,0,7,0,0,0,7,0,7,Toscana,ITI1
2021-01-11,COMIRNATY Vaccino a mRNA contro COVID-19,090603,Covid 19 - Ospedale Santa Croce in Garfagnana,TOS,30-39,3,10,0,13,0,0,0,13,0,13,Toscana,ITI1
2021-01-11,COMIRNATY Vaccino a mRNA contro COVID-19,090603,Covid 19 - Ospedale Santa Croce in Garfagnana,TOS,40-49,2,4,0,6,0,0,0,6,0,6,Toscana,ITI1
2021-01-11,COMIRNATY Vaccino a mRNA contro COVID-19,090603,Covid 19 - Ospedale Santa Croce in Garfagnana,TOS,50-59,5,10,0,15,0,0,0,15,0,15,Toscana,ITI1
2021-01-11,COMIRNATY Vaccino a mRNA contro COVID-19,090603,Covid 19 - Ospedale Santa Croce in Garfagnana,TOS,60-69,11,7,0,18,0,0,0,18,0,18,Toscana,ITI1
2021-01-11,COMIRNATY Vaccino a mRNA contro COVID-19,090603,Covid 19 - Ospedale Santa Croce in Garfagnana,TOS,70-79,1,0,0,1,0,0,0,1,0,1,Toscana,ITI1
2021-01-11,COMIRNATY Vaccino a mRNA contro COVID-19,090604,Covid 19 - Ospedale San Luca di  Lucca,TOS,20-29,8,18,0,26,0,0,0,26,0,26,Toscana,ITI1
2021-01-11,COMIRNATY Vaccino a mRNA contro COVID-19,090604,Covid 19 - Ospedale San Luca di  Lucca,TOS,30-39,9,25,0,34,0,0,0,34,0,34,Toscana,ITI1
2021-01-11,COMIRNATY Vaccino a mRNA contro COVID-19,090604,Covid 19 - Ospedale San Luca di  Lucca,TOS,40-49,12,29,0,41,0,0,0,41,0,41,Toscana,ITI1
2021-01-11,COMIRNATY Vaccino a mRNA contro COVID-19,090604,Covid 19 - Ospedale San Luca di  Lucca,TOS,50-59,20,36,0,56,0,0,0,56,0,56,Toscana,ITI1
2021-01-11,COMIRNATY Vaccino a mRNA contro COVID-19,090604,Covid 19 - Ospedale San Luca di  Lucca,TOS,60-69,29,10,0,39,0,0,0,39,0,39,Toscana,ITI1
2021-01-11,COMIRNATY Vaccino a mRNA contro COVID-19,090604,Covid 19 - Ospedale San Luca di  Lucca,TOS,70-79,0,1,0,1,0,0,0,1,0,1,Toscana,ITI1
2021-01-11,COMIRNATY Vaccino a mRNA contro COVID-19,090606,COVID19 - Ospedale San Iacopo,TOS,16-19,1,1,0,0,2,0,0,2,0,2,Toscana,ITI1
2021-01-11,COMIRNATY Vaccino a mRNA contro COVID-19,090606,COVID19 - Ospedale San Iacopo,TOS,20-29,14,6,0,16,4,0,0,20,0,20,Toscana,ITI1
2021-01-11,COMIRNATY Vaccino a mRNA contro COVID-19,090606,COVID19 - Ospedale San Iacopo,TOS,30-39,9,23,0,31,1,0,0,32,0,32,Toscana,ITI1
2021-01-11,COMIRNATY Vaccino a mRNA contro COVID-19,090606,COVID19 - Ospedale San Iacopo,TOS,40-49,4,27,0,30,1,0,0,31,0,31,Toscana,ITI1
2021-01-11,COMIRNATY Vaccino a mRNA contro COVID-19,090606,COVID19 - Ospedale San Iacopo,TOS,50-59,10,30,0,30,10,0,0,40,0,40,Toscana,ITI1
2021-01-11,COMIRNATY Vaccino a mRNA contro COVID-19,090606,COVID19 - Ospedale San Iacopo,TOS,60-69,10,14,0,20,4,0,0,24,0,24,Toscana,ITI1
2021-01-11,COMIRNATY Vaccino a mRNA contro COVID-19,090607,COVID19 - Ospedale SS.Cosma e Damiano,TOS,20-29,3,4,0,7,0,0,0,7,0,7,Toscana,ITI1
2021-01-11,COMIRNATY Vaccino a mRNA contro COVID-19,090607,COVID19 - Ospedale SS.Cosma e Damiano,TOS,30-39,0,6,0,6,0,0,0,6,0,6,Toscana,ITI1
2021-01-11,COMIRNATY Vaccino a mRNA contro COVID-19,090607,COVID19 - Ospedale SS.Cosma e Damiano,TOS,40-49,2,6,0,8,0,0,0,8,0,8,Toscana,ITI1
2021-01-11,COMIRNATY Vaccino a mRNA contro COVID-19,090607,COVID19 - Ospedale SS.Cosma e Damiano,TOS,50-59,3,19,0,22,0,0,0,22,0,22,Toscana,ITI1
2021-01-11,COMIRNATY Vaccino a mRNA contro COVID-19,090607,COVID19 - Ospedale SS.Cosma e Damiano,TOS,60-69,3,2,0,5,0,0,0,5,0,5,Toscana,ITI1
2021-01-11,COMIRNATY Vaccino a mRNA contro COVID-19,090608,COVID19 - Ospedale Santo Stefano,TOS,20-29,9,10,0,19,0,0,0,19,0,19,Toscana,ITI1
2021-01-11,COMIRNATY Vaccino a mRNA contro COVID-19,090608,COVID19 - Ospedale Santo Stefano,TOS,30-39,10,21,0,31,0,0,0,31,0,31,Toscana,ITI1
2021-01-11,COMIRNATY Vaccino a mRNA contro COVID-19,090608,COVID19 - Ospedale Santo Stefano,TOS,40-49,5,26,0,31,0,0,0,31,0,31,Toscana,ITI1
2021-01-11,COMIRNATY Vaccino a mRNA contro COVID-19,090608,COVID19 - Ospedale Santo Stefano,TOS,50-59,12,32,0,44,0,0,0,44,0,44,Toscana,ITI1
2021-01-11,COMIRNATY Vaccino a mRNA contro COVID-19,090608,COVID19 - Ospedale Santo Stefano,TOS,60-69,8,17,0,25,0,0,0,25,0,25,Toscana,ITI1
2021-01-11,COMIRNATY Vaccino a mRNA contro COVID-19,090609,Covid 19 - Ospedale S.Maria Maddalena di Volterra,TOS,20-29,2,6,0,8,0,0,0,8,0,8,Toscana,ITI1
2021-01-11,COMIRNATY Vaccino a mRNA contro COVID-19,090609,Covid 19 - Ospedale S.Maria Maddalena di Volterra,TOS,30-39,1,5,0,6,0,0,0,6,0,6,Toscana,ITI1
2021-01-11,COMIRNATY Vaccino a mRNA contro COVID-19,090609,Covid 19 - Ospedale S.Maria Maddalena di Volterra,TOS,40-49,2,12,0,13,1,0,0,14,0,14,Toscana,ITI1
2021-01-11,COMIRNATY Vaccino a mRNA contro COVID-19,090609,Covid 19 - Ospedale S.Maria Maddalena di Volterra,TOS,50-59,4,22,0,25,1,0,0,26,0,26,Toscana,ITI1
2021-01-11,COMIRNATY Vaccino a mRNA contro COVID-19,090609,Covid 19 - Ospedale S.Maria Maddalena di Volterra,TOS,60-69,1,5,0,6,0,0,0,6,0,6,Toscana,ITI1
2021-01-11,COMIRNATY Vaccino a mRNA contro COVID-19,090610,Covid 19 - Ospedale F.Lotti di Pontedera,TOS,20-29,1,9,0,10,0,0,0,10,0,10,Toscana,ITI1
2021-01-11,COMIRNATY Vaccino a mRNA contro COVID-19,090610,Covid 19 - Ospedale F.Lotti di Pontedera,TOS,30-39,5,13,0,18,0,0,0,18,0,18,Toscana,ITI1
2021-01-11,COMIRNATY Vaccino a mRNA contro COVID-19,090610,Covid 19 - Ospedale F.Lotti di Pontedera,TOS,40-49,6,17,0,23,0,0,0,23,0,23,Toscana,ITI1
2021-01-11,COMIRNATY Vaccino a mRNA contro COVID-19,090610,Covid 19 - Ospedale F.Lotti di Pontedera,TOS,50-59,3,15,0,18,0,0,0,18,0,18,Toscana,ITI1
2021-01-11,COMIRNATY Vaccino a mRNA contro COVID-19,090610,Covid 19 - Ospedale F.Lotti di Pontedera,TOS,60-69,8,13,0,21,0,0,0,21,0,21,Toscana,ITI1
2021-01-11,COMIRNATY Vaccino a mRNA contro COVID-19,090610,Covid 19 - Ospedale F.Lotti di Pontedera,TOS,70-79,1,0,0,1,0,0,0,1,0,1,Toscana,ITI1
2021-01-11,COMIRNATY Vaccino a mRNA contro COVID-19,090613,Covid 19 - Ospedali Riuniti di Livorno,TOS,20-29,7,20,0,27,0,0,0,27,0,27,Toscana,ITI1
2021-01-11,COMIRNATY Vaccino a mRNA contro COVID-19,090613,Covid 19 - Ospedali Riuniti di Livorno,TOS,30-39,15,23,0,38,0,0,0,38,0,38,Toscana,ITI1
2021-01-11,COMIRNATY Vaccino a mRNA contro COVID-19,090613,Covid 19 - Ospedali Riuniti di Livorno,TOS,40-49,14,38,0,52,0,0,0,52,0,52,Toscana,ITI1
2021-01-11,COMIRNATY Vaccino a mRNA contro COVID-19,090613,Covid 19 - Ospedali Riuniti di Livorno,TOS,50-59,25,34,0,56,3,0,0,59,0,59,Toscana,ITI1
2021-01-11,COMIRNATY Vaccino a mRNA contro COVID-19,090613,Covid 19 - Ospedali Riuniti di Livorno,TOS,60-69,36,25,0,60,1,0,0,61,0,61,Toscana,ITI1
2021-01-11,COMIRNATY Vaccino a mRNA contro COVID-19,090613,Covid 19 - Ospedali Riuniti di Livorno,TOS,70-79,3,0,0,2,0,1,0,3,0,3,Toscana,ITI1
2021-01-11,COMIRNATY Vaccino a mRNA contro COVID-19,090614,Covid 19 - Ospedale Civile di Piombino,TOS,20-29,1,0,0,1,0,0,0,1,0,1,Toscana,ITI1
2021-01-11,COMIRNATY Vaccino a mRNA contro COVID-19,090614,Covid 19 - Ospedale Civile di Piombino,TOS,30-39,1,5,0,6,0,0,0,6,0,6,Toscana,ITI1
2021-01-11,COMIRNATY Vaccino a mRNA contro COVID-19,090614,Covid 19 - Ospedale Civile di Piombino,TOS,40-49,2,4,0,6,0,0,0,6,0,6,Toscana,ITI1
2021-01-11,COMIRNATY Vaccino a mRNA contro COVID-19,090614,Covid 19 - Ospedale Civile di Piombino,TOS,50-59,1,10,0,11,0,0,0,11,0,11,Toscana,ITI1
2021-01-11,COMIRNATY Vaccino a mRNA contro COVID-19,090614,Covid 19 - Ospedale Civile di Piombino,TOS,60-69,2,3,0,5,0,0,0,5,0,5,Toscana,ITI1
2021-01-11,COMIRNATY Vaccino a mRNA contro COVID-19,090614,Covid 19 - Ospedale Civile di Piombino,TOS,70-79,1,0,0,1,0,0,0,1,0,1,Toscana,ITI1
2021-01-11,COMIRNATY Vaccino a mRNA contro COVID-19,090615,Ambulatorio Ospedale Portoferraio - Direzione Sanitaria,TOS,20-29,2,3,0,5,0,0,0,5,0,5,Toscana,ITI1
2021-01-11,COMIRNATY Vaccino a mRNA contro COVID-19,090615,Ambulatorio Ospedale Portoferraio - Direzione Sanitaria,TOS,30-39,3,2,0,5,0,0,0,5,0,5,Toscana,ITI1
2021-01-11,COMIRNATY Vaccino a mRNA contro COVID-19,090615,Ambulatorio Ospedale Portoferraio - Direzione Sanitaria,TOS,40-49,1,3,0,4,0,0,0,4,0,4,Toscana,ITI1
2021-01-11,COMIRNATY Vaccino a mRNA contro COVID-19,090615,Ambulatorio Ospedale Portoferraio - Direzione Sanitaria,TOS,50-59,3,7,0,10,0,0,0,10,0,10,Toscana,ITI1
2021-01-11,COMIRNATY Vaccino a mRNA contro COVID-19,090615,Ambulatorio Ospedale Portoferraio - Direzione Sanitaria,TOS,60-69,3,2,0,5,0,0,0,5,0,5,Toscana,ITI1
2021-01-11,COMIRNATY Vaccino a mRNA contro COVID-19,090615,Ambulatorio Ospedale Portoferraio - Direzione Sanitaria,TOS,70-79,1,0,0,1,0,0,0,1,0,1,Toscana,ITI1
2021-01-11,COMIRNATY Vaccino a mRNA contro COVID-19,090626,COVID19 - Ospedale di Grosseto,TOS,20-29,5,8,0,13,0,0,0,13,0,13,Toscana,ITI1
2021-01-11,COMIRNATY Vaccino a mRNA contro COVID-19,090626,COVID19 - Ospedale di Grosseto,TOS,30-39,6,13,0,19,0,0,0,19,0,19,Toscana,ITI1
2021-01-11,COMIRNATY Vaccino a mRNA contro COVID-19,090626,COVID19 - Ospedale di Grosseto,TOS,40-49,4,9,0,13,0,0,0,13,0,13,Toscana,ITI1
2021-01-11,COMIRNATY Vaccino a mRNA contro COVID-19,090626,COVID19 - Ospedale di Grosseto,TOS,50-59,8,15,0,23,0,0,0,23,0,23,Toscana,ITI1
2021-01-11,COMIRNATY Vaccino a mRNA contro COVID-19,090626,COVID19 - Ospedale di Grosseto,TOS,60-69,17,10,0,27,0,0,0,27,0,27,Toscana,ITI1
2021-01-11,COMIRNATY Vaccino a mRNA contro COVID-19,090626,COVID19 - Ospedale di Grosseto,TOS,70-79,1,0,0,1,0,0,0,1,0,1,Toscana,ITI1
2021-01-11,COMIRNATY Vaccino a mRNA contro COVID-19,090627,COVID19 - Ospedale Mugello,TOS,20-29,1,3,0,4,0,0,0,4,0,4,Toscana,ITI1
2021-01-11,COMIRNATY Vaccino a mRNA contro COVID-19,090627,COVID19 - Ospedale Mugello,TOS,30-39,1,5,0,6,0,0,0,6,0,6,Toscana,ITI1
2021-01-11,COMIRNATY Vaccino a mRNA contro COVID-19,090627,COVID19 - Ospedale Mugello,TOS,40-49,1,9,0,10,0,0,0,10,0,10,Toscana,ITI1
2021-01-11,COMIRNATY Vaccino a mRNA contro COVID-19,090627,COVID19 - Ospedale Mugello,TOS,50-59,4,20,0,24,0,0,0,24,0,24,Toscana,ITI1
2021-01-11,COMIRNATY Vaccino a mRNA contro COVID-19,090627,COVID19 - Ospedale Mugello,TOS,60-69,0,3,0,3,0,0,0,3,0,3,Toscana,ITI1
2021-01-11,COMIRNATY Vaccino a mRNA contro COVID-19,090627,COVID19 - Ospedale Mugello,TOS,70-79,1,0,0,0,1,0,0,1,0,1,Toscana,ITI1
2021-01-11,COMIRNATY Vaccino a mRNA contro COVID-19,090629,COVID19 - Ospedale SS. Maria Annunziata,TOS,16-19,0,1,1,1,0,0,0,1,0,1,Toscana,ITI1
2021-01-11,COMIRNATY Vaccino a mRNA contro COVID-19,090629,COVID19 - Ospedale SS. Maria Annunziata,TOS,20-29,3,8,1,10,1,0,0,11,0,11,Toscana,ITI1
2021-01-11,COMIRNATY Vaccino a mRNA contro COVID-19,090629,COVID19 - Ospedale SS. Maria Annunziata,TOS,30-39,9,17,1,25,1,0,0,26,0,26,Toscana,ITI1
2021-01-11,COMIRNATY Vaccino a mRNA contro COVID-19,090629,COVID19 - Ospedale SS. Maria Annunziata,TOS,40-49,12,27,1,35,4,0,0,39,0,39,Toscana,ITI1
2021-01-11,COMIRNATY Vaccino a mRNA contro COVID-19,090629,COVID19 - Ospedale SS. Maria Annunziata,TOS,50-59,13,40,1,50,2,0,1,53,0,53,Toscana,ITI1
2021-01-11,COMIRNATY Vaccino a mRNA contro COVID-19,090629,COVID19 - Ospedale SS. Maria Annunziata,TOS,60-69,12,13,1,22,3,0,0,25,0,25,Toscana,ITI1
2021-01-11,COMIRNATY Vaccino a mRNA contro COVID-19,090629,COVID19 - Ospedale SS. Maria Annunziata,TOS,70-79,1,0,1,1,0,0,0,1,0,1,Toscana,ITI1
2021-01-11,COMIRNATY Vaccino a mRNA contro COVID-19,090632,COVID19 - Ospedale Santa Maria Nuova,TOS,20-29,7,9,0,16,0,0,0,16,0,16,Toscana,ITI1
2021-01-11,COMIRNATY Vaccino a mRNA contro COVID-19,090632,COVID19 - Ospedale Santa Maria Nuova,TOS,30-39,6,9,0,15,0,0,0,15,0,15,Toscana,ITI1
2021-01-11,COMIRNATY Vaccino a mRNA contro COVID-19,090632,COVID19 - Ospedale Santa Maria Nuova,TOS,40-49,5,15,0,20,0,0,0,20,0,20,Toscana,ITI1
2021-01-11,COMIRNATY Vaccino a mRNA contro COVID-19,090632,COVID19 - Ospedale Santa Maria Nuova,TOS,50-59,9,23,0,32,0,0,0,32,0,32,Toscana,ITI1
2021-01-11,COMIRNATY Vaccino a mRNA contro COVID-19,090632,COVID19 - Ospedale Santa Maria Nuova,TOS,60-69,9,10,0,19,0,0,0,19,0,19,Toscana,ITI1
2021-01-11,COMIRNATY Vaccino a mRNA contro COVID-19,090637,COVID19 - Ospedale Amiata Val d'Orcia  Abbadia San Salvatore,TOS,20-29,1,1,0,0,2,0,0,2,0,2,Toscana,ITI1
2021-01-11,COMIRNATY Vaccino a mRNA contro COVID-19,090637,COVID19 - Ospedale Amiata Val d'Orcia  Abbadia San Salvatore,TOS,30-39,0,1,0,1,0,0,0,1,0,1,Toscana,ITI1
2021-01-11,COMIRNATY Vaccino a mRNA contro COVID-19,090637,COVID19 - Ospedale Amiata Val d'Orcia  Abbadia San Salvatore,TOS,40-49,2,3,0,3,1,1,0,5,0,5,Toscana,ITI1
2021-01-11,COMIRNATY Vaccino a mRNA contro COVID-19,090637,COVID19 - Ospedale Amiata Val d'Orcia  Abbadia San Salvatore,TOS,50-59,2,0,0,1,1,0,0,2,0,2,Toscana,ITI1
2021-01-11,COMIRNATY Vaccino a mRNA contro COVID-19,090637,COVID19 - Ospedale Amiata Val d'Orcia  Abbadia San Salvatore,TOS,60-69,1,1,0,1,1,0,0,2,0,2,Toscana,ITI1
2021-01-11,COMIRNATY Vaccino a mRNA contro COVID-19,090638,COVID19 - Ospedale di Campostaggia Poggibonsi,TOS,20-29,1,1,0,2,0,0,0,2,0,2,Toscana,ITI1
2021-01-11,COMIRNATY Vaccino a mRNA contro COVID-19,090638,COVID19 - Ospedale di Campostaggia Poggibonsi,TOS,30-39,3,2,0,5,0,0,0,5,0,5,Toscana,ITI1
2021-01-11,COMIRNATY Vaccino a mRNA contro COVID-19,090638,COVID19 - Ospedale di Campostaggia Poggibonsi,TOS,40-49,2,7,0,9,0,0,0,9,0,9,Toscana,ITI1
2021-01-11,COMIRNATY Vaccino a mRNA contro COVID-19,090638,COVID19 - Ospedale di Campostaggia Poggibonsi,TOS,50-59,2,10,0,12,0,0,0,12,0,12,Toscana,ITI1
2021-01-11,COMIRNATY Vaccino a mRNA contro COVID-19,090638,COVID19 - Ospedale di Campostaggia Poggibonsi,TOS,60-69,1,3,0,4,0,0,0,4,0,4,Toscana,ITI1
2021-01-11,COMIRNATY Vaccino a mRNA contro COVID-19,090639,COVID19 - Ospedale di Nottola Montepulciano,TOS,20-29,2,4,0,6,0,0,0,6,0,6,Toscana,ITI1
2021-01-11,COMIRNATY Vaccino a mRNA contro COVID-19,090639,COVID19 - Ospedale di Nottola Montepulciano,TOS,30-39,3,5,0,7,1,0,0,8,0,8,Toscana,ITI1
2021-01-11,COMIRNATY Vaccino a mRNA contro COVID-19,090639,COVID19 - Ospedale di Nottola Montepulciano,TOS,40-49,2,9,0,11,0,0,0,11,0,11,Toscana,ITI1
2021-01-11,COMIRNATY Vaccino a mRNA contro COVID-19,090639,COVID19 - Ospedale di Nottola Montepulciano,TOS,50-59,3,21,0,24,0,0,0,24,0,24,Toscana,ITI1
2021-01-11,COMIRNATY Vaccino a mRNA contro COVID-19,090639,COVID19 - Ospedale di Nottola Montepulciano,TOS,60-69,7,3,0,10,0,0,0,10,0,10,Toscana,ITI1
2021-01-11,COMIRNATY Vaccino a mRNA contro COVID-19,090639,COVID19 - Ospedale di Nottola Montepulciano,TOS,80-89,0,1,0,1,0,0,0,1,0,1,Toscana,ITI1
2021-01-11,COMIRNATY Vaccino a mRNA contro COVID-19,090640,Covid 19 - Ospedale Unico Versilia,TOS,16-19,0,1,0,1,0,0,0,1,0,1,Toscana,ITI1
2021-01-11,COMIRNATY Vaccino a mRNA contro COVID-19,090640,Covid 19 - Ospedale Unico Versilia,TOS,20-29,6,17,0,22,1,0,0,23,0,23,Toscana,ITI1
2021-01-11,COMIRNATY Vaccino a mRNA contro COVID-19,090640,Covid 19 - Ospedale Unico Versilia,TOS,30-39,10,24,0,34,0,0,0,34,0,34,Toscana,ITI1
2021-01-11,COMIRNATY Vaccino a mRNA contro COVID-19,090640,Covid 19 - Ospedale Unico Versilia,TOS,40-49,15,28,0,43,0,0,0,43,0,43,Toscana,ITI1
2021-01-11,COMIRNATY Vaccino a mRNA contro COVID-19,090640,Covid 19 - Ospedale Unico Versilia,TOS,50-59,14,42,0,56,0,0,0,56,0,56,Toscana,ITI1
2021-01-11,COMIRNATY Vaccino a mRNA contro COVID-19,090640,Covid 19 - Ospedale Unico Versilia,TOS,60-69,22,19,0,41,0,0,0,41,0,41,Toscana,ITI1
2021-01-11,COMIRNATY Vaccino a mRNA contro COVID-19,090640,Covid 19 - Ospedale Unico Versilia,TOS,70-79,3,0,0,3,0,0,0,3,0,3,Toscana,ITI1
2021-01-11,COMIRNATY Vaccino a mRNA contro COVID-19,090901,COVID19 - AOU Pisana,TOS,16-19,4,9,0,12,1,0,0,13,0,13,Toscana,ITI1
2021-01-11,COMIRNATY Vaccino a mRNA contro COVID-19,090901,COVID19 - AOU Pisana,TOS,20-29,55,98,0,151,2,0,0,153,0,153,Toscana,ITI1
2021-01-11,COMIRNATY Vaccino a mRNA contro COVID-19,090901,COVID19 - AOU Pisana,TOS,30-39,47,79,0,121,5,0,0,126,0,126,Toscana,ITI1
2021-01-11,COMIRNATY Vaccino a mRNA contro COVID-19,090901,COVID19 - AOU Pisana,TOS,40-49,39,100,0,129,10,0,0,139,0,139,Toscana,ITI1
2021-01-11,COMIRNATY Vaccino a mRNA contro COVID-19,090901,COVID19 - AOU Pisana,TOS,50-59,38,137,0,163,12,0,0,175,0,175,Toscana,ITI1
2021-01-11,COMIRNATY Vaccino a mRNA contro COVID-19,090901,COVID19 - AOU Pisana,TOS,60-69,19,42,0,60,1,0,0,61,0,61,Toscana,ITI1
2021-01-11,COMIRNATY Vaccino a mRNA contro COVID-19,090901,COVID19 - AOU Pisana,TOS,70-79,7,3,0,10,0,0,0,10,0,10,Toscana,ITI1
2021-01-11,COMIRNATY Vaccino a mRNA contro COVID-19,090901,COVID19 - AOU Pisana,TOS,80-89,1,0,0,1,0,0,0,1,0,1,Toscana,ITI1
2021-01-11,COMIRNATY Vaccino a mRNA contro COVID-19,090902,COVID19 - AOU Senese,TOS,16-19,1,8,0,9,0,0,0,9,0,9,Toscana,ITI1
2021-01-11,COMIRNATY Vaccino a mRNA contro COVID-19,090902,COVID19 - AOU Senese,TOS,20-29,85,177,0,261,0,1,0,262,0,262,Toscana,ITI1
2021-01-11,COMIRNATY Vaccino a mRNA contro COVID-19,090902,COVID19 - AOU Senese,TOS,30-39,14,25,0,39,0,0,0,39,0,39,Toscana,ITI1
2021-01-11,COMIRNATY Vaccino a mRNA contro COVID-19,090902,COVID19 - AOU Senese,TOS,40-49,6,22,0,28,0,0,0,28,0,28,Toscana,ITI1
2021-01-11,COMIRNATY Vaccino a mRNA contro COVID-19,090902,COVID19 - AOU Senese,TOS,50-59,8,12,0,20,0,0,0,20,0,20,Toscana,ITI1
2021-01-11,COMIRNATY Vaccino a mRNA contro COVID-19,090902,COVID19 - AOU Senese,TOS,60-69,1,5,0,6,0,0,0,6,0,6,Toscana,ITI1
2021-01-11,COMIRNATY Vaccino a mRNA contro COVID-19,090903,COVID19 - AOU Careggi - CTO,TOS,16-19,2,18,0,18,2,0,0,20,0,20,Toscana,ITI1
2021-01-11,COMIRNATY Vaccino a mRNA contro COVID-19,090903,COVID19 - AOU Careggi - CTO,TOS,20-29,88,177,0,254,11,0,0,265,0,265,Toscana,ITI1
2021-01-11,COMIRNATY Vaccino a mRNA contro COVID-19,090903,COVID19 - AOU Careggi - CTO,TOS,30-39,44,61,0,94,11,0,0,105,0,105,Toscana,ITI1
2021-01-11,COMIRNATY Vaccino a mRNA contro COVID-19,090903,COVID19 - AOU Careggi - CTO,TOS,40-49,35,75,0,92,18,0,0,110,0,110,Toscana,ITI1
2021-01-11,COMIRNATY Vaccino a mRNA contro COVID-19,090903,COVID19 - AOU Careggi - CTO,TOS,50-59,45,117,0,132,29,1,0,162,0,162,Toscana,ITI1
2021-01-11,COMIRNATY Vaccino a mRNA contro COVID-19,090903,COVID19 - AOU Careggi - CTO,TOS,60-69,25,29,0,45,9,0,0,54,0,54,Toscana,ITI1
2021-01-11,COMIRNATY Vaccino a mRNA contro COVID-19,090903,COVID19 - AOU Careggi - CTO,TOS,70-79,3,1,0,1,3,0,0,4,0,4,Toscana,ITI1
2021-01-11,COMIRNATY Vaccino a mRNA contro COVID-19,090903,COVID19 - AOU Careggi - PIASTRA,TOS,16-19,2,3,0,5,0,0,0,5,0,5,Toscana,ITI1
2021-01-11,COMIRNATY Vaccino a mRNA contro COVID-19,090903,COVID19 - AOU Careggi - PIASTRA,TOS,20-29,15,33,0,48,0,0,0,48,0,48,Toscana,ITI1
2021-01-11,COMIRNATY Vaccino a mRNA contro COVID-19,090903,COVID19 - AOU Careggi - PIASTRA,TOS,30-39,2,3,0,5,0,0,0,5,0,5,Toscana,ITI1
2021-01-11,COMIRNATY Vaccino a mRNA contro COVID-19,090903,COVID19 - AOU Careggi - PIASTRA,TOS,40-49,4,11,0,15,0,0,0,15,0,15,Toscana,ITI1
2021-01-11,COMIRNATY Vaccino a mRNA contro COVID-19,090903,COVID19 - AOU Careggi - PIASTRA,TOS,50-59,0,8,0,8,0,0,0,8,0,8,Toscana,ITI1
2021-01-11,COMIRNATY Vaccino a mRNA contro COVID-19,090903,COVID19 - AOU Careggi - PIASTRA,TOS,60-69,1,2,0,3,0,0,0,3,0,3,Toscana,ITI1
2021-01-11,COMIRNATY Vaccino a mRNA contro COVID-19,090904,COVID19 - Ospedale AOU Meyer,TOS,20-29,9,19,0,28,0,0,0,28,0,28,Toscana,ITI1
2021-01-11,COMIRNATY Vaccino a mRNA contro COVID-19,090904,COVID19 - Ospedale AOU Meyer,TOS,30-39,11,37,0,44,4,0,0,48,0,48,Toscana,ITI1
2021-01-11,COMIRNATY Vaccino a mRNA contro COVID-19,090904,COVID19 - Ospedale AOU Meyer,TOS,40-49,9,38,0,44,3,0,0,47,0,47,Toscana,ITI1
2021-01-11,COMIRNATY Vaccino a mRNA contro COVID-19,090904,COVID19 - Ospedale AOU Meyer,TOS,50-59,11,24,0,32,3,0,0,35,0,35,Toscana,ITI1
2021-01-11,COMIRNATY Vaccino a mRNA contro COVID-19,090904,COVID19 - Ospedale AOU Meyer,TOS,60-69,4,11,0,15,0,0,0,15,0,15,Toscana,ITI1
2021-01-11,COMIRNATY Vaccino a mRNA contro COVID-19,090904,COVID19 - Ospedale AOU Meyer,TOS,70-79,1,0,0,1,0,0,0,1,0,1,Toscana,ITI1
2021-01-11,COMIRNATY Vaccino a mRNA contro COVID-19,11012E,COVID19 - Ospedale San Giuseppe,TOS,20-29,5,10,0,15,0,0,0,15,0,15,Toscana,ITI1
2021-01-11,COMIRNATY Vaccino a mRNA contro COVID-19,11012E,COVID19 - Ospedale San Giuseppe,TOS,30-39,9,15,0,24,0,0,0,24,0,24,Toscana,ITI1
2021-01-11,COMIRNATY Vaccino a mRNA contro COVID-19,11012E,COVID19 - Ospedale San Giuseppe,TOS,40-49,9,31,0,40,0,0,0,40,0,40,Toscana,ITI1
2021-01-11,COMIRNATY Vaccino a mRNA contro COVID-19,11012E,COVID19 - Ospedale San Giuseppe,TOS,50-59,15,32,0,47,0,0,0,47,0,47,Toscana,ITI1
2021-01-11,COMIRNATY Vaccino a mRNA contro COVID-19,11012E,COVID19 - Ospedale San Giuseppe,TOS,60-69,7,15,0,21,0,1,0,22,0,22,Toscana,ITI1
2021-01-11,COMIRNATY Vaccino a mRNA contro COVID-19,11012E,COVID19 - Ospedale San Giuseppe,TOS,70-79,2,0,0,2,0,0,0,2,0,2,Toscana,ITI1
2021-01-11,COMIRNATY Vaccino a mRNA contro COVID-19,11151A,Covid 19 - Ospedale S.Antonio Abate di Pontremoli,TOS,16-19,0,1,0,1,0,0,0,1,0,1,Toscana,ITI1
2021-01-11,COMIRNATY Vaccino a mRNA contro COVID-19,11151A,Covid 19 - Ospedale S.Antonio Abate di Pontremoli,TOS,20-29,0,1,0,1,0,0,0,1,0,1,Toscana,ITI1
2021-01-11,COMIRNATY Vaccino a mRNA contro COVID-19,11151A,Covid 19 - Ospedale S.Antonio Abate di Pontremoli,TOS,30-39,4,9,0,9,4,0,0,13,0,13,Toscana,ITI1
2021-01-11,COMIRNATY Vaccino a mRNA contro COVID-19,11151A,Covid 19 - Ospedale S.Antonio Abate di Pontremoli,TOS,40-49,1,10,0,8,3,0,0,11,0,11,Toscana,ITI1
2021-01-11,COMIRNATY Vaccino a mRNA contro COVID-19,11151A,Covid 19 - Ospedale S.Antonio Abate di Pontremoli,TOS,50-59,1,9,0,7,3,0,0,10,0,10,Toscana,ITI1
2021-01-11,COMIRNATY Vaccino a mRNA contro COVID-19,11151A,Covid 19 - Ospedale S.Antonio Abate di Pontremoli,TOS,60-69,3,7,0,9,1,0,0,10,0,10,Toscana,ITI1
2021-01-11,COMIRNATY Vaccino a mRNA contro COVID-19,11151A,Covid 19 - Ospedale S.Antonio Abate di Pontremoli,TOS,70-79,1,0,0,0,1,0,0,1,0,1,Toscana,ITI1
2021-01-11,COMIRNATY Vaccino a mRNA contro COVID-19,11151A,Covid 19 - Ospedale S.Antonio Abate di Pontremoli,TOS,80-89,1,0,0,0,1,0,0,1,0,1,Toscana,ITI1
2021-01-11,COMIRNATY Vaccino a mRNA contro COVID-19,111G4L,R.S.A Umberto Viale,TOS,20-29,2,0,0,2,0,0,0,2,0,2,Toscana,ITI1
2021-01-11,COMIRNATY Vaccino a mRNA contro COVID-19,111G4L,R.S.A Umberto Viale,TOS,30-39,0,1,0,1,0,0,0,1,0,1,Toscana,ITI1
2021-01-11,COMIRNATY Vaccino a mRNA contro COVID-19,111G4L,R.S.A Umberto Viale,TOS,40-49,0,1,0,1,0,0,0,1,0,1,Toscana,ITI1
2021-01-11,COMIRNATY Vaccino a mRNA contro COVID-19,111G4L,R.S.A Umberto Viale,TOS,50-59,0,1,0,1,0,0,0,1,0,1,Toscana,ITI1
2021-01-11,COMIRNATY Vaccino a mRNA contro COVID-19,111G4L,R.S.A Umberto Viale,TOS,60-69,2,1,0,0,0,3,0,3,0,3,Toscana,ITI1
2021-01-11,COMIRNATY Vaccino a mRNA contro COVID-19,111G4L,R.S.A Umberto Viale,TOS,70-79,1,1,0,0,0,2,0,2,0,2,Toscana,ITI1
2021-01-11,COMIRNATY Vaccino a mRNA contro COVID-19,111G4L,R.S.A Umberto Viale,TOS,80-89,2,3,0,0,0,5,0,5,0,5,Toscana,ITI1
2021-01-11,COMIRNATY Vaccino a mRNA contro COVID-19,111G4L,R.S.A Umberto Viale,TOS,90+,0,3,0,0,0,3,0,3,0,3,Toscana,ITI1
2021-01-11,COMIRNATY Vaccino a mRNA contro COVID-19,13021A,COVID19 - Ospedale S.Giovanni di Dio,TOS,20-29,17,12,0,29,0,0,0,29,0,29,Toscana,ITI1
2021-01-11,COMIRNATY Vaccino a mRNA contro COVID-19,13021A,COVID19 - Ospedale S.Giovanni di Dio,TOS,30-39,15,17,0,28,0,4,0,32,0,32,Toscana,ITI1
2021-01-11,COMIRNATY Vaccino a mRNA contro COVID-19,13021A,COVID19 - Ospedale S.Giovanni di Dio,TOS,40-49,13,30,0,32,2,9,0,43,0,43,Toscana,ITI1
2021-01-11,COMIRNATY Vaccino a mRNA contro COVID-19,13021A,COVID19 - Ospedale S.Giovanni di Dio,TOS,50-59,12,40,0,40,0,12,0,52,0,52,Toscana,ITI1
2021-01-11,COMIRNATY Vaccino a mRNA contro COVID-19,13021A,COVID19 - Ospedale S.Giovanni di Dio,TOS,60-69,28,19,0,27,0,20,0,47,0,47,Toscana,ITI1
2021-01-11,COMIRNATY Vaccino a mRNA contro COVID-19,13021A,COVID19 - Ospedale S.Giovanni di Dio,TOS,70-79,8,2,0,2,0,8,0,10,0,10,Toscana,ITI1
2021-01-11,COMIRNATY Vaccino a mRNA contro COVID-19,13021A,COVID19 - Ospedale S.Giovanni di Dio,TOS,80-89,3,9,0,1,1,10,0,12,0,12,Toscana,ITI1
2021-01-11,COMIRNATY Vaccino a mRNA contro COVID-19,13021A,COVID19 - Ospedale S.Giovanni di Dio,TOS,90+,1,7,0,0,0,8,0,8,0,8,Toscana,ITI1
2021-01-11,COMIRNATY Vaccino a mRNA contro COVID-19,13254I,Covid19 - Fondazione Cardinal Maffi,TOS,50-59,1,1,0,0,1,1,0,2,0,2,Toscana,ITI1
2021-01-11,COMIRNATY Vaccino a mRNA contro COVID-19,13254I,Covid19 - Fondazione Cardinal Maffi,TOS,60-69,2,2,0,0,0,4,0,4,0,4,Toscana,ITI1
2021-01-11,COMIRNATY Vaccino a mRNA contro COVID-19,160A1A,Casa famiglia Cassiopea UNITALSI Pisa,TOS,30-39,1,0,0,0,0,1,0,1,0,1,Toscana,ITI1
2021-01-11,COMIRNATY Vaccino a mRNA contro COVID-19,160A1A,Casa famiglia Cassiopea UNITALSI Pisa,TOS,50-59,1,1,0,0,0,2,0,2,0,2,Toscana,ITI1
2021-01-11,COMIRNATY Vaccino a mRNA contro COVID-19,160A1A,Casa famiglia Cassiopea UNITALSI Pisa,TOS,60-69,2,1,0,0,0,3,0,3,0,3,Toscana,ITI1
2021-01-11,COMIRNATY Vaccino a mRNA contro COVID-19,16121A,Covid 19 - Ospedale Civile di Cecina,TOS,20-29,0,4,0,4,0,0,0,4,0,4,Toscana,ITI1
2021-01-11,COMIRNATY Vaccino a mRNA contro COVID-19,16121A,Covid 19 - Ospedale Civile di Cecina,TOS,30-39,1,4,0,5,0,0,0,5,0,5,Toscana,ITI1
2021-01-11,COMIRNATY Vaccino a mRNA contro COVID-19,16121A,Covid 19 - Ospedale Civile di Cecina,TOS,40-49,1,4,0,5,0,0,0,5,0,5,Toscana,ITI1
2021-01-11,COMIRNATY Vaccino a mRNA contro COVID-19,16121A,Covid 19 - Ospedale Civile di Cecina,TOS,50-59,3,9,0,12,0,0,0,12,0,12,Toscana,ITI1
2021-01-11,COMIRNATY Vaccino a mRNA contro COVID-19,16121A,Covid 19 - Ospedale Civile di Cecina,TOS,60-69,1,3,0,4,0,0,0,4,0,4,Toscana,ITI1
2021-01-11,COMIRNATY Vaccino a mRNA contro COVID-19,16614I,RSA PONTE A POPPI,TOS,40-49,1,1,0,2,0,0,0,2,0,2,Toscana,ITI1
2021-01-11,COMIRNATY Vaccino a mRNA contro COVID-19,16614I,RSA PONTE A POPPI,TOS,50-59,0,2,0,1,0,1,0,2,0,2,Toscana,ITI1
2021-01-11,COMIRNATY Vaccino a mRNA contro COVID-19,16614I,RSA PONTE A POPPI,TOS,60-69,1,1,0,0,0,2,0,2,0,2,Toscana,ITI1
2021-01-11,COMIRNATY Vaccino a mRNA contro COVID-19,16614I,RSA PONTE A POPPI,TOS,70-79,3,1,0,0,0,4,0,4,0,4,Toscana,ITI1
2021-01-11,COMIRNATY Vaccino a mRNA contro COVID-19,16614I,RSA PONTE A POPPI,TOS,80-89,5,9,0,0,0,14,0,14,0,14,Toscana,ITI1
2021-01-11,COMIRNATY Vaccino a mRNA contro COVID-19,16614I,RSA PONTE A POPPI,TOS,90+,1,5,0,0,0,6,0,6,0,6,Toscana,ITI1
2021-01-11,COMIRNATY Vaccino a mRNA contro COVID-19,20844I,Covid19 - RSA ALFIERI,TOS,20-29,0,1,0,0,1,0,0,1,0,1,Toscana,ITI1
2021-01-11,COMIRNATY Vaccino a mRNA contro COVID-19,20844I,Covid19 - RSA ALFIERI,TOS,40-49,0,1,0,0,1,0,0,1,0,1,Toscana,ITI1
2021-01-11,COMIRNATY Vaccino a mRNA contro COVID-19,20844I,Covid19 - RSA ALFIERI,TOS,50-59,0,1,0,0,1,0,0,1,0,1,Toscana,ITI1
2021-01-11,COMIRNATY Vaccino a mRNA contro COVID-19,20844I,Covid19 - RSA ALFIERI,TOS,60-69,0,1,0,0,1,0,0,1,0,1,Toscana,ITI1
2021-01-11,COMIRNATY Vaccino a mRNA contro COVID-19,20844I,Covid19 - RSA ALFIERI,TOS,70-79,2,0,0,0,0,2,0,2,0,2,Toscana,ITI1
2021-01-11,COMIRNATY Vaccino a mRNA contro COVID-19,20844I,Covid19 - RSA ALFIERI,TOS,80-89,1,3,0,0,0,4,0,4,0,4,Toscana,ITI1
2021-01-11,COMIRNATY Vaccino a mRNA contro COVID-19,20844I,Covid19 - RSA ALFIERI,TOS,90+,0,1,0,0,0,1,0,1,0,1,Toscana,ITI1
2021-01-11,COMIRNATY Vaccino a mRNA contro COVID-19,20884I,R.S.A. VILLA S. LORENZO,TOS,20-29,0,2,0,0,2,0,0,2,0,2,Toscana,ITI1
2021-01-11,COMIRNATY Vaccino a mRNA contro COVID-19,20884I,R.S.A. VILLA S. LORENZO,TOS,30-39,1,0,0,0,0,1,0,1,0,1,Toscana,ITI1
2021-01-11,COMIRNATY Vaccino a mRNA contro COVID-19,20884I,R.S.A. VILLA S. LORENZO,TOS,40-49,1,0,0,0,0,1,0,1,0,1,Toscana,ITI1
2021-01-11,COMIRNATY Vaccino a mRNA contro COVID-19,20884I,R.S.A. VILLA S. LORENZO,TOS,50-59,1,2,0,0,2,1,0,3,0,3,Toscana,ITI1
2021-01-11,COMIRNATY Vaccino a mRNA contro COVID-19,20884I,R.S.A. VILLA S. LORENZO,TOS,60-69,2,0,0,0,0,2,0,2,0,2,Toscana,ITI1
2021-01-11,COMIRNATY Vaccino a mRNA contro COVID-19,20884I,R.S.A. VILLA S. LORENZO,TOS,70-79,1,4,0,0,0,5,0,5,0,5,Toscana,ITI1
2021-01-11,COMIRNATY Vaccino a mRNA contro COVID-19,20884I,R.S.A. VILLA S. LORENZO,TOS,80-89,3,3,0,0,0,6,0,6,0,6,Toscana,ITI1
2021-01-11,COMIRNATY Vaccino a mRNA contro COVID-19,20884I,R.S.A. VILLA S. LORENZO,TOS,90+,0,3,0,0,0,3,0,3,0,3,Toscana,ITI1
2021-01-11,COMIRNATY Vaccino a mRNA contro COVID-19,33564L,IST. PER ADULTI INABILI CAM,TOS,20-29,1,1,0,0,0,2,0,2,0,2,Toscana,ITI1
2021-01-11,COMIRNATY Vaccino a mRNA contro COVID-19,33564L,IST. PER ADULTI INABILI CAM,TOS,30-39,13,3,0,0,0,16,0,16,0,16,Toscana,ITI1
2021-01-11,COMIRNATY Vaccino a mRNA contro COVID-19,33564L,IST. PER ADULTI INABILI CAM,TOS,40-49,9,3,0,0,0,12,0,12,0,12,Toscana,ITI1
2021-01-11,COMIRNATY Vaccino a mRNA contro COVID-19,33564L,IST. PER ADULTI INABILI CAM,TOS,50-59,14,2,0,1,0,15,0,16,0,16,Toscana,ITI1
2021-01-11,COMIRNATY Vaccino a mRNA contro COVID-19,33564L,IST. PER ADULTI INABILI CAM,TOS,60-69,6,0,0,0,0,6,0,6,0,6,Toscana,ITI1
2021-01-11,COMIRNATY Vaccino a mRNA contro COVID-19,33564L,IST. PER ADULTI INABILI CAM,TOS,70-79,2,0,0,0,0,2,0,2,0,2,Toscana,ITI1
2021-01-11,COMIRNATY Vaccino a mRNA contro COVID-19,40911A,COVID19 - Dip. Prevenzione Ruffolo Siena,TOS,20-29,1,3,0,4,0,0,0,4,0,4,Toscana,ITI1
2021-01-11,COMIRNATY Vaccino a mRNA contro COVID-19,40911A,COVID19 - Dip. Prevenzione Ruffolo Siena,TOS,30-39,3,9,0,12,0,0,0,12,0,12,Toscana,ITI1
2021-01-11,COMIRNATY Vaccino a mRNA contro COVID-19,40911A,COVID19 - Dip. Prevenzione Ruffolo Siena,TOS,40-49,2,2,0,4,0,0,0,4,0,4,Toscana,ITI1
2021-01-11,COMIRNATY Vaccino a mRNA contro COVID-19,40911A,COVID19 - Dip. Prevenzione Ruffolo Siena,TOS,50-59,2,6,0,8,0,0,0,8,0,8,Toscana,ITI1
2021-01-11,COMIRNATY Vaccino a mRNA contro COVID-19,40911A,COVID19 - Dip. Prevenzione Ruffolo Siena,TOS,60-69,10,6,0,14,0,2,0,16,0,16,Toscana,ITI1
2021-01-11,COMIRNATY Vaccino a mRNA contro COVID-19,40911A,COVID19 - Dip. Prevenzione Ruffolo Siena,TOS,70-79,1,4,0,0,0,5,0,5,0,5,Toscana,ITI1
2021-01-11,COMIRNATY Vaccino a mRNA contro COVID-19,40911A,COVID19 - Dip. Prevenzione Ruffolo Siena,TOS,80-89,1,9,0,0,0,10,0,10,0,10,Toscana,ITI1
2021-01-11,COMIRNATY Vaccino a mRNA contro COVID-19,40911A,COVID19 - Dip. Prevenzione Ruffolo Siena,TOS,90+,0,13,0,0,0,13,0,13,0,13,Toscana,ITI1
2021-01-11,COMIRNATY Vaccino a mRNA contro COVID-19,42194I,RSA MADONNA DEL BUON INCONTRO,TOS,40-49,1,1,0,0,0,2,0,2,0,2,Toscana,ITI1
2021-01-11,COMIRNATY Vaccino a mRNA contro COVID-19,42194I,RSA MADONNA DEL BUON INCONTRO,TOS,50-59,4,3,0,0,0,7,0,7,0,7,Toscana,ITI1
2021-01-11,COMIRNATY Vaccino a mRNA contro COVID-19,42194I,RSA MADONNA DEL BUON INCONTRO,TOS,60-69,1,2,0,0,0,3,0,3,0,3,Toscana,ITI1
2021-01-11,COMIRNATY Vaccino a mRNA contro COVID-19,42194I,RSA MADONNA DEL BUON INCONTRO,TOS,70-79,1,5,0,0,0,6,0,6,0,6,Toscana,ITI1
2021-01-11,COMIRNATY Vaccino a mRNA contro COVID-19,42194I,RSA MADONNA DEL BUON INCONTRO,TOS,80-89,3,9,0,0,0,12,0,12,0,12,Toscana,ITI1
2021-01-11,COMIRNATY Vaccino a mRNA contro COVID-19,42194I,RSA MADONNA DEL BUON INCONTRO,TOS,90+,2,4,0,0,0,6,0,6,0,6,Toscana,ITI1
2021-01-11,COMIRNATY Vaccino a mRNA contro COVID-19,43514I,VILLA FIORITA,TOS,70-79,3,3,0,0,0,6,0,6,0,6,Toscana,ITI1
2021-01-11,COMIRNATY Vaccino a mRNA contro COVID-19,43514I,VILLA FIORITA,TOS,80-89,7,14,0,0,0,21,0,21,0,21,Toscana,ITI1
2021-01-11,COMIRNATY Vaccino a mRNA contro COVID-19,43514I,VILLA FIORITA,TOS,90+,2,7,0,0,0,9,0,9,0,9,Toscana,ITI1
2021-01-11,COMIRNATY Vaccino a mRNA contro COVID-19,46824I,R.S.A. CAMPANSI,TOS,50-59,0,1,0,0,0,1,0,1,0,1,Toscana,ITI1
2021-01-11,COMIRNATY Vaccino a mRNA contro COVID-19,46824I,R.S.A. CAMPANSI,TOS,60-69,0,4,0,0,0,4,0,4,0,4,Toscana,ITI1
2021-01-11,COMIRNATY Vaccino a mRNA contro COVID-19,46824I,R.S.A. CAMPANSI,TOS,70-79,5,6,0,0,0,11,0,11,0,11,Toscana,ITI1
2021-01-11,COMIRNATY Vaccino a mRNA contro COVID-19,46824I,R.S.A. CAMPANSI,TOS,80-89,8,23,0,0,0,31,0,31,0,31,Toscana,ITI1
2021-01-11,COMIRNATY Vaccino a mRNA contro COVID-19,46824I,R.S.A. CAMPANSI,TOS,90+,9,30,0,0,0,39,0,39,0,39,Toscana,ITI1
2021-01-11,COMIRNATY Vaccino a mRNA contro COVID-19,61384I,IST.S.TERESA DEL BAMBINO GESU',TOS,30-39,0,2,0,1,1,0,0,2,0,2,Toscana,ITI1
2021-01-11,COMIRNATY Vaccino a mRNA contro COVID-19,61384I,IST.S.TERESA DEL BAMBINO GESU',TOS,40-49,0,4,0,0,4,0,0,4,0,4,Toscana,ITI1
2021-01-11,COMIRNATY Vaccino a mRNA contro COVID-19,61384I,IST.S.TERESA DEL BAMBINO GESU',TOS,50-59,0,4,0,3,0,1,0,4,0,4,Toscana,ITI1
2021-01-11,COMIRNATY Vaccino a mRNA contro COVID-19,61384I,IST.S.TERESA DEL BAMBINO GESU',TOS,70-79,0,1,0,0,1,0,0,1,0,1,Toscana,ITI1
2021-01-11,COMIRNATY Vaccino a mRNA contro COVID-19,61384I,IST.S.TERESA DEL BAMBINO GESU',TOS,80-89,0,6,0,0,1,5,0,6,0,6,Toscana,ITI1
2021-01-11,COMIRNATY Vaccino a mRNA contro COVID-19,61384I,IST.S.TERESA DEL BAMBINO GESU',TOS,90+,0,7,0,0,0,7,0,7,0,7,Toscana,ITI1
2021-01-11,COMIRNATY Vaccino a mRNA contro COVID-19,80234I,OP.PIA CAS. RIP. L. E G. VANNI,TOS,20-29,1,0,0,1,0,0,0,1,0,1,Toscana,ITI1
2021-01-11,COMIRNATY Vaccino a mRNA contro COVID-19,80234I,OP.PIA CAS. RIP. L. E G. VANNI,TOS,30-39,1,0,0,1,0,0,0,1,0,1,Toscana,ITI1
2021-01-11,COMIRNATY Vaccino a mRNA contro COVID-19,80234I,OP.PIA CAS. RIP. L. E G. VANNI,TOS,40-49,2,1,0,3,0,0,0,3,0,3,Toscana,ITI1
2021-01-11,COMIRNATY Vaccino a mRNA contro COVID-19,80234I,OP.PIA CAS. RIP. L. E G. VANNI,TOS,50-59,1,5,0,6,0,0,0,6,0,6,Toscana,ITI1
2021-01-11,COMIRNATY Vaccino a mRNA contro COVID-19,80234I,OP.PIA CAS. RIP. L. E G. VANNI,TOS,60-69,1,0,0,0,0,1,0,1,0,1,Toscana,ITI1
2021-01-11,COMIRNATY Vaccino a mRNA contro COVID-19,80234I,OP.PIA CAS. RIP. L. E G. VANNI,TOS,70-79,3,2,0,0,0,5,0,5,0,5,Toscana,ITI1
2021-01-11,COMIRNATY Vaccino a mRNA contro COVID-19,80234I,OP.PIA CAS. RIP. L. E G. VANNI,TOS,80-89,11,15,0,0,0,26,0,26,0,26,Toscana,ITI1
2021-01-11,COMIRNATY Vaccino a mRNA contro COVID-19,80234I,OP.PIA CAS. RIP. L. E G. VANNI,TOS,90+,1,22,0,0,0,23,0,23,0,23,Toscana,ITI1
2021-01-11,COMIRNATY Vaccino a mRNA contro COVID-19,90134I,ISTITUTO S.FRANCESCO,TOS,40-49,0,1,0,0,0,1,0,1,0,1,Toscana,ITI1
2021-01-11,COMIRNATY Vaccino a mRNA contro COVID-19,90134I,ISTITUTO S.FRANCESCO,TOS,50-59,3,0,0,0,0,3,0,3,0,3,Toscana,ITI1
2021-01-11,COMIRNATY Vaccino a mRNA contro COVID-19,90134I,ISTITUTO S.FRANCESCO,TOS,60-69,4,0,0,0,0,4,0,4,0,4,Toscana,ITI1
2021-01-11,COMIRNATY Vaccino a mRNA contro COVID-19,90134I,ISTITUTO S.FRANCESCO,TOS,70-79,1,0,0,0,0,1,0,1,0,1,Toscana,ITI1
2021-01-11,COMIRNATY Vaccino a mRNA contro COVID-19,90134I,ISTITUTO S.FRANCESCO,TOS,80-89,0,1,0,0,0,1,0,1,0,1,Toscana,ITI1
2021-01-11,COMIRNATY Vaccino a mRNA contro COVID-19,90134I,ISTITUTO S.FRANCESCO,TOS,90+,0,2,0,0,0,2,0,2,0,2,Toscana,ITI1
2021-01-11,COMIRNATY Vaccino a mRNA contro COVID-19,ND,RSD CASA FAMIGLIA PAIM PONTASSERCHIO,TOS,20-29,0,1,0,1,0,0,0,1,0,1,Toscana,ITI1
2021-01-11,COMIRNATY Vaccino a mRNA contro COVID-19,ND,RSD CASA FAMIGLIA PAIM PONTASSERCHIO,TOS,40-49,2,2,0,1,0,3,0,4,0,4,Toscana,ITI1
2021-01-11,COMIRNATY Vaccino a mRNA contro COVID-19,ND,RSD CASA FAMIGLIA PAIM PONTASSERCHIO,TOS,50-59,2,3,0,1,0,4,0,5,0,5,Toscana,ITI1
2021-01-11,COMIRNATY Vaccino a mRNA contro COVID-19,ND,RSD CASA FAMIGLIA PAIM PONTASSERCHIO,TOS,60-69,1,1,0,1,0,1,0,2,0,2,Toscana,ITI1
2021-01-11,COMIRNATY Vaccino a mRNA contro COVID-19,R0074I,RSA S. FRANCESCO POGGIO A CAIA,TOS,20-29,1,0,0,1,0,0,0,1,0,1,Toscana,ITI1
2021-01-11,COMIRNATY Vaccino a mRNA contro COVID-19,R0074I,RSA S. FRANCESCO POGGIO A CAIA,TOS,40-49,0,1,0,1,0,0,0,1,0,1,Toscana,ITI1
2021-01-11,COMIRNATY Vaccino a mRNA contro COVID-19,R0074I,RSA S. FRANCESCO POGGIO A CAIA,TOS,50-59,0,1,0,1,0,0,0,1,0,1,Toscana,ITI1
2021-01-11,COMIRNATY Vaccino a mRNA contro COVID-19,R0074I,RSA S. FRANCESCO POGGIO A CAIA,TOS,60-69,0,2,0,2,0,0,0,2,0,2,Toscana,ITI1
2021-01-11,COMIRNATY Vaccino a mRNA contro COVID-19,R0074I,RSA S. FRANCESCO POGGIO A CAIA,TOS,70-79,0,2,0,1,0,1,0,2,0,2,Toscana,ITI1
2021-01-11,COMIRNATY Vaccino a mRNA contro COVID-19,R0074I,RSA S. FRANCESCO POGGIO A CAIA,TOS,80-89,0,6,0,4,0,2,0,6,0,6,Toscana,ITI1
2021-01-11,COMIRNATY Vaccino a mRNA contro COVID-19,R0074I,RSA S. FRANCESCO POGGIO A CAIA,TOS,90+,0,5,0,1,0,4,0,5,0,5,Toscana,ITI1
2021-01-11,COMIRNATY Vaccino a mRNA contro COVID-19,R0094I,CASA ANZIANI DI COMEANA,TOS,40-49,0,1,0,1,0,0,0,1,0,1,Toscana,ITI1
2021-01-11,COMIRNATY Vaccino a mRNA contro COVID-19,R0094I,CASA ANZIANI DI COMEANA,TOS,50-59,0,1,0,1,0,0,0,1,0,1,Toscana,ITI1
2021-01-11,COMIRNATY Vaccino a mRNA contro COVID-19,R0094I,CASA ANZIANI DI COMEANA,TOS,60-69,0,4,0,3,0,1,0,4,0,4,Toscana,ITI1
2021-01-11,COMIRNATY Vaccino a mRNA contro COVID-19,R0094I,CASA ANZIANI DI COMEANA,TOS,70-79,1,1,0,0,0,2,0,2,0,2,Toscana,ITI1
2021-01-11,COMIRNATY Vaccino a mRNA contro COVID-19,R0094I,CASA ANZIANI DI COMEANA,TOS,80-89,0,1,0,0,0,1,0,1,0,1,Toscana,ITI1
2021-01-11,COMIRNATY Vaccino a mRNA contro COVID-19,R0094I,CASA ANZIANI DI COMEANA,TOS,90+,0,3,0,0,0,3,0,3,0,3,Toscana,ITI1
2021-01-11,COMIRNATY Vaccino a mRNA contro COVID-19,V0054I,RSA VILLA MARIA LIDO DI CAMAIO,TOS,80-89,0,1,0,0,0,1,0,1,0,1,Toscana,ITI1
2021-01-12,COMIRNATY Vaccino a mRNA contro COVID-19,00924I,RSA CANTAGRILLO,TOS,80-89,0,1,0,0,0,1,0,1,0,1,Toscana,ITI1
2021-01-12,COMIRNATY Vaccino a mRNA contro COVID-19,090602,Covid 19 - Nuovo Ospedale Apuane,TOS,20-29,7,8,0,15,0,0,0,15,0,15,Toscana,ITI1
2021-01-12,COMIRNATY Vaccino a mRNA contro COVID-19,090602,Covid 19 - Nuovo Ospedale Apuane,TOS,30-39,7,6,0,13,0,0,0,13,0,13,Toscana,ITI1
2021-01-12,COMIRNATY Vaccino a mRNA contro COVID-19,090602,Covid 19 - Nuovo Ospedale Apuane,TOS,40-49,8,23,0,31,0,0,0,31,0,31,Toscana,ITI1
2021-01-12,COMIRNATY Vaccino a mRNA contro COVID-19,090602,Covid 19 - Nuovo Ospedale Apuane,TOS,50-59,4,28,0,32,0,0,0,32,0,32,Toscana,ITI1
2021-01-12,COMIRNATY Vaccino a mRNA contro COVID-19,090602,Covid 19 - Nuovo Ospedale Apuane,TOS,60-69,13,10,0,23,0,0,0,23,0,23,Toscana,ITI1
2021-01-12,COMIRNATY Vaccino a mRNA contro COVID-19,090602,Covid 19 - Nuovo Ospedale Apuane,TOS,70-79,5,0,0,5,0,0,0,5,0,5,Toscana,ITI1
2021-01-12,COMIRNATY Vaccino a mRNA contro COVID-19,090602,Covid 19 - Nuovo Ospedale Apuane,TOS,80-89,1,0,0,1,0,0,0,1,0,1,Toscana,ITI1
2021-01-12,COMIRNATY Vaccino a mRNA contro COVID-19,090604,Covid 19 - Ospedale San Luca di  Lucca,TOS,16-19,0,5,0,5,0,0,0,5,0,5,Toscana,ITI1
2021-01-12,COMIRNATY Vaccino a mRNA contro COVID-19,090604,Covid 19 - Ospedale San Luca di  Lucca,TOS,20-29,6,14,0,20,0,0,0,20,0,20,Toscana,ITI1
2021-01-12,COMIRNATY Vaccino a mRNA contro COVID-19,090604,Covid 19 - Ospedale San Luca di  Lucca,TOS,30-39,8,16,0,24,0,0,0,24,0,24,Toscana,ITI1
2021-01-12,COMIRNATY Vaccino a mRNA contro COVID-19,090604,Covid 19 - Ospedale San Luca di  Lucca,TOS,40-49,5,10,0,15,0,0,0,15,0,15,Toscana,ITI1
2021-01-12,COMIRNATY Vaccino a mRNA contro COVID-19,090604,Covid 19 - Ospedale San Luca di  Lucca,TOS,50-59,7,16,0,23,0,0,0,23,0,23,Toscana,ITI1
2021-01-12,COMIRNATY Vaccino a mRNA contro COVID-19,090604,Covid 19 - Ospedale San Luca di  Lucca,TOS,60-69,7,7,0,14,0,0,0,14,0,14,Toscana,ITI1
2021-01-12,COMIRNATY Vaccino a mRNA contro COVID-19,090604,Covid 19 - Ospedale San Luca di  Lucca,TOS,70-79,6,1,0,7,0,0,0,7,0,7,Toscana,ITI1
2021-01-12,COMIRNATY Vaccino a mRNA contro COVID-19,090606,COVID19 - Ospedale San Iacopo,TOS,20-29,6,7,0,8,5,0,0,13,0,13,Toscana,ITI1
2021-01-12,COMIRNATY Vaccino a mRNA contro COVID-19,090606,COVID19 - Ospedale San Iacopo,TOS,30-39,11,9,0,12,8,0,0,20,0,20,Toscana,ITI1
2021-01-12,COMIRNATY Vaccino a mRNA contro COVID-19,090606,COVID19 - Ospedale San Iacopo,TOS,40-49,11,23,0,22,8,4,0,34,0,34,Toscana,ITI1
2021-01-12,COMIRNATY Vaccino a mRNA contro COVID-19,090606,COVID19 - Ospedale San Iacopo,TOS,50-59,22,30,0,30,18,4,0,52,0,52,Toscana,ITI1
2021-01-12,COMIRNATY Vaccino a mRNA contro COVID-19,090606,COVID19 - Ospedale San Iacopo,TOS,60-69,24,17,0,29,8,4,0,41,0,41,Toscana,ITI1
2021-01-12,COMIRNATY Vaccino a mRNA contro COVID-19,090606,COVID19 - Ospedale San Iacopo,TOS,70-79,7,1,0,0,5,3,0,8,0,8,Toscana,ITI1
2021-01-12,COMIRNATY Vaccino a mRNA contro COVID-19,090606,COVID19 - Ospedale San Iacopo,TOS,80-89,0,1,0,0,0,1,0,1,0,1,Toscana,ITI1
2021-01-12,COMIRNATY Vaccino a mRNA contro COVID-19,090607,COVID19 - Ospedale SS.Cosma e Damiano,TOS,20-29,2,4,0,6,0,0,0,6,0,6,Toscana,ITI1
2021-01-12,COMIRNATY Vaccino a mRNA contro COVID-19,090607,COVID19 - Ospedale SS.Cosma e Damiano,TOS,30-39,1,2,0,3,0,0,0,3,0,3,Toscana,ITI1
2021-01-12,COMIRNATY Vaccino a mRNA contro COVID-19,090607,COVID19 - Ospedale SS.Cosma e Damiano,TOS,40-49,3,5,0,8,0,0,0,8,0,8,Toscana,ITI1
2021-01-12,COMIRNATY Vaccino a mRNA contro COVID-19,090607,COVID19 - Ospedale SS.Cosma e Damiano,TOS,50-59,5,14,0,19,0,0,0,19,0,19,Toscana,ITI1
2021-01-12,COMIRNATY Vaccino a mRNA contro COVID-19,090607,COVID19 - Ospedale SS.Cosma e Damiano,TOS,60-69,6,6,0,9,3,0,0,12,0,12,Toscana,ITI1
2021-01-12,COMIRNATY Vaccino a mRNA contro COVID-19,090608,COVID19 - Ospedale Santo Stefano,TOS,16-19,3,0,0,1,2,0,0,3,0,3,Toscana,ITI1
2021-01-12,COMIRNATY Vaccino a mRNA contro COVID-19,090608,COVID19 - Ospedale Santo Stefano,TOS,20-29,4,8,0,7,4,1,0,12,0,12,Toscana,ITI1
2021-01-12,COMIRNATY Vaccino a mRNA contro COVID-19,090608,COVID19 - Ospedale Santo Stefano,TOS,30-39,10,21,0,22,6,3,0,31,0,31,Toscana,ITI1
2021-01-12,COMIRNATY Vaccino a mRNA contro COVID-19,090608,COVID19 - Ospedale Santo Stefano,TOS,40-49,15,15,0,22,3,5,0,30,0,30,Toscana,ITI1
2021-01-12,COMIRNATY Vaccino a mRNA contro COVID-19,090608,COVID19 - Ospedale Santo Stefano,TOS,50-59,16,42,0,47,3,8,0,58,0,58,Toscana,ITI1
2021-01-12,COMIRNATY Vaccino a mRNA contro COVID-19,090608,COVID19 - Ospedale Santo Stefano,TOS,60-69,21,12,0,29,3,1,0,33,0,33,Toscana,ITI1
2021-01-12,COMIRNATY Vaccino a mRNA contro COVID-19,090608,COVID19 - Ospedale Santo Stefano,TOS,70-79,2,4,0,5,1,0,0,6,0,6,Toscana,ITI1
2021-01-12,COMIRNATY Vaccino a mRNA contro COVID-19,090610,Covid 19 - Ospedale F.Lotti di Pontedera,TOS,20-29,1,6,0,7,0,0,0,7,0,7,Toscana,ITI1
2021-01-12,COMIRNATY Vaccino a mRNA contro COVID-19,090610,Covid 19 - Ospedale F.Lotti di Pontedera,TOS,30-39,1,17,0,18,0,0,0,18,0,18,Toscana,ITI1
2021-01-12,COMIRNATY Vaccino a mRNA contro COVID-19,090610,Covid 19 - Ospedale F.Lotti di Pontedera,TOS,40-49,3,10,0,13,0,0,0,13,0,13,Toscana,ITI1
2021-01-12,COMIRNATY Vaccino a mRNA contro COVID-19,090610,Covid 19 - Ospedale F.Lotti di Pontedera,TOS,50-59,3,17,0,20,0,0,0,20,0,20,Toscana,ITI1
2021-01-12,COMIRNATY Vaccino a mRNA contro COVID-19,090610,Covid 19 - Ospedale F.Lotti di Pontedera,TOS,60-69,9,17,0,26,0,0,0,26,0,26,Toscana,ITI1
2021-01-12,COMIRNATY Vaccino a mRNA contro COVID-19,090613,Covid 19 - Ospedali Riuniti di Livorno,TOS,20-29,3,6,1,9,0,0,0,9,0,9,Toscana,ITI1
2021-01-12,COMIRNATY Vaccino a mRNA contro COVID-19,090613,Covid 19 - Ospedali Riuniti di Livorno,TOS,30-39,8,12,1,20,0,0,0,20,0,20,Toscana,ITI1
2021-01-12,COMIRNATY Vaccino a mRNA contro COVID-19,090613,Covid 19 - Ospedali Riuniti di Livorno,TOS,40-49,9,10,1,19,0,0,0,19,0,19,Toscana,ITI1
2021-01-12,COMIRNATY Vaccino a mRNA contro COVID-19,090613,Covid 19 - Ospedali Riuniti di Livorno,TOS,50-59,17,21,1,38,0,0,0,38,0,38,Toscana,ITI1
2021-01-12,COMIRNATY Vaccino a mRNA contro COVID-19,090613,Covid 19 - Ospedali Riuniti di Livorno,TOS,60-69,16,6,1,21,0,0,1,22,0,22,Toscana,ITI1
2021-01-12,COMIRNATY Vaccino a mRNA contro COVID-19,090613,Covid 19 - Ospedali Riuniti di Livorno,TOS,70-79,11,1,1,12,0,0,0,12,0,12,Toscana,ITI1
2021-01-12,COMIRNATY Vaccino a mRNA contro COVID-19,090614,Covid 19 - Ospedale Civile di Piombino,TOS,20-29,1,0,0,1,0,0,0,1,0,1,Toscana,ITI1
2021-01-12,COMIRNATY Vaccino a mRNA contro COVID-19,090614,Covid 19 - Ospedale Civile di Piombino,TOS,30-39,3,3,0,6,0,0,0,6,0,6,Toscana,ITI1
2021-01-12,COMIRNATY Vaccino a mRNA contro COVID-19,090614,Covid 19 - Ospedale Civile di Piombino,TOS,40-49,1,2,0,3,0,0,0,3,0,3,Toscana,ITI1
2021-01-12,COMIRNATY Vaccino a mRNA contro COVID-19,090614,Covid 19 - Ospedale Civile di Piombino,TOS,50-59,2,12,0,14,0,0,0,14,0,14,Toscana,ITI1
2021-01-12,COMIRNATY Vaccino a mRNA contro COVID-19,090614,Covid 19 - Ospedale Civile di Piombino,TOS,60-69,3,3,0,6,0,0,0,6,0,6,Toscana,ITI1
2021-01-12,COMIRNATY Vaccino a mRNA contro COVID-19,090618,COVID19 - Ospedale del Bibbiena,TOS,30-39,0,1,0,1,0,0,0,1,0,1,Toscana,ITI1
2021-01-12,COMIRNATY Vaccino a mRNA contro COVID-19,090618,COVID19 - Ospedale del Bibbiena,TOS,40-49,1,2,0,3,0,0,0,3,0,3,Toscana,ITI1
2021-01-12,COMIRNATY Vaccino a mRNA contro COVID-19,090618,COVID19 - Ospedale del Bibbiena,TOS,50-59,0,1,0,1,0,0,0,1,0,1,Toscana,ITI1
2021-01-12,COMIRNATY Vaccino a mRNA contro COVID-19,090618,COVID19 - Ospedale del Bibbiena,TOS,60-69,0,1,0,1,0,0,0,1,0,1,Toscana,ITI1
2021-01-12,COMIRNATY Vaccino a mRNA contro COVID-19,090621,COVID19 - Ospedale di Arezzo,TOS,20-29,11,44,0,55,0,0,0,55,0,55,Toscana,ITI1
2021-01-12,COMIRNATY Vaccino a mRNA contro COVID-19,090621,COVID19 - Ospedale di Arezzo,TOS,30-39,11,25,0,36,0,0,0,36,0,36,Toscana,ITI1
2021-01-12,COMIRNATY Vaccino a mRNA contro COVID-19,090621,COVID19 - Ospedale di Arezzo,TOS,40-49,10,59,0,65,4,0,0,69,0,69,Toscana,ITI1
2021-01-12,COMIRNATY Vaccino a mRNA contro COVID-19,090621,COVID19 - Ospedale di Arezzo,TOS,50-59,19,56,0,72,3,0,0,75,0,75,Toscana,ITI1
2021-01-12,COMIRNATY Vaccino a mRNA contro COVID-19,090621,COVID19 - Ospedale di Arezzo,TOS,60-69,33,26,0,58,1,0,0,59,0,59,Toscana,ITI1
2021-01-12,COMIRNATY Vaccino a mRNA contro COVID-19,090626,COVID19 - Ospedale di Grosseto,TOS,16-19,1,1,0,2,0,0,0,2,0,2,Toscana,ITI1
2021-01-12,COMIRNATY Vaccino a mRNA contro COVID-19,090626,COVID19 - Ospedale di Grosseto,TOS,20-29,7,8,0,15,0,0,0,15,0,15,Toscana,ITI1
2021-01-12,COMIRNATY Vaccino a mRNA contro COVID-19,090626,COVID19 - Ospedale di Grosseto,TOS,30-39,13,13,0,26,0,0,0,26,0,26,Toscana,ITI1
2021-01-12,COMIRNATY Vaccino a mRNA contro COVID-19,090626,COVID19 - Ospedale di Grosseto,TOS,40-49,13,24,0,37,0,0,0,37,0,37,Toscana,ITI1
2021-01-12,COMIRNATY Vaccino a mRNA contro COVID-19,090626,COVID19 - Ospedale di Grosseto,TOS,50-59,21,21,0,42,0,0,0,42,0,42,Toscana,ITI1
2021-01-12,COMIRNATY Vaccino a mRNA contro COVID-19,090626,COVID19 - Ospedale di Grosseto,TOS,60-69,16,16,0,32,0,0,0,32,0,32,Toscana,ITI1
2021-01-12,COMIRNATY Vaccino a mRNA contro COVID-19,090626,COVID19 - Ospedale di Grosseto,TOS,70-79,6,1,0,7,0,0,0,7,0,7,Toscana,ITI1
2021-01-12,COMIRNATY Vaccino a mRNA contro COVID-19,090626,COVID19 - Ospedale di Grosseto,TOS,80-89,1,0,0,1,0,0,0,1,0,1,Toscana,ITI1
2021-01-12,COMIRNATY Vaccino a mRNA contro COVID-19,090627,COVID19 - Ospedale Mugello,TOS,20-29,1,5,0,6,0,0,0,6,0,6,Toscana,ITI1
2021-01-12,COMIRNATY Vaccino a mRNA contro COVID-19,090627,COVID19 - Ospedale Mugello,TOS,30-39,0,5,0,5,0,0,0,5,0,5,Toscana,ITI1
2021-01-12,COMIRNATY Vaccino a mRNA contro COVID-19,090627,COVID19 - Ospedale Mugello,TOS,40-49,2,4,0,4,2,0,0,6,0,6,Toscana,ITI1
2021-01-12,COMIRNATY Vaccino a mRNA contro COVID-19,090627,COVID19 - Ospedale Mugello,TOS,50-59,5,18,0,16,7,0,0,23,0,23,Toscana,ITI1
2021-01-12,COMIRNATY Vaccino a mRNA contro COVID-19,090627,COVID19 - Ospedale Mugello,TOS,60-69,4,4,0,7,1,0,0,8,0,8,Toscana,ITI1
2021-01-12,COMIRNATY Vaccino a mRNA contro COVID-19,090629,COVID19 - Ospedale SS. Maria Annunziata,TOS,16-19,0,1,0,1,0,0,0,1,0,1,Toscana,ITI1
2021-01-12,COMIRNATY Vaccino a mRNA contro COVID-19,090629,COVID19 - Ospedale SS. Maria Annunziata,TOS,20-29,6,4,0,10,0,0,0,10,0,10,Toscana,ITI1
2021-01-12,COMIRNATY Vaccino a mRNA contro COVID-19,090629,COVID19 - Ospedale SS. Maria Annunziata,TOS,30-39,17,9,0,25,1,0,0,26,0,26,Toscana,ITI1
2021-01-12,COMIRNATY Vaccino a mRNA contro COVID-19,090629,COVID19 - Ospedale SS. Maria Annunziata,TOS,40-49,10,19,0,26,3,0,0,29,0,29,Toscana,ITI1
2021-01-12,COMIRNATY Vaccino a mRNA contro COVID-19,090629,COVID19 - Ospedale SS. Maria Annunziata,TOS,50-59,15,30,0,40,5,0,0,45,0,45,Toscana,ITI1
2021-01-12,COMIRNATY Vaccino a mRNA contro COVID-19,090629,COVID19 - Ospedale SS. Maria Annunziata,TOS,60-69,19,12,0,30,1,0,0,31,0,31,Toscana,ITI1
2021-01-12,COMIRNATY Vaccino a mRNA contro COVID-19,090629,COVID19 - Ospedale SS. Maria Annunziata,TOS,70-79,5,0,0,5,0,0,0,5,0,5,Toscana,ITI1
2021-01-12,COMIRNATY Vaccino a mRNA contro COVID-19,090629,COVID19 - Ospedale SS. Maria Annunziata,TOS,80-89,0,1,0,1,0,0,0,1,0,1,Toscana,ITI1
2021-01-12,COMIRNATY Vaccino a mRNA contro COVID-19,090632,COVID19 - Ospedale Santa Maria Nuova,TOS,16-19,2,0,0,2,0,0,0,2,0,2,Toscana,ITI1
2021-01-12,COMIRNATY Vaccino a mRNA contro COVID-19,090632,COVID19 - Ospedale Santa Maria Nuova,TOS,20-29,3,3,0,6,0,0,0,6,0,6,Toscana,ITI1
2021-01-12,COMIRNATY Vaccino a mRNA contro COVID-19,090632,COVID19 - Ospedale Santa Maria Nuova,TOS,30-39,7,8,0,15,0,0,0,15,0,15,Toscana,ITI1
2021-01-12,COMIRNATY Vaccino a mRNA contro COVID-19,090632,COVID19 - Ospedale Santa Maria Nuova,TOS,40-49,10,7,0,17,0,0,0,17,0,17,Toscana,ITI1
2021-01-12,COMIRNATY Vaccino a mRNA contro COVID-19,090632,COVID19 - Ospedale Santa Maria Nuova,TOS,50-59,8,15,0,23,0,0,0,23,0,23,Toscana,ITI1
2021-01-12,COMIRNATY Vaccino a mRNA contro COVID-19,090632,COVID19 - Ospedale Santa Maria Nuova,TOS,60-69,22,12,0,34,0,0,0,34,0,34,Toscana,ITI1
2021-01-12,COMIRNATY Vaccino a mRNA contro COVID-19,090632,COVID19 - Ospedale Santa Maria Nuova,TOS,70-79,3,1,0,4,0,0,0,4,0,4,Toscana,ITI1
2021-01-12,COMIRNATY Vaccino a mRNA contro COVID-19,090632,COVID19 - Ospedale Santa Maria Nuova,TOS,80-89,1,0,0,1,0,0,0,1,0,1,Toscana,ITI1
2021-01-12,COMIRNATY Vaccino a mRNA contro COVID-19,090640,Covid 19 - Ospedale Unico Versilia,TOS,20-29,4,9,0,13,0,0,0,13,0,13,Toscana,ITI1
2021-01-12,COMIRNATY Vaccino a mRNA contro COVID-19,090640,Covid 19 - Ospedale Unico Versilia,TOS,30-39,6,8,0,13,1,0,0,14,0,14,Toscana,ITI1
2021-01-12,COMIRNATY Vaccino a mRNA contro COVID-19,090640,Covid 19 - Ospedale Unico Versilia,TOS,40-49,11,10,0,20,1,0,0,21,0,21,Toscana,ITI1
2021-01-12,COMIRNATY Vaccino a mRNA contro COVID-19,090640,Covid 19 - Ospedale Unico Versilia,TOS,50-59,6,19,0,23,2,0,0,25,0,25,Toscana,ITI1
2021-01-12,COMIRNATY Vaccino a mRNA contro COVID-19,090640,Covid 19 - Ospedale Unico Versilia,TOS,60-69,14,7,0,21,0,0,0,21,0,21,Toscana,ITI1
2021-01-12,COMIRNATY Vaccino a mRNA contro COVID-19,090640,Covid 19 - Ospedale Unico Versilia,TOS,70-79,3,4,0,4,0,3,0,7,0,7,Toscana,ITI1
2021-01-12,COMIRNATY Vaccino a mRNA contro COVID-19,090640,Covid 19 - Ospedale Unico Versilia,TOS,80-89,1,1,0,0,0,2,0,2,0,2,Toscana,ITI1
2021-01-12,COMIRNATY Vaccino a mRNA contro COVID-19,090640,Covid 19 - Ospedale Unico Versilia,TOS,90+,1,5,0,0,0,6,0,6,0,6,Toscana,ITI1
2021-01-12,COMIRNATY Vaccino a mRNA contro COVID-19,090641,COVID19 - Ospedale La Gruccia Montevarchi,TOS,16-19,0,1,0,1,0,0,0,1,0,1,Toscana,ITI1
2021-01-12,COMIRNATY Vaccino a mRNA contro COVID-19,090641,COVID19 - Ospedale La Gruccia Montevarchi,TOS,20-29,5,8,0,13,0,0,0,13,0,13,Toscana,ITI1
2021-01-12,COMIRNATY Vaccino a mRNA contro COVID-19,090641,COVID19 - Ospedale La Gruccia Montevarchi,TOS,30-39,7,10,0,17,0,0,0,17,0,17,Toscana,ITI1
2021-01-12,COMIRNATY Vaccino a mRNA contro COVID-19,090641,COVID19 - Ospedale La Gruccia Montevarchi,TOS,40-49,6,10,0,16,0,0,0,16,0,16,Toscana,ITI1
2021-01-12,COMIRNATY Vaccino a mRNA contro COVID-19,090641,COVID19 - Ospedale La Gruccia Montevarchi,TOS,50-59,5,28,0,33,0,0,0,33,0,33,Toscana,ITI1
2021-01-12,COMIRNATY Vaccino a mRNA contro COVID-19,090641,COVID19 - Ospedale La Gruccia Montevarchi,TOS,60-69,10,6,0,16,0,0,0,16,0,16,Toscana,ITI1
2021-01-12,COMIRNATY Vaccino a mRNA contro COVID-19,090901,COVID19 - AOU Pisana,TOS,16-19,0,1,0,1,0,0,0,1,0,1,Toscana,ITI1
2021-01-12,COMIRNATY Vaccino a mRNA contro COVID-19,090901,COVID19 - AOU Pisana,TOS,20-29,13,17,0,29,1,0,0,30,0,30,Toscana,ITI1
2021-01-12,COMIRNATY Vaccino a mRNA contro COVID-19,090901,COVID19 - AOU Pisana,TOS,30-39,10,11,0,20,1,0,0,21,0,21,Toscana,ITI1
2021-01-12,COMIRNATY Vaccino a mRNA contro COVID-19,090901,COVID19 - AOU Pisana,TOS,40-49,10,13,0,20,3,0,0,23,0,23,Toscana,ITI1
2021-01-12,COMIRNATY Vaccino a mRNA contro COVID-19,090901,COVID19 - AOU Pisana,TOS,50-59,11,15,0,24,2,0,0,26,0,26,Toscana,ITI1
2021-01-12,COMIRNATY Vaccino a mRNA contro COVID-19,090901,COVID19 - AOU Pisana,TOS,60-69,7,5,0,9,3,0,0,12,0,12,Toscana,ITI1
2021-01-12,COMIRNATY Vaccino a mRNA contro COVID-19,090901,COVID19 - AOU Pisana,TOS,70-79,1,0,0,1,0,0,0,1,0,1,Toscana,ITI1
2021-01-12,COMIRNATY Vaccino a mRNA contro COVID-19,090902,COVID19 - AOU Senese,TOS,16-19,2,3,0,3,2,0,0,5,0,5,Toscana,ITI1
2021-01-12,COMIRNATY Vaccino a mRNA contro COVID-19,090902,COVID19 - AOU Senese,TOS,20-29,63,144,0,184,23,0,0,207,0,207,Toscana,ITI1
2021-01-12,COMIRNATY Vaccino a mRNA contro COVID-19,090902,COVID19 - AOU Senese,TOS,30-39,20,18,0,38,0,0,0,38,0,38,Toscana,ITI1
2021-01-12,COMIRNATY Vaccino a mRNA contro COVID-19,090902,COVID19 - AOU Senese,TOS,40-49,10,25,0,35,0,0,0,35,0,35,Toscana,ITI1
2021-01-12,COMIRNATY Vaccino a mRNA contro COVID-19,090902,COVID19 - AOU Senese,TOS,50-59,16,42,0,57,1,0,0,58,0,58,Toscana,ITI1
2021-01-12,COMIRNATY Vaccino a mRNA contro COVID-19,090902,COVID19 - AOU Senese,TOS,60-69,15,13,0,27,1,0,0,28,0,28,Toscana,ITI1
2021-01-12,COMIRNATY Vaccino a mRNA contro COVID-19,090902,COVID19 - AOU Senese,TOS,70-79,4,1,0,5,0,0,0,5,0,5,Toscana,ITI1
2021-01-12,COMIRNATY Vaccino a mRNA contro COVID-19,090903,COVID19 - AOU Careggi - CTO,TOS,16-19,1,3,0,3,1,0,0,4,0,4,Toscana,ITI1
2021-01-12,COMIRNATY Vaccino a mRNA contro COVID-19,090903,COVID19 - AOU Careggi - CTO,TOS,20-29,41,66,0,95,11,1,0,107,0,107,Toscana,ITI1
2021-01-12,COMIRNATY Vaccino a mRNA contro COVID-19,090903,COVID19 - AOU Careggi - CTO,TOS,30-39,22,32,0,49,5,0,0,54,0,54,Toscana,ITI1
2021-01-12,COMIRNATY Vaccino a mRNA contro COVID-19,090903,COVID19 - AOU Careggi - CTO,TOS,40-49,18,44,0,50,11,1,0,62,0,62,Toscana,ITI1
2021-01-12,COMIRNATY Vaccino a mRNA contro COVID-19,090903,COVID19 - AOU Careggi - CTO,TOS,50-59,31,63,0,77,17,0,0,94,0,94,Toscana,ITI1
2021-01-12,COMIRNATY Vaccino a mRNA contro COVID-19,090903,COVID19 - AOU Careggi - CTO,TOS,60-69,22,22,0,32,12,0,0,44,0,44,Toscana,ITI1
2021-01-12,COMIRNATY Vaccino a mRNA contro COVID-19,090903,COVID19 - AOU Careggi - CTO,TOS,70-79,10,1,0,5,6,0,0,11,0,11,Toscana,ITI1
2021-01-12,COMIRNATY Vaccino a mRNA contro COVID-19,090903,COVID19 - AOU Careggi - PIASTRA,TOS,20-29,11,14,0,25,0,0,0,25,0,25,Toscana,ITI1
2021-01-12,COMIRNATY Vaccino a mRNA contro COVID-19,090903,COVID19 - AOU Careggi - PIASTRA,TOS,30-39,8,7,0,15,0,0,0,15,0,15,Toscana,ITI1
2021-01-12,COMIRNATY Vaccino a mRNA contro COVID-19,090903,COVID19 - AOU Careggi - PIASTRA,TOS,40-49,3,5,0,8,0,0,0,8,0,8,Toscana,ITI1
2021-01-12,COMIRNATY Vaccino a mRNA contro COVID-19,090903,COVID19 - AOU Careggi - PIASTRA,TOS,50-59,7,13,0,20,0,0,0,20,0,20,Toscana,ITI1
2021-01-12,COMIRNATY Vaccino a mRNA contro COVID-19,090903,COVID19 - AOU Careggi - PIASTRA,TOS,60-69,7,6,0,13,0,0,0,13,0,13,Toscana,ITI1
2021-01-12,COMIRNATY Vaccino a mRNA contro COVID-19,090903,COVID19 - AOU Careggi - PIASTRA,TOS,70-79,3,0,0,3,0,0,0,3,0,3,Toscana,ITI1
2021-01-12,COMIRNATY Vaccino a mRNA contro COVID-19,090904,COVID19 - Ospedale AOU Meyer,TOS,16-19,1,1,0,2,0,0,0,2,0,2,Toscana,ITI1
2021-01-12,COMIRNATY Vaccino a mRNA contro COVID-19,090904,COVID19 - Ospedale AOU Meyer,TOS,20-29,9,4,0,11,2,0,0,13,0,13,Toscana,ITI1
2021-01-12,COMIRNATY Vaccino a mRNA contro COVID-19,090904,COVID19 - Ospedale AOU Meyer,TOS,30-39,7,12,0,19,0,0,0,19,0,19,Toscana,ITI1
2021-01-12,COMIRNATY Vaccino a mRNA contro COVID-19,090904,COVID19 - Ospedale AOU Meyer,TOS,40-49,8,8,0,16,0,0,0,16,0,16,Toscana,ITI1
2021-01-12,COMIRNATY Vaccino a mRNA contro COVID-19,090904,COVID19 - Ospedale AOU Meyer,TOS,50-59,6,7,0,12,0,1,0,13,0,13,Toscana,ITI1
2021-01-12,COMIRNATY Vaccino a mRNA contro COVID-19,090904,COVID19 - Ospedale AOU Meyer,TOS,60-69,7,2,0,9,0,0,0,9,0,9,Toscana,ITI1
2021-01-12,COMIRNATY Vaccino a mRNA contro COVID-19,11012E,COVID19 - Ospedale San Giuseppe,TOS,16-19,1,0,0,1,0,0,0,1,0,1,Toscana,ITI1
2021-01-12,COMIRNATY Vaccino a mRNA contro COVID-19,11012E,COVID19 - Ospedale San Giuseppe,TOS,20-29,3,9,0,7,5,0,0,12,0,12,Toscana,ITI1
2021-01-12,COMIRNATY Vaccino a mRNA contro COVID-19,11012E,COVID19 - Ospedale San Giuseppe,TOS,30-39,9,17,0,19,7,0,0,26,0,26,Toscana,ITI1
2021-01-12,COMIRNATY Vaccino a mRNA contro COVID-19,11012E,COVID19 - Ospedale San Giuseppe,TOS,40-49,11,18,0,20,9,0,0,29,0,29,Toscana,ITI1
2021-01-12,COMIRNATY Vaccino a mRNA contro COVID-19,11012E,COVID19 - Ospedale San Giuseppe,TOS,50-59,8,29,0,25,12,0,0,37,0,37,Toscana,ITI1
2021-01-12,COMIRNATY Vaccino a mRNA contro COVID-19,11012E,COVID19 - Ospedale San Giuseppe,TOS,60-69,23,10,0,28,5,0,0,33,0,33,Toscana,ITI1
2021-01-12,COMIRNATY Vaccino a mRNA contro COVID-19,121P4I,R.S.A. MADONNA DELLA FIDUCIA,TOS,30-39,2,0,0,1,0,1,0,2,0,2,Toscana,ITI1
2021-01-12,COMIRNATY Vaccino a mRNA contro COVID-19,121P4I,R.S.A. MADONNA DELLA FIDUCIA,TOS,40-49,1,0,0,1,0,0,0,1,0,1,Toscana,ITI1
2021-01-12,COMIRNATY Vaccino a mRNA contro COVID-19,121P4I,R.S.A. MADONNA DELLA FIDUCIA,TOS,70-79,0,2,0,0,0,2,0,2,0,2,Toscana,ITI1
2021-01-12,COMIRNATY Vaccino a mRNA contro COVID-19,121P4I,R.S.A. MADONNA DELLA FIDUCIA,TOS,80-89,0,4,0,0,0,4,0,4,0,4,Toscana,ITI1
2021-01-12,COMIRNATY Vaccino a mRNA contro COVID-19,121P4I,R.S.A. MADONNA DELLA FIDUCIA,TOS,90+,0,3,0,0,0,3,0,3,0,3,Toscana,ITI1
2021-01-12,COMIRNATY Vaccino a mRNA contro COVID-19,13021A,COVID19 - Ospedale S.Giovanni di Dio,TOS,20-29,8,16,0,16,7,1,0,24,0,24,Toscana,ITI1
2021-01-12,COMIRNATY Vaccino a mRNA contro COVID-19,13021A,COVID19 - Ospedale S.Giovanni di Dio,TOS,30-39,16,21,0,28,8,1,0,37,0,37,Toscana,ITI1
2021-01-12,COMIRNATY Vaccino a mRNA contro COVID-19,13021A,COVID19 - Ospedale S.Giovanni di Dio,TOS,40-49,15,23,0,26,5,7,0,38,0,38,Toscana,ITI1
2021-01-12,COMIRNATY Vaccino a mRNA contro COVID-19,13021A,COVID19 - Ospedale S.Giovanni di Dio,TOS,50-59,26,27,0,35,5,13,0,53,0,53,Toscana,ITI1
2021-01-12,COMIRNATY Vaccino a mRNA contro COVID-19,13021A,COVID19 - Ospedale S.Giovanni di Dio,TOS,60-69,29,14,0,29,5,9,0,43,0,43,Toscana,ITI1
2021-01-12,COMIRNATY Vaccino a mRNA contro COVID-19,13021A,COVID19 - Ospedale S.Giovanni di Dio,TOS,70-79,8,8,0,6,3,7,0,16,0,16,Toscana,ITI1
2021-01-12,COMIRNATY Vaccino a mRNA contro COVID-19,13021A,COVID19 - Ospedale S.Giovanni di Dio,TOS,80-89,2,5,0,1,0,6,0,7,0,7,Toscana,ITI1
2021-01-12,COMIRNATY Vaccino a mRNA contro COVID-19,13021A,COVID19 - Ospedale S.Giovanni di Dio,TOS,90+,5,6,0,0,0,11,0,11,0,11,Toscana,ITI1
2021-01-12,COMIRNATY Vaccino a mRNA contro COVID-19,13304I,Covid19 - RSA VILLA SERENA - COMANO,TOS,20-29,0,1,0,1,0,0,0,1,0,1,Toscana,ITI1
2021-01-12,COMIRNATY Vaccino a mRNA contro COVID-19,13304I,Covid19 - RSA VILLA SERENA - COMANO,TOS,50-59,0,1,0,1,0,0,0,1,0,1,Toscana,ITI1
2021-01-12,COMIRNATY Vaccino a mRNA contro COVID-19,13304I,Covid19 - RSA VILLA SERENA - COMANO,TOS,60-69,2,0,0,2,0,0,0,2,0,2,Toscana,ITI1
2021-01-12,COMIRNATY Vaccino a mRNA contro COVID-19,13304I,Covid19 - RSA VILLA SERENA - COMANO,TOS,90+,0,2,0,0,0,2,0,2,0,2,Toscana,ITI1
2021-01-12,COMIRNATY Vaccino a mRNA contro COVID-19,16121A,Covid 19 - Ospedale Civile di Cecina,TOS,20-29,0,2,0,2,0,0,0,2,0,2,Toscana,ITI1
2021-01-12,COMIRNATY Vaccino a mRNA contro COVID-19,16121A,Covid 19 - Ospedale Civile di Cecina,TOS,30-39,0,2,0,2,0,0,0,2,0,2,Toscana,ITI1
2021-01-12,COMIRNATY Vaccino a mRNA contro COVID-19,16121A,Covid 19 - Ospedale Civile di Cecina,TOS,40-49,0,7,0,7,0,0,0,7,0,7,Toscana,ITI1
2021-01-12,COMIRNATY Vaccino a mRNA contro COVID-19,16121A,Covid 19 - Ospedale Civile di Cecina,TOS,50-59,5,8,0,13,0,0,0,13,0,13,Toscana,ITI1
2021-01-12,COMIRNATY Vaccino a mRNA contro COVID-19,16121A,Covid 19 - Ospedale Civile di Cecina,TOS,60-69,2,4,0,6,0,0,0,6,0,6,Toscana,ITI1
2021-01-12,COMIRNATY Vaccino a mRNA contro COVID-19,40911A,COVID19 - Dip. Prevenzione Ruffolo Siena,TOS,20-29,0,3,0,3,0,0,0,3,0,3,Toscana,ITI1
2021-01-12,COMIRNATY Vaccino a mRNA contro COVID-19,40911A,COVID19 - Dip. Prevenzione Ruffolo Siena,TOS,30-39,4,2,0,6,0,0,0,6,0,6,Toscana,ITI1
2021-01-12,COMIRNATY Vaccino a mRNA contro COVID-19,40911A,COVID19 - Dip. Prevenzione Ruffolo Siena,TOS,40-49,2,4,0,6,0,0,0,6,0,6,Toscana,ITI1
2021-01-12,COMIRNATY Vaccino a mRNA contro COVID-19,40911A,COVID19 - Dip. Prevenzione Ruffolo Siena,TOS,50-59,2,12,0,14,0,0,0,14,0,14,Toscana,ITI1
2021-01-12,COMIRNATY Vaccino a mRNA contro COVID-19,40911A,COVID19 - Dip. Prevenzione Ruffolo Siena,TOS,60-69,7,9,0,16,0,0,0,16,0,16,Toscana,ITI1
2021-01-12,COMIRNATY Vaccino a mRNA contro COVID-19,46814I,CASA DI RIPOSO S.M.MADDALENA,TOS,40-49,0,1,0,0,0,1,0,1,0,1,Toscana,ITI1
2021-01-12,COMIRNATY Vaccino a mRNA contro COVID-19,46814I,CASA DI RIPOSO S.M.MADDALENA,TOS,50-59,0,3,0,3,0,0,0,3,0,3,Toscana,ITI1
2021-01-12,COMIRNATY Vaccino a mRNA contro COVID-19,46814I,CASA DI RIPOSO S.M.MADDALENA,TOS,60-69,1,1,0,0,0,2,0,2,0,2,Toscana,ITI1
2021-01-12,COMIRNATY Vaccino a mRNA contro COVID-19,46814I,CASA DI RIPOSO S.M.MADDALENA,TOS,70-79,1,4,0,0,0,5,0,5,0,5,Toscana,ITI1
2021-01-12,COMIRNATY Vaccino a mRNA contro COVID-19,46814I,CASA DI RIPOSO S.M.MADDALENA,TOS,80-89,7,24,0,0,0,31,0,31,0,31,Toscana,ITI1
2021-01-12,COMIRNATY Vaccino a mRNA contro COVID-19,46814I,CASA DI RIPOSO S.M.MADDALENA,TOS,90+,3,21,0,0,0,24,0,24,0,24,Toscana,ITI1
2021-01-12,COMIRNATY Vaccino a mRNA contro COVID-19,46824I,R.S.A. CAMPANSI,TOS,60-69,2,0,0,0,0,2,0,2,0,2,Toscana,ITI1
2021-01-12,COMIRNATY Vaccino a mRNA contro COVID-19,46824I,R.S.A. CAMPANSI,TOS,70-79,2,5,0,0,0,7,0,7,0,7,Toscana,ITI1
2021-01-12,COMIRNATY Vaccino a mRNA contro COVID-19,46824I,R.S.A. CAMPANSI,TOS,80-89,1,13,0,0,0,14,0,14,0,14,Toscana,ITI1
2021-01-12,COMIRNATY Vaccino a mRNA contro COVID-19,46824I,R.S.A. CAMPANSI,TOS,90+,4,18,0,0,0,22,0,22,0,22,Toscana,ITI1
2021-01-12,COMIRNATY Vaccino a mRNA contro COVID-19,48624L,RSD SANTA PETRONILLA,TOS,20-29,0,1,0,0,0,1,0,1,0,1,Toscana,ITI1
2021-01-12,COMIRNATY Vaccino a mRNA contro COVID-19,48624L,RSD SANTA PETRONILLA,TOS,40-49,5,2,0,0,0,7,0,7,0,7,Toscana,ITI1
2021-01-12,COMIRNATY Vaccino a mRNA contro COVID-19,48624L,RSD SANTA PETRONILLA,TOS,50-59,7,1,0,0,0,8,0,8,0,8,Toscana,ITI1
2021-01-12,COMIRNATY Vaccino a mRNA contro COVID-19,48624L,RSD SANTA PETRONILLA,TOS,60-69,1,2,0,0,0,3,0,3,0,3,Toscana,ITI1
2021-01-12,COMIRNATY Vaccino a mRNA contro COVID-19,48624L,RSD SANTA PETRONILLA,TOS,80-89,0,1,0,0,0,1,0,1,0,1,Toscana,ITI1
2021-01-12,COMIRNATY Vaccino a mRNA contro COVID-19,70154I,IST.MONSIGNOR OLINTO FEDI,TOS,30-39,1,0,0,1,0,0,0,1,0,1,Toscana,ITI1
2021-01-12,COMIRNATY Vaccino a mRNA contro COVID-19,70154I,IST.MONSIGNOR OLINTO FEDI,TOS,50-59,0,1,0,1,0,0,0,1,0,1,Toscana,ITI1
2021-01-12,COMIRNATY Vaccino a mRNA contro COVID-19,70154I,IST.MONSIGNOR OLINTO FEDI,TOS,80-89,1,1,0,0,0,2,0,2,0,2,Toscana,ITI1
2021-01-12,COMIRNATY Vaccino a mRNA contro COVID-19,70154I,IST.MONSIGNOR OLINTO FEDI,TOS,90+,1,5,0,0,0,6,0,6,0,6,Toscana,ITI1
2021-01-12,COMIRNATY Vaccino a mRNA contro COVID-19,70164I,SERENI ORIZZONTI 1 SPA EX VILL - SIGNA,TOS,70-79,0,1,0,0,0,1,0,1,0,1,Toscana,ITI1
2021-01-12,COMIRNATY Vaccino a mRNA contro COVID-19,70234I,VILLA SERENA SIGNA,TOS,20-29,0,1,0,1,0,0,0,1,0,1,Toscana,ITI1
2021-01-12,COMIRNATY Vaccino a mRNA contro COVID-19,70234I,VILLA SERENA SIGNA,TOS,40-49,0,1,0,1,0,0,0,1,0,1,Toscana,ITI1
2021-01-12,COMIRNATY Vaccino a mRNA contro COVID-19,70234I,VILLA SERENA SIGNA,TOS,50-59,0,2,0,0,0,2,0,2,0,2,Toscana,ITI1
2021-01-12,COMIRNATY Vaccino a mRNA contro COVID-19,70234I,VILLA SERENA SIGNA,TOS,60-69,0,3,0,0,0,3,0,3,0,3,Toscana,ITI1
2021-01-12,COMIRNATY Vaccino a mRNA contro COVID-19,70234I,VILLA SERENA SIGNA,TOS,70-79,0,1,0,0,0,1,0,1,0,1,Toscana,ITI1
2021-01-12,COMIRNATY Vaccino a mRNA contro COVID-19,70234I,VILLA SERENA SIGNA,TOS,90+,0,1,0,0,0,1,0,1,0,1,Toscana,ITI1
2021-01-12,COMIRNATY Vaccino a mRNA contro COVID-19,70284I,SOGGIORNO ANGELICA,TOS,80-89,0,1,0,0,0,1,0,1,0,1,Toscana,ITI1
2021-01-12,COMIRNATY Vaccino a mRNA contro COVID-19,70284I,SOGGIORNO ANGELICA,TOS,90+,0,2,0,0,0,2,0,2,0,2,Toscana,ITI1
2021-01-12,COMIRNATY Vaccino a mRNA contro COVID-19,80014I,PIO IST.S.CATERINA DE'RICCI RE,TOS,20-29,0,1,0,1,0,0,0,1,0,1,Toscana,ITI1
2021-01-12,COMIRNATY Vaccino a mRNA contro COVID-19,80014I,PIO IST.S.CATERINA DE'RICCI RE,TOS,40-49,2,9,0,11,0,0,0,11,0,11,Toscana,ITI1
2021-01-12,COMIRNATY Vaccino a mRNA contro COVID-19,80014I,PIO IST.S.CATERINA DE'RICCI RE,TOS,50-59,0,9,0,8,0,1,0,9,0,9,Toscana,ITI1
2021-01-12,COMIRNATY Vaccino a mRNA contro COVID-19,80014I,PIO IST.S.CATERINA DE'RICCI RE,TOS,60-69,1,2,0,3,0,0,0,3,0,3,Toscana,ITI1
2021-01-12,COMIRNATY Vaccino a mRNA contro COVID-19,80034I,CASA SANTA MARIA DELLA PIETA',TOS,50-59,0,3,0,3,0,0,0,3,0,3,Toscana,ITI1
2021-01-12,COMIRNATY Vaccino a mRNA contro COVID-19,80034I,CASA SANTA MARIA DELLA PIETA',TOS,80-89,0,3,0,1,0,2,0,3,0,3,Toscana,ITI1
2021-01-12,COMIRNATY Vaccino a mRNA contro COVID-19,80284I,DELFINO RESIDENZE SRL(VILLA PO,TOS,30-39,0,1,0,1,0,0,0,1,0,1,Toscana,ITI1
2021-01-12,COMIRNATY Vaccino a mRNA contro COVID-19,80284I,DELFINO RESIDENZE SRL(VILLA PO,TOS,40-49,1,1,0,1,0,1,0,2,0,2,Toscana,ITI1
2021-01-12,COMIRNATY Vaccino a mRNA contro COVID-19,80284I,DELFINO RESIDENZE SRL(VILLA PO,TOS,50-59,1,2,0,2,0,1,0,3,0,3,Toscana,ITI1
2021-01-12,COMIRNATY Vaccino a mRNA contro COVID-19,80284I,DELFINO RESIDENZE SRL(VILLA PO,TOS,60-69,0,1,0,0,0,1,0,1,0,1,Toscana,ITI1
2021-01-12,COMIRNATY Vaccino a mRNA contro COVID-19,80284I,DELFINO RESIDENZE SRL(VILLA PO,TOS,70-79,4,1,0,0,0,5,0,5,0,5,Toscana,ITI1
2021-01-12,COMIRNATY Vaccino a mRNA contro COVID-19,80284I,DELFINO RESIDENZE SRL(VILLA PO,TOS,80-89,5,10,0,0,0,15,0,15,0,15,Toscana,ITI1
2021-01-12,COMIRNATY Vaccino a mRNA contro COVID-19,80284I,DELFINO RESIDENZE SRL(VILLA PO,TOS,90+,2,13,0,0,0,15,0,15,0,15,Toscana,ITI1
2021-01-12,COMIRNATY Vaccino a mRNA contro COVID-19,ND,RSA Villa Serena,TOS,20-29,0,1,0,1,0,0,0,1,0,1,Toscana,ITI1
2021-01-12,COMIRNATY Vaccino a mRNA contro COVID-19,ND,RSA Villa Serena,TOS,40-49,0,1,0,1,0,0,0,1,0,1,Toscana,ITI1
2021-01-12,COMIRNATY Vaccino a mRNA contro COVID-19,ND,RSA Villa Serena,TOS,70-79,1,2,0,0,0,3,0,3,0,3,Toscana,ITI1
2021-01-12,COMIRNATY Vaccino a mRNA contro COVID-19,ND,RSA Villa Serena,TOS,80-89,0,5,0,0,0,5,0,5,0,5,Toscana,ITI1
2021-01-12,COMIRNATY Vaccino a mRNA contro COVID-19,ND,RSA Villa Serena,TOS,90+,2,10,0,0,0,12,0,12,0,12,Toscana,ITI1
2021-01-12,COMIRNATY Vaccino a mRNA contro COVID-19,P0074M,R.S.A LE VELE S. GIULIANO TERME,TOS,20-29,2,2,0,0,0,4,0,4,0,4,Toscana,ITI1
2021-01-12,COMIRNATY Vaccino a mRNA contro COVID-19,P0074M,R.S.A LE VELE S. GIULIANO TERME,TOS,30-39,6,1,0,1,0,6,0,7,0,7,Toscana,ITI1
2021-01-12,COMIRNATY Vaccino a mRNA contro COVID-19,P0074M,R.S.A LE VELE S. GIULIANO TERME,TOS,40-49,3,2,0,1,0,4,0,5,0,5,Toscana,ITI1
2021-01-12,COMIRNATY Vaccino a mRNA contro COVID-19,P0074M,R.S.A LE VELE S. GIULIANO TERME,TOS,50-59,5,6,0,0,0,11,0,11,0,11,Toscana,ITI1
2021-01-12,COMIRNATY Vaccino a mRNA contro COVID-19,P0074M,R.S.A LE VELE S. GIULIANO TERME,TOS,60-69,3,2,0,0,0,5,0,5,0,5,Toscana,ITI1
2021-01-13,COMIRNATY Vaccino a mRNA contro COVID-19,04001A,Campo di Marte Lucca - iGIENE PUBBLICA,TOS,60-69,1,0,0,0,0,1,0,1,0,1,Toscana,ITI1
2021-01-13,COMIRNATY Vaccino a mRNA contro COVID-19,04001A,Campo di Marte Lucca - iGIENE PUBBLICA,TOS,70-79,1,1,0,0,0,2,0,2,0,2,Toscana,ITI1
2021-01-13,COMIRNATY Vaccino a mRNA contro COVID-19,04001A,Campo di Marte Lucca - iGIENE PUBBLICA,TOS,80-89,2,7,0,0,0,9,0,9,0,9,Toscana,ITI1
2021-01-13,COMIRNATY Vaccino a mRNA contro COVID-19,04001A,Campo di Marte Lucca - iGIENE PUBBLICA,TOS,90+,3,8,0,0,0,11,0,11,0,11,Toscana,ITI1
2021-01-13,COMIRNATY Vaccino a mRNA contro COVID-19,090601,Covid 19 - Ospedale S.Antonio Abate di Fivizzano,TOS,30-39,0,4,0,4,0,0,0,4,0,4,Toscana,ITI1
2021-01-13,COMIRNATY Vaccino a mRNA contro COVID-19,090601,Covid 19 - Ospedale S.Antonio Abate di Fivizzano,TOS,40-49,4,5,0,9,0,0,0,9,0,9,Toscana,ITI1
2021-01-13,COMIRNATY Vaccino a mRNA contro COVID-19,090601,Covid 19 - Ospedale S.Antonio Abate di Fivizzano,TOS,50-59,5,8,0,13,0,0,0,13,0,13,Toscana,ITI1
2021-01-13,COMIRNATY Vaccino a mRNA contro COVID-19,090601,Covid 19 - Ospedale S.Antonio Abate di Fivizzano,TOS,60-69,0,4,0,4,0,0,0,4,0,4,Toscana,ITI1
2021-01-13,COMIRNATY Vaccino a mRNA contro COVID-19,090602,Covid 19 - Nuovo Ospedale Apuane,TOS,16-19,1,1,0,1,1,0,0,2,0,2,Toscana,ITI1
2021-01-13,COMIRNATY Vaccino a mRNA contro COVID-19,090602,Covid 19 - Nuovo Ospedale Apuane,TOS,20-29,5,9,0,11,3,0,0,14,0,14,Toscana,ITI1
2021-01-13,COMIRNATY Vaccino a mRNA contro COVID-19,090602,Covid 19 - Nuovo Ospedale Apuane,TOS,30-39,13,20,0,29,4,0,0,33,0,33,Toscana,ITI1
2021-01-13,COMIRNATY Vaccino a mRNA contro COVID-19,090602,Covid 19 - Nuovo Ospedale Apuane,TOS,40-49,12,16,0,25,3,0,0,28,0,28,Toscana,ITI1
2021-01-13,COMIRNATY Vaccino a mRNA contro COVID-19,090602,Covid 19 - Nuovo Ospedale Apuane,TOS,50-59,15,24,0,34,4,1,0,39,0,39,Toscana,ITI1
2021-01-13,COMIRNATY Vaccino a mRNA contro COVID-19,090602,Covid 19 - Nuovo Ospedale Apuane,TOS,60-69,22,15,0,34,3,0,0,37,0,37,Toscana,ITI1
2021-01-13,COMIRNATY Vaccino a mRNA contro COVID-19,090602,Covid 19 - Nuovo Ospedale Apuane,TOS,70-79,3,0,0,1,2,0,0,3,0,3,Toscana,ITI1
2021-01-13,COMIRNATY Vaccino a mRNA contro COVID-19,090603,Covid 19 - Ospedale Santa Croce in Garfagnana,TOS,20-29,2,7,0,9,0,0,0,9,0,9,Toscana,ITI1
2021-01-13,COMIRNATY Vaccino a mRNA contro COVID-19,090603,Covid 19 - Ospedale Santa Croce in Garfagnana,TOS,30-39,4,8,0,12,0,0,0,12,0,12,Toscana,ITI1
2021-01-13,COMIRNATY Vaccino a mRNA contro COVID-19,090603,Covid 19 - Ospedale Santa Croce in Garfagnana,TOS,40-49,1,9,0,9,0,1,0,10,0,10,Toscana,ITI1
2021-01-13,COMIRNATY Vaccino a mRNA contro COVID-19,090603,Covid 19 - Ospedale Santa Croce in Garfagnana,TOS,50-59,4,13,0,17,0,0,0,17,0,17,Toscana,ITI1
2021-01-13,COMIRNATY Vaccino a mRNA contro COVID-19,090603,Covid 19 - Ospedale Santa Croce in Garfagnana,TOS,60-69,5,6,0,11,0,0,0,11,0,11,Toscana,ITI1
2021-01-13,COMIRNATY Vaccino a mRNA contro COVID-19,090603,Covid 19 - Ospedale Santa Croce in Garfagnana,TOS,70-79,1,0,0,1,0,0,0,1,0,1,Toscana,ITI1
2021-01-13,COMIRNATY Vaccino a mRNA contro COVID-19,090604,Covid 19 - Ospedale San Luca di  Lucca,TOS,16-19,2,1,0,3,0,0,0,3,0,3,Toscana,ITI1
2021-01-13,COMIRNATY Vaccino a mRNA contro COVID-19,090604,Covid 19 - Ospedale San Luca di  Lucca,TOS,20-29,6,13,0,19,0,0,0,19,0,19,Toscana,ITI1
2021-01-13,COMIRNATY Vaccino a mRNA contro COVID-19,090604,Covid 19 - Ospedale San Luca di  Lucca,TOS,30-39,7,6,0,13,0,0,0,13,0,13,Toscana,ITI1
2021-01-13,COMIRNATY Vaccino a mRNA contro COVID-19,090604,Covid 19 - Ospedale San Luca di  Lucca,TOS,40-49,5,24,0,28,0,1,0,29,0,29,Toscana,ITI1
2021-01-13,COMIRNATY Vaccino a mRNA contro COVID-19,090604,Covid 19 - Ospedale San Luca di  Lucca,TOS,50-59,11,30,0,39,2,0,0,41,0,41,Toscana,ITI1
2021-01-13,COMIRNATY Vaccino a mRNA contro COVID-19,090604,Covid 19 - Ospedale San Luca di  Lucca,TOS,60-69,13,12,0,23,2,0,0,25,0,25,Toscana,ITI1
2021-01-13,COMIRNATY Vaccino a mRNA contro COVID-19,090604,Covid 19 - Ospedale San Luca di  Lucca,TOS,70-79,4,2,0,5,1,0,0,6,0,6,Toscana,ITI1
2021-01-13,COMIRNATY Vaccino a mRNA contro COVID-19,090604,Covid 19 - Ospedale San Luca di  Lucca,TOS,80-89,1,0,0,1,0,0,0,1,0,1,Toscana,ITI1
2021-01-13,COMIRNATY Vaccino a mRNA contro COVID-19,090606,COVID19 - Ospedale San Iacopo,TOS,16-19,2,2,0,2,1,1,0,4,0,4,Toscana,ITI1
2021-01-13,COMIRNATY Vaccino a mRNA contro COVID-19,090606,COVID19 - Ospedale San Iacopo,TOS,20-29,14,13,0,17,4,6,0,27,0,27,Toscana,ITI1
2021-01-13,COMIRNATY Vaccino a mRNA contro COVID-19,090606,COVID19 - Ospedale San Iacopo,TOS,30-39,7,18,0,18,2,5,0,25,0,25,Toscana,ITI1
2021-01-13,COMIRNATY Vaccino a mRNA contro COVID-19,090606,COVID19 - Ospedale San Iacopo,TOS,40-49,11,24,0,26,4,5,0,35,0,35,Toscana,ITI1
2021-01-13,COMIRNATY Vaccino a mRNA contro COVID-19,090606,COVID19 - Ospedale San Iacopo,TOS,50-59,8,29,0,31,6,0,0,37,0,37,Toscana,ITI1
2021-01-13,COMIRNATY Vaccino a mRNA contro COVID-19,090606,COVID19 - Ospedale San Iacopo,TOS,60-69,20,18,0,28,10,0,0,38,0,38,Toscana,ITI1
2021-01-13,COMIRNATY Vaccino a mRNA contro COVID-19,090606,COVID19 - Ospedale San Iacopo,TOS,70-79,5,1,0,3,2,1,0,6,0,6,Toscana,ITI1
2021-01-13,COMIRNATY Vaccino a mRNA contro COVID-19,090606,COVID19 - Ospedale San Iacopo,TOS,80-89,3,4,0,3,0,4,0,7,0,7,Toscana,ITI1
2021-01-13,COMIRNATY Vaccino a mRNA contro COVID-19,090606,COVID19 - Ospedale San Iacopo,TOS,90+,1,8,0,0,0,9,0,9,0,9,Toscana,ITI1
2021-01-13,COMIRNATY Vaccino a mRNA contro COVID-19,090607,COVID19 - Ospedale SS.Cosma e Damiano,TOS,20-29,2,5,0,7,0,0,0,7,0,7,Toscana,ITI1
2021-01-13,COMIRNATY Vaccino a mRNA contro COVID-19,090607,COVID19 - Ospedale SS.Cosma e Damiano,TOS,30-39,4,4,0,7,1,0,0,8,0,8,Toscana,ITI1
2021-01-13,COMIRNATY Vaccino a mRNA contro COVID-19,090607,COVID19 - Ospedale SS.Cosma e Damiano,TOS,40-49,1,11,0,12,0,0,0,12,0,12,Toscana,ITI1
2021-01-13,COMIRNATY Vaccino a mRNA contro COVID-19,090607,COVID19 - Ospedale SS.Cosma e Damiano,TOS,50-59,2,12,0,14,0,0,0,14,0,14,Toscana,ITI1
2021-01-13,COMIRNATY Vaccino a mRNA contro COVID-19,090607,COVID19 - Ospedale SS.Cosma e Damiano,TOS,60-69,3,3,0,6,0,0,0,6,0,6,Toscana,ITI1
2021-01-13,COMIRNATY Vaccino a mRNA contro COVID-19,090607,COVID19 - Ospedale SS.Cosma e Damiano,TOS,70-79,0,1,0,1,0,0,0,1,0,1,Toscana,ITI1
2021-01-13,COMIRNATY Vaccino a mRNA contro COVID-19,090608,COVID19 - Ospedale Santo Stefano,TOS,20-29,6,12,0,13,4,1,0,18,0,18,Toscana,ITI1
2021-01-13,COMIRNATY Vaccino a mRNA contro COVID-19,090608,COVID19 - Ospedale Santo Stefano,TOS,30-39,10,15,0,18,5,2,0,25,0,25,Toscana,ITI1
2021-01-13,COMIRNATY Vaccino a mRNA contro COVID-19,090608,COVID19 - Ospedale Santo Stefano,TOS,40-49,12,23,0,29,3,3,0,35,0,35,Toscana,ITI1
2021-01-13,COMIRNATY Vaccino a mRNA contro COVID-19,090608,COVID19 - Ospedale Santo Stefano,TOS,50-59,18,44,0,44,7,11,0,62,0,62,Toscana,ITI1
2021-01-13,COMIRNATY Vaccino a mRNA contro COVID-19,090608,COVID19 - Ospedale Santo Stefano,TOS,60-69,19,17,0,21,5,10,0,36,0,36,Toscana,ITI1
2021-01-13,COMIRNATY Vaccino a mRNA contro COVID-19,090608,COVID19 - Ospedale Santo Stefano,TOS,70-79,2,1,0,2,0,1,0,3,0,3,Toscana,ITI1
2021-01-13,COMIRNATY Vaccino a mRNA contro COVID-19,090610,Covid 19 - Ospedale F.Lotti di Pontedera,TOS,16-19,0,7,0,7,0,0,0,7,0,7,Toscana,ITI1
2021-01-13,COMIRNATY Vaccino a mRNA contro COVID-19,090610,Covid 19 - Ospedale F.Lotti di Pontedera,TOS,20-29,5,27,0,32,0,0,0,32,0,32,Toscana,ITI1
2021-01-13,COMIRNATY Vaccino a mRNA contro COVID-19,090610,Covid 19 - Ospedale F.Lotti di Pontedera,TOS,30-39,0,2,0,2,0,0,0,2,0,2,Toscana,ITI1
2021-01-13,COMIRNATY Vaccino a mRNA contro COVID-19,090610,Covid 19 - Ospedale F.Lotti di Pontedera,TOS,40-49,1,6,0,7,0,0,0,7,0,7,Toscana,ITI1
2021-01-13,COMIRNATY Vaccino a mRNA contro COVID-19,090610,Covid 19 - Ospedale F.Lotti di Pontedera,TOS,50-59,3,4,0,7,0,0,0,7,0,7,Toscana,ITI1
2021-01-13,COMIRNATY Vaccino a mRNA contro COVID-19,090610,Covid 19 - Ospedale F.Lotti di Pontedera,TOS,60-69,2,3,0,5,0,0,0,5,0,5,Toscana,ITI1
2021-01-13,COMIRNATY Vaccino a mRNA contro COVID-19,090613,Covid 19 - Ospedali Riuniti di Livorno,TOS,16-19,2,1,1,3,0,0,0,3,0,3,Toscana,ITI1
2021-01-13,COMIRNATY Vaccino a mRNA contro COVID-19,090613,Covid 19 - Ospedali Riuniti di Livorno,TOS,20-29,5,23,1,28,0,0,0,28,0,28,Toscana,ITI1
2021-01-13,COMIRNATY Vaccino a mRNA contro COVID-19,090613,Covid 19 - Ospedali Riuniti di Livorno,TOS,30-39,5,16,1,20,0,0,1,21,0,21,Toscana,ITI1
2021-01-13,COMIRNATY Vaccino a mRNA contro COVID-19,090613,Covid 19 - Ospedali Riuniti di Livorno,TOS,40-49,7,26,1,32,1,0,0,33,0,33,Toscana,ITI1
2021-01-13,COMIRNATY Vaccino a mRNA contro COVID-19,090613,Covid 19 - Ospedali Riuniti di Livorno,TOS,50-59,9,35,1,44,0,0,0,44,0,44,Toscana,ITI1
2021-01-13,COMIRNATY Vaccino a mRNA contro COVID-19,090613,Covid 19 - Ospedali Riuniti di Livorno,TOS,60-69,13,19,1,31,1,0,0,32,0,32,Toscana,ITI1
2021-01-13,COMIRNATY Vaccino a mRNA contro COVID-19,090613,Covid 19 - Ospedali Riuniti di Livorno,TOS,80-89,1,0,1,1,0,0,0,1,0,1,Toscana,ITI1
2021-01-13,COMIRNATY Vaccino a mRNA contro COVID-19,090614,Covid 19 - Ospedale Civile di Piombino,TOS,16-19,1,0,0,1,0,0,0,1,0,1,Toscana,ITI1
2021-01-13,COMIRNATY Vaccino a mRNA contro COVID-19,090614,Covid 19 - Ospedale Civile di Piombino,TOS,20-29,1,0,0,1,0,0,0,1,0,1,Toscana,ITI1
2021-01-13,COMIRNATY Vaccino a mRNA contro COVID-19,090614,Covid 19 - Ospedale Civile di Piombino,TOS,30-39,0,2,0,2,0,0,0,2,0,2,Toscana,ITI1
2021-01-13,COMIRNATY Vaccino a mRNA contro COVID-19,090614,Covid 19 - Ospedale Civile di Piombino,TOS,40-49,4,9,0,13,0,0,0,13,0,13,Toscana,ITI1
2021-01-13,COMIRNATY Vaccino a mRNA contro COVID-19,090614,Covid 19 - Ospedale Civile di Piombino,TOS,50-59,1,6,0,7,0,0,0,7,0,7,Toscana,ITI1
2021-01-13,COMIRNATY Vaccino a mRNA contro COVID-19,090614,Covid 19 - Ospedale Civile di Piombino,TOS,60-69,3,1,0,4,0,0,0,4,0,4,Toscana,ITI1
2021-01-13,COMIRNATY Vaccino a mRNA contro COVID-19,090614,Covid 19 - Ospedale Civile di Piombino,TOS,70-79,2,0,0,2,0,0,0,2,0,2,Toscana,ITI1
2021-01-13,COMIRNATY Vaccino a mRNA contro COVID-19,090621,COVID19 - Ospedale di Arezzo,TOS,16-19,0,4,0,4,0,0,0,4,0,4,Toscana,ITI1
2021-01-13,COMIRNATY Vaccino a mRNA contro COVID-19,090621,COVID19 - Ospedale di Arezzo,TOS,20-29,21,30,0,50,1,0,0,51,0,51,Toscana,ITI1
2021-01-13,COMIRNATY Vaccino a mRNA contro COVID-19,090621,COVID19 - Ospedale di Arezzo,TOS,30-39,11,34,0,42,3,0,0,45,0,45,Toscana,ITI1
2021-01-13,COMIRNATY Vaccino a mRNA contro COVID-19,090621,COVID19 - Ospedale di Arezzo,TOS,40-49,20,38,0,57,1,0,0,58,0,58,Toscana,ITI1
2021-01-13,COMIRNATY Vaccino a mRNA contro COVID-19,090621,COVID19 - Ospedale di Arezzo,TOS,50-59,17,37,0,53,1,0,0,54,0,54,Toscana,ITI1
2021-01-13,COMIRNATY Vaccino a mRNA contro COVID-19,090621,COVID19 - Ospedale di Arezzo,TOS,60-69,28,19,0,46,1,0,0,47,0,47,Toscana,ITI1
2021-01-13,COMIRNATY Vaccino a mRNA contro COVID-19,090621,COVID19 - Ospedale di Arezzo,TOS,70-79,2,0,0,1,1,0,0,2,0,2,Toscana,ITI1
2021-01-13,COMIRNATY Vaccino a mRNA contro COVID-19,090626,COVID19 - Ospedale di Grosseto,TOS,16-19,1,2,0,3,0,0,0,3,0,3,Toscana,ITI1
2021-01-13,COMIRNATY Vaccino a mRNA contro COVID-19,090626,COVID19 - Ospedale di Grosseto,TOS,20-29,8,11,0,19,0,0,0,19,0,19,Toscana,ITI1
2021-01-13,COMIRNATY Vaccino a mRNA contro COVID-19,090626,COVID19 - Ospedale di Grosseto,TOS,30-39,7,4,0,11,0,0,0,11,0,11,Toscana,ITI1
2021-01-13,COMIRNATY Vaccino a mRNA contro COVID-19,090626,COVID19 - Ospedale di Grosseto,TOS,40-49,5,9,0,14,0,0,0,14,0,14,Toscana,ITI1
2021-01-13,COMIRNATY Vaccino a mRNA contro COVID-19,090626,COVID19 - Ospedale di Grosseto,TOS,50-59,9,26,0,35,0,0,0,35,0,35,Toscana,ITI1
2021-01-13,COMIRNATY Vaccino a mRNA contro COVID-19,090626,COVID19 - Ospedale di Grosseto,TOS,60-69,16,11,0,27,0,0,0,27,0,27,Toscana,ITI1
2021-01-13,COMIRNATY Vaccino a mRNA contro COVID-19,090626,COVID19 - Ospedale di Grosseto,TOS,70-79,4,0,0,4,0,0,0,4,0,4,Toscana,ITI1
2021-01-13,COMIRNATY Vaccino a mRNA contro COVID-19,090627,COVID19 - Ospedale Mugello,TOS,30-39,0,4,0,2,2,0,0,4,0,4,Toscana,ITI1
2021-01-13,COMIRNATY Vaccino a mRNA contro COVID-19,090627,COVID19 - Ospedale Mugello,TOS,40-49,6,9,0,9,6,0,0,15,0,15,Toscana,ITI1
2021-01-13,COMIRNATY Vaccino a mRNA contro COVID-19,090627,COVID19 - Ospedale Mugello,TOS,50-59,3,15,0,17,1,0,0,18,0,18,Toscana,ITI1
2021-01-13,COMIRNATY Vaccino a mRNA contro COVID-19,090627,COVID19 - Ospedale Mugello,TOS,60-69,3,6,0,6,3,0,0,9,0,9,Toscana,ITI1
2021-01-13,COMIRNATY Vaccino a mRNA contro COVID-19,090627,COVID19 - Ospedale Mugello,TOS,70-79,2,0,0,0,2,0,0,2,0,2,Toscana,ITI1
2021-01-13,COMIRNATY Vaccino a mRNA contro COVID-19,090629,COVID19 - Ospedale SS. Maria Annunziata,TOS,20-29,5,7,0,12,0,0,0,12,0,12,Toscana,ITI1
2021-01-13,COMIRNATY Vaccino a mRNA contro COVID-19,090629,COVID19 - Ospedale SS. Maria Annunziata,TOS,30-39,7,13,0,20,0,0,0,20,0,20,Toscana,ITI1
2021-01-13,COMIRNATY Vaccino a mRNA contro COVID-19,090629,COVID19 - Ospedale SS. Maria Annunziata,TOS,40-49,7,29,0,34,2,0,0,36,0,36,Toscana,ITI1
2021-01-13,COMIRNATY Vaccino a mRNA contro COVID-19,090629,COVID19 - Ospedale SS. Maria Annunziata,TOS,50-59,13,37,0,46,4,0,0,50,0,50,Toscana,ITI1
2021-01-13,COMIRNATY Vaccino a mRNA contro COVID-19,090629,COVID19 - Ospedale SS. Maria Annunziata,TOS,60-69,10,13,0,22,1,0,0,23,0,23,Toscana,ITI1
2021-01-13,COMIRNATY Vaccino a mRNA contro COVID-19,090629,COVID19 - Ospedale SS. Maria Annunziata,TOS,70-79,2,0,0,2,0,0,0,2,0,2,Toscana,ITI1
2021-01-13,COMIRNATY Vaccino a mRNA contro COVID-19,090629,COVID19 - Ospedale SS. Maria Annunziata,TOS,80-89,0,1,0,0,1,0,0,1,0,1,Toscana,ITI1
2021-01-13,COMIRNATY Vaccino a mRNA contro COVID-19,090632,COVID19 - Ospedale Santa Maria Nuova,TOS,20-29,3,8,0,11,0,0,0,11,0,11,Toscana,ITI1
2021-01-13,COMIRNATY Vaccino a mRNA contro COVID-19,090632,COVID19 - Ospedale Santa Maria Nuova,TOS,30-39,5,14,0,19,0,0,0,19,0,19,Toscana,ITI1
2021-01-13,COMIRNATY Vaccino a mRNA contro COVID-19,090632,COVID19 - Ospedale Santa Maria Nuova,TOS,40-49,2,22,0,24,0,0,0,24,0,24,Toscana,ITI1
2021-01-13,COMIRNATY Vaccino a mRNA contro COVID-19,090632,COVID19 - Ospedale Santa Maria Nuova,TOS,50-59,9,9,0,18,0,0,0,18,0,18,Toscana,ITI1
2021-01-13,COMIRNATY Vaccino a mRNA contro COVID-19,090632,COVID19 - Ospedale Santa Maria Nuova,TOS,60-69,9,6,0,15,0,0,0,15,0,15,Toscana,ITI1
2021-01-13,COMIRNATY Vaccino a mRNA contro COVID-19,090632,COVID19 - Ospedale Santa Maria Nuova,TOS,70-79,3,0,0,3,0,0,0,3,0,3,Toscana,ITI1
2021-01-13,COMIRNATY Vaccino a mRNA contro COVID-19,090638,COVID19 - Ospedale di Campostaggia Poggibonsi,TOS,20-29,7,5,0,12,0,0,0,12,0,12,Toscana,ITI1
2021-01-13,COMIRNATY Vaccino a mRNA contro COVID-19,090638,COVID19 - Ospedale di Campostaggia Poggibonsi,TOS,30-39,2,5,0,7,0,0,0,7,0,7,Toscana,ITI1
2021-01-13,COMIRNATY Vaccino a mRNA contro COVID-19,090638,COVID19 - Ospedale di Campostaggia Poggibonsi,TOS,40-49,5,23,0,28,0,0,0,28,0,28,Toscana,ITI1
2021-01-13,COMIRNATY Vaccino a mRNA contro COVID-19,090638,COVID19 - Ospedale di Campostaggia Poggibonsi,TOS,50-59,10,37,0,47,0,0,0,47,0,47,Toscana,ITI1
2021-01-13,COMIRNATY Vaccino a mRNA contro COVID-19,090638,COVID19 - Ospedale di Campostaggia Poggibonsi,TOS,60-69,7,10,0,17,0,0,0,17,0,17,Toscana,ITI1
2021-01-13,COMIRNATY Vaccino a mRNA contro COVID-19,090639,COVID19 - Ospedale di Nottola Montepulciano,TOS,20-29,2,11,0,13,0,0,0,13,0,13,Toscana,ITI1
2021-01-13,COMIRNATY Vaccino a mRNA contro COVID-19,090639,COVID19 - Ospedale di Nottola Montepulciano,TOS,30-39,6,8,0,14,0,0,0,14,0,14,Toscana,ITI1
2021-01-13,COMIRNATY Vaccino a mRNA contro COVID-19,090639,COVID19 - Ospedale di Nottola Montepulciano,TOS,40-49,9,14,0,21,2,0,0,23,0,23,Toscana,ITI1
2021-01-13,COMIRNATY Vaccino a mRNA contro COVID-19,090639,COVID19 - Ospedale di Nottola Montepulciano,TOS,50-59,4,25,0,28,1,0,0,29,0,29,Toscana,ITI1
2021-01-13,COMIRNATY Vaccino a mRNA contro COVID-19,090639,COVID19 - Ospedale di Nottola Montepulciano,TOS,60-69,9,7,0,15,1,0,0,16,0,16,Toscana,ITI1
2021-01-13,COMIRNATY Vaccino a mRNA contro COVID-19,090639,COVID19 - Ospedale di Nottola Montepulciano,TOS,70-79,1,0,0,0,1,0,0,1,0,1,Toscana,ITI1
2021-01-13,COMIRNATY Vaccino a mRNA contro COVID-19,090640,Covid 19 - Ospedale Unico Versilia,TOS,16-19,0,1,0,1,0,0,0,1,0,1,Toscana,ITI1
2021-01-13,COMIRNATY Vaccino a mRNA contro COVID-19,090640,Covid 19 - Ospedale Unico Versilia,TOS,20-29,7,10,0,17,0,0,0,17,0,17,Toscana,ITI1
2021-01-13,COMIRNATY Vaccino a mRNA contro COVID-19,090640,Covid 19 - Ospedale Unico Versilia,TOS,30-39,6,13,0,19,0,0,0,19,0,19,Toscana,ITI1
2021-01-13,COMIRNATY Vaccino a mRNA contro COVID-19,090640,Covid 19 - Ospedale Unico Versilia,TOS,40-49,7,13,0,20,0,0,0,20,0,20,Toscana,ITI1
2021-01-13,COMIRNATY Vaccino a mRNA contro COVID-19,090640,Covid 19 - Ospedale Unico Versilia,TOS,50-59,14,23,0,37,0,0,0,37,0,37,Toscana,ITI1
2021-01-13,COMIRNATY Vaccino a mRNA contro COVID-19,090640,Covid 19 - Ospedale Unico Versilia,TOS,60-69,12,12,0,24,0,0,0,24,0,24,Toscana,ITI1
2021-01-13,COMIRNATY Vaccino a mRNA contro COVID-19,090640,Covid 19 - Ospedale Unico Versilia,TOS,70-79,2,0,0,2,0,0,0,2,0,2,Toscana,ITI1
2021-01-13,COMIRNATY Vaccino a mRNA contro COVID-19,090641,COVID19 - Ospedale La Gruccia Montevarchi,TOS,20-29,7,4,0,11,0,0,0,11,0,11,Toscana,ITI1
2021-01-13,COMIRNATY Vaccino a mRNA contro COVID-19,090641,COVID19 - Ospedale La Gruccia Montevarchi,TOS,30-39,2,4,0,6,0,0,0,6,0,6,Toscana,ITI1
2021-01-13,COMIRNATY Vaccino a mRNA contro COVID-19,090641,COVID19 - Ospedale La Gruccia Montevarchi,TOS,40-49,1,3,0,4,0,0,0,4,0,4,Toscana,ITI1
2021-01-13,COMIRNATY Vaccino a mRNA contro COVID-19,090641,COVID19 - Ospedale La Gruccia Montevarchi,TOS,50-59,4,9,0,13,0,0,0,13,0,13,Toscana,ITI1
2021-01-13,COMIRNATY Vaccino a mRNA contro COVID-19,090641,COVID19 - Ospedale La Gruccia Montevarchi,TOS,60-69,3,5,0,8,0,0,0,8,0,8,Toscana,ITI1
2021-01-13,COMIRNATY Vaccino a mRNA contro COVID-19,090901,COVID19 - AOU Pisana,TOS,16-19,2,8,0,10,0,0,0,10,0,10,Toscana,ITI1
2021-01-13,COMIRNATY Vaccino a mRNA contro COVID-19,090901,COVID19 - AOU Pisana,TOS,20-29,76,125,0,183,18,0,0,201,0,201,Toscana,ITI1
2021-01-13,COMIRNATY Vaccino a mRNA contro COVID-19,090901,COVID19 - AOU Pisana,TOS,30-39,19,69,0,78,10,0,0,88,0,88,Toscana,ITI1
2021-01-13,COMIRNATY Vaccino a mRNA contro COVID-19,090901,COVID19 - AOU Pisana,TOS,40-49,24,54,1,70,7,0,1,78,0,78,Toscana,ITI1
2021-01-13,COMIRNATY Vaccino a mRNA contro COVID-19,090901,COVID19 - AOU Pisana,TOS,50-59,24,62,0,76,10,0,0,86,0,86,Toscana,ITI1
2021-01-13,COMIRNATY Vaccino a mRNA contro COVID-19,090901,COVID19 - AOU Pisana,TOS,60-69,12,9,0,16,5,0,0,21,0,21,Toscana,ITI1
2021-01-13,COMIRNATY Vaccino a mRNA contro COVID-19,090901,COVID19 - AOU Pisana,TOS,70-79,2,0,0,2,0,0,0,2,0,2,Toscana,ITI1
2021-01-13,COMIRNATY Vaccino a mRNA contro COVID-19,090902,COVID19 - AOU Senese,TOS,16-19,1,12,0,4,9,0,0,13,0,13,Toscana,ITI1
2021-01-13,COMIRNATY Vaccino a mRNA contro COVID-19,090902,COVID19 - AOU Senese,TOS,20-29,69,119,0,87,101,0,0,188,0,188,Toscana,ITI1
2021-01-13,COMIRNATY Vaccino a mRNA contro COVID-19,090902,COVID19 - AOU Senese,TOS,30-39,22,16,0,32,6,0,0,38,0,38,Toscana,ITI1
2021-01-13,COMIRNATY Vaccino a mRNA contro COVID-19,090902,COVID19 - AOU Senese,TOS,40-49,9,19,0,24,4,0,0,28,0,28,Toscana,ITI1
2021-01-13,COMIRNATY Vaccino a mRNA contro COVID-19,090902,COVID19 - AOU Senese,TOS,50-59,11,29,0,39,1,0,0,40,0,40,Toscana,ITI1
2021-01-13,COMIRNATY Vaccino a mRNA contro COVID-19,090902,COVID19 - AOU Senese,TOS,60-69,11,8,0,19,0,0,0,19,0,19,Toscana,ITI1
2021-01-13,COMIRNATY Vaccino a mRNA contro COVID-19,090902,COVID19 - AOU Senese,TOS,70-79,2,0,0,1,1,0,0,2,0,2,Toscana,ITI1
2021-01-13,COMIRNATY Vaccino a mRNA contro COVID-19,090903,COVID19 - AOU Careggi - CTO,TOS,16-19,0,3,0,3,0,0,0,3,0,3,Toscana,ITI1
2021-01-13,COMIRNATY Vaccino a mRNA contro COVID-19,090903,COVID19 - AOU Careggi - CTO,TOS,20-29,28,59,0,79,8,0,0,87,0,87,Toscana,ITI1
2021-01-13,COMIRNATY Vaccino a mRNA contro COVID-19,090903,COVID19 - AOU Careggi - CTO,TOS,30-39,9,19,0,23,5,0,0,28,0,28,Toscana,ITI1
2021-01-13,COMIRNATY Vaccino a mRNA contro COVID-19,090903,COVID19 - AOU Careggi - CTO,TOS,40-49,12,31,0,32,11,0,0,43,0,43,Toscana,ITI1
2021-01-13,COMIRNATY Vaccino a mRNA contro COVID-19,090903,COVID19 - AOU Careggi - CTO,TOS,50-59,18,53,0,62,9,0,0,71,0,71,Toscana,ITI1
2021-01-13,COMIRNATY Vaccino a mRNA contro COVID-19,090903,COVID19 - AOU Careggi - CTO,TOS,60-69,8,11,0,15,4,0,0,19,0,19,Toscana,ITI1
2021-01-13,COMIRNATY Vaccino a mRNA contro COVID-19,090903,COVID19 - AOU Careggi - CTO,TOS,70-79,1,0,0,1,0,0,0,1,0,1,Toscana,ITI1
2021-01-13,COMIRNATY Vaccino a mRNA contro COVID-19,090903,COVID19 - AOU Careggi - PIASTRA,TOS,16-19,1,1,0,2,0,0,0,2,0,2,Toscana,ITI1
2021-01-13,COMIRNATY Vaccino a mRNA contro COVID-19,090903,COVID19 - AOU Careggi - PIASTRA,TOS,20-29,10,13,0,23,0,0,0,23,0,23,Toscana,ITI1
2021-01-13,COMIRNATY Vaccino a mRNA contro COVID-19,090903,COVID19 - AOU Careggi - PIASTRA,TOS,30-39,6,5,0,11,0,0,0,11,0,11,Toscana,ITI1
2021-01-13,COMIRNATY Vaccino a mRNA contro COVID-19,090903,COVID19 - AOU Careggi - PIASTRA,TOS,40-49,4,12,0,16,0,0,0,16,0,16,Toscana,ITI1
2021-01-13,COMIRNATY Vaccino a mRNA contro COVID-19,090903,COVID19 - AOU Careggi - PIASTRA,TOS,50-59,6,16,0,22,0,0,0,22,0,22,Toscana,ITI1
2021-01-13,COMIRNATY Vaccino a mRNA contro COVID-19,090903,COVID19 - AOU Careggi - PIASTRA,TOS,60-69,5,5,0,10,0,0,0,10,0,10,Toscana,ITI1
2021-01-13,COMIRNATY Vaccino a mRNA contro COVID-19,090904,COVID19 - Ospedale AOU Meyer,TOS,20-29,1,5,0,6,0,0,0,6,0,6,Toscana,ITI1
2021-01-13,COMIRNATY Vaccino a mRNA contro COVID-19,090904,COVID19 - Ospedale AOU Meyer,TOS,30-39,5,9,0,11,3,0,0,14,0,14,Toscana,ITI1
2021-01-13,COMIRNATY Vaccino a mRNA contro COVID-19,090904,COVID19 - Ospedale AOU Meyer,TOS,40-49,5,9,0,11,3,0,0,14,0,14,Toscana,ITI1
2021-01-13,COMIRNATY Vaccino a mRNA contro COVID-19,090904,COVID19 - Ospedale AOU Meyer,TOS,50-59,2,10,0,10,2,0,0,12,0,12,Toscana,ITI1
2021-01-13,COMIRNATY Vaccino a mRNA contro COVID-19,090904,COVID19 - Ospedale AOU Meyer,TOS,60-69,0,1,0,1,0,0,0,1,0,1,Toscana,ITI1
2021-01-13,COMIRNATY Vaccino a mRNA contro COVID-19,090904,COVID19 - Ospedale AOU Meyer,TOS,70-79,1,0,0,0,1,0,0,1,0,1,Toscana,ITI1
2021-01-13,COMIRNATY Vaccino a mRNA contro COVID-19,11012E,COVID19 - Ospedale San Giuseppe,TOS,16-19,1,0,0,1,0,0,0,1,0,1,Toscana,ITI1
2021-01-13,COMIRNATY Vaccino a mRNA contro COVID-19,11012E,COVID19 - Ospedale San Giuseppe,TOS,20-29,5,13,0,18,0,0,0,18,0,18,Toscana,ITI1
2021-01-13,COMIRNATY Vaccino a mRNA contro COVID-19,11012E,COVID19 - Ospedale San Giuseppe,TOS,30-39,4,9,0,13,0,0,0,13,0,13,Toscana,ITI1
2021-01-13,COMIRNATY Vaccino a mRNA contro COVID-19,11012E,COVID19 - Ospedale San Giuseppe,TOS,40-49,18,21,0,39,0,0,0,39,0,39,Toscana,ITI1
2021-01-13,COMIRNATY Vaccino a mRNA contro COVID-19,11012E,COVID19 - Ospedale San Giuseppe,TOS,50-59,13,29,0,41,1,0,0,42,0,42,Toscana,ITI1
2021-01-13,COMIRNATY Vaccino a mRNA contro COVID-19,11012E,COVID19 - Ospedale San Giuseppe,TOS,60-69,14,15,0,29,0,0,0,29,0,29,Toscana,ITI1
2021-01-13,COMIRNATY Vaccino a mRNA contro COVID-19,11012E,COVID19 - Ospedale San Giuseppe,TOS,70-79,1,0,0,1,0,0,0,1,0,1,Toscana,ITI1
2021-01-13,COMIRNATY Vaccino a mRNA contro COVID-19,11012E,COVID19 - Ospedale San Giuseppe,TOS,80-89,1,0,0,0,1,0,0,1,0,1,Toscana,ITI1
2021-01-13,COMIRNATY Vaccino a mRNA contro COVID-19,13021A,Allergologia San Giovanni di Dio,TOS,50-59,0,2,0,2,0,0,0,2,0,2,Toscana,ITI1
2021-01-13,COMIRNATY Vaccino a mRNA contro COVID-19,13021A,COVID19 - Ospedale S.Giovanni di Dio,TOS,20-29,2,14,0,15,0,1,0,16,0,16,Toscana,ITI1
2021-01-13,COMIRNATY Vaccino a mRNA contro COVID-19,13021A,COVID19 - Ospedale S.Giovanni di Dio,TOS,30-39,4,19,0,20,2,1,0,23,0,23,Toscana,ITI1
2021-01-13,COMIRNATY Vaccino a mRNA contro COVID-19,13021A,COVID19 - Ospedale S.Giovanni di Dio,TOS,40-49,17,31,0,46,1,1,0,48,0,48,Toscana,ITI1
2021-01-13,COMIRNATY Vaccino a mRNA contro COVID-19,13021A,COVID19 - Ospedale S.Giovanni di Dio,TOS,50-59,9,32,0,38,0,3,0,41,0,41,Toscana,ITI1
2021-01-13,COMIRNATY Vaccino a mRNA contro COVID-19,13021A,COVID19 - Ospedale S.Giovanni di Dio,TOS,60-69,18,15,0,30,0,3,0,33,0,33,Toscana,ITI1
2021-01-13,COMIRNATY Vaccino a mRNA contro COVID-19,13021A,COVID19 - Ospedale S.Giovanni di Dio,TOS,70-79,6,10,0,6,1,9,0,16,0,16,Toscana,ITI1
2021-01-13,COMIRNATY Vaccino a mRNA contro COVID-19,13021A,COVID19 - Ospedale S.Giovanni di Dio,TOS,80-89,2,13,0,6,2,7,0,15,0,15,Toscana,ITI1
2021-01-13,COMIRNATY Vaccino a mRNA contro COVID-19,13021A,COVID19 - Ospedale S.Giovanni di Dio,TOS,90+,0,13,0,0,1,12,0,13,0,13,Toscana,ITI1
2021-01-13,COMIRNATY Vaccino a mRNA contro COVID-19,13324I,Covid19 - RSA Residenza degli Ulivi,TOS,50-59,0,1,0,1,0,0,0,1,0,1,Toscana,ITI1
2021-01-13,COMIRNATY Vaccino a mRNA contro COVID-19,13324I,Covid19 - RSA Residenza degli Ulivi,TOS,60-69,1,2,0,2,0,1,0,3,0,3,Toscana,ITI1
2021-01-13,COMIRNATY Vaccino a mRNA contro COVID-19,13324I,Covid19 - RSA Residenza degli Ulivi,TOS,70-79,1,1,0,1,0,1,0,2,0,2,Toscana,ITI1
2021-01-13,COMIRNATY Vaccino a mRNA contro COVID-19,16121A,Covid 19 - Ospedale Civile di Cecina,TOS,16-19,1,1,0,2,0,0,0,2,0,2,Toscana,ITI1
2021-01-13,COMIRNATY Vaccino a mRNA contro COVID-19,16121A,Covid 19 - Ospedale Civile di Cecina,TOS,20-29,1,0,0,1,0,0,0,1,0,1,Toscana,ITI1
2021-01-13,COMIRNATY Vaccino a mRNA contro COVID-19,16121A,Covid 19 - Ospedale Civile di Cecina,TOS,30-39,0,1,0,1,0,0,0,1,0,1,Toscana,ITI1
2021-01-13,COMIRNATY Vaccino a mRNA contro COVID-19,16121A,Covid 19 - Ospedale Civile di Cecina,TOS,40-49,6,5,0,11,0,0,0,11,0,11,Toscana,ITI1
2021-01-13,COMIRNATY Vaccino a mRNA contro COVID-19,16121A,Covid 19 - Ospedale Civile di Cecina,TOS,50-59,6,10,0,16,0,0,0,16,0,16,Toscana,ITI1
2021-01-13,COMIRNATY Vaccino a mRNA contro COVID-19,16121A,Covid 19 - Ospedale Civile di Cecina,TOS,60-69,2,2,0,4,0,0,0,4,0,4,Toscana,ITI1
2021-01-13,COMIRNATY Vaccino a mRNA contro COVID-19,16121A,Covid 19 - Ospedale Civile di Cecina,TOS,70-79,1,0,0,1,0,0,0,1,0,1,Toscana,ITI1
2021-01-13,COMIRNATY Vaccino a mRNA contro COVID-19,20554I,RSA NUOVA VILLA LAGUIDARA E DE,TOS,40-49,0,1,0,0,1,0,0,1,0,1,Toscana,ITI1
2021-01-13,COMIRNATY Vaccino a mRNA contro COVID-19,20554I,RSA NUOVA VILLA LAGUIDARA E DE,TOS,50-59,1,1,0,0,1,1,0,2,0,2,Toscana,ITI1
2021-01-13,COMIRNATY Vaccino a mRNA contro COVID-19,20554I,RSA NUOVA VILLA LAGUIDARA E DE,TOS,60-69,4,1,0,0,1,4,0,5,0,5,Toscana,ITI1
2021-01-13,COMIRNATY Vaccino a mRNA contro COVID-19,20554I,RSA NUOVA VILLA LAGUIDARA E DE,TOS,70-79,4,4,0,0,0,8,0,8,0,8,Toscana,ITI1
2021-01-13,COMIRNATY Vaccino a mRNA contro COVID-19,20554I,RSA NUOVA VILLA LAGUIDARA E DE,TOS,80-89,1,4,0,0,0,5,0,5,0,5,Toscana,ITI1
2021-01-13,COMIRNATY Vaccino a mRNA contro COVID-19,20554I,RSA NUOVA VILLA LAGUIDARA E DE,TOS,90+,0,1,0,0,0,1,0,1,0,1,Toscana,ITI1
2021-01-13,COMIRNATY Vaccino a mRNA contro COVID-19,211H1A,Covid19 - Comunit+á Alloggio Protetta Elio Visone,TOS,40-49,1,1,0,0,0,2,0,2,0,2,Toscana,ITI1
2021-01-13,COMIRNATY Vaccino a mRNA contro COVID-19,211H1A,Covid19 - Comunit+á Alloggio Protetta Elio Visone,TOS,50-59,4,1,0,0,0,5,0,5,0,5,Toscana,ITI1
2021-01-13,COMIRNATY Vaccino a mRNA contro COVID-19,211H1A,Covid19 - Comunit+á Alloggio Protetta Elio Visone,TOS,60-69,0,2,0,0,0,2,0,2,0,2,Toscana,ITI1
2021-01-13,COMIRNATY Vaccino a mRNA contro COVID-19,220V4I,RSA MARGHERITA LEONCINI,TOS,20-29,0,1,0,1,0,0,0,1,0,1,Toscana,ITI1
2021-01-13,COMIRNATY Vaccino a mRNA contro COVID-19,220V4I,RSA MARGHERITA LEONCINI,TOS,50-59,0,2,0,2,0,0,0,2,0,2,Toscana,ITI1
2021-01-13,COMIRNATY Vaccino a mRNA contro COVID-19,220V4I,RSA MARGHERITA LEONCINI,TOS,60-69,1,1,0,1,0,1,0,2,0,2,Toscana,ITI1
2021-01-13,COMIRNATY Vaccino a mRNA contro COVID-19,220V4I,RSA MARGHERITA LEONCINI,TOS,80-89,3,0,0,0,0,3,0,3,0,3,Toscana,ITI1
2021-01-13,COMIRNATY Vaccino a mRNA contro COVID-19,221I4I,RSA GIAMPIERI,TOS,80-89,1,0,0,0,0,1,0,1,0,1,Toscana,ITI1
2021-01-13,COMIRNATY Vaccino a mRNA contro COVID-19,40911A,COVID19 - Dip. Prevenzione Ruffolo Siena,TOS,20-29,0,6,0,6,0,0,0,6,0,6,Toscana,ITI1
2021-01-13,COMIRNATY Vaccino a mRNA contro COVID-19,40911A,COVID19 - Dip. Prevenzione Ruffolo Siena,TOS,30-39,3,1,0,4,0,0,0,4,0,4,Toscana,ITI1
2021-01-13,COMIRNATY Vaccino a mRNA contro COVID-19,40911A,COVID19 - Dip. Prevenzione Ruffolo Siena,TOS,40-49,1,8,0,8,0,1,0,9,0,9,Toscana,ITI1
2021-01-13,COMIRNATY Vaccino a mRNA contro COVID-19,40911A,COVID19 - Dip. Prevenzione Ruffolo Siena,TOS,50-59,6,5,0,10,0,1,0,11,0,11,Toscana,ITI1
2021-01-13,COMIRNATY Vaccino a mRNA contro COVID-19,40911A,COVID19 - Dip. Prevenzione Ruffolo Siena,TOS,60-69,5,13,0,14,0,4,0,18,0,18,Toscana,ITI1
2021-01-13,COMIRNATY Vaccino a mRNA contro COVID-19,40911A,COVID19 - Dip. Prevenzione Ruffolo Siena,TOS,70-79,1,2,0,1,0,2,0,3,0,3,Toscana,ITI1
2021-01-13,COMIRNATY Vaccino a mRNA contro COVID-19,40911A,COVID19 - Dip. Prevenzione Ruffolo Siena,TOS,80-89,0,5,0,0,0,5,0,5,0,5,Toscana,ITI1
2021-01-13,COMIRNATY Vaccino a mRNA contro COVID-19,40911A,COVID19 - Dip. Prevenzione Ruffolo Siena,TOS,90+,0,1,0,0,0,1,0,1,0,1,Toscana,ITI1
2021-01-13,COMIRNATY Vaccino a mRNA contro COVID-19,43024I,CASA DI RIPOSO V.FOSSOMBRONI,TOS,30-39,0,1,0,1,0,0,0,1,0,1,Toscana,ITI1
2021-01-13,COMIRNATY Vaccino a mRNA contro COVID-19,43024I,CASA DI RIPOSO V.FOSSOMBRONI,TOS,40-49,2,1,0,1,0,2,0,3,0,3,Toscana,ITI1
2021-01-13,COMIRNATY Vaccino a mRNA contro COVID-19,43024I,CASA DI RIPOSO V.FOSSOMBRONI,TOS,50-59,5,2,0,2,0,5,0,7,0,7,Toscana,ITI1
2021-01-13,COMIRNATY Vaccino a mRNA contro COVID-19,43024I,CASA DI RIPOSO V.FOSSOMBRONI,TOS,60-69,13,8,0,0,0,21,0,21,0,21,Toscana,ITI1
2021-01-13,COMIRNATY Vaccino a mRNA contro COVID-19,43024I,CASA DI RIPOSO V.FOSSOMBRONI,TOS,70-79,6,11,0,0,0,17,0,17,0,17,Toscana,ITI1
2021-01-13,COMIRNATY Vaccino a mRNA contro COVID-19,43024I,CASA DI RIPOSO V.FOSSOMBRONI,TOS,80-89,8,9,0,0,0,17,0,17,0,17,Toscana,ITI1
2021-01-13,COMIRNATY Vaccino a mRNA contro COVID-19,43024I,CASA DI RIPOSO V.FOSSOMBRONI,TOS,90+,2,10,0,0,0,12,0,12,0,12,Toscana,ITI1
2021-01-13,COMIRNATY Vaccino a mRNA contro COVID-19,61134I,OSPIZIO ISRAELITICO SAADUN,TOS,30-39,1,1,0,2,0,0,0,2,0,2,Toscana,ITI1
2021-01-13,COMIRNATY Vaccino a mRNA contro COVID-19,61134I,OSPIZIO ISRAELITICO SAADUN,TOS,40-49,0,3,0,3,0,0,0,3,0,3,Toscana,ITI1
2021-01-13,COMIRNATY Vaccino a mRNA contro COVID-19,61134I,OSPIZIO ISRAELITICO SAADUN,TOS,50-59,0,2,0,2,0,0,0,2,0,2,Toscana,ITI1
2021-01-13,COMIRNATY Vaccino a mRNA contro COVID-19,61134I,OSPIZIO ISRAELITICO SAADUN,TOS,60-69,1,3,0,1,0,3,0,4,0,4,Toscana,ITI1
2021-01-13,COMIRNATY Vaccino a mRNA contro COVID-19,61134I,OSPIZIO ISRAELITICO SAADUN,TOS,90+,3,10,0,0,0,13,0,13,0,13,Toscana,ITI1
2021-01-13,COMIRNATY Vaccino a mRNA contro COVID-19,80074I,ISTITUTO SAN GIUSEPPE - S. CAS,TOS,50-59,0,1,0,0,0,1,0,1,0,1,Toscana,ITI1
2021-01-13,COMIRNATY Vaccino a mRNA contro COVID-19,80074I,ISTITUTO SAN GIUSEPPE - S. CAS,TOS,70-79,1,3,0,0,0,4,0,4,0,4,Toscana,ITI1
2021-01-13,COMIRNATY Vaccino a mRNA contro COVID-19,80074I,ISTITUTO SAN GIUSEPPE - S. CAS,TOS,80-89,4,17,0,0,0,21,0,21,0,21,Toscana,ITI1
2021-01-13,COMIRNATY Vaccino a mRNA contro COVID-19,80074I,ISTITUTO SAN GIUSEPPE - S. CAS,TOS,90+,3,25,0,0,0,28,0,28,0,28,Toscana,ITI1
2021-01-13,COMIRNATY Vaccino a mRNA contro COVID-19,ND,R.A. OASI DEL SACRO CUORE,TOS,40-49,0,1,0,1,0,0,0,1,0,1,Toscana,ITI1
2021-01-13,COMIRNATY Vaccino a mRNA contro COVID-19,ND,R.A. OASI DEL SACRO CUORE,TOS,50-59,0,2,0,2,0,0,0,2,0,2,Toscana,ITI1
2021-01-13,COMIRNATY Vaccino a mRNA contro COVID-19,ND,R.A. OASI DEL SACRO CUORE,TOS,70-79,4,1,0,1,0,4,0,5,0,5,Toscana,ITI1
2021-01-13,COMIRNATY Vaccino a mRNA contro COVID-19,ND,R.A. OASI DEL SACRO CUORE,TOS,80-89,3,13,0,0,0,16,0,16,0,16,Toscana,ITI1
2021-01-13,COMIRNATY Vaccino a mRNA contro COVID-19,ND,R.A. OASI DEL SACRO CUORE,TOS,90+,1,4,0,0,0,5,0,5,0,5,Toscana,ITI1
2021-01-13,COMIRNATY Vaccino a mRNA contro COVID-19,ND,R.S.D BORGO DEI COLORI,TOS,20-29,0,1,0,1,0,0,0,1,0,1,Toscana,ITI1
2021-01-13,COMIRNATY Vaccino a mRNA contro COVID-19,ND,R.S.D BORGO DEI COLORI,TOS,40-49,0,1,0,1,0,0,0,1,0,1,Toscana,ITI1
2021-01-13,COMIRNATY Vaccino a mRNA contro COVID-19,ND,R.S.D BORGO DEI COLORI,TOS,50-59,3,1,0,3,0,1,0,4,0,4,Toscana,ITI1
2021-01-13,COMIRNATY Vaccino a mRNA contro COVID-19,ND,R.S.D STELLA MARIS Montalto,TOS,16-19,2,0,0,0,0,2,0,2,0,2,Toscana,ITI1
2021-01-13,COMIRNATY Vaccino a mRNA contro COVID-19,ND,R.S.D STELLA MARIS Montalto,TOS,20-29,4,1,0,1,0,4,0,5,0,5,Toscana,ITI1
2021-01-13,COMIRNATY Vaccino a mRNA contro COVID-19,ND,R.S.D STELLA MARIS Montalto,TOS,40-49,1,0,0,0,0,1,0,1,0,1,Toscana,ITI1
2021-01-13,COMIRNATY Vaccino a mRNA contro COVID-19,ND,R.S.D STELLA MARIS Montalto,TOS,50-59,6,0,0,1,0,5,0,6,0,6,Toscana,ITI1
2021-01-13,COMIRNATY Vaccino a mRNA contro COVID-19,ND,R.S.D STELLA MARIS Montalto,TOS,60-69,3,1,0,3,0,1,0,4,0,4,Toscana,ITI1
2021-01-13,COMIRNATY Vaccino a mRNA contro COVID-19,R0134I,RSA CASA DI MARTA RESIDENZIALE,TOS,30-39,1,0,0,1,0,0,0,1,0,1,Toscana,ITI1
2021-01-13,COMIRNATY Vaccino a mRNA contro COVID-19,R0134I,RSA CASA DI MARTA RESIDENZIALE,TOS,60-69,0,1,0,1,0,0,0,1,0,1,Toscana,ITI1
2021-01-13,COMIRNATY Vaccino a mRNA contro COVID-19,R0134I,RSA CASA DI MARTA RESIDENZIALE,TOS,70-79,1,0,0,0,0,1,0,1,0,1,Toscana,ITI1
2021-01-13,COMIRNATY Vaccino a mRNA contro COVID-19,R0134I,RSA CASA DI MARTA RESIDENZIALE,TOS,80-89,1,6,0,1,0,6,0,7,0,7,Toscana,ITI1
2021-01-13,COMIRNATY Vaccino a mRNA contro COVID-19,R0134I,RSA CASA DI MARTA RESIDENZIALE,TOS,90+,1,6,0,1,0,6,0,7,0,7,Toscana,ITI1
2021-01-13,COMIRNATY Vaccino a mRNA contro COVID-19,V0044M,Covid19 - CENTRO LAGUIDARA,TOS,40-49,0,1,0,0,0,1,0,1,0,1,Toscana,ITI1
2021-01-13,COMIRNATY Vaccino a mRNA contro COVID-19,V0044M,Covid19 - CENTRO LAGUIDARA,TOS,50-59,1,2,0,0,0,3,0,3,0,3,Toscana,ITI1
2021-01-13,COMIRNATY Vaccino a mRNA contro COVID-19,V0044M,Covid19 - CENTRO LAGUIDARA,TOS,60-69,3,0,0,0,0,3,0,3,0,3,Toscana,ITI1
2021-01-13,COMIRNATY Vaccino a mRNA contro COVID-19,V0044M,Covid19 - CENTRO LAGUIDARA,TOS,70-79,0,1,0,0,0,1,0,1,0,1,Toscana,ITI1
2021-01-14,COMIRNATY Vaccino a mRNA contro COVID-19,00511A,Centro Sanitario Fornaci di Barga,TOS,20-29,0,8,0,8,0,0,0,8,0,8,Toscana,ITI1
2021-01-14,COMIRNATY Vaccino a mRNA contro COVID-19,00511A,Centro Sanitario Fornaci di Barga,TOS,30-39,1,7,0,7,1,0,0,8,0,8,Toscana,ITI1
2021-01-14,COMIRNATY Vaccino a mRNA contro COVID-19,00511A,Centro Sanitario Fornaci di Barga,TOS,40-49,0,9,0,7,2,0,0,9,0,9,Toscana,ITI1
2021-01-14,COMIRNATY Vaccino a mRNA contro COVID-19,00511A,Centro Sanitario Fornaci di Barga,TOS,50-59,1,23,0,23,1,0,0,24,0,24,Toscana,ITI1
2021-01-14,COMIRNATY Vaccino a mRNA contro COVID-19,00511A,Centro Sanitario Fornaci di Barga,TOS,60-69,5,6,0,11,0,0,0,11,0,11,Toscana,ITI1
2021-01-14,COMIRNATY Vaccino a mRNA contro COVID-19,090604,Covid 19 - Ospedale San Luca di  Lucca,TOS,20-29,5,11,0,9,7,0,0,16,0,16,Toscana,ITI1
2021-01-14,COMIRNATY Vaccino a mRNA contro COVID-19,090604,Covid 19 - Ospedale San Luca di  Lucca,TOS,30-39,6,24,0,23,7,0,0,30,0,30,Toscana,ITI1
2021-01-14,COMIRNATY Vaccino a mRNA contro COVID-19,090604,Covid 19 - Ospedale San Luca di  Lucca,TOS,40-49,18,18,0,27,9,0,0,36,0,36,Toscana,ITI1
2021-01-14,COMIRNATY Vaccino a mRNA contro COVID-19,090604,Covid 19 - Ospedale San Luca di  Lucca,TOS,50-59,8,34,0,37,5,0,0,42,0,42,Toscana,ITI1
2021-01-14,COMIRNATY Vaccino a mRNA contro COVID-19,090604,Covid 19 - Ospedale San Luca di  Lucca,TOS,60-69,9,5,0,12,2,0,0,14,0,14,Toscana,ITI1
2021-01-14,COMIRNATY Vaccino a mRNA contro COVID-19,090606,COVID19 - Ospedale San Iacopo,TOS,16-19,3,1,0,0,0,4,0,4,0,4,Toscana,ITI1
2021-01-14,COMIRNATY Vaccino a mRNA contro COVID-19,090606,COVID19 - Ospedale San Iacopo,TOS,20-29,12,18,0,8,0,22,0,30,0,30,Toscana,ITI1
2021-01-14,COMIRNATY Vaccino a mRNA contro COVID-19,090606,COVID19 - Ospedale San Iacopo,TOS,30-39,18,20,0,15,3,20,0,38,0,38,Toscana,ITI1
2021-01-14,COMIRNATY Vaccino a mRNA contro COVID-19,090606,COVID19 - Ospedale San Iacopo,TOS,40-49,30,33,0,30,6,27,0,63,0,63,Toscana,ITI1
2021-01-14,COMIRNATY Vaccino a mRNA contro COVID-19,090606,COVID19 - Ospedale San Iacopo,TOS,50-59,40,56,0,56,11,29,0,96,0,96,Toscana,ITI1
2021-01-14,COMIRNATY Vaccino a mRNA contro COVID-19,090606,COVID19 - Ospedale San Iacopo,TOS,60-69,27,21,0,27,3,18,0,48,0,48,Toscana,ITI1
2021-01-14,COMIRNATY Vaccino a mRNA contro COVID-19,090606,COVID19 - Ospedale San Iacopo,TOS,70-79,1,2,0,2,1,0,0,3,0,3,Toscana,ITI1
2021-01-14,COMIRNATY Vaccino a mRNA contro COVID-19,090606,COVID19 - Ospedale San Iacopo,TOS,80-89,1,0,0,0,1,0,0,1,0,1,Toscana,ITI1
2021-01-14,COMIRNATY Vaccino a mRNA contro COVID-19,090607,COVID19 - Ospedale SS.Cosma e Damiano,TOS,20-29,2,3,0,4,1,0,0,5,0,5,Toscana,ITI1
2021-01-14,COMIRNATY Vaccino a mRNA contro COVID-19,090607,COVID19 - Ospedale SS.Cosma e Damiano,TOS,30-39,2,3,0,4,1,0,0,5,0,5,Toscana,ITI1
2021-01-14,COMIRNATY Vaccino a mRNA contro COVID-19,090607,COVID19 - Ospedale SS.Cosma e Damiano,TOS,40-49,1,16,0,10,5,2,0,17,0,17,Toscana,ITI1
2021-01-14,COMIRNATY Vaccino a mRNA contro COVID-19,090607,COVID19 - Ospedale SS.Cosma e Damiano,TOS,50-59,5,8,0,9,4,0,0,13,0,13,Toscana,ITI1
2021-01-14,COMIRNATY Vaccino a mRNA contro COVID-19,090607,COVID19 - Ospedale SS.Cosma e Damiano,TOS,60-69,6,1,0,6,1,0,0,7,0,7,Toscana,ITI1
2021-01-14,COMIRNATY Vaccino a mRNA contro COVID-19,090607,COVID19 - Ospedale SS.Cosma e Damiano,TOS,70-79,1,0,0,1,0,0,0,1,0,1,Toscana,ITI1
2021-01-14,COMIRNATY Vaccino a mRNA contro COVID-19,090608,COVID19 - Ospedale Santo Stefano,TOS,20-29,11,13,0,22,2,0,0,24,0,24,Toscana,ITI1
2021-01-14,COMIRNATY Vaccino a mRNA contro COVID-19,090608,COVID19 - Ospedale Santo Stefano,TOS,30-39,9,13,0,18,4,0,0,22,0,22,Toscana,ITI1
2021-01-14,COMIRNATY Vaccino a mRNA contro COVID-19,090608,COVID19 - Ospedale Santo Stefano,TOS,40-49,11,16,0,19,8,0,0,27,0,27,Toscana,ITI1
2021-01-14,COMIRNATY Vaccino a mRNA contro COVID-19,090608,COVID19 - Ospedale Santo Stefano,TOS,50-59,11,36,0,37,10,0,0,47,0,47,Toscana,ITI1
2021-01-14,COMIRNATY Vaccino a mRNA contro COVID-19,090608,COVID19 - Ospedale Santo Stefano,TOS,60-69,8,19,0,23,4,0,0,27,0,27,Toscana,ITI1
2021-01-14,COMIRNATY Vaccino a mRNA contro COVID-19,090608,COVID19 - Ospedale Santo Stefano,TOS,70-79,1,0,0,1,0,0,0,1,0,1,Toscana,ITI1
2021-01-14,COMIRNATY Vaccino a mRNA contro COVID-19,090609,Covid 19 - Ospedale S.Maria Maddalena di Volterra,TOS,20-29,0,2,0,2,0,0,0,2,0,2,Toscana,ITI1
2021-01-14,COMIRNATY Vaccino a mRNA contro COVID-19,090609,Covid 19 - Ospedale S.Maria Maddalena di Volterra,TOS,30-39,4,2,0,6,0,0,0,6,0,6,Toscana,ITI1
2021-01-14,COMIRNATY Vaccino a mRNA contro COVID-19,090609,Covid 19 - Ospedale S.Maria Maddalena di Volterra,TOS,40-49,0,8,0,8,0,0,0,8,0,8,Toscana,ITI1
2021-01-14,COMIRNATY Vaccino a mRNA contro COVID-19,090609,Covid 19 - Ospedale S.Maria Maddalena di Volterra,TOS,50-59,5,18,0,23,0,0,0,23,0,23,Toscana,ITI1
2021-01-14,COMIRNATY Vaccino a mRNA contro COVID-19,090609,Covid 19 - Ospedale S.Maria Maddalena di Volterra,TOS,60-69,1,7,0,8,0,0,0,8,0,8,Toscana,ITI1
2021-01-14,COMIRNATY Vaccino a mRNA contro COVID-19,090609,Covid 19 - Ospedale S.Maria Maddalena di Volterra,TOS,70-79,1,0,0,1,0,0,0,1,0,1,Toscana,ITI1
2021-01-14,COMIRNATY Vaccino a mRNA contro COVID-19,090610,Covid 19 - Ospedale F.Lotti di Pontedera,TOS,20-29,8,5,0,13,0,0,0,13,0,13,Toscana,ITI1
2021-01-14,COMIRNATY Vaccino a mRNA contro COVID-19,090610,Covid 19 - Ospedale F.Lotti di Pontedera,TOS,30-39,2,4,0,6,0,0,0,6,0,6,Toscana,ITI1
2021-01-14,COMIRNATY Vaccino a mRNA contro COVID-19,090610,Covid 19 - Ospedale F.Lotti di Pontedera,TOS,40-49,7,6,0,13,0,0,0,13,0,13,Toscana,ITI1
2021-01-14,COMIRNATY Vaccino a mRNA contro COVID-19,090610,Covid 19 - Ospedale F.Lotti di Pontedera,TOS,50-59,4,19,0,23,0,0,0,23,0,23,Toscana,ITI1
2021-01-14,COMIRNATY Vaccino a mRNA contro COVID-19,090610,Covid 19 - Ospedale F.Lotti di Pontedera,TOS,60-69,2,3,0,5,0,0,0,5,0,5,Toscana,ITI1
2021-01-14,COMIRNATY Vaccino a mRNA contro COVID-19,090613,Covid 19 - Ospedali Riuniti di Livorno,TOS,20-29,3,4,0,6,1,0,0,7,0,7,Toscana,ITI1
2021-01-14,COMIRNATY Vaccino a mRNA contro COVID-19,090613,Covid 19 - Ospedali Riuniti di Livorno,TOS,30-39,4,7,0,10,1,0,0,11,0,11,Toscana,ITI1
2021-01-14,COMIRNATY Vaccino a mRNA contro COVID-19,090613,Covid 19 - Ospedali Riuniti di Livorno,TOS,40-49,14,11,0,17,8,0,0,25,0,25,Toscana,ITI1
2021-01-14,COMIRNATY Vaccino a mRNA contro COVID-19,090613,Covid 19 - Ospedali Riuniti di Livorno,TOS,50-59,11,21,0,28,4,0,0,32,0,32,Toscana,ITI1
2021-01-14,COMIRNATY Vaccino a mRNA contro COVID-19,090613,Covid 19 - Ospedali Riuniti di Livorno,TOS,60-69,6,8,0,14,0,0,0,14,0,14,Toscana,ITI1
2021-01-14,COMIRNATY Vaccino a mRNA contro COVID-19,090613,Covid 19 - Ospedali Riuniti di Livorno,TOS,70-79,1,0,0,1,0,0,0,1,0,1,Toscana,ITI1
2021-01-14,COMIRNATY Vaccino a mRNA contro COVID-19,090621,COVID19 - Ospedale di Arezzo,TOS,20-29,0,4,0,4,0,0,0,4,0,4,Toscana,ITI1
2021-01-14,COMIRNATY Vaccino a mRNA contro COVID-19,090621,COVID19 - Ospedale di Arezzo,TOS,30-39,2,7,0,6,3,0,0,9,0,9,Toscana,ITI1
2021-01-14,COMIRNATY Vaccino a mRNA contro COVID-19,090621,COVID19 - Ospedale di Arezzo,TOS,40-49,7,8,0,12,3,0,0,15,0,15,Toscana,ITI1
2021-01-14,COMIRNATY Vaccino a mRNA contro COVID-19,090621,COVID19 - Ospedale di Arezzo,TOS,50-59,3,12,0,11,4,0,0,15,0,15,Toscana,ITI1
2021-01-14,COMIRNATY Vaccino a mRNA contro COVID-19,090621,COVID19 - Ospedale di Arezzo,TOS,60-69,1,4,0,5,0,0,0,5,0,5,Toscana,ITI1
2021-01-14,COMIRNATY Vaccino a mRNA contro COVID-19,090626,COVID19 - Ospedale di Grosseto,TOS,20-29,2,6,0,8,0,0,0,8,0,8,Toscana,ITI1
2021-01-14,COMIRNATY Vaccino a mRNA contro COVID-19,090626,COVID19 - Ospedale di Grosseto,TOS,30-39,3,13,0,16,0,0,0,16,0,16,Toscana,ITI1
2021-01-14,COMIRNATY Vaccino a mRNA contro COVID-19,090626,COVID19 - Ospedale di Grosseto,TOS,40-49,10,11,0,21,0,0,0,21,0,21,Toscana,ITI1
2021-01-14,COMIRNATY Vaccino a mRNA contro COVID-19,090626,COVID19 - Ospedale di Grosseto,TOS,50-59,8,23,0,31,0,0,0,31,0,31,Toscana,ITI1
2021-01-14,COMIRNATY Vaccino a mRNA contro COVID-19,090626,COVID19 - Ospedale di Grosseto,TOS,60-69,12,6,0,18,0,0,0,18,0,18,Toscana,ITI1
2021-01-14,COMIRNATY Vaccino a mRNA contro COVID-19,090626,COVID19 - Ospedale di Grosseto,TOS,70-79,0,1,0,1,0,0,0,1,0,1,Toscana,ITI1
2021-01-14,COMIRNATY Vaccino a mRNA contro COVID-19,090627,COVID19 - Ospedale Mugello,TOS,16-19,1,0,0,0,1,0,0,1,0,1,Toscana,ITI1
2021-01-14,COMIRNATY Vaccino a mRNA contro COVID-19,090627,COVID19 - Ospedale Mugello,TOS,20-29,1,7,0,6,2,0,0,8,0,8,Toscana,ITI1
2021-01-14,COMIRNATY Vaccino a mRNA contro COVID-19,090627,COVID19 - Ospedale Mugello,TOS,30-39,2,5,0,4,3,0,0,7,0,7,Toscana,ITI1
2021-01-14,COMIRNATY Vaccino a mRNA contro COVID-19,090627,COVID19 - Ospedale Mugello,TOS,40-49,1,9,0,9,1,0,0,10,0,10,Toscana,ITI1
2021-01-14,COMIRNATY Vaccino a mRNA contro COVID-19,090627,COVID19 - Ospedale Mugello,TOS,50-59,4,14,0,16,2,0,0,18,0,18,Toscana,ITI1
2021-01-14,COMIRNATY Vaccino a mRNA contro COVID-19,090627,COVID19 - Ospedale Mugello,TOS,60-69,3,1,0,3,1,0,0,4,0,4,Toscana,ITI1
2021-01-14,COMIRNATY Vaccino a mRNA contro COVID-19,090629,COVID19 - Ospedale SS. Maria Annunziata,TOS,20-29,2,10,0,12,0,0,0,12,0,12,Toscana,ITI1
2021-01-14,COMIRNATY Vaccino a mRNA contro COVID-19,090629,COVID19 - Ospedale SS. Maria Annunziata,TOS,30-39,6,20,0,23,3,0,0,26,0,26,Toscana,ITI1
2021-01-14,COMIRNATY Vaccino a mRNA contro COVID-19,090629,COVID19 - Ospedale SS. Maria Annunziata,TOS,40-49,9,19,0,28,0,0,0,28,0,28,Toscana,ITI1
2021-01-14,COMIRNATY Vaccino a mRNA contro COVID-19,090629,COVID19 - Ospedale SS. Maria Annunziata,TOS,50-59,19,34,0,50,3,0,0,53,0,53,Toscana,ITI1
2021-01-14,COMIRNATY Vaccino a mRNA contro COVID-19,090629,COVID19 - Ospedale SS. Maria Annunziata,TOS,60-69,10,20,0,28,2,0,0,30,0,30,Toscana,ITI1
2021-01-14,COMIRNATY Vaccino a mRNA contro COVID-19,090629,COVID19 - Ospedale SS. Maria Annunziata,TOS,70-79,1,0,0,1,0,0,0,1,0,1,Toscana,ITI1
2021-01-14,COMIRNATY Vaccino a mRNA contro COVID-19,090632,COVID19 - Ospedale Santa Maria Nuova,TOS,20-29,3,13,0,16,0,0,0,16,0,16,Toscana,ITI1
2021-01-14,COMIRNATY Vaccino a mRNA contro COVID-19,090632,COVID19 - Ospedale Santa Maria Nuova,TOS,30-39,7,7,0,14,0,0,0,14,0,14,Toscana,ITI1
2021-01-14,COMIRNATY Vaccino a mRNA contro COVID-19,090632,COVID19 - Ospedale Santa Maria Nuova,TOS,40-49,3,16,0,19,0,0,0,19,0,19,Toscana,ITI1
2021-01-14,COMIRNATY Vaccino a mRNA contro COVID-19,090632,COVID19 - Ospedale Santa Maria Nuova,TOS,50-59,8,22,0,30,0,0,0,30,0,30,Toscana,ITI1
2021-01-14,COMIRNATY Vaccino a mRNA contro COVID-19,090632,COVID19 - Ospedale Santa Maria Nuova,TOS,60-69,9,13,0,22,0,0,0,22,0,22,Toscana,ITI1
2021-01-14,COMIRNATY Vaccino a mRNA contro COVID-19,090632,COVID19 - Ospedale Santa Maria Nuova,TOS,70-79,1,0,0,1,0,0,0,1,0,1,Toscana,ITI1
2021-01-14,COMIRNATY Vaccino a mRNA contro COVID-19,090638,COVID19 - Ospedale di Campostaggia Poggibonsi,TOS,20-29,4,5,0,9,0,0,0,9,0,9,Toscana,ITI1
2021-01-14,COMIRNATY Vaccino a mRNA contro COVID-19,090638,COVID19 - Ospedale di Campostaggia Poggibonsi,TOS,30-39,2,8,0,10,0,0,0,10,0,10,Toscana,ITI1
2021-01-14,COMIRNATY Vaccino a mRNA contro COVID-19,090638,COVID19 - Ospedale di Campostaggia Poggibonsi,TOS,40-49,6,22,0,28,0,0,0,28,0,28,Toscana,ITI1
2021-01-14,COMIRNATY Vaccino a mRNA contro COVID-19,090638,COVID19 - Ospedale di Campostaggia Poggibonsi,TOS,50-59,7,25,0,30,1,1,0,32,0,32,Toscana,ITI1
2021-01-14,COMIRNATY Vaccino a mRNA contro COVID-19,090638,COVID19 - Ospedale di Campostaggia Poggibonsi,TOS,60-69,8,8,0,16,0,0,0,16,0,16,Toscana,ITI1
2021-01-14,COMIRNATY Vaccino a mRNA contro COVID-19,090639,COVID19 - Ospedale di Nottola Montepulciano,TOS,20-29,2,4,0,6,0,0,0,6,0,6,Toscana,ITI1
2021-01-14,COMIRNATY Vaccino a mRNA contro COVID-19,090639,COVID19 - Ospedale di Nottola Montepulciano,TOS,30-39,3,7,0,10,0,0,0,10,0,10,Toscana,ITI1
2021-01-14,COMIRNATY Vaccino a mRNA contro COVID-19,090639,COVID19 - Ospedale di Nottola Montepulciano,TOS,40-49,3,8,0,11,0,0,0,11,0,11,Toscana,ITI1
2021-01-14,COMIRNATY Vaccino a mRNA contro COVID-19,090639,COVID19 - Ospedale di Nottola Montepulciano,TOS,50-59,6,9,0,12,3,0,0,15,0,15,Toscana,ITI1
2021-01-14,COMIRNATY Vaccino a mRNA contro COVID-19,090639,COVID19 - Ospedale di Nottola Montepulciano,TOS,60-69,1,5,0,5,1,0,0,6,0,6,Toscana,ITI1
2021-01-14,COMIRNATY Vaccino a mRNA contro COVID-19,090640,Covid 19 - Ospedale Unico Versilia,TOS,20-29,2,3,0,5,0,0,0,5,0,5,Toscana,ITI1
2021-01-14,COMIRNATY Vaccino a mRNA contro COVID-19,090640,Covid 19 - Ospedale Unico Versilia,TOS,30-39,7,5,0,10,2,0,0,12,0,12,Toscana,ITI1
2021-01-14,COMIRNATY Vaccino a mRNA contro COVID-19,090640,Covid 19 - Ospedale Unico Versilia,TOS,40-49,7,15,0,20,2,0,0,22,0,22,Toscana,ITI1
2021-01-14,COMIRNATY Vaccino a mRNA contro COVID-19,090640,Covid 19 - Ospedale Unico Versilia,TOS,50-59,13,20,0,32,1,0,0,33,0,33,Toscana,ITI1
2021-01-14,COMIRNATY Vaccino a mRNA contro COVID-19,090640,Covid 19 - Ospedale Unico Versilia,TOS,60-69,7,9,0,16,0,0,0,16,0,16,Toscana,ITI1
2021-01-14,COMIRNATY Vaccino a mRNA contro COVID-19,090640,Covid 19 - Ospedale Unico Versilia,TOS,70-79,2,0,0,2,0,0,0,2,0,2,Toscana,ITI1
2021-01-14,COMIRNATY Vaccino a mRNA contro COVID-19,090641,COVID19 - Ospedale La Gruccia Montevarchi,TOS,20-29,2,2,0,4,0,0,0,4,0,4,Toscana,ITI1
2021-01-14,COMIRNATY Vaccino a mRNA contro COVID-19,090641,COVID19 - Ospedale La Gruccia Montevarchi,TOS,30-39,5,6,0,11,0,0,0,11,0,11,Toscana,ITI1
2021-01-14,COMIRNATY Vaccino a mRNA contro COVID-19,090641,COVID19 - Ospedale La Gruccia Montevarchi,TOS,40-49,1,10,0,11,0,0,0,11,0,11,Toscana,ITI1
2021-01-14,COMIRNATY Vaccino a mRNA contro COVID-19,090641,COVID19 - Ospedale La Gruccia Montevarchi,TOS,50-59,3,13,0,16,0,0,0,16,0,16,Toscana,ITI1
2021-01-14,COMIRNATY Vaccino a mRNA contro COVID-19,090641,COVID19 - Ospedale La Gruccia Montevarchi,TOS,60-69,0,6,0,6,0,0,0,6,0,6,Toscana,ITI1
2021-01-14,COMIRNATY Vaccino a mRNA contro COVID-19,090901,COVID19 - AOU Pisana,TOS,16-19,1,0,0,0,1,0,0,1,0,1,Toscana,ITI1
2021-01-14,COMIRNATY Vaccino a mRNA contro COVID-19,090901,COVID19 - AOU Pisana,TOS,20-29,6,8,0,10,4,0,0,14,0,14,Toscana,ITI1
2021-01-14,COMIRNATY Vaccino a mRNA contro COVID-19,090901,COVID19 - AOU Pisana,TOS,30-39,11,15,0,13,13,0,0,26,0,26,Toscana,ITI1
2021-01-14,COMIRNATY Vaccino a mRNA contro COVID-19,090901,COVID19 - AOU Pisana,TOS,40-49,31,33,0,25,38,1,0,64,0,64,Toscana,ITI1
2021-01-14,COMIRNATY Vaccino a mRNA contro COVID-19,090901,COVID19 - AOU Pisana,TOS,50-59,22,65,0,41,46,0,0,87,0,87,Toscana,ITI1
2021-01-14,COMIRNATY Vaccino a mRNA contro COVID-19,090901,COVID19 - AOU Pisana,TOS,60-69,9,13,0,9,13,0,0,22,0,22,Toscana,ITI1
2021-01-14,COMIRNATY Vaccino a mRNA contro COVID-19,090901,COVID19 - AOU Pisana,TOS,70-79,1,1,0,1,1,0,0,2,0,2,Toscana,ITI1
2021-01-14,COMIRNATY Vaccino a mRNA contro COVID-19,090902,COVID19 - AOU Senese,TOS,16-19,0,1,0,1,0,0,0,1,0,1,Toscana,ITI1
2021-01-14,COMIRNATY Vaccino a mRNA contro COVID-19,090902,COVID19 - AOU Senese,TOS,20-29,31,38,0,65,4,0,0,69,0,69,Toscana,ITI1
2021-01-14,COMIRNATY Vaccino a mRNA contro COVID-19,090902,COVID19 - AOU Senese,TOS,30-39,13,17,0,30,0,0,0,30,0,30,Toscana,ITI1
2021-01-14,COMIRNATY Vaccino a mRNA contro COVID-19,090902,COVID19 - AOU Senese,TOS,40-49,11,23,0,34,0,0,0,34,0,34,Toscana,ITI1
2021-01-14,COMIRNATY Vaccino a mRNA contro COVID-19,090902,COVID19 - AOU Senese,TOS,50-59,16,48,0,63,1,0,0,64,0,64,Toscana,ITI1
2021-01-14,COMIRNATY Vaccino a mRNA contro COVID-19,090902,COVID19 - AOU Senese,TOS,60-69,6,12,0,18,0,0,0,18,0,18,Toscana,ITI1
2021-01-14,COMIRNATY Vaccino a mRNA contro COVID-19,090903,COVID19 - AOU Careggi - CTO,TOS,16-19,1,4,0,3,2,0,0,5,0,5,Toscana,ITI1
2021-01-14,COMIRNATY Vaccino a mRNA contro COVID-19,090903,COVID19 - AOU Careggi - CTO,TOS,20-29,26,38,0,50,14,0,0,64,0,64,Toscana,ITI1
2021-01-14,COMIRNATY Vaccino a mRNA contro COVID-19,090903,COVID19 - AOU Careggi - CTO,TOS,30-39,17,33,0,24,26,0,0,50,0,50,Toscana,ITI1
2021-01-14,COMIRNATY Vaccino a mRNA contro COVID-19,090903,COVID19 - AOU Careggi - CTO,TOS,40-49,21,33,0,16,38,0,0,54,0,54,Toscana,ITI1
2021-01-14,COMIRNATY Vaccino a mRNA contro COVID-19,090903,COVID19 - AOU Careggi - CTO,TOS,50-59,26,39,0,13,52,0,0,65,0,65,Toscana,ITI1
2021-01-14,COMIRNATY Vaccino a mRNA contro COVID-19,090903,COVID19 - AOU Careggi - CTO,TOS,60-69,4,16,0,7,13,0,0,20,0,20,Toscana,ITI1
2021-01-14,COMIRNATY Vaccino a mRNA contro COVID-19,090903,COVID19 - AOU Careggi - CTO,TOS,70-79,3,2,0,4,1,0,0,5,0,5,Toscana,ITI1
2021-01-14,COMIRNATY Vaccino a mRNA contro COVID-19,090903,COVID19 - AOU Careggi - PIASTRA,TOS,16-19,0,2,0,2,0,0,0,2,0,2,Toscana,ITI1
2021-01-14,COMIRNATY Vaccino a mRNA contro COVID-19,090903,COVID19 - AOU Careggi - PIASTRA,TOS,20-29,11,8,0,19,0,0,0,19,0,19,Toscana,ITI1
2021-01-14,COMIRNATY Vaccino a mRNA contro COVID-19,090903,COVID19 - AOU Careggi - PIASTRA,TOS,30-39,4,9,0,13,0,0,0,13,0,13,Toscana,ITI1
2021-01-14,COMIRNATY Vaccino a mRNA contro COVID-19,090903,COVID19 - AOU Careggi - PIASTRA,TOS,40-49,6,7,0,12,0,1,0,13,0,13,Toscana,ITI1
2021-01-14,COMIRNATY Vaccino a mRNA contro COVID-19,090903,COVID19 - AOU Careggi - PIASTRA,TOS,50-59,10,17,0,27,0,0,0,27,0,27,Toscana,ITI1
2021-01-14,COMIRNATY Vaccino a mRNA contro COVID-19,090903,COVID19 - AOU Careggi - PIASTRA,TOS,60-69,2,8,0,10,0,0,0,10,0,10,Toscana,ITI1
2021-01-14,COMIRNATY Vaccino a mRNA contro COVID-19,090904,COVID19 - Ospedale AOU Meyer,TOS,20-29,3,7,0,5,5,0,0,10,0,10,Toscana,ITI1
2021-01-14,COMIRNATY Vaccino a mRNA contro COVID-19,090904,COVID19 - Ospedale AOU Meyer,TOS,30-39,7,14,0,8,13,0,0,21,0,21,Toscana,ITI1
2021-01-14,COMIRNATY Vaccino a mRNA contro COVID-19,090904,COVID19 - Ospedale AOU Meyer,TOS,40-49,5,11,0,7,9,0,0,16,0,16,Toscana,ITI1
2021-01-14,COMIRNATY Vaccino a mRNA contro COVID-19,090904,COVID19 - Ospedale AOU Meyer,TOS,50-59,5,27,0,17,15,0,0,32,0,32,Toscana,ITI1
2021-01-14,COMIRNATY Vaccino a mRNA contro COVID-19,090904,COVID19 - Ospedale AOU Meyer,TOS,60-69,5,11,0,13,3,0,0,16,0,16,Toscana,ITI1
2021-01-14,COMIRNATY Vaccino a mRNA contro COVID-19,090904,COVID19 - Ospedale AOU Meyer,TOS,70-79,1,0,0,0,1,0,0,1,0,1,Toscana,ITI1
2021-01-14,COMIRNATY Vaccino a mRNA contro COVID-19,11012E,COVID19 - Ospedale San Giuseppe,TOS,20-29,4,8,0,11,1,0,0,12,0,12,Toscana,ITI1
2021-01-14,COMIRNATY Vaccino a mRNA contro COVID-19,11012E,COVID19 - Ospedale San Giuseppe,TOS,30-39,6,9,0,15,0,0,0,15,0,15,Toscana,ITI1
2021-01-14,COMIRNATY Vaccino a mRNA contro COVID-19,11012E,COVID19 - Ospedale San Giuseppe,TOS,40-49,13,29,0,41,1,0,0,42,0,42,Toscana,ITI1
2021-01-14,COMIRNATY Vaccino a mRNA contro COVID-19,11012E,COVID19 - Ospedale San Giuseppe,TOS,50-59,21,36,0,54,3,0,0,57,0,57,Toscana,ITI1
2021-01-14,COMIRNATY Vaccino a mRNA contro COVID-19,11012E,COVID19 - Ospedale San Giuseppe,TOS,60-69,8,14,0,22,0,0,0,22,0,22,Toscana,ITI1
2021-01-14,COMIRNATY Vaccino a mRNA contro COVID-19,11012E,COVID19 - Ospedale San Giuseppe,TOS,70-79,1,1,0,2,0,0,0,2,0,2,Toscana,ITI1
2021-01-14,COMIRNATY Vaccino a mRNA contro COVID-19,12011A,Distretto Sanitario - Pontremoli,TOS,20-29,0,3,0,3,0,0,0,3,0,3,Toscana,ITI1
2021-01-14,COMIRNATY Vaccino a mRNA contro COVID-19,12011A,Distretto Sanitario - Pontremoli,TOS,30-39,1,4,0,4,1,0,0,5,0,5,Toscana,ITI1
2021-01-14,COMIRNATY Vaccino a mRNA contro COVID-19,12011A,Distretto Sanitario - Pontremoli,TOS,40-49,1,9,0,9,1,0,0,10,0,10,Toscana,ITI1
2021-01-14,COMIRNATY Vaccino a mRNA contro COVID-19,12011A,Distretto Sanitario - Pontremoli,TOS,50-59,0,4,0,3,1,0,0,4,0,4,Toscana,ITI1
2021-01-14,COMIRNATY Vaccino a mRNA contro COVID-19,12011A,Distretto Sanitario - Pontremoli,TOS,60-69,2,5,0,6,1,0,0,7,0,7,Toscana,ITI1
2021-01-14,COMIRNATY Vaccino a mRNA contro COVID-19,12011A,Distretto Sanitario - Pontremoli,TOS,70-79,1,0,0,0,1,0,0,1,0,1,Toscana,ITI1
2021-01-14,COMIRNATY Vaccino a mRNA contro COVID-19,13021A,COVID19 - Ospedale S.Giovanni di Dio,TOS,16-19,0,1,0,0,0,1,0,1,0,1,Toscana,ITI1
2021-01-14,COMIRNATY Vaccino a mRNA contro COVID-19,13021A,COVID19 - Ospedale S.Giovanni di Dio,TOS,20-29,17,23,0,25,0,15,0,40,0,40,Toscana,ITI1
2021-01-14,COMIRNATY Vaccino a mRNA contro COVID-19,13021A,COVID19 - Ospedale S.Giovanni di Dio,TOS,30-39,21,17,0,34,0,4,0,38,0,38,Toscana,ITI1
2021-01-14,COMIRNATY Vaccino a mRNA contro COVID-19,13021A,COVID19 - Ospedale S.Giovanni di Dio,TOS,40-49,22,19,0,38,0,3,0,41,0,41,Toscana,ITI1
2021-01-14,COMIRNATY Vaccino a mRNA contro COVID-19,13021A,COVID19 - Ospedale S.Giovanni di Dio,TOS,50-59,28,37,0,52,0,13,0,65,0,65,Toscana,ITI1
2021-01-14,COMIRNATY Vaccino a mRNA contro COVID-19,13021A,COVID19 - Ospedale S.Giovanni di Dio,TOS,60-69,47,24,0,42,0,29,0,71,0,71,Toscana,ITI1
2021-01-14,COMIRNATY Vaccino a mRNA contro COVID-19,13021A,COVID19 - Ospedale S.Giovanni di Dio,TOS,70-79,9,4,0,7,0,6,0,13,0,13,Toscana,ITI1
2021-01-14,COMIRNATY Vaccino a mRNA contro COVID-19,13021A,COVID19 - Ospedale S.Giovanni di Dio,TOS,80-89,1,0,0,1,0,0,0,1,0,1,Toscana,ITI1
2021-01-14,COMIRNATY Vaccino a mRNA contro COVID-19,13294I,Covi19 - RSA VILLA ROSA,TOS,30-39,1,0,0,1,0,0,0,1,0,1,Toscana,ITI1
2021-01-14,COMIRNATY Vaccino a mRNA contro COVID-19,13294I,Covi19 - RSA VILLA ROSA,TOS,40-49,0,1,0,1,0,0,0,1,0,1,Toscana,ITI1
2021-01-14,COMIRNATY Vaccino a mRNA contro COVID-19,13294I,Covi19 - RSA VILLA ROSA,TOS,50-59,1,0,0,1,0,0,0,1,0,1,Toscana,ITI1
2021-01-14,COMIRNATY Vaccino a mRNA contro COVID-19,13294I,Covi19 - RSA VILLA ROSA,TOS,70-79,2,1,0,2,0,1,0,3,0,3,Toscana,ITI1
2021-01-14,COMIRNATY Vaccino a mRNA contro COVID-19,22011A,PRESIDIO MASSA CENTRO,TOS,20-29,1,3,0,4,0,0,0,4,0,4,Toscana,ITI1
2021-01-14,COMIRNATY Vaccino a mRNA contro COVID-19,22011A,PRESIDIO MASSA CENTRO,TOS,30-39,3,8,0,11,0,0,0,11,0,11,Toscana,ITI1
2021-01-14,COMIRNATY Vaccino a mRNA contro COVID-19,22011A,PRESIDIO MASSA CENTRO,TOS,40-49,8,19,0,27,0,0,0,27,0,27,Toscana,ITI1
2021-01-14,COMIRNATY Vaccino a mRNA contro COVID-19,22011A,PRESIDIO MASSA CENTRO,TOS,50-59,3,22,0,25,0,0,0,25,0,25,Toscana,ITI1
2021-01-14,COMIRNATY Vaccino a mRNA contro COVID-19,22011A,PRESIDIO MASSA CENTRO,TOS,60-69,8,13,0,21,0,0,0,21,0,21,Toscana,ITI1
2021-01-14,COMIRNATY Vaccino a mRNA contro COVID-19,22011A,PRESIDIO MASSA CENTRO,TOS,70-79,1,0,0,1,0,0,0,1,0,1,Toscana,ITI1
2021-01-14,COMIRNATY Vaccino a mRNA contro COVID-19,22011A,PRESIDIO MASSA CENTRO,TOS,80-89,1,0,0,1,0,0,0,1,0,1,Toscana,ITI1
2021-01-14,COMIRNATY Vaccino a mRNA contro COVID-19,40911A,COVID19 - Dip. Prevenzione Ruffolo Siena,TOS,20-29,5,8,0,13,0,0,0,13,0,13,Toscana,ITI1
2021-01-14,COMIRNATY Vaccino a mRNA contro COVID-19,40911A,COVID19 - Dip. Prevenzione Ruffolo Siena,TOS,30-39,3,3,0,6,0,0,0,6,0,6,Toscana,ITI1
2021-01-14,COMIRNATY Vaccino a mRNA contro COVID-19,40911A,COVID19 - Dip. Prevenzione Ruffolo Siena,TOS,40-49,1,6,0,7,0,0,0,7,0,7,Toscana,ITI1
2021-01-14,COMIRNATY Vaccino a mRNA contro COVID-19,40911A,COVID19 - Dip. Prevenzione Ruffolo Siena,TOS,50-59,4,6,0,9,0,1,0,10,0,10,Toscana,ITI1
2021-01-14,COMIRNATY Vaccino a mRNA contro COVID-19,40911A,COVID19 - Dip. Prevenzione Ruffolo Siena,TOS,60-69,7,6,0,9,0,4,0,13,0,13,Toscana,ITI1
2021-01-14,COMIRNATY Vaccino a mRNA contro COVID-19,40911A,COVID19 - Dip. Prevenzione Ruffolo Siena,TOS,70-79,5,3,0,0,0,8,0,8,0,8,Toscana,ITI1
2021-01-14,COMIRNATY Vaccino a mRNA contro COVID-19,40911A,COVID19 - Dip. Prevenzione Ruffolo Siena,TOS,80-89,5,5,0,1,0,9,0,10,0,10,Toscana,ITI1
2021-01-14,COMIRNATY Vaccino a mRNA contro COVID-19,40911A,COVID19 - Dip. Prevenzione Ruffolo Siena,TOS,90+,1,10,0,4,0,7,0,11,0,11,Toscana,ITI1
2021-01-14,COMIRNATY Vaccino a mRNA contro COVID-19,46151A,CSS Portoferraio,TOS,16-19,1,1,0,2,0,0,0,2,0,2,Toscana,ITI1
2021-01-14,COMIRNATY Vaccino a mRNA contro COVID-19,46151A,CSS Portoferraio,TOS,20-29,1,6,0,7,0,0,0,7,0,7,Toscana,ITI1
2021-01-14,COMIRNATY Vaccino a mRNA contro COVID-19,46151A,CSS Portoferraio,TOS,30-39,3,3,0,6,0,0,0,6,0,6,Toscana,ITI1
2021-01-14,COMIRNATY Vaccino a mRNA contro COVID-19,46151A,CSS Portoferraio,TOS,40-49,4,4,0,8,0,0,0,8,0,8,Toscana,ITI1
2021-01-14,COMIRNATY Vaccino a mRNA contro COVID-19,46151A,CSS Portoferraio,TOS,50-59,7,7,0,14,0,0,0,14,0,14,Toscana,ITI1
2021-01-14,COMIRNATY Vaccino a mRNA contro COVID-19,46151A,CSS Portoferraio,TOS,60-69,6,4,0,10,0,0,0,10,0,10,Toscana,ITI1
2021-01-14,COMIRNATY Vaccino a mRNA contro COVID-19,46151A,CSS Portoferraio,TOS,70-79,1,0,0,1,0,0,0,1,0,1,Toscana,ITI1
2021-01-14,COMIRNATY Vaccino a mRNA contro COVID-19,46914I,RSA S.MARIA DELLA PACE,TOS,20-29,1,1,0,2,0,0,0,2,0,2,Toscana,ITI1
2021-01-14,COMIRNATY Vaccino a mRNA contro COVID-19,46914I,RSA S.MARIA DELLA PACE,TOS,60-69,2,0,0,0,1,1,0,2,0,2,Toscana,ITI1
2021-01-14,COMIRNATY Vaccino a mRNA contro COVID-19,46914I,RSA S.MARIA DELLA PACE,TOS,70-79,1,0,0,0,0,1,0,1,0,1,Toscana,ITI1
2021-01-14,COMIRNATY Vaccino a mRNA contro COVID-19,46914I,RSA S.MARIA DELLA PACE,TOS,80-89,1,5,0,0,0,6,0,6,0,6,Toscana,ITI1
2021-01-14,COMIRNATY Vaccino a mRNA contro COVID-19,46914I,RSA S.MARIA DELLA PACE,TOS,90+,2,3,0,0,0,5,0,5,0,5,Toscana,ITI1
2021-01-14,COMIRNATY Vaccino a mRNA contro COVID-19,80024I,CASA SERENA MEZZANA RESIDENZIA,TOS,70-79,0,3,0,0,0,3,0,3,0,3,Toscana,ITI1
2021-01-14,COMIRNATY Vaccino a mRNA contro COVID-19,80024I,CASA SERENA MEZZANA RESIDENZIA,TOS,80-89,1,3,0,0,0,4,0,4,0,4,Toscana,ITI1
2021-01-14,COMIRNATY Vaccino a mRNA contro COVID-19,80024I,CASA SERENA MEZZANA RESIDENZIA,TOS,90+,1,4,0,0,0,5,0,5,0,5,Toscana,ITI1
2021-01-14,COMIRNATY Vaccino a mRNA contro COVID-19,80104I,R.S.A LUISA E LIVIO CAMOZZI,TOS,16-19,0,1,0,1,0,0,0,1,0,1,Toscana,ITI1
2021-01-14,COMIRNATY Vaccino a mRNA contro COVID-19,80104I,R.S.A LUISA E LIVIO CAMOZZI,TOS,30-39,0,1,0,1,0,0,0,1,0,1,Toscana,ITI1
2021-01-14,COMIRNATY Vaccino a mRNA contro COVID-19,80104I,R.S.A LUISA E LIVIO CAMOZZI,TOS,50-59,1,2,0,3,0,0,0,3,0,3,Toscana,ITI1
2021-01-14,COMIRNATY Vaccino a mRNA contro COVID-19,80104I,R.S.A LUISA E LIVIO CAMOZZI,TOS,60-69,0,3,0,0,0,3,0,3,0,3,Toscana,ITI1
2021-01-14,COMIRNATY Vaccino a mRNA contro COVID-19,80104I,R.S.A LUISA E LIVIO CAMOZZI,TOS,70-79,2,3,0,0,0,5,0,5,0,5,Toscana,ITI1
2021-01-14,COMIRNATY Vaccino a mRNA contro COVID-19,80104I,R.S.A LUISA E LIVIO CAMOZZI,TOS,80-89,3,12,0,0,0,15,0,15,0,15,Toscana,ITI1
2021-01-14,COMIRNATY Vaccino a mRNA contro COVID-19,80104I,R.S.A LUISA E LIVIO CAMOZZI,TOS,90+,1,19,0,0,0,20,0,20,0,20,Toscana,ITI1
2021-01-14,COMIRNATY Vaccino a mRNA contro COVID-19,80264I,RSA ROSALIBRI,TOS,40-49,0,1,0,1,0,0,0,1,0,1,Toscana,ITI1
2021-01-14,COMIRNATY Vaccino a mRNA contro COVID-19,80264I,RSA ROSALIBRI,TOS,70-79,1,0,0,0,0,1,0,1,0,1,Toscana,ITI1
2021-01-14,COMIRNATY Vaccino a mRNA contro COVID-19,80304I,RSA TAVARNELLE,TOS,40-49,0,1,0,1,0,0,0,1,0,1,Toscana,ITI1
2021-01-14,COMIRNATY Vaccino a mRNA contro COVID-19,80304I,RSA TAVARNELLE,TOS,50-59,0,3,0,3,0,0,0,3,0,3,Toscana,ITI1
2021-01-14,COMIRNATY Vaccino a mRNA contro COVID-19,80304I,RSA TAVARNELLE,TOS,70-79,0,2,0,0,0,2,0,2,0,2,Toscana,ITI1
2021-01-14,COMIRNATY Vaccino a mRNA contro COVID-19,80304I,RSA TAVARNELLE,TOS,80-89,3,10,0,0,0,13,0,13,0,13,Toscana,ITI1
2021-01-14,COMIRNATY Vaccino a mRNA contro COVID-19,80304I,RSA TAVARNELLE,TOS,90+,2,7,0,0,0,9,0,9,0,9,Toscana,ITI1
2021-01-15,COMIRNATY Vaccino a mRNA contro COVID-19,04001A,Campo di Marte Lucca - iGIENE PUBBLICA,TOS,20-29,4,6,0,8,2,0,0,10,0,10,Toscana,ITI1
2021-01-15,COMIRNATY Vaccino a mRNA contro COVID-19,04001A,Campo di Marte Lucca - iGIENE PUBBLICA,TOS,30-39,5,9,0,13,1,0,0,14,0,14,Toscana,ITI1
2021-01-15,COMIRNATY Vaccino a mRNA contro COVID-19,04001A,Campo di Marte Lucca - iGIENE PUBBLICA,TOS,40-49,7,16,0,21,2,0,0,23,0,23,Toscana,ITI1
2021-01-15,COMIRNATY Vaccino a mRNA contro COVID-19,04001A,Campo di Marte Lucca - iGIENE PUBBLICA,TOS,50-59,2,25,0,25,1,1,0,27,0,27,Toscana,ITI1
2021-01-15,COMIRNATY Vaccino a mRNA contro COVID-19,04001A,Campo di Marte Lucca - iGIENE PUBBLICA,TOS,60-69,6,9,0,15,0,0,0,15,0,15,Toscana,ITI1
2021-01-15,COMIRNATY Vaccino a mRNA contro COVID-19,04001A,Campo di Marte Lucca - iGIENE PUBBLICA,TOS,70-79,1,0,0,1,0,0,0,1,0,1,Toscana,ITI1
2021-01-15,COMIRNATY Vaccino a mRNA contro COVID-19,090606,COVID19 - Ospedale San Iacopo,TOS,20-29,11,11,0,9,3,10,0,22,0,22,Toscana,ITI1
2021-01-15,COMIRNATY Vaccino a mRNA contro COVID-19,090606,COVID19 - Ospedale San Iacopo,TOS,30-39,27,21,0,18,11,19,0,48,0,48,Toscana,ITI1
2021-01-15,COMIRNATY Vaccino a mRNA contro COVID-19,090606,COVID19 - Ospedale San Iacopo,TOS,40-49,23,40,0,38,7,18,0,63,0,63,Toscana,ITI1
2021-01-15,COMIRNATY Vaccino a mRNA contro COVID-19,090606,COVID19 - Ospedale San Iacopo,TOS,50-59,26,43,0,47,13,9,0,69,0,69,Toscana,ITI1
2021-01-15,COMIRNATY Vaccino a mRNA contro COVID-19,090606,COVID19 - Ospedale San Iacopo,TOS,60-69,9,15,0,17,7,0,0,24,0,24,Toscana,ITI1
2021-01-15,COMIRNATY Vaccino a mRNA contro COVID-19,090606,COVID19 - Ospedale San Iacopo,TOS,70-79,1,0,0,1,0,0,0,1,0,1,Toscana,ITI1
2021-01-15,COMIRNATY Vaccino a mRNA contro COVID-19,090607,COVID19 - Ospedale SS.Cosma e Damiano,TOS,20-29,1,2,0,3,0,0,0,3,0,3,Toscana,ITI1
2021-01-15,COMIRNATY Vaccino a mRNA contro COVID-19,090607,COVID19 - Ospedale SS.Cosma e Damiano,TOS,30-39,2,4,0,6,0,0,0,6,0,6,Toscana,ITI1
2021-01-15,COMIRNATY Vaccino a mRNA contro COVID-19,090607,COVID19 - Ospedale SS.Cosma e Damiano,TOS,40-49,2,10,0,12,0,0,0,12,0,12,Toscana,ITI1
2021-01-15,COMIRNATY Vaccino a mRNA contro COVID-19,090607,COVID19 - Ospedale SS.Cosma e Damiano,TOS,50-59,2,17,0,16,3,0,0,19,0,19,Toscana,ITI1
2021-01-15,COMIRNATY Vaccino a mRNA contro COVID-19,090607,COVID19 - Ospedale SS.Cosma e Damiano,TOS,60-69,4,4,0,8,0,0,0,8,0,8,Toscana,ITI1
2021-01-15,COMIRNATY Vaccino a mRNA contro COVID-19,090608,COVID19 - Ospedale Santo Stefano,TOS,20-29,7,7,0,12,1,1,0,14,0,14,Toscana,ITI1
2021-01-15,COMIRNATY Vaccino a mRNA contro COVID-19,090608,COVID19 - Ospedale Santo Stefano,TOS,30-39,11,19,0,24,6,0,0,30,0,30,Toscana,ITI1
2021-01-15,COMIRNATY Vaccino a mRNA contro COVID-19,090608,COVID19 - Ospedale Santo Stefano,TOS,40-49,16,22,0,26,11,1,0,38,0,38,Toscana,ITI1
2021-01-15,COMIRNATY Vaccino a mRNA contro COVID-19,090608,COVID19 - Ospedale Santo Stefano,TOS,50-59,14,38,0,42,10,0,0,52,0,52,Toscana,ITI1
2021-01-15,COMIRNATY Vaccino a mRNA contro COVID-19,090608,COVID19 - Ospedale Santo Stefano,TOS,60-69,5,12,0,15,2,0,0,17,0,17,Toscana,ITI1
2021-01-15,COMIRNATY Vaccino a mRNA contro COVID-19,090610,Covid 19 - Ospedale F.Lotti di Pontedera,TOS,20-29,2,9,0,10,0,1,0,11,0,11,Toscana,ITI1
2021-01-15,COMIRNATY Vaccino a mRNA contro COVID-19,090610,Covid 19 - Ospedale F.Lotti di Pontedera,TOS,30-39,7,7,0,14,0,0,0,14,0,14,Toscana,ITI1
2021-01-15,COMIRNATY Vaccino a mRNA contro COVID-19,090610,Covid 19 - Ospedale F.Lotti di Pontedera,TOS,40-49,7,10,0,17,0,0,0,17,0,17,Toscana,ITI1
2021-01-15,COMIRNATY Vaccino a mRNA contro COVID-19,090610,Covid 19 - Ospedale F.Lotti di Pontedera,TOS,50-59,3,6,0,9,0,0,0,9,0,9,Toscana,ITI1
2021-01-15,COMIRNATY Vaccino a mRNA contro COVID-19,090610,Covid 19 - Ospedale F.Lotti di Pontedera,TOS,60-69,4,5,0,9,0,0,0,9,0,9,Toscana,ITI1
2021-01-15,COMIRNATY Vaccino a mRNA contro COVID-19,090613,Covid 19 - Ospedali Riuniti di Livorno,TOS,20-29,3,4,0,7,0,0,0,7,0,7,Toscana,ITI1
2021-01-15,COMIRNATY Vaccino a mRNA contro COVID-19,090613,Covid 19 - Ospedali Riuniti di Livorno,TOS,30-39,3,7,0,10,0,0,0,10,0,10,Toscana,ITI1
2021-01-15,COMIRNATY Vaccino a mRNA contro COVID-19,090613,Covid 19 - Ospedali Riuniti di Livorno,TOS,40-49,9,17,0,26,0,0,0,26,0,26,Toscana,ITI1
2021-01-15,COMIRNATY Vaccino a mRNA contro COVID-19,090613,Covid 19 - Ospedali Riuniti di Livorno,TOS,50-59,13,24,0,37,0,0,0,37,0,37,Toscana,ITI1
2021-01-15,COMIRNATY Vaccino a mRNA contro COVID-19,090613,Covid 19 - Ospedali Riuniti di Livorno,TOS,60-69,3,7,0,10,0,0,0,10,0,10,Toscana,ITI1
2021-01-15,COMIRNATY Vaccino a mRNA contro COVID-19,090614,Covid 19 - Ospedale Civile di Piombino,TOS,20-29,0,2,0,2,0,0,0,2,0,2,Toscana,ITI1
2021-01-15,COMIRNATY Vaccino a mRNA contro COVID-19,090614,Covid 19 - Ospedale Civile di Piombino,TOS,30-39,1,4,0,5,0,0,0,5,0,5,Toscana,ITI1
2021-01-15,COMIRNATY Vaccino a mRNA contro COVID-19,090614,Covid 19 - Ospedale Civile di Piombino,TOS,40-49,0,6,0,6,0,0,0,6,0,6,Toscana,ITI1
2021-01-15,COMIRNATY Vaccino a mRNA contro COVID-19,090614,Covid 19 - Ospedale Civile di Piombino,TOS,50-59,2,5,0,7,0,0,0,7,0,7,Toscana,ITI1
2021-01-15,COMIRNATY Vaccino a mRNA contro COVID-19,090614,Covid 19 - Ospedale Civile di Piombino,TOS,60-69,6,4,0,10,0,0,0,10,0,10,Toscana,ITI1
2021-01-15,COMIRNATY Vaccino a mRNA contro COVID-19,090621,COVID19 - Ospedale di Arezzo,TOS,20-29,6,25,0,30,1,0,0,31,0,31,Toscana,ITI1
2021-01-15,COMIRNATY Vaccino a mRNA contro COVID-19,090621,COVID19 - Ospedale di Arezzo,TOS,30-39,6,32,0,32,6,0,0,38,0,38,Toscana,ITI1
2021-01-15,COMIRNATY Vaccino a mRNA contro COVID-19,090621,COVID19 - Ospedale di Arezzo,TOS,40-49,23,51,0,53,21,0,0,74,0,74,Toscana,ITI1
2021-01-15,COMIRNATY Vaccino a mRNA contro COVID-19,090621,COVID19 - Ospedale di Arezzo,TOS,50-59,27,74,1,83,17,0,1,101,0,101,Toscana,ITI1
2021-01-15,COMIRNATY Vaccino a mRNA contro COVID-19,090621,COVID19 - Ospedale di Arezzo,TOS,60-69,22,33,0,49,6,0,0,55,0,55,Toscana,ITI1
2021-01-15,COMIRNATY Vaccino a mRNA contro COVID-19,090621,COVID19 - Ospedale di Arezzo,TOS,70-79,1,0,0,0,1,0,0,1,0,1,Toscana,ITI1
2021-01-15,COMIRNATY Vaccino a mRNA contro COVID-19,090624,COVID19 - Ospedale di Orbetello,TOS,30-39,2,0,0,2,0,0,0,2,0,2,Toscana,ITI1
2021-01-15,COMIRNATY Vaccino a mRNA contro COVID-19,090624,COVID19 - Ospedale di Orbetello,TOS,40-49,0,1,0,1,0,0,0,1,0,1,Toscana,ITI1
2021-01-15,COMIRNATY Vaccino a mRNA contro COVID-19,090624,COVID19 - Ospedale di Orbetello,TOS,60-69,1,0,0,1,0,0,0,1,0,1,Toscana,ITI1
2021-01-15,COMIRNATY Vaccino a mRNA contro COVID-19,090626,COVID19 - Ospedale di Grosseto,TOS,16-19,0,1,0,1,0,0,0,1,0,1,Toscana,ITI1
2021-01-15,COMIRNATY Vaccino a mRNA contro COVID-19,090626,COVID19 - Ospedale di Grosseto,TOS,20-29,6,14,0,20,0,0,0,20,0,20,Toscana,ITI1
2021-01-15,COMIRNATY Vaccino a mRNA contro COVID-19,090626,COVID19 - Ospedale di Grosseto,TOS,30-39,11,16,0,27,0,0,0,27,0,27,Toscana,ITI1
2021-01-15,COMIRNATY Vaccino a mRNA contro COVID-19,090626,COVID19 - Ospedale di Grosseto,TOS,40-49,10,25,0,35,0,0,0,35,0,35,Toscana,ITI1
2021-01-15,COMIRNATY Vaccino a mRNA contro COVID-19,090626,COVID19 - Ospedale di Grosseto,TOS,50-59,21,35,0,56,0,0,0,56,0,56,Toscana,ITI1
2021-01-15,COMIRNATY Vaccino a mRNA contro COVID-19,090626,COVID19 - Ospedale di Grosseto,TOS,60-69,11,15,0,26,0,0,0,26,0,26,Toscana,ITI1
2021-01-15,COMIRNATY Vaccino a mRNA contro COVID-19,090626,COVID19 - Ospedale di Grosseto,TOS,70-79,1,0,0,1,0,0,0,1,0,1,Toscana,ITI1
2021-01-15,COMIRNATY Vaccino a mRNA contro COVID-19,090627,COVID19 - Ospedale Mugello,TOS,20-29,2,4,0,6,0,0,0,6,0,6,Toscana,ITI1
2021-01-15,COMIRNATY Vaccino a mRNA contro COVID-19,090627,COVID19 - Ospedale Mugello,TOS,30-39,4,5,0,7,2,0,0,9,0,9,Toscana,ITI1
2021-01-15,COMIRNATY Vaccino a mRNA contro COVID-19,090627,COVID19 - Ospedale Mugello,TOS,40-49,3,4,0,5,2,0,0,7,0,7,Toscana,ITI1
2021-01-15,COMIRNATY Vaccino a mRNA contro COVID-19,090627,COVID19 - Ospedale Mugello,TOS,50-59,8,19,0,24,3,0,0,27,0,27,Toscana,ITI1
2021-01-15,COMIRNATY Vaccino a mRNA contro COVID-19,090627,COVID19 - Ospedale Mugello,TOS,60-69,5,6,0,9,1,1,0,11,0,11,Toscana,ITI1
2021-01-15,COMIRNATY Vaccino a mRNA contro COVID-19,090629,COVID19 - Ospedale SS. Maria Annunziata,TOS,16-19,4,0,0,0,0,4,0,4,0,4,Toscana,ITI1
2021-01-15,COMIRNATY Vaccino a mRNA contro COVID-19,090629,COVID19 - Ospedale SS. Maria Annunziata,TOS,20-29,12,16,0,15,3,10,0,28,0,28,Toscana,ITI1
2021-01-15,COMIRNATY Vaccino a mRNA contro COVID-19,090629,COVID19 - Ospedale SS. Maria Annunziata,TOS,30-39,9,15,0,13,6,5,0,24,0,24,Toscana,ITI1
2021-01-15,COMIRNATY Vaccino a mRNA contro COVID-19,090629,COVID19 - Ospedale SS. Maria Annunziata,TOS,40-49,10,28,0,31,3,4,0,38,0,38,Toscana,ITI1
2021-01-15,COMIRNATY Vaccino a mRNA contro COVID-19,090629,COVID19 - Ospedale SS. Maria Annunziata,TOS,50-59,21,39,0,42,11,7,0,60,0,60,Toscana,ITI1
2021-01-15,COMIRNATY Vaccino a mRNA contro COVID-19,090629,COVID19 - Ospedale SS. Maria Annunziata,TOS,60-69,17,18,0,29,3,3,0,35,0,35,Toscana,ITI1
2021-01-15,COMIRNATY Vaccino a mRNA contro COVID-19,090629,COVID19 - Ospedale SS. Maria Annunziata,TOS,70-79,1,1,0,2,0,0,0,2,0,2,Toscana,ITI1
2021-01-15,COMIRNATY Vaccino a mRNA contro COVID-19,090632,COVID19 - Ospedale Santa Maria Nuova,TOS,20-29,0,15,0,15,0,0,0,15,0,15,Toscana,ITI1
2021-01-15,COMIRNATY Vaccino a mRNA contro COVID-19,090632,COVID19 - Ospedale Santa Maria Nuova,TOS,30-39,10,7,0,17,0,0,0,17,0,17,Toscana,ITI1
2021-01-15,COMIRNATY Vaccino a mRNA contro COVID-19,090632,COVID19 - Ospedale Santa Maria Nuova,TOS,40-49,3,10,0,13,0,0,0,13,0,13,Toscana,ITI1
2021-01-15,COMIRNATY Vaccino a mRNA contro COVID-19,090632,COVID19 - Ospedale Santa Maria Nuova,TOS,50-59,8,19,0,27,0,0,0,27,0,27,Toscana,ITI1
2021-01-15,COMIRNATY Vaccino a mRNA contro COVID-19,090632,COVID19 - Ospedale Santa Maria Nuova,TOS,60-69,12,17,0,29,0,0,0,29,0,29,Toscana,ITI1
2021-01-15,COMIRNATY Vaccino a mRNA contro COVID-19,090632,COVID19 - Ospedale Santa Maria Nuova,TOS,70-79,1,0,0,1,0,0,0,1,0,1,Toscana,ITI1
2021-01-15,COMIRNATY Vaccino a mRNA contro COVID-19,090640,Covid 19 - Ospedale Unico Versilia,TOS,20-29,1,5,0,6,0,0,0,6,0,6,Toscana,ITI1
2021-01-15,COMIRNATY Vaccino a mRNA contro COVID-19,090640,Covid 19 - Ospedale Unico Versilia,TOS,30-39,4,9,0,13,0,0,0,13,0,13,Toscana,ITI1
2021-01-15,COMIRNATY Vaccino a mRNA contro COVID-19,090640,Covid 19 - Ospedale Unico Versilia,TOS,40-49,6,18,0,24,0,0,0,24,0,24,Toscana,ITI1
2021-01-15,COMIRNATY Vaccino a mRNA contro COVID-19,090640,Covid 19 - Ospedale Unico Versilia,TOS,50-59,9,20,0,29,0,0,0,29,0,29,Toscana,ITI1
2021-01-15,COMIRNATY Vaccino a mRNA contro COVID-19,090640,Covid 19 - Ospedale Unico Versilia,TOS,60-69,8,8,0,16,0,0,0,16,0,16,Toscana,ITI1
2021-01-15,COMIRNATY Vaccino a mRNA contro COVID-19,090640,Covid 19 - Ospedale Unico Versilia,TOS,70-79,2,0,0,2,0,0,0,2,0,2,Toscana,ITI1
2021-01-15,COMIRNATY Vaccino a mRNA contro COVID-19,090901,COVID19 - AOU Pisana,TOS,20-29,12,15,1,25,2,0,0,27,0,27,Toscana,ITI1
2021-01-15,COMIRNATY Vaccino a mRNA contro COVID-19,090901,COVID19 - AOU Pisana,TOS,30-39,16,27,1,35,8,0,0,43,0,43,Toscana,ITI1
2021-01-15,COMIRNATY Vaccino a mRNA contro COVID-19,090901,COVID19 - AOU Pisana,TOS,40-49,23,33,1,46,10,0,0,56,0,56,Toscana,ITI1
2021-01-15,COMIRNATY Vaccino a mRNA contro COVID-19,090901,COVID19 - AOU Pisana,TOS,50-59,28,56,1,74,10,0,0,84,0,84,Toscana,ITI1
2021-01-15,COMIRNATY Vaccino a mRNA contro COVID-19,090901,COVID19 - AOU Pisana,TOS,60-69,16,29,1,36,8,0,1,45,0,45,Toscana,ITI1
2021-01-15,COMIRNATY Vaccino a mRNA contro COVID-19,090901,COVID19 - AOU Pisana,TOS,70-79,3,0,1,3,0,0,0,3,0,3,Toscana,ITI1
2021-01-15,COMIRNATY Vaccino a mRNA contro COVID-19,090902,COVID19 - AOU Senese,TOS,16-19,1,2,0,1,2,0,0,3,0,3,Toscana,ITI1
2021-01-15,COMIRNATY Vaccino a mRNA contro COVID-19,090902,COVID19 - AOU Senese,TOS,20-29,27,55,0,58,24,0,0,82,0,82,Toscana,ITI1
2021-01-15,COMIRNATY Vaccino a mRNA contro COVID-19,090902,COVID19 - AOU Senese,TOS,30-39,28,29,0,56,1,0,0,57,0,57,Toscana,ITI1
2021-01-15,COMIRNATY Vaccino a mRNA contro COVID-19,090902,COVID19 - AOU Senese,TOS,40-49,20,45,0,63,2,0,0,65,0,65,Toscana,ITI1
2021-01-15,COMIRNATY Vaccino a mRNA contro COVID-19,090902,COVID19 - AOU Senese,TOS,50-59,21,66,0,80,7,0,0,87,0,87,Toscana,ITI1
2021-01-15,COMIRNATY Vaccino a mRNA contro COVID-19,090902,COVID19 - AOU Senese,TOS,60-69,16,25,0,38,3,0,0,41,0,41,Toscana,ITI1
2021-01-15,COMIRNATY Vaccino a mRNA contro COVID-19,090902,COVID19 - AOU Senese,TOS,70-79,1,0,0,1,0,0,0,1,0,1,Toscana,ITI1
2021-01-15,COMIRNATY Vaccino a mRNA contro COVID-19,090903,COVID19 - AOU Careggi - CTO,TOS,16-19,0,4,0,4,0,0,0,4,0,4,Toscana,ITI1
2021-01-15,COMIRNATY Vaccino a mRNA contro COVID-19,090903,COVID19 - AOU Careggi - CTO,TOS,20-29,48,76,0,111,13,0,0,124,0,124,Toscana,ITI1
2021-01-15,COMIRNATY Vaccino a mRNA contro COVID-19,090903,COVID19 - AOU Careggi - CTO,TOS,30-39,33,38,0,35,35,1,0,71,0,71,Toscana,ITI1
2021-01-15,COMIRNATY Vaccino a mRNA contro COVID-19,090903,COVID19 - AOU Careggi - CTO,TOS,40-49,24,48,0,25,47,0,0,72,0,72,Toscana,ITI1
2021-01-15,COMIRNATY Vaccino a mRNA contro COVID-19,090903,COVID19 - AOU Careggi - CTO,TOS,50-59,50,56,0,32,74,0,0,106,0,106,Toscana,ITI1
2021-01-15,COMIRNATY Vaccino a mRNA contro COVID-19,090903,COVID19 - AOU Careggi - CTO,TOS,60-69,14,20,0,11,23,0,0,34,0,34,Toscana,ITI1
2021-01-15,COMIRNATY Vaccino a mRNA contro COVID-19,090903,COVID19 - AOU Careggi - CTO,TOS,70-79,2,0,0,2,0,0,0,2,0,2,Toscana,ITI1
2021-01-15,COMIRNATY Vaccino a mRNA contro COVID-19,090903,COVID19 - AOU Careggi - PIASTRA,TOS,16-19,0,4,0,4,0,0,0,4,0,4,Toscana,ITI1
2021-01-15,COMIRNATY Vaccino a mRNA contro COVID-19,090903,COVID19 - AOU Careggi - PIASTRA,TOS,20-29,13,19,0,32,0,0,0,32,0,32,Toscana,ITI1
2021-01-15,COMIRNATY Vaccino a mRNA contro COVID-19,090903,COVID19 - AOU Careggi - PIASTRA,TOS,30-39,7,5,0,12,0,0,0,12,0,12,Toscana,ITI1
2021-01-15,COMIRNATY Vaccino a mRNA contro COVID-19,090903,COVID19 - AOU Careggi - PIASTRA,TOS,40-49,1,10,0,11,0,0,0,11,0,11,Toscana,ITI1
2021-01-15,COMIRNATY Vaccino a mRNA contro COVID-19,090903,COVID19 - AOU Careggi - PIASTRA,TOS,50-59,7,13,0,20,0,0,0,20,0,20,Toscana,ITI1
2021-01-15,COMIRNATY Vaccino a mRNA contro COVID-19,090903,COVID19 - AOU Careggi - PIASTRA,TOS,60-69,2,3,0,5,0,0,0,5,0,5,Toscana,ITI1
2021-01-15,COMIRNATY Vaccino a mRNA contro COVID-19,090904,COVID19 - Ospedale AOU Meyer,TOS,20-29,5,8,0,9,4,0,0,13,0,13,Toscana,ITI1
2021-01-15,COMIRNATY Vaccino a mRNA contro COVID-19,090904,COVID19 - Ospedale AOU Meyer,TOS,30-39,4,12,0,10,6,0,0,16,0,16,Toscana,ITI1
2021-01-15,COMIRNATY Vaccino a mRNA contro COVID-19,090904,COVID19 - Ospedale AOU Meyer,TOS,40-49,13,16,0,9,20,0,0,29,0,29,Toscana,ITI1
2021-01-15,COMIRNATY Vaccino a mRNA contro COVID-19,090904,COVID19 - Ospedale AOU Meyer,TOS,50-59,11,13,0,11,13,0,0,24,0,24,Toscana,ITI1
2021-01-15,COMIRNATY Vaccino a mRNA contro COVID-19,090904,COVID19 - Ospedale AOU Meyer,TOS,60-69,3,4,0,6,1,0,0,7,0,7,Toscana,ITI1
2021-01-15,COMIRNATY Vaccino a mRNA contro COVID-19,090904,COVID19 - Ospedale AOU Meyer,TOS,70-79,1,0,0,1,0,0,0,1,0,1,Toscana,ITI1
2021-01-15,COMIRNATY Vaccino a mRNA contro COVID-19,090907,Covid19 - FTGM Pisa San Cataldo,TOS,20-29,6,8,0,4,10,0,0,14,0,14,Toscana,ITI1
2021-01-15,COMIRNATY Vaccino a mRNA contro COVID-19,090907,Covid19 - FTGM Pisa San Cataldo,TOS,30-39,6,10,0,6,10,0,0,16,0,16,Toscana,ITI1
2021-01-15,COMIRNATY Vaccino a mRNA contro COVID-19,090907,Covid19 - FTGM Pisa San Cataldo,TOS,40-49,8,15,0,0,23,0,0,23,0,23,Toscana,ITI1
2021-01-15,COMIRNATY Vaccino a mRNA contro COVID-19,090907,Covid19 - FTGM Pisa San Cataldo,TOS,50-59,11,15,0,1,25,0,0,26,0,26,Toscana,ITI1
2021-01-15,COMIRNATY Vaccino a mRNA contro COVID-19,090907,Covid19 - FTGM Pisa San Cataldo,TOS,60-69,4,6,0,2,8,0,0,10,0,10,Toscana,ITI1
2021-01-15,COMIRNATY Vaccino a mRNA contro COVID-19,090907,Covid19 - FTGM Pisa San Cataldo,TOS,70-79,1,0,0,1,0,0,0,1,0,1,Toscana,ITI1
2021-01-15,COMIRNATY Vaccino a mRNA contro COVID-19,090N07,CD DISABILI S.ROCCO,TOS,16-19,1,0,0,0,0,1,0,1,0,1,Toscana,ITI1
2021-01-15,COMIRNATY Vaccino a mRNA contro COVID-19,090N07,CD DISABILI S.ROCCO,TOS,20-29,3,3,0,0,0,6,0,6,0,6,Toscana,ITI1
2021-01-15,COMIRNATY Vaccino a mRNA contro COVID-19,090N07,CD DISABILI S.ROCCO,TOS,30-39,1,0,0,0,0,1,0,1,0,1,Toscana,ITI1
2021-01-15,COMIRNATY Vaccino a mRNA contro COVID-19,090N07,CD DISABILI S.ROCCO,TOS,40-49,1,2,0,0,0,3,0,3,0,3,Toscana,ITI1
2021-01-15,COMIRNATY Vaccino a mRNA contro COVID-19,090N07,CD DISABILI S.ROCCO,TOS,50-59,1,1,0,0,0,2,0,2,0,2,Toscana,ITI1
2021-01-15,COMIRNATY Vaccino a mRNA contro COVID-19,090N07,CD DISABILI S.ROCCO,TOS,60-69,1,1,0,0,0,2,0,2,0,2,Toscana,ITI1
2021-01-15,COMIRNATY Vaccino a mRNA contro COVID-19,11012E,COVID19 - Ospedale San Giuseppe,TOS,20-29,2,6,0,8,0,0,0,8,0,8,Toscana,ITI1
2021-01-15,COMIRNATY Vaccino a mRNA contro COVID-19,11012E,COVID19 - Ospedale San Giuseppe,TOS,30-39,5,17,0,19,3,0,0,22,0,22,Toscana,ITI1
2021-01-15,COMIRNATY Vaccino a mRNA contro COVID-19,11012E,COVID19 - Ospedale San Giuseppe,TOS,40-49,8,26,0,34,0,0,0,34,0,34,Toscana,ITI1
2021-01-15,COMIRNATY Vaccino a mRNA contro COVID-19,11012E,COVID19 - Ospedale San Giuseppe,TOS,50-59,14,39,0,51,1,1,0,53,0,53,Toscana,ITI1
2021-01-15,COMIRNATY Vaccino a mRNA contro COVID-19,11012E,COVID19 - Ospedale San Giuseppe,TOS,60-69,10,22,0,32,0,0,0,32,0,32,Toscana,ITI1
2021-01-15,COMIRNATY Vaccino a mRNA contro COVID-19,11012E,COVID19 - Ospedale San Giuseppe,TOS,70-79,1,0,0,1,0,0,0,1,0,1,Toscana,ITI1
2021-01-15,COMIRNATY Vaccino a mRNA contro COVID-19,12031A,PRESIDIO AULLA,TOS,30-39,0,2,0,2,0,0,0,2,0,2,Toscana,ITI1
2021-01-15,COMIRNATY Vaccino a mRNA contro COVID-19,12031A,PRESIDIO AULLA,TOS,40-49,2,5,0,6,1,0,0,7,0,7,Toscana,ITI1
2021-01-15,COMIRNATY Vaccino a mRNA contro COVID-19,12031A,PRESIDIO AULLA,TOS,50-59,5,9,0,14,0,0,0,14,0,14,Toscana,ITI1
2021-01-15,COMIRNATY Vaccino a mRNA contro COVID-19,12031A,PRESIDIO AULLA,TOS,60-69,5,1,0,4,2,0,0,6,0,6,Toscana,ITI1
2021-01-15,COMIRNATY Vaccino a mRNA contro COVID-19,12031A,PRESIDIO AULLA,TOS,70-79,1,0,0,1,0,0,0,1,0,1,Toscana,ITI1
2021-01-15,COMIRNATY Vaccino a mRNA contro COVID-19,12173L,CD DISABILI CERBAIOLA,TOS,20-29,3,1,0,0,0,4,0,4,0,4,Toscana,ITI1
2021-01-15,COMIRNATY Vaccino a mRNA contro COVID-19,12173L,CD DISABILI CERBAIOLA,TOS,30-39,3,2,0,0,0,5,0,5,0,5,Toscana,ITI1
2021-01-15,COMIRNATY Vaccino a mRNA contro COVID-19,12173L,CD DISABILI CERBAIOLA,TOS,40-49,3,4,0,0,0,7,0,7,0,7,Toscana,ITI1
2021-01-15,COMIRNATY Vaccino a mRNA contro COVID-19,12173L,CD DISABILI CERBAIOLA,TOS,50-59,3,1,0,0,0,4,0,4,0,4,Toscana,ITI1
2021-01-15,COMIRNATY Vaccino a mRNA contro COVID-19,12173L,CD DISABILI CERBAIOLA,TOS,60-69,1,0,0,0,0,1,0,1,0,1,Toscana,ITI1
2021-01-15,COMIRNATY Vaccino a mRNA contro COVID-19,13021A,COVID19 - Ospedale S.Giovanni di Dio,TOS,20-29,7,17,0,24,0,0,0,24,0,24,Toscana,ITI1
2021-01-15,COMIRNATY Vaccino a mRNA contro COVID-19,13021A,COVID19 - Ospedale S.Giovanni di Dio,TOS,30-39,13,17,0,29,0,1,0,30,0,30,Toscana,ITI1
2021-01-15,COMIRNATY Vaccino a mRNA contro COVID-19,13021A,COVID19 - Ospedale S.Giovanni di Dio,TOS,40-49,9,30,0,34,5,0,0,39,0,39,Toscana,ITI1
2021-01-15,COMIRNATY Vaccino a mRNA contro COVID-19,13021A,COVID19 - Ospedale S.Giovanni di Dio,TOS,50-59,17,45,0,45,4,13,0,62,0,62,Toscana,ITI1
2021-01-15,COMIRNATY Vaccino a mRNA contro COVID-19,13021A,COVID19 - Ospedale S.Giovanni di Dio,TOS,60-69,12,17,0,24,4,1,0,29,0,29,Toscana,ITI1
2021-01-15,COMIRNATY Vaccino a mRNA contro COVID-19,13021A,COVID19 - Ospedale S.Giovanni di Dio,TOS,70-79,2,13,0,2,5,8,0,15,0,15,Toscana,ITI1
2021-01-15,COMIRNATY Vaccino a mRNA contro COVID-19,13021A,COVID19 - Ospedale S.Giovanni di Dio,TOS,80-89,1,31,0,0,11,21,0,32,0,32,Toscana,ITI1
2021-01-15,COMIRNATY Vaccino a mRNA contro COVID-19,13021A,COVID19 - Ospedale S.Giovanni di Dio,TOS,90+,0,26,0,0,4,22,0,26,0,26,Toscana,ITI1
2021-01-15,COMIRNATY Vaccino a mRNA contro COVID-19,13274I,Covid19 - RSA SOGGIORNO MADRE CABRINI,TOS,50-59,0,2,0,2,0,0,0,2,0,2,Toscana,ITI1
2021-01-15,COMIRNATY Vaccino a mRNA contro COVID-19,13274I,Covid19 - RSA SOGGIORNO MADRE CABRINI,TOS,60-69,0,1,0,1,0,0,0,1,0,1,Toscana,ITI1
2021-01-15,COMIRNATY Vaccino a mRNA contro COVID-19,13274I,Covid19 - RSA SOGGIORNO MADRE CABRINI,TOS,70-79,0,1,0,0,0,1,0,1,0,1,Toscana,ITI1
2021-01-15,COMIRNATY Vaccino a mRNA contro COVID-19,13274I,Covid19 - RSA SOGGIORNO MADRE CABRINI,TOS,80-89,1,1,0,0,0,2,0,2,0,2,Toscana,ITI1
2021-01-15,COMIRNATY Vaccino a mRNA contro COVID-19,16121A,Covid 19 - Ospedale Civile di Cecina,TOS,40-49,0,4,0,3,1,0,0,4,0,4,Toscana,ITI1
2021-01-15,COMIRNATY Vaccino a mRNA contro COVID-19,16121A,Covid 19 - Ospedale Civile di Cecina,TOS,50-59,6,8,0,9,5,0,0,14,0,14,Toscana,ITI1
2021-01-15,COMIRNATY Vaccino a mRNA contro COVID-19,16121A,Covid 19 - Ospedale Civile di Cecina,TOS,60-69,1,11,0,11,1,0,0,12,0,12,Toscana,ITI1
2021-01-15,COMIRNATY Vaccino a mRNA contro COVID-19,20534M,COvid19 - CAP DON BEPPE SOCCI,TOS,30-39,1,0,0,0,0,1,0,1,0,1,Toscana,ITI1
2021-01-15,COMIRNATY Vaccino a mRNA contro COVID-19,20534M,COvid19 - CAP DON BEPPE SOCCI,TOS,40-49,2,3,0,0,0,5,0,5,0,5,Toscana,ITI1
2021-01-15,COMIRNATY Vaccino a mRNA contro COVID-19,20534M,COvid19 - CAP DON BEPPE SOCCI,TOS,50-59,4,0,0,0,0,4,0,4,0,4,Toscana,ITI1
2021-01-15,COMIRNATY Vaccino a mRNA contro COVID-19,20534M,COvid19 - CAP DON BEPPE SOCCI,TOS,60-69,1,2,0,0,0,3,0,3,0,3,Toscana,ITI1
2021-01-15,COMIRNATY Vaccino a mRNA contro COVID-19,20534M,COvid19 - CAP DON BEPPE SOCCI,TOS,70-79,0,1,0,0,0,1,0,1,0,1,Toscana,ITI1
2021-01-15,COMIRNATY Vaccino a mRNA contro COVID-19,20694I,Covid19 - RSA VILLA MARILLA,TOS,40-49,1,1,0,0,0,2,0,2,0,2,Toscana,ITI1
2021-01-15,COMIRNATY Vaccino a mRNA contro COVID-19,20694I,Covid19 - RSA VILLA MARILLA,TOS,50-59,3,1,0,0,0,4,0,4,0,4,Toscana,ITI1
2021-01-15,COMIRNATY Vaccino a mRNA contro COVID-19,20694I,Covid19 - RSA VILLA MARILLA,TOS,60-69,2,1,0,0,0,3,0,3,0,3,Toscana,ITI1
2021-01-15,COMIRNATY Vaccino a mRNA contro COVID-19,20694I,Covid19 - RSA VILLA MARILLA,TOS,70-79,0,2,0,0,0,2,0,2,0,2,Toscana,ITI1
2021-01-15,COMIRNATY Vaccino a mRNA contro COVID-19,21791A,COVID19 - FTGM OPA Massa,TOS,20-29,7,6,0,7,6,0,0,13,0,13,Toscana,ITI1
2021-01-15,COMIRNATY Vaccino a mRNA contro COVID-19,21791A,COVID19 - FTGM OPA Massa,TOS,30-39,3,20,0,17,6,0,0,23,0,23,Toscana,ITI1
2021-01-15,COMIRNATY Vaccino a mRNA contro COVID-19,21791A,COVID19 - FTGM OPA Massa,TOS,40-49,12,18,0,8,22,0,0,30,0,30,Toscana,ITI1
2021-01-15,COMIRNATY Vaccino a mRNA contro COVID-19,21791A,COVID19 - FTGM OPA Massa,TOS,50-59,16,37,0,24,28,1,0,53,0,53,Toscana,ITI1
2021-01-15,COMIRNATY Vaccino a mRNA contro COVID-19,21791A,COVID19 - FTGM OPA Massa,TOS,60-69,7,8,0,5,10,0,0,15,0,15,Toscana,ITI1
2021-01-15,COMIRNATY Vaccino a mRNA contro COVID-19,21791A,COVID19 - FTGM OPA Massa,TOS,70-79,1,0,0,1,0,0,0,1,0,1,Toscana,ITI1
2021-01-15,COMIRNATY Vaccino a mRNA contro COVID-19,22011A,PRESIDIO MASSA CENTRO,TOS,20-29,1,8,0,9,0,0,0,9,0,9,Toscana,ITI1
2021-01-15,COMIRNATY Vaccino a mRNA contro COVID-19,22011A,PRESIDIO MASSA CENTRO,TOS,30-39,9,9,0,18,0,0,0,18,0,18,Toscana,ITI1
2021-01-15,COMIRNATY Vaccino a mRNA contro COVID-19,22011A,PRESIDIO MASSA CENTRO,TOS,40-49,3,19,0,22,0,0,0,22,0,22,Toscana,ITI1
2021-01-15,COMIRNATY Vaccino a mRNA contro COVID-19,22011A,PRESIDIO MASSA CENTRO,TOS,50-59,10,14,0,23,0,1,0,24,0,24,Toscana,ITI1
2021-01-15,COMIRNATY Vaccino a mRNA contro COVID-19,22011A,PRESIDIO MASSA CENTRO,TOS,60-69,9,8,0,17,0,0,0,17,0,17,Toscana,ITI1
2021-01-15,COMIRNATY Vaccino a mRNA contro COVID-19,40911A,COVID19 - Dip. Prevenzione Ruffolo Siena,TOS,40-49,0,1,0,1,0,0,0,1,0,1,Toscana,ITI1
2021-01-15,COMIRNATY Vaccino a mRNA contro COVID-19,40911A,COVID19 - Dip. Prevenzione Ruffolo Siena,TOS,50-59,0,1,0,0,0,1,0,1,0,1,Toscana,ITI1
2021-01-15,COMIRNATY Vaccino a mRNA contro COVID-19,40911A,COVID19 - Dip. Prevenzione Ruffolo Siena,TOS,70-79,1,1,0,0,0,2,0,2,0,2,Toscana,ITI1
2021-01-15,COMIRNATY Vaccino a mRNA contro COVID-19,40911A,COVID19 - Dip. Prevenzione Ruffolo Siena,TOS,80-89,3,7,0,0,0,10,0,10,0,10,Toscana,ITI1
2021-01-15,COMIRNATY Vaccino a mRNA contro COVID-19,40911A,COVID19 - Dip. Prevenzione Ruffolo Siena,TOS,90+,2,8,0,0,0,10,0,10,0,10,Toscana,ITI1
2021-01-15,COMIRNATY Vaccino a mRNA contro COVID-19,46014I,RSA BECATTINI CIVITELLA,TOS,40-49,0,1,0,1,0,0,0,1,0,1,Toscana,ITI1
2021-01-15,COMIRNATY Vaccino a mRNA contro COVID-19,46014I,RSA BECATTINI CIVITELLA,TOS,70-79,1,2,0,0,0,3,0,3,0,3,Toscana,ITI1
2021-01-15,COMIRNATY Vaccino a mRNA contro COVID-19,46014I,RSA BECATTINI CIVITELLA,TOS,80-89,0,3,0,0,0,3,0,3,0,3,Toscana,ITI1
2021-01-15,COMIRNATY Vaccino a mRNA contro COVID-19,46014I,RSA BECATTINI CIVITELLA,TOS,90+,1,2,0,0,0,3,0,3,0,3,Toscana,ITI1
2021-01-15,COMIRNATY Vaccino a mRNA contro COVID-19,46714I,RSA G. CIAPI,TOS,50-59,1,0,0,0,0,1,0,1,0,1,Toscana,ITI1
2021-01-15,COMIRNATY Vaccino a mRNA contro COVID-19,46714I,RSA G. CIAPI,TOS,60-69,2,1,0,0,0,3,0,3,0,3,Toscana,ITI1
2021-01-15,COMIRNATY Vaccino a mRNA contro COVID-19,46714I,RSA G. CIAPI,TOS,70-79,6,1,0,0,0,7,0,7,0,7,Toscana,ITI1
2021-01-15,COMIRNATY Vaccino a mRNA contro COVID-19,46714I,RSA G. CIAPI,TOS,80-89,1,4,0,0,0,5,0,5,0,5,Toscana,ITI1
2021-01-15,COMIRNATY Vaccino a mRNA contro COVID-19,46714I,RSA G. CIAPI,TOS,90+,1,4,0,0,0,5,0,5,0,5,Toscana,ITI1
2021-01-15,COMIRNATY Vaccino a mRNA contro COVID-19,80044I,OFELIA E UGO BALESTRI,TOS,80-89,0,5,0,1,0,4,0,5,0,5,Toscana,ITI1
2021-01-15,COMIRNATY Vaccino a mRNA contro COVID-19,80044I,OFELIA E UGO BALESTRI,TOS,90+,0,6,0,0,0,6,0,6,0,6,Toscana,ITI1
2021-01-15,COMIRNATY Vaccino a mRNA contro COVID-19,80054I,VILLA MARIA ASSUNTA RESIDENZIA,TOS,40-49,0,1,0,1,0,0,0,1,0,1,Toscana,ITI1
2021-01-15,COMIRNATY Vaccino a mRNA contro COVID-19,80054I,VILLA MARIA ASSUNTA RESIDENZIA,TOS,80-89,0,1,0,0,0,1,0,1,0,1,Toscana,ITI1
2021-01-15,COMIRNATY Vaccino a mRNA contro COVID-19,80054I,VILLA MARIA ASSUNTA RESIDENZIA,TOS,90+,0,1,0,0,0,1,0,1,0,1,Toscana,ITI1
2021-01-15,COMIRNATY Vaccino a mRNA contro COVID-19,80124I,R.S.A. VILLA AMELIA SRL,TOS,40-49,0,1,0,1,0,0,0,1,0,1,Toscana,ITI1
2021-01-15,COMIRNATY Vaccino a mRNA contro COVID-19,80124I,R.S.A. VILLA AMELIA SRL,TOS,70-79,0,1,0,0,0,1,0,1,0,1,Toscana,ITI1
2021-01-15,COMIRNATY Vaccino a mRNA contro COVID-19,80124I,R.S.A. VILLA AMELIA SRL,TOS,80-89,2,5,0,0,0,7,0,7,0,7,Toscana,ITI1
2021-01-15,COMIRNATY Vaccino a mRNA contro COVID-19,80124I,R.S.A. VILLA AMELIA SRL,TOS,90+,0,5,0,0,0,5,0,5,0,5,Toscana,ITI1
2021-01-15,COMIRNATY Vaccino a mRNA contro COVID-19,81104I,R.S.A. UBALDO BITI,TOS,70-79,1,0,0,0,0,1,0,1,0,1,Toscana,ITI1
2021-01-15,COMIRNATY Vaccino a mRNA contro COVID-19,90124I,ISTITUTO GIOTTO LA VILLA SPA,TOS,20-29,1,0,0,1,0,0,0,1,0,1,Toscana,ITI1
2021-01-15,COMIRNATY Vaccino a mRNA contro COVID-19,90124I,ISTITUTO GIOTTO LA VILLA SPA,TOS,40-49,0,1,0,1,0,0,0,1,0,1,Toscana,ITI1
2021-01-15,COMIRNATY Vaccino a mRNA contro COVID-19,90124I,ISTITUTO GIOTTO LA VILLA SPA,TOS,50-59,0,2,0,1,0,1,0,2,0,2,Toscana,ITI1
2021-01-15,COMIRNATY Vaccino a mRNA contro COVID-19,90124I,ISTITUTO GIOTTO LA VILLA SPA,TOS,70-79,1,0,0,0,0,1,0,1,0,1,Toscana,ITI1
2021-01-15,COMIRNATY Vaccino a mRNA contro COVID-19,90124I,ISTITUTO GIOTTO LA VILLA SPA,TOS,80-89,1,0,0,0,0,1,0,1,0,1,Toscana,ITI1
2021-01-15,COMIRNATY Vaccino a mRNA contro COVID-19,90134I,ISTITUTO S.FRANCESCO,TOS,30-39,0,2,0,1,0,1,0,2,0,2,Toscana,ITI1
2021-01-15,COMIRNATY Vaccino a mRNA contro COVID-19,90134I,ISTITUTO S.FRANCESCO,TOS,40-49,0,2,0,1,0,1,0,2,0,2,Toscana,ITI1
2021-01-15,COMIRNATY Vaccino a mRNA contro COVID-19,90134I,ISTITUTO S.FRANCESCO,TOS,50-59,1,0,0,0,0,1,0,1,0,1,Toscana,ITI1
2021-01-15,COMIRNATY Vaccino a mRNA contro COVID-19,90134I,ISTITUTO S.FRANCESCO,TOS,60-69,0,1,0,1,0,0,0,1,0,1,Toscana,ITI1
2021-01-15,COMIRNATY Vaccino a mRNA contro COVID-19,ND,Casa di Riposo S. Caterina,TOS,60-69,0,2,0,2,0,0,0,2,0,2,Toscana,ITI1
2021-01-15,COMIRNATY Vaccino a mRNA contro COVID-19,ND,Casa di Riposo S. Caterina,TOS,70-79,0,1,0,0,0,1,0,1,0,1,Toscana,ITI1
2021-01-15,COMIRNATY Vaccino a mRNA contro COVID-19,ND,Casa di Riposo S. Caterina,TOS,80-89,0,4,0,0,0,4,0,4,0,4,Toscana,ITI1
2021-01-15,COMIRNATY Vaccino a mRNA contro COVID-19,ND,Casa di Riposo S. Caterina,TOS,90+,0,5,0,0,0,5,0,5,0,5,Toscana,ITI1
2021-01-15,COMIRNATY Vaccino a mRNA contro COVID-19,ND,Casa Famiglia Santa Margherita,TOS,70-79,0,1,0,0,0,1,0,1,0,1,Toscana,ITI1
2021-01-15,COMIRNATY Vaccino a mRNA contro COVID-19,ND,Casa Famiglia Santa Margherita,TOS,80-89,0,3,0,0,0,3,0,3,0,3,Toscana,ITI1
2021-01-15,COMIRNATY Vaccino a mRNA contro COVID-19,ND,Casa Famiglia Santa Margherita,TOS,90+,0,2,0,0,0,2,0,2,0,2,Toscana,ITI1
2021-01-15,COMIRNATY Vaccino a mRNA contro COVID-19,ND,Casa Famiglia Vetulonia,TOS,50-59,1,0,0,0,0,1,0,1,0,1,Toscana,ITI1
2021-01-15,COMIRNATY Vaccino a mRNA contro COVID-19,ND,Casa Famiglia Vetulonia,TOS,70-79,2,0,0,0,0,2,0,2,0,2,Toscana,ITI1
2021-01-15,COMIRNATY Vaccino a mRNA contro COVID-19,ND,Casa Famiglia Vetulonia,TOS,80-89,1,1,0,0,0,2,0,2,0,2,Toscana,ITI1
2021-01-15,COMIRNATY Vaccino a mRNA contro COVID-19,ND,Casa Famiglia Vetulonia,TOS,90+,1,0,0,0,0,1,0,1,0,1,Toscana,ITI1
2021-01-15,COMIRNATY Vaccino a mRNA contro COVID-19,ND,istituto padre agostino da montefeltro,TOS,50-59,0,2,0,2,0,0,0,2,0,2,Toscana,ITI1
2021-01-15,COMIRNATY Vaccino a mRNA contro COVID-19,ND,istituto padre agostino da montefeltro,TOS,70-79,1,0,0,0,0,1,0,1,0,1,Toscana,ITI1
2021-01-15,COMIRNATY Vaccino a mRNA contro COVID-19,ND,istituto padre agostino da montefeltro,TOS,80-89,0,1,0,0,0,1,0,1,0,1,Toscana,ITI1
2021-01-15,COMIRNATY Vaccino a mRNA contro COVID-19,ND,istituto padre agostino da montefeltro,TOS,90+,0,2,0,0,0,2,0,2,0,2,Toscana,ITI1
2021-01-15,COMIRNATY Vaccino a mRNA contro COVID-19,ND,RA Comunit+á della Resurerzione,TOS,50-59,4,0,0,2,0,2,0,4,0,4,Toscana,ITI1
2021-01-15,COMIRNATY Vaccino a mRNA contro COVID-19,ND,RA Comunit+á della Resurerzione,TOS,60-69,6,0,0,0,0,6,0,6,0,6,Toscana,ITI1
2021-01-15,COMIRNATY Vaccino a mRNA contro COVID-19,ND,RA Comunit+á della Resurerzione,TOS,70-79,3,1,0,1,0,3,0,4,0,4,Toscana,ITI1
2021-01-15,COMIRNATY Vaccino a mRNA contro COVID-19,ND,RA Comunit+á della Resurerzione,TOS,80-89,2,0,0,0,0,2,0,2,0,2,Toscana,ITI1
2021-01-15,COMIRNATY Vaccino a mRNA contro COVID-19,ND,RA Comunit+á della Resurerzione,TOS,90+,2,0,0,0,0,2,0,2,0,2,Toscana,ITI1
2021-01-15,COMIRNATY Vaccino a mRNA contro COVID-19,ND,RA Don Francesco Rossi,TOS,60-69,1,0,0,0,0,1,0,1,0,1,Toscana,ITI1
2021-01-15,COMIRNATY Vaccino a mRNA contro COVID-19,ND,RA Don Francesco Rossi,TOS,70-79,2,2,0,0,0,4,0,4,0,4,Toscana,ITI1
2021-01-15,COMIRNATY Vaccino a mRNA contro COVID-19,ND,RA Don Francesco Rossi,TOS,80-89,3,8,0,0,0,11,0,11,0,11,Toscana,ITI1
2021-01-15,COMIRNATY Vaccino a mRNA contro COVID-19,ND,RA Don Francesco Rossi,TOS,90+,3,13,0,0,0,16,0,16,0,16,Toscana,ITI1
2021-01-15,COMIRNATY Vaccino a mRNA contro COVID-19,ND,RA San Francesco,TOS,60-69,0,1,0,0,0,1,0,1,0,1,Toscana,ITI1
2021-01-15,COMIRNATY Vaccino a mRNA contro COVID-19,ND,RA San Francesco,TOS,70-79,0,1,0,0,0,1,0,1,0,1,Toscana,ITI1
2021-01-15,COMIRNATY Vaccino a mRNA contro COVID-19,ND,RA San Francesco,TOS,80-89,0,3,0,0,0,3,0,3,0,3,Toscana,ITI1
2021-01-15,COMIRNATY Vaccino a mRNA contro COVID-19,ND,RA San Francesco,TOS,90+,0,1,0,0,0,1,0,1,0,1,Toscana,ITI1
2021-01-15,COMIRNATY Vaccino a mRNA contro COVID-19,ND,RA Vultus Christi,TOS,70-79,0,1,0,0,0,1,0,1,0,1,Toscana,ITI1
2021-01-15,COMIRNATY Vaccino a mRNA contro COVID-19,ND,RA Vultus Christi,TOS,80-89,0,6,0,0,0,6,0,6,0,6,Toscana,ITI1
2021-01-15,COMIRNATY Vaccino a mRNA contro COVID-19,ND,RA Vultus Christi,TOS,90+,0,23,0,0,0,23,0,23,0,23,Toscana,ITI1
2021-01-15,COMIRNATY Vaccino a mRNA contro COVID-19,V0094E,Covid19 -  SRCC VILLA MARENE',TOS,50-59,4,1,0,0,0,5,0,5,0,5,Toscana,ITI1
2021-01-15,COMIRNATY Vaccino a mRNA contro COVID-19,V0094E,Covid19 -  SRCC VILLA MARENE',TOS,60-69,3,3,0,0,0,6,0,6,0,6,Toscana,ITI1
2021-01-15,COVID-19 VACCINE MODERNA*10FL,090606,COVID19 - Ospedale San Iacopo,TOS,20-29,1,1,0,0,0,2,0,2,0,2,Toscana,ITI1
2021-01-15,COVID-19 VACCINE MODERNA*10FL,090606,COVID19 - Ospedale San Iacopo,TOS,30-39,1,2,0,1,0,2,0,3,0,3,Toscana,ITI1
2021-01-15,COVID-19 VACCINE MODERNA*10FL,090606,COVID19 - Ospedale San Iacopo,TOS,40-49,1,4,0,2,0,3,0,5,0,5,Toscana,ITI1
2021-01-15,COVID-19 VACCINE MODERNA*10FL,090606,COVID19 - Ospedale San Iacopo,TOS,50-59,0,2,0,1,0,1,0,2,0,2,Toscana,ITI1
2021-01-16,COMIRNATY Vaccino a mRNA contro COVID-19,00511A,Centro Sanitario Fornaci di Barga,TOS,20-29,1,5,0,5,1,0,0,6,0,6,Toscana,ITI1
2021-01-16,COMIRNATY Vaccino a mRNA contro COVID-19,00511A,Centro Sanitario Fornaci di Barga,TOS,30-39,0,4,0,4,0,0,0,4,0,4,Toscana,ITI1
2021-01-16,COMIRNATY Vaccino a mRNA contro COVID-19,00511A,Centro Sanitario Fornaci di Barga,TOS,40-49,0,14,0,11,3,0,0,14,0,14,Toscana,ITI1
2021-01-16,COMIRNATY Vaccino a mRNA contro COVID-19,00511A,Centro Sanitario Fornaci di Barga,TOS,50-59,2,19,0,18,3,0,0,21,0,21,Toscana,ITI1
2021-01-16,COMIRNATY Vaccino a mRNA contro COVID-19,00511A,Centro Sanitario Fornaci di Barga,TOS,60-69,5,10,0,10,5,0,0,15,0,15,Toscana,ITI1
2021-01-16,COMIRNATY Vaccino a mRNA contro COVID-19,04001A,Campo di Marte Lucca - iGIENE PUBBLICA,TOS,20-29,2,10,0,12,0,0,0,12,0,12,Toscana,ITI1
2021-01-16,COMIRNATY Vaccino a mRNA contro COVID-19,04001A,Campo di Marte Lucca - iGIENE PUBBLICA,TOS,30-39,3,6,0,9,0,0,0,9,0,9,Toscana,ITI1
2021-01-16,COMIRNATY Vaccino a mRNA contro COVID-19,04001A,Campo di Marte Lucca - iGIENE PUBBLICA,TOS,40-49,4,19,0,23,0,0,0,23,0,23,Toscana,ITI1
2021-01-16,COMIRNATY Vaccino a mRNA contro COVID-19,04001A,Campo di Marte Lucca - iGIENE PUBBLICA,TOS,50-59,11,21,0,32,0,0,0,32,0,32,Toscana,ITI1
2021-01-16,COMIRNATY Vaccino a mRNA contro COVID-19,04001A,Campo di Marte Lucca - iGIENE PUBBLICA,TOS,60-69,5,9,0,14,0,0,0,14,0,14,Toscana,ITI1
2021-01-16,COMIRNATY Vaccino a mRNA contro COVID-19,090606,COVID19 - Ospedale San Iacopo,TOS,16-19,3,0,0,0,0,3,0,3,0,3,Toscana,ITI1
2021-01-16,COMIRNATY Vaccino a mRNA contro COVID-19,090606,COVID19 - Ospedale San Iacopo,TOS,20-29,17,26,0,23,3,17,0,43,0,43,Toscana,ITI1
2021-01-16,COMIRNATY Vaccino a mRNA contro COVID-19,090606,COVID19 - Ospedale San Iacopo,TOS,30-39,17,15,0,25,1,6,0,32,0,32,Toscana,ITI1
2021-01-16,COMIRNATY Vaccino a mRNA contro COVID-19,090606,COVID19 - Ospedale San Iacopo,TOS,40-49,18,40,0,45,5,8,0,58,0,58,Toscana,ITI1
2021-01-16,COMIRNATY Vaccino a mRNA contro COVID-19,090606,COVID19 - Ospedale San Iacopo,TOS,50-59,14,35,0,43,6,0,0,49,0,49,Toscana,ITI1
2021-01-16,COMIRNATY Vaccino a mRNA contro COVID-19,090606,COVID19 - Ospedale San Iacopo,TOS,60-69,10,5,0,11,4,0,0,15,0,15,Toscana,ITI1
2021-01-16,COMIRNATY Vaccino a mRNA contro COVID-19,090606,COVID19 - Ospedale San Iacopo,TOS,70-79,2,0,0,2,0,0,0,2,0,2,Toscana,ITI1
2021-01-16,COMIRNATY Vaccino a mRNA contro COVID-19,090607,COVID19 - Ospedale SS.Cosma e Damiano,TOS,20-29,2,3,0,2,3,0,0,5,0,5,Toscana,ITI1
2021-01-16,COMIRNATY Vaccino a mRNA contro COVID-19,090607,COVID19 - Ospedale SS.Cosma e Damiano,TOS,30-39,2,8,0,6,4,0,0,10,0,10,Toscana,ITI1
2021-01-16,COMIRNATY Vaccino a mRNA contro COVID-19,090607,COVID19 - Ospedale SS.Cosma e Damiano,TOS,40-49,0,7,0,5,2,0,0,7,0,7,Toscana,ITI1
2021-01-16,COMIRNATY Vaccino a mRNA contro COVID-19,090607,COVID19 - Ospedale SS.Cosma e Damiano,TOS,50-59,7,9,0,7,9,0,0,16,0,16,Toscana,ITI1
2021-01-16,COMIRNATY Vaccino a mRNA contro COVID-19,090607,COVID19 - Ospedale SS.Cosma e Damiano,TOS,60-69,2,8,0,8,2,0,0,10,0,10,Toscana,ITI1
2021-01-16,COMIRNATY Vaccino a mRNA contro COVID-19,090608,COVID19 - Ospedale Santo Stefano,TOS,16-19,1,0,0,0,1,0,0,1,0,1,Toscana,ITI1
2021-01-16,COMIRNATY Vaccino a mRNA contro COVID-19,090608,COVID19 - Ospedale Santo Stefano,TOS,20-29,6,13,0,19,0,0,0,19,0,19,Toscana,ITI1
2021-01-16,COMIRNATY Vaccino a mRNA contro COVID-19,090608,COVID19 - Ospedale Santo Stefano,TOS,30-39,11,23,0,26,8,0,0,34,0,34,Toscana,ITI1
2021-01-16,COMIRNATY Vaccino a mRNA contro COVID-19,090608,COVID19 - Ospedale Santo Stefano,TOS,40-49,8,20,0,24,4,0,0,28,0,28,Toscana,ITI1
2021-01-16,COMIRNATY Vaccino a mRNA contro COVID-19,090608,COVID19 - Ospedale Santo Stefano,TOS,50-59,8,36,0,39,5,0,0,44,0,44,Toscana,ITI1
2021-01-16,COMIRNATY Vaccino a mRNA contro COVID-19,090608,COVID19 - Ospedale Santo Stefano,TOS,60-69,7,10,0,16,1,0,0,17,0,17,Toscana,ITI1
2021-01-16,COMIRNATY Vaccino a mRNA contro COVID-19,090608,COVID19 - Ospedale Santo Stefano,TOS,70-79,4,1,0,5,0,0,0,5,0,5,Toscana,ITI1
2021-01-16,COMIRNATY Vaccino a mRNA contro COVID-19,090608,COVID19 - Ospedale Santo Stefano,TOS,80-89,1,0,0,1,0,0,0,1,0,1,Toscana,ITI1
2021-01-16,COMIRNATY Vaccino a mRNA contro COVID-19,090609,Covid 19 - Ospedale S.Maria Maddalena di Volterra,TOS,20-29,2,5,0,6,1,0,0,7,0,7,Toscana,ITI1
2021-01-16,COMIRNATY Vaccino a mRNA contro COVID-19,090609,Covid 19 - Ospedale S.Maria Maddalena di Volterra,TOS,30-39,0,4,0,4,0,0,0,4,0,4,Toscana,ITI1
2021-01-16,COMIRNATY Vaccino a mRNA contro COVID-19,090609,Covid 19 - Ospedale S.Maria Maddalena di Volterra,TOS,40-49,2,14,0,15,1,0,0,16,0,16,Toscana,ITI1
2021-01-16,COMIRNATY Vaccino a mRNA contro COVID-19,090609,Covid 19 - Ospedale S.Maria Maddalena di Volterra,TOS,50-59,3,11,0,12,2,0,0,14,0,14,Toscana,ITI1
2021-01-16,COMIRNATY Vaccino a mRNA contro COVID-19,090609,Covid 19 - Ospedale S.Maria Maddalena di Volterra,TOS,60-69,1,6,0,7,0,0,0,7,0,7,Toscana,ITI1
2021-01-16,COMIRNATY Vaccino a mRNA contro COVID-19,090610,Covid 19 - Ospedale F.Lotti di Pontedera,TOS,20-29,1,8,0,9,0,0,0,9,0,9,Toscana,ITI1
2021-01-16,COMIRNATY Vaccino a mRNA contro COVID-19,090610,Covid 19 - Ospedale F.Lotti di Pontedera,TOS,30-39,2,11,0,13,0,0,0,13,0,13,Toscana,ITI1
2021-01-16,COMIRNATY Vaccino a mRNA contro COVID-19,090610,Covid 19 - Ospedale F.Lotti di Pontedera,TOS,40-49,4,9,0,13,0,0,0,13,0,13,Toscana,ITI1
2021-01-16,COMIRNATY Vaccino a mRNA contro COVID-19,090610,Covid 19 - Ospedale F.Lotti di Pontedera,TOS,50-59,2,9,0,11,0,0,0,11,0,11,Toscana,ITI1
2021-01-16,COMIRNATY Vaccino a mRNA contro COVID-19,090610,Covid 19 - Ospedale F.Lotti di Pontedera,TOS,60-69,8,6,0,14,0,0,0,14,0,14,Toscana,ITI1
2021-01-16,COMIRNATY Vaccino a mRNA contro COVID-19,090613,Covid 19 - Ospedali Riuniti di Livorno,TOS,20-29,4,12,0,16,0,0,0,16,0,16,Toscana,ITI1
2021-01-16,COMIRNATY Vaccino a mRNA contro COVID-19,090613,Covid 19 - Ospedali Riuniti di Livorno,TOS,30-39,7,10,0,16,1,0,0,17,0,17,Toscana,ITI1
2021-01-16,COMIRNATY Vaccino a mRNA contro COVID-19,090613,Covid 19 - Ospedali Riuniti di Livorno,TOS,40-49,5,12,0,16,1,0,0,17,0,17,Toscana,ITI1
2021-01-16,COMIRNATY Vaccino a mRNA contro COVID-19,090613,Covid 19 - Ospedali Riuniti di Livorno,TOS,50-59,3,22,0,24,1,0,0,25,0,25,Toscana,ITI1
2021-01-16,COMIRNATY Vaccino a mRNA contro COVID-19,090613,Covid 19 - Ospedali Riuniti di Livorno,TOS,60-69,5,10,0,15,0,0,0,15,0,15,Toscana,ITI1
2021-01-16,COMIRNATY Vaccino a mRNA contro COVID-19,090615,Covid 19 - Ospedale Civile di Portoferraio,TOS,20-29,1,5,0,6,0,0,0,6,0,6,Toscana,ITI1
2021-01-16,COMIRNATY Vaccino a mRNA contro COVID-19,090615,Covid 19 - Ospedale Civile di Portoferraio,TOS,30-39,2,1,0,3,0,0,0,3,0,3,Toscana,ITI1
2021-01-16,COMIRNATY Vaccino a mRNA contro COVID-19,090615,Covid 19 - Ospedale Civile di Portoferraio,TOS,40-49,2,9,0,11,0,0,0,11,0,11,Toscana,ITI1
2021-01-16,COMIRNATY Vaccino a mRNA contro COVID-19,090615,Covid 19 - Ospedale Civile di Portoferraio,TOS,50-59,6,12,0,18,0,0,0,18,0,18,Toscana,ITI1
2021-01-16,COMIRNATY Vaccino a mRNA contro COVID-19,090615,Covid 19 - Ospedale Civile di Portoferraio,TOS,60-69,5,4,0,9,0,0,0,9,0,9,Toscana,ITI1
2021-01-16,COMIRNATY Vaccino a mRNA contro COVID-19,090615,Covid 19 - Ospedale Civile di Portoferraio,TOS,70-79,0,1,0,1,0,0,0,1,0,1,Toscana,ITI1
2021-01-16,COMIRNATY Vaccino a mRNA contro COVID-19,090624,COVID19 - Ospedale di Orbetello,TOS,16-19,1,1,0,1,1,0,0,2,0,2,Toscana,ITI1
2021-01-16,COMIRNATY Vaccino a mRNA contro COVID-19,090624,COVID19 - Ospedale di Orbetello,TOS,20-29,5,4,0,9,0,0,0,9,0,9,Toscana,ITI1
2021-01-16,COMIRNATY Vaccino a mRNA contro COVID-19,090624,COVID19 - Ospedale di Orbetello,TOS,30-39,4,9,0,10,3,0,0,13,0,13,Toscana,ITI1
2021-01-16,COMIRNATY Vaccino a mRNA contro COVID-19,090624,COVID19 - Ospedale di Orbetello,TOS,40-49,7,18,0,22,3,0,0,25,0,25,Toscana,ITI1
2021-01-16,COMIRNATY Vaccino a mRNA contro COVID-19,090624,COVID19 - Ospedale di Orbetello,TOS,50-59,15,24,0,32,7,0,0,39,0,39,Toscana,ITI1
2021-01-16,COMIRNATY Vaccino a mRNA contro COVID-19,090624,COVID19 - Ospedale di Orbetello,TOS,60-69,9,16,0,23,2,0,0,25,0,25,Toscana,ITI1
2021-01-16,COMIRNATY Vaccino a mRNA contro COVID-19,090624,COVID19 - Ospedale di Orbetello,TOS,70-79,1,0,0,1,0,0,0,1,0,1,Toscana,ITI1
2021-01-16,COMIRNATY Vaccino a mRNA contro COVID-19,090627,COVID19 - Ospedale Mugello,TOS,20-29,3,4,0,7,0,0,0,7,0,7,Toscana,ITI1
2021-01-16,COMIRNATY Vaccino a mRNA contro COVID-19,090627,COVID19 - Ospedale Mugello,TOS,30-39,3,7,0,9,1,0,0,10,0,10,Toscana,ITI1
2021-01-16,COMIRNATY Vaccino a mRNA contro COVID-19,090627,COVID19 - Ospedale Mugello,TOS,40-49,3,3,0,5,1,0,0,6,0,6,Toscana,ITI1
2021-01-16,COMIRNATY Vaccino a mRNA contro COVID-19,090627,COVID19 - Ospedale Mugello,TOS,50-59,2,15,0,14,3,0,0,17,0,17,Toscana,ITI1
2021-01-16,COMIRNATY Vaccino a mRNA contro COVID-19,090627,COVID19 - Ospedale Mugello,TOS,60-69,1,7,0,8,0,0,0,8,0,8,Toscana,ITI1
2021-01-16,COMIRNATY Vaccino a mRNA contro COVID-19,090629,COVID19 - Ospedale SS. Maria Annunziata,TOS,20-29,4,14,0,13,4,1,0,18,0,18,Toscana,ITI1
2021-01-16,COMIRNATY Vaccino a mRNA contro COVID-19,090629,COVID19 - Ospedale SS. Maria Annunziata,TOS,30-39,7,12,0,15,4,0,0,19,0,19,Toscana,ITI1
2021-01-16,COMIRNATY Vaccino a mRNA contro COVID-19,090629,COVID19 - Ospedale SS. Maria Annunziata,TOS,40-49,11,28,0,27,12,0,0,39,0,39,Toscana,ITI1
2021-01-16,COMIRNATY Vaccino a mRNA contro COVID-19,090629,COVID19 - Ospedale SS. Maria Annunziata,TOS,50-59,19,30,0,43,6,0,0,49,0,49,Toscana,ITI1
2021-01-16,COMIRNATY Vaccino a mRNA contro COVID-19,090629,COVID19 - Ospedale SS. Maria Annunziata,TOS,60-69,11,11,0,20,1,1,0,22,0,22,Toscana,ITI1
2021-01-16,COMIRNATY Vaccino a mRNA contro COVID-19,090629,COVID19 - Ospedale SS. Maria Annunziata,TOS,70-79,1,1,0,2,0,0,0,2,0,2,Toscana,ITI1
2021-01-16,COMIRNATY Vaccino a mRNA contro COVID-19,090632,COVID19 - Ospedale Santa Maria Nuova,TOS,20-29,7,11,0,18,0,0,0,18,0,18,Toscana,ITI1
2021-01-16,COMIRNATY Vaccino a mRNA contro COVID-19,090632,COVID19 - Ospedale Santa Maria Nuova,TOS,30-39,6,15,0,21,0,0,0,21,0,21,Toscana,ITI1
2021-01-16,COMIRNATY Vaccino a mRNA contro COVID-19,090632,COVID19 - Ospedale Santa Maria Nuova,TOS,40-49,5,19,0,24,0,0,0,24,0,24,Toscana,ITI1
2021-01-16,COMIRNATY Vaccino a mRNA contro COVID-19,090632,COVID19 - Ospedale Santa Maria Nuova,TOS,50-59,6,15,0,21,0,0,0,21,0,21,Toscana,ITI1
2021-01-16,COMIRNATY Vaccino a mRNA contro COVID-19,090632,COVID19 - Ospedale Santa Maria Nuova,TOS,60-69,9,14,0,23,0,0,0,23,0,23,Toscana,ITI1
2021-01-16,COMIRNATY Vaccino a mRNA contro COVID-19,090632,COVID19 - Ospedale Santa Maria Nuova,TOS,70-79,1,0,0,1,0,0,0,1,0,1,Toscana,ITI1
2021-01-16,COMIRNATY Vaccino a mRNA contro COVID-19,090638,COVID19 - Ospedale di Campostaggia Poggibonsi,TOS,20-29,2,6,0,8,0,0,0,8,0,8,Toscana,ITI1
2021-01-16,COMIRNATY Vaccino a mRNA contro COVID-19,090638,COVID19 - Ospedale di Campostaggia Poggibonsi,TOS,30-39,1,8,0,9,0,0,0,9,0,9,Toscana,ITI1
2021-01-16,COMIRNATY Vaccino a mRNA contro COVID-19,090638,COVID19 - Ospedale di Campostaggia Poggibonsi,TOS,40-49,7,22,0,29,0,0,0,29,0,29,Toscana,ITI1
2021-01-16,COMIRNATY Vaccino a mRNA contro COVID-19,090638,COVID19 - Ospedale di Campostaggia Poggibonsi,TOS,50-59,6,34,0,40,0,0,0,40,0,40,Toscana,ITI1
2021-01-16,COMIRNATY Vaccino a mRNA contro COVID-19,090638,COVID19 - Ospedale di Campostaggia Poggibonsi,TOS,60-69,5,8,0,13,0,0,0,13,0,13,Toscana,ITI1
2021-01-16,COMIRNATY Vaccino a mRNA contro COVID-19,090640,Covid 19 - Ospedale Unico Versilia,TOS,20-29,0,3,0,3,0,0,0,3,0,3,Toscana,ITI1
2021-01-16,COMIRNATY Vaccino a mRNA contro COVID-19,090640,Covid 19 - Ospedale Unico Versilia,TOS,30-39,2,11,0,12,1,0,0,13,0,13,Toscana,ITI1
2021-01-16,COMIRNATY Vaccino a mRNA contro COVID-19,090640,Covid 19 - Ospedale Unico Versilia,TOS,40-49,3,14,0,13,4,0,0,17,0,17,Toscana,ITI1
2021-01-16,COMIRNATY Vaccino a mRNA contro COVID-19,090640,Covid 19 - Ospedale Unico Versilia,TOS,50-59,8,24,0,28,4,0,0,32,0,32,Toscana,ITI1
2021-01-16,COMIRNATY Vaccino a mRNA contro COVID-19,090640,Covid 19 - Ospedale Unico Versilia,TOS,60-69,12,7,0,17,2,0,0,19,0,19,Toscana,ITI1
2021-01-16,COMIRNATY Vaccino a mRNA contro COVID-19,090640,Covid 19 - Ospedale Unico Versilia,TOS,70-79,5,0,0,4,1,0,0,5,0,5,Toscana,ITI1
2021-01-16,COMIRNATY Vaccino a mRNA contro COVID-19,090901,COVID19 - AOU Pisana,TOS,16-19,0,1,0,1,0,0,0,1,0,1,Toscana,ITI1
2021-01-16,COMIRNATY Vaccino a mRNA contro COVID-19,090901,COVID19 - AOU Pisana,TOS,20-29,6,32,0,30,8,0,0,38,0,38,Toscana,ITI1
2021-01-16,COMIRNATY Vaccino a mRNA contro COVID-19,090901,COVID19 - AOU Pisana,TOS,30-39,14,26,0,23,17,0,0,40,0,40,Toscana,ITI1
2021-01-16,COMIRNATY Vaccino a mRNA contro COVID-19,090901,COVID19 - AOU Pisana,TOS,40-49,19,38,0,31,26,0,0,57,0,57,Toscana,ITI1
2021-01-16,COMIRNATY Vaccino a mRNA contro COVID-19,090901,COVID19 - AOU Pisana,TOS,50-59,20,34,0,34,20,0,0,54,0,54,Toscana,ITI1
2021-01-16,COMIRNATY Vaccino a mRNA contro COVID-19,090901,COVID19 - AOU Pisana,TOS,60-69,8,16,0,18,6,0,0,24,0,24,Toscana,ITI1
2021-01-16,COMIRNATY Vaccino a mRNA contro COVID-19,090901,COVID19 - AOU Pisana,TOS,70-79,4,1,0,4,1,0,0,5,0,5,Toscana,ITI1
2021-01-16,COMIRNATY Vaccino a mRNA contro COVID-19,090901,COVID19 - AOU Pisana,TOS,80-89,1,0,0,1,0,0,0,1,0,1,Toscana,ITI1
2021-01-16,COMIRNATY Vaccino a mRNA contro COVID-19,090902,COVID19 - AOU Senese,TOS,16-19,2,4,0,2,4,0,0,6,0,6,Toscana,ITI1
2021-01-16,COMIRNATY Vaccino a mRNA contro COVID-19,090902,COVID19 - AOU Senese,TOS,20-29,24,64,0,34,53,1,0,88,0,88,Toscana,ITI1
2021-01-16,COMIRNATY Vaccino a mRNA contro COVID-19,090902,COVID19 - AOU Senese,TOS,30-39,17,27,0,29,15,0,0,44,0,44,Toscana,ITI1
2021-01-16,COMIRNATY Vaccino a mRNA contro COVID-19,090902,COVID19 - AOU Senese,TOS,40-49,23,38,0,36,25,0,0,61,0,61,Toscana,ITI1
2021-01-16,COMIRNATY Vaccino a mRNA contro COVID-19,090902,COVID19 - AOU Senese,TOS,50-59,31,54,0,61,24,0,0,85,0,85,Toscana,ITI1
2021-01-16,COMIRNATY Vaccino a mRNA contro COVID-19,090902,COVID19 - AOU Senese,TOS,60-69,11,20,0,26,5,0,0,31,0,31,Toscana,ITI1
2021-01-16,COMIRNATY Vaccino a mRNA contro COVID-19,090902,COVID19 - AOU Senese,TOS,70-79,1,1,0,2,0,0,0,2,0,2,Toscana,ITI1
2021-01-16,COMIRNATY Vaccino a mRNA contro COVID-19,090903,COVID19 - AOU Careggi - CTO,TOS,16-19,6,22,0,28,0,0,0,28,0,28,Toscana,ITI1
2021-01-16,COMIRNATY Vaccino a mRNA contro COVID-19,090903,COVID19 - AOU Careggi - CTO,TOS,20-29,68,115,0,164,19,0,0,183,0,183,Toscana,ITI1
2021-01-16,COMIRNATY Vaccino a mRNA contro COVID-19,090903,COVID19 - AOU Careggi - CTO,TOS,30-39,23,40,0,41,22,0,0,63,0,63,Toscana,ITI1
2021-01-16,COMIRNATY Vaccino a mRNA contro COVID-19,090903,COVID19 - AOU Careggi - CTO,TOS,40-49,26,45,0,41,29,1,0,71,0,71,Toscana,ITI1
2021-01-16,COMIRNATY Vaccino a mRNA contro COVID-19,090903,COVID19 - AOU Careggi - CTO,TOS,50-59,22,61,0,45,38,0,0,83,0,83,Toscana,ITI1
2021-01-16,COMIRNATY Vaccino a mRNA contro COVID-19,090903,COVID19 - AOU Careggi - CTO,TOS,60-69,18,21,0,31,8,0,0,39,0,39,Toscana,ITI1
2021-01-16,COMIRNATY Vaccino a mRNA contro COVID-19,090903,COVID19 - AOU Careggi - CTO,TOS,70-79,5,2,0,5,2,0,0,7,0,7,Toscana,ITI1
2021-01-16,COMIRNATY Vaccino a mRNA contro COVID-19,090903,COVID19 - AOU Careggi - PIASTRA,TOS,16-19,0,2,0,2,0,0,0,2,0,2,Toscana,ITI1
2021-01-16,COMIRNATY Vaccino a mRNA contro COVID-19,090903,COVID19 - AOU Careggi - PIASTRA,TOS,20-29,13,33,0,46,0,0,0,46,0,46,Toscana,ITI1
2021-01-16,COMIRNATY Vaccino a mRNA contro COVID-19,090903,COVID19 - AOU Careggi - PIASTRA,TOS,30-39,4,9,0,13,0,0,0,13,0,13,Toscana,ITI1
2021-01-16,COMIRNATY Vaccino a mRNA contro COVID-19,090903,COVID19 - AOU Careggi - PIASTRA,TOS,40-49,0,6,0,6,0,0,0,6,0,6,Toscana,ITI1
2021-01-16,COMIRNATY Vaccino a mRNA contro COVID-19,090903,COVID19 - AOU Careggi - PIASTRA,TOS,50-59,4,10,0,14,0,0,0,14,0,14,Toscana,ITI1
2021-01-16,COMIRNATY Vaccino a mRNA contro COVID-19,090903,COVID19 - AOU Careggi - PIASTRA,TOS,60-69,0,2,0,2,0,0,0,2,0,2,Toscana,ITI1
2021-01-16,COMIRNATY Vaccino a mRNA contro COVID-19,090903,COVID19 - AOU Careggi - PIASTRA,TOS,70-79,1,0,0,1,0,0,0,1,0,1,Toscana,ITI1
2021-01-16,COMIRNATY Vaccino a mRNA contro COVID-19,090904,COVID19 - Ospedale AOU Meyer,TOS,20-29,4,4,0,6,2,0,0,8,0,8,Toscana,ITI1
2021-01-16,COMIRNATY Vaccino a mRNA contro COVID-19,090904,COVID19 - Ospedale AOU Meyer,TOS,30-39,3,6,0,5,4,0,0,9,0,9,Toscana,ITI1
2021-01-16,COMIRNATY Vaccino a mRNA contro COVID-19,090904,COVID19 - Ospedale AOU Meyer,TOS,40-49,5,11,0,9,7,0,0,16,0,16,Toscana,ITI1
2021-01-16,COMIRNATY Vaccino a mRNA contro COVID-19,090904,COVID19 - Ospedale AOU Meyer,TOS,50-59,5,13,0,8,10,0,0,18,0,18,Toscana,ITI1
2021-01-16,COMIRNATY Vaccino a mRNA contro COVID-19,090904,COVID19 - Ospedale AOU Meyer,TOS,60-69,3,5,0,5,3,0,0,8,0,8,Toscana,ITI1
2021-01-16,COMIRNATY Vaccino a mRNA contro COVID-19,090904,COVID19 - Ospedale AOU Meyer,TOS,70-79,0,1,0,0,1,0,0,1,0,1,Toscana,ITI1
2021-01-16,COMIRNATY Vaccino a mRNA contro COVID-19,090907,Covid19 - FTGM Pisa San Cataldo,TOS,20-29,2,6,0,6,2,0,0,8,0,8,Toscana,ITI1
2021-01-16,COMIRNATY Vaccino a mRNA contro COVID-19,090907,Covid19 - FTGM Pisa San Cataldo,TOS,30-39,3,7,0,4,5,1,0,10,0,10,Toscana,ITI1
2021-01-16,COMIRNATY Vaccino a mRNA contro COVID-19,090907,Covid19 - FTGM Pisa San Cataldo,TOS,40-49,5,13,0,11,7,0,0,18,0,18,Toscana,ITI1
2021-01-16,COMIRNATY Vaccino a mRNA contro COVID-19,090907,Covid19 - FTGM Pisa San Cataldo,TOS,50-59,12,10,0,12,10,0,0,22,0,22,Toscana,ITI1
2021-01-16,COMIRNATY Vaccino a mRNA contro COVID-19,090907,Covid19 - FTGM Pisa San Cataldo,TOS,60-69,3,4,0,4,3,0,0,7,0,7,Toscana,ITI1
2021-01-16,COMIRNATY Vaccino a mRNA contro COVID-19,090907,Covid19 - FTGM Pisa San Cataldo,TOS,70-79,1,0,0,0,1,0,0,1,0,1,Toscana,ITI1
2021-01-16,COMIRNATY Vaccino a mRNA contro COVID-19,11012E,COVID19 - Ospedale San Giuseppe,TOS,20-29,3,11,0,14,0,0,0,14,0,14,Toscana,ITI1
2021-01-16,COMIRNATY Vaccino a mRNA contro COVID-19,11012E,COVID19 - Ospedale San Giuseppe,TOS,30-39,9,17,0,26,0,0,0,26,0,26,Toscana,ITI1
2021-01-16,COMIRNATY Vaccino a mRNA contro COVID-19,11012E,COVID19 - Ospedale San Giuseppe,TOS,40-49,6,30,0,35,1,0,0,36,0,36,Toscana,ITI1
2021-01-16,COMIRNATY Vaccino a mRNA contro COVID-19,11012E,COVID19 - Ospedale San Giuseppe,TOS,50-59,14,32,0,46,0,0,0,46,0,46,Toscana,ITI1
2021-01-16,COMIRNATY Vaccino a mRNA contro COVID-19,11012E,COVID19 - Ospedale San Giuseppe,TOS,60-69,13,15,0,28,0,0,0,28,0,28,Toscana,ITI1
2021-01-16,COMIRNATY Vaccino a mRNA contro COVID-19,12011A,Distretto Sanitario - Pontremoli,TOS,20-29,1,1,0,1,1,0,0,2,0,2,Toscana,ITI1
2021-01-16,COMIRNATY Vaccino a mRNA contro COVID-19,12011A,Distretto Sanitario - Pontremoli,TOS,30-39,0,7,0,7,0,0,0,7,0,7,Toscana,ITI1
2021-01-16,COMIRNATY Vaccino a mRNA contro COVID-19,12011A,Distretto Sanitario - Pontremoli,TOS,40-49,0,5,0,4,1,0,0,5,0,5,Toscana,ITI1
2021-01-16,COMIRNATY Vaccino a mRNA contro COVID-19,12011A,Distretto Sanitario - Pontremoli,TOS,50-59,1,10,0,7,4,0,0,11,0,11,Toscana,ITI1
2021-01-16,COMIRNATY Vaccino a mRNA contro COVID-19,12011A,Distretto Sanitario - Pontremoli,TOS,60-69,2,3,0,4,1,0,0,5,0,5,Toscana,ITI1
2021-01-16,COMIRNATY Vaccino a mRNA contro COVID-19,13021A,COVID19 - Ospedale S.Giovanni di Dio,TOS,16-19,0,1,0,1,0,0,0,1,0,1,Toscana,ITI1
2021-01-16,COMIRNATY Vaccino a mRNA contro COVID-19,13021A,COVID19 - Ospedale S.Giovanni di Dio,TOS,20-29,5,18,0,23,0,0,0,23,0,23,Toscana,ITI1
2021-01-16,COMIRNATY Vaccino a mRNA contro COVID-19,13021A,COVID19 - Ospedale S.Giovanni di Dio,TOS,30-39,7,21,0,28,0,0,0,28,0,28,Toscana,ITI1
2021-01-16,COMIRNATY Vaccino a mRNA contro COVID-19,13021A,COVID19 - Ospedale S.Giovanni di Dio,TOS,40-49,8,29,0,35,1,1,0,37,0,37,Toscana,ITI1
2021-01-16,COMIRNATY Vaccino a mRNA contro COVID-19,13021A,COVID19 - Ospedale S.Giovanni di Dio,TOS,50-59,17,31,0,39,7,2,0,47,1,48,Toscana,ITI1
2021-01-16,COMIRNATY Vaccino a mRNA contro COVID-19,13021A,COVID19 - Ospedale S.Giovanni di Dio,TOS,60-69,11,12,0,21,1,1,0,23,0,23,Toscana,ITI1
2021-01-16,COMIRNATY Vaccino a mRNA contro COVID-19,13021A,COVID19 - Ospedale S.Giovanni di Dio,TOS,70-79,5,6,0,1,0,10,0,11,0,11,Toscana,ITI1
2021-01-16,COMIRNATY Vaccino a mRNA contro COVID-19,13021A,COVID19 - Ospedale S.Giovanni di Dio,TOS,80-89,5,3,0,0,0,8,0,8,0,8,Toscana,ITI1
2021-01-16,COMIRNATY Vaccino a mRNA contro COVID-19,13021A,COVID19 - Ospedale S.Giovanni di Dio,TOS,90+,1,0,0,0,0,1,0,1,0,1,Toscana,ITI1
2021-01-16,COMIRNATY Vaccino a mRNA contro COVID-19,13254I,Covid19 - Fondazione Cardinal Maffi,TOS,40-49,1,5,0,3,0,3,0,6,0,6,Toscana,ITI1
2021-01-16,COMIRNATY Vaccino a mRNA contro COVID-19,13254I,Covid19 - Fondazione Cardinal Maffi,TOS,50-59,2,2,0,2,0,2,0,4,0,4,Toscana,ITI1
2021-01-16,COMIRNATY Vaccino a mRNA contro COVID-19,13254I,Covid19 - Fondazione Cardinal Maffi,TOS,60-69,2,0,0,0,0,2,0,2,0,2,Toscana,ITI1
2021-01-16,COMIRNATY Vaccino a mRNA contro COVID-19,22011A,PRESIDIO MASSA CENTRO,TOS,16-19,1,0,0,1,0,0,0,1,0,1,Toscana,ITI1
2021-01-16,COMIRNATY Vaccino a mRNA contro COVID-19,22011A,PRESIDIO MASSA CENTRO,TOS,20-29,1,5,0,5,0,1,0,6,0,6,Toscana,ITI1
2021-01-16,COMIRNATY Vaccino a mRNA contro COVID-19,22011A,PRESIDIO MASSA CENTRO,TOS,30-39,4,8,0,12,0,0,0,12,0,12,Toscana,ITI1
2021-01-16,COMIRNATY Vaccino a mRNA contro COVID-19,22011A,PRESIDIO MASSA CENTRO,TOS,40-49,5,16,0,17,4,0,0,21,0,21,Toscana,ITI1
2021-01-16,COMIRNATY Vaccino a mRNA contro COVID-19,22011A,PRESIDIO MASSA CENTRO,TOS,50-59,12,18,0,29,1,0,0,30,0,30,Toscana,ITI1
2021-01-16,COMIRNATY Vaccino a mRNA contro COVID-19,22011A,PRESIDIO MASSA CENTRO,TOS,60-69,9,10,0,19,0,0,0,19,0,19,Toscana,ITI1
2021-01-16,COMIRNATY Vaccino a mRNA contro COVID-19,22011A,PRESIDIO MASSA CENTRO,TOS,70-79,1,0,0,1,0,0,0,1,0,1,Toscana,ITI1
2021-01-16,COMIRNATY Vaccino a mRNA contro COVID-19,81004I,R.S.A. CICIGNANO,TOS,20-29,1,0,0,1,0,0,0,1,0,1,Toscana,ITI1
2021-01-16,COMIRNATY Vaccino a mRNA contro COVID-19,81004I,R.S.A. CICIGNANO,TOS,50-59,0,1,0,1,0,0,0,1,0,1,Toscana,ITI1
2021-01-16,COMIRNATY Vaccino a mRNA contro COVID-19,81004I,R.S.A. CICIGNANO,TOS,60-69,2,1,0,1,0,2,0,3,0,3,Toscana,ITI1
2021-01-16,COMIRNATY Vaccino a mRNA contro COVID-19,81004I,R.S.A. CICIGNANO,TOS,70-79,1,0,0,0,0,1,0,1,0,1,Toscana,ITI1
2021-01-16,COMIRNATY Vaccino a mRNA contro COVID-19,ND,Condominio Sociale Seggiano,TOS,40-49,1,3,0,2,0,2,0,4,0,4,Toscana,ITI1
2021-01-16,COMIRNATY Vaccino a mRNA contro COVID-19,ND,Condominio Sociale Seggiano,TOS,60-69,1,0,0,0,0,1,0,1,0,1,Toscana,ITI1
2021-01-16,COMIRNATY Vaccino a mRNA contro COVID-19,ND,Condominio Sociale Seggiano,TOS,70-79,1,0,0,0,0,1,0,1,0,1,Toscana,ITI1
2021-01-16,COMIRNATY Vaccino a mRNA contro COVID-19,ND,Condominio Sociale Seggiano,TOS,80-89,3,1,0,0,0,4,0,4,0,4,Toscana,ITI1
2021-01-16,COMIRNATY Vaccino a mRNA contro COVID-19,ND,Condominio Sociale Seggiano,TOS,90+,0,2,0,0,0,2,0,2,0,2,Toscana,ITI1
2021-01-16,COMIRNATY Vaccino a mRNA contro COVID-19,ND,R.A. PICCOLE ANCELLE S. CUORE,TOS,60-69,0,1,0,0,0,1,0,1,0,1,Toscana,ITI1
2021-01-16,COMIRNATY Vaccino a mRNA contro COVID-19,ND,R.A. PICCOLE ANCELLE S. CUORE,TOS,80-89,0,6,0,2,0,4,0,6,0,6,Toscana,ITI1
2021-01-16,COMIRNATY Vaccino a mRNA contro COVID-19,ND,R.A. PICCOLE ANCELLE S. CUORE,TOS,90+,0,11,0,1,0,10,0,11,0,11,Toscana,ITI1
2021-01-16,COMIRNATY Vaccino a mRNA contro COVID-19,ND,RA Casa Manetti,TOS,50-59,0,1,0,1,0,0,0,1,0,1,Toscana,ITI1
2021-01-16,COMIRNATY Vaccino a mRNA contro COVID-19,ND,RA Casa Manetti,TOS,60-69,2,0,0,0,0,2,0,2,0,2,Toscana,ITI1
2021-01-16,COMIRNATY Vaccino a mRNA contro COVID-19,ND,RA Casa Manetti,TOS,70-79,2,0,0,0,0,2,0,2,0,2,Toscana,ITI1
2021-01-16,COMIRNATY Vaccino a mRNA contro COVID-19,ND,RA Casa Manetti,TOS,80-89,1,1,0,0,0,2,0,2,0,2,Toscana,ITI1
2021-01-16,COMIRNATY Vaccino a mRNA contro COVID-19,ND,RA Casa Manetti,TOS,90+,1,4,0,0,0,5,0,5,0,5,Toscana,ITI1
2021-01-16,COMIRNATY Vaccino a mRNA contro COVID-19,ND,RA I Lecci,TOS,50-59,0,2,0,0,0,2,0,2,0,2,Toscana,ITI1
2021-01-16,COMIRNATY Vaccino a mRNA contro COVID-19,ND,RA I Lecci,TOS,70-79,3,1,0,0,0,4,0,4,0,4,Toscana,ITI1
2021-01-16,COMIRNATY Vaccino a mRNA contro COVID-19,ND,RA I Lecci,TOS,80-89,2,16,0,0,0,18,0,18,0,18,Toscana,ITI1
2021-01-16,COMIRNATY Vaccino a mRNA contro COVID-19,ND,RA I Lecci,TOS,90+,2,10,0,0,0,12,0,12,0,12,Toscana,ITI1
2021-01-16,COMIRNATY Vaccino a mRNA contro COVID-19,ND,RA ISTITUTO S. MARIA IN GRADI,TOS,40-49,0,2,0,2,0,0,0,2,0,2,Toscana,ITI1
2021-01-16,COMIRNATY Vaccino a mRNA contro COVID-19,ND,RA ISTITUTO S. MARIA IN GRADI,TOS,50-59,0,1,0,1,0,0,0,1,0,1,Toscana,ITI1
2021-01-16,COMIRNATY Vaccino a mRNA contro COVID-19,ND,RA ISTITUTO S. MARIA IN GRADI,TOS,60-69,0,2,0,1,0,1,0,2,0,2,Toscana,ITI1
2021-01-16,COMIRNATY Vaccino a mRNA contro COVID-19,ND,RA ISTITUTO S. MARIA IN GRADI,TOS,70-79,0,2,0,0,0,2,0,2,0,2,Toscana,ITI1
2021-01-16,COMIRNATY Vaccino a mRNA contro COVID-19,ND,RA ISTITUTO S. MARIA IN GRADI,TOS,80-89,0,8,0,0,0,8,0,8,0,8,Toscana,ITI1
2021-01-16,COMIRNATY Vaccino a mRNA contro COVID-19,ND,RA ISTITUTO S. MARIA IN GRADI,TOS,90+,0,9,0,0,0,9,0,9,0,9,Toscana,ITI1
2021-01-16,COMIRNATY Vaccino a mRNA contro COVID-19,ND,Residenza Assistita Casa di Riposo P. Morviducci,TOS,20-29,0,1,0,1,0,0,0,1,0,1,Toscana,ITI1
2021-01-16,COMIRNATY Vaccino a mRNA contro COVID-19,ND,Residenza Assistita Casa di Riposo P. Morviducci,TOS,60-69,0,1,0,0,0,1,0,1,0,1,Toscana,ITI1
2021-01-16,COMIRNATY Vaccino a mRNA contro COVID-19,ND,Residenza Assistita Casa di Riposo P. Morviducci,TOS,70-79,1,2,0,0,0,3,0,3,0,3,Toscana,ITI1
2021-01-16,COMIRNATY Vaccino a mRNA contro COVID-19,ND,Residenza Assistita Casa di Riposo P. Morviducci,TOS,80-89,1,7,0,0,0,8,0,8,0,8,Toscana,ITI1
2021-01-16,COMIRNATY Vaccino a mRNA contro COVID-19,ND,Residenza Assistita Casa di Riposo P. Morviducci,TOS,90+,1,10,0,0,0,11,0,11,0,11,Toscana,ITI1
2021-01-17,COMIRNATY Vaccino a mRNA contro COVID-19,04001A,Campo di Marte Lucca - iGIENE PUBBLICA,TOS,20-29,3,10,0,13,0,0,0,13,0,13,Toscana,ITI1
2021-01-17,COMIRNATY Vaccino a mRNA contro COVID-19,04001A,Campo di Marte Lucca - iGIENE PUBBLICA,TOS,30-39,5,11,0,16,0,0,0,16,0,16,Toscana,ITI1
2021-01-17,COMIRNATY Vaccino a mRNA contro COVID-19,04001A,Campo di Marte Lucca - iGIENE PUBBLICA,TOS,40-49,6,13,0,19,0,0,0,19,0,19,Toscana,ITI1
2021-01-17,COMIRNATY Vaccino a mRNA contro COVID-19,04001A,Campo di Marte Lucca - iGIENE PUBBLICA,TOS,50-59,9,20,0,29,0,0,0,29,0,29,Toscana,ITI1
2021-01-17,COMIRNATY Vaccino a mRNA contro COVID-19,04001A,Campo di Marte Lucca - iGIENE PUBBLICA,TOS,60-69,6,5,0,11,0,0,0,11,0,11,Toscana,ITI1
2021-01-17,COMIRNATY Vaccino a mRNA contro COVID-19,04001A,Campo di Marte Lucca - iGIENE PUBBLICA,TOS,70-79,2,0,0,2,0,0,0,2,0,2,Toscana,ITI1
2021-01-17,COMIRNATY Vaccino a mRNA contro COVID-19,090604,Covid 19 - Ospedale San Luca di  Lucca,TOS,30-39,5,6,0,9,2,0,0,2,9,11,Toscana,ITI1
2021-01-17,COMIRNATY Vaccino a mRNA contro COVID-19,090604,Covid 19 - Ospedale San Luca di  Lucca,TOS,40-49,1,12,0,13,0,0,0,1,12,13,Toscana,ITI1
2021-01-17,COMIRNATY Vaccino a mRNA contro COVID-19,090604,Covid 19 - Ospedale San Luca di  Lucca,TOS,50-59,0,10,0,10,0,0,0,1,9,10,Toscana,ITI1
2021-01-17,COMIRNATY Vaccino a mRNA contro COVID-19,090604,Covid 19 - Ospedale San Luca di  Lucca,TOS,60-69,7,3,0,10,0,0,0,1,9,10,Toscana,ITI1
2021-01-17,COMIRNATY Vaccino a mRNA contro COVID-19,090606,COVID19 - Ospedale San Iacopo,TOS,20-29,8,10,0,17,1,0,0,16,2,18,Toscana,ITI1
2021-01-17,COMIRNATY Vaccino a mRNA contro COVID-19,090606,COVID19 - Ospedale San Iacopo,TOS,30-39,4,22,0,23,3,0,0,20,6,26,Toscana,ITI1
2021-01-17,COMIRNATY Vaccino a mRNA contro COVID-19,090606,COVID19 - Ospedale San Iacopo,TOS,40-49,4,39,0,42,1,0,0,32,11,43,Toscana,ITI1
2021-01-17,COMIRNATY Vaccino a mRNA contro COVID-19,090606,COVID19 - Ospedale San Iacopo,TOS,50-59,13,35,0,43,5,0,0,30,18,48,Toscana,ITI1
2021-01-17,COMIRNATY Vaccino a mRNA contro COVID-19,090606,COVID19 - Ospedale San Iacopo,TOS,60-69,11,13,0,18,2,4,0,17,7,24,Toscana,ITI1
2021-01-17,COMIRNATY Vaccino a mRNA contro COVID-19,090606,COVID19 - Ospedale San Iacopo,TOS,70-79,5,6,0,2,0,9,0,11,0,11,Toscana,ITI1
2021-01-17,COMIRNATY Vaccino a mRNA contro COVID-19,090606,COVID19 - Ospedale San Iacopo,TOS,80-89,4,13,0,1,0,16,0,17,0,17,Toscana,ITI1
2021-01-17,COMIRNATY Vaccino a mRNA contro COVID-19,090606,COVID19 - Ospedale San Iacopo,TOS,90+,0,4,0,0,0,4,0,4,0,4,Toscana,ITI1
2021-01-17,COMIRNATY Vaccino a mRNA contro COVID-19,090607,COVID19 - Ospedale SS.Cosma e Damiano,TOS,20-29,0,5,0,4,1,0,0,5,0,5,Toscana,ITI1
2021-01-17,COMIRNATY Vaccino a mRNA contro COVID-19,090607,COVID19 - Ospedale SS.Cosma e Damiano,TOS,30-39,4,5,0,5,4,0,0,9,0,9,Toscana,ITI1
2021-01-17,COMIRNATY Vaccino a mRNA contro COVID-19,090607,COVID19 - Ospedale SS.Cosma e Damiano,TOS,40-49,2,10,0,8,4,0,0,12,0,12,Toscana,ITI1
2021-01-17,COMIRNATY Vaccino a mRNA contro COVID-19,090607,COVID19 - Ospedale SS.Cosma e Damiano,TOS,50-59,5,11,0,9,7,0,0,16,0,16,Toscana,ITI1
2021-01-17,COMIRNATY Vaccino a mRNA contro COVID-19,090607,COVID19 - Ospedale SS.Cosma e Damiano,TOS,60-69,3,3,0,4,2,0,0,6,0,6,Toscana,ITI1
2021-01-17,COMIRNATY Vaccino a mRNA contro COVID-19,090608,COVID19 - Ospedale Santo Stefano,TOS,20-29,6,13,0,15,3,1,0,19,0,19,Toscana,ITI1
2021-01-17,COMIRNATY Vaccino a mRNA contro COVID-19,090608,COVID19 - Ospedale Santo Stefano,TOS,30-39,11,16,0,25,2,0,0,22,5,27,Toscana,ITI1
2021-01-17,COMIRNATY Vaccino a mRNA contro COVID-19,090608,COVID19 - Ospedale Santo Stefano,TOS,40-49,11,32,0,35,7,1,0,27,16,43,Toscana,ITI1
2021-01-17,COMIRNATY Vaccino a mRNA contro COVID-19,090608,COVID19 - Ospedale Santo Stefano,TOS,50-59,18,27,0,39,5,1,0,27,18,45,Toscana,ITI1
2021-01-17,COMIRNATY Vaccino a mRNA contro COVID-19,090608,COVID19 - Ospedale Santo Stefano,TOS,60-69,7,11,0,17,1,0,0,12,6,18,Toscana,ITI1
2021-01-17,COMIRNATY Vaccino a mRNA contro COVID-19,090608,COVID19 - Ospedale Santo Stefano,TOS,70-79,1,1,0,2,0,0,0,2,0,2,Toscana,ITI1
2021-01-17,COMIRNATY Vaccino a mRNA contro COVID-19,090610,Covid 19 - Ospedale F.Lotti di Pontedera,TOS,20-29,2,6,0,8,0,0,0,8,0,8,Toscana,ITI1
2021-01-17,COMIRNATY Vaccino a mRNA contro COVID-19,090610,Covid 19 - Ospedale F.Lotti di Pontedera,TOS,30-39,1,9,0,10,0,0,0,10,0,10,Toscana,ITI1
2021-01-17,COMIRNATY Vaccino a mRNA contro COVID-19,090610,Covid 19 - Ospedale F.Lotti di Pontedera,TOS,40-49,4,8,0,12,0,0,0,12,0,12,Toscana,ITI1
2021-01-17,COMIRNATY Vaccino a mRNA contro COVID-19,090610,Covid 19 - Ospedale F.Lotti di Pontedera,TOS,50-59,2,16,0,18,0,0,0,18,0,18,Toscana,ITI1
2021-01-17,COMIRNATY Vaccino a mRNA contro COVID-19,090610,Covid 19 - Ospedale F.Lotti di Pontedera,TOS,60-69,4,7,0,11,0,0,0,11,0,11,Toscana,ITI1
2021-01-17,COMIRNATY Vaccino a mRNA contro COVID-19,090610,Covid 19 - Ospedale F.Lotti di Pontedera,TOS,70-79,1,0,0,1,0,0,0,1,0,1,Toscana,ITI1
2021-01-17,COMIRNATY Vaccino a mRNA contro COVID-19,090613,Covid 19 - Ospedali Riuniti di Livorno,TOS,20-29,7,13,0,17,3,0,0,12,8,20,Toscana,ITI1
2021-01-17,COMIRNATY Vaccino a mRNA contro COVID-19,090613,Covid 19 - Ospedali Riuniti di Livorno,TOS,30-39,8,19,0,20,7,0,0,18,9,27,Toscana,ITI1
2021-01-17,COMIRNATY Vaccino a mRNA contro COVID-19,090613,Covid 19 - Ospedali Riuniti di Livorno,TOS,40-49,4,27,0,23,8,0,0,24,7,31,Toscana,ITI1
2021-01-17,COMIRNATY Vaccino a mRNA contro COVID-19,090613,Covid 19 - Ospedali Riuniti di Livorno,TOS,50-59,13,32,0,37,8,0,0,31,14,45,Toscana,ITI1
2021-01-17,COMIRNATY Vaccino a mRNA contro COVID-19,090613,Covid 19 - Ospedali Riuniti di Livorno,TOS,60-69,7,14,0,17,4,0,0,10,11,21,Toscana,ITI1
2021-01-17,COMIRNATY Vaccino a mRNA contro COVID-19,090614,Covid 19 - Ospedale Civile di Piombino,TOS,20-29,0,2,0,2,0,0,0,2,0,2,Toscana,ITI1
2021-01-17,COMIRNATY Vaccino a mRNA contro COVID-19,090614,Covid 19 - Ospedale Civile di Piombino,TOS,30-39,2,1,0,3,0,0,0,3,0,3,Toscana,ITI1
2021-01-17,COMIRNATY Vaccino a mRNA contro COVID-19,090614,Covid 19 - Ospedale Civile di Piombino,TOS,40-49,0,2,0,2,0,0,0,2,0,2,Toscana,ITI1
2021-01-17,COMIRNATY Vaccino a mRNA contro COVID-19,090614,Covid 19 - Ospedale Civile di Piombino,TOS,50-59,2,12,0,14,0,0,0,14,0,14,Toscana,ITI1
2021-01-17,COMIRNATY Vaccino a mRNA contro COVID-19,090614,Covid 19 - Ospedale Civile di Piombino,TOS,60-69,2,6,0,7,0,1,0,8,0,8,Toscana,ITI1
2021-01-17,COMIRNATY Vaccino a mRNA contro COVID-19,090627,COVID19 - Ospedale Mugello,TOS,20-29,1,2,0,3,0,0,0,3,0,3,Toscana,ITI1
2021-01-17,COMIRNATY Vaccino a mRNA contro COVID-19,090627,COVID19 - Ospedale Mugello,TOS,30-39,0,9,0,8,1,0,0,9,0,9,Toscana,ITI1
2021-01-17,COMIRNATY Vaccino a mRNA contro COVID-19,090627,COVID19 - Ospedale Mugello,TOS,40-49,1,10,0,10,1,0,0,11,0,11,Toscana,ITI1
2021-01-17,COMIRNATY Vaccino a mRNA contro COVID-19,090627,COVID19 - Ospedale Mugello,TOS,50-59,5,7,0,8,4,0,0,12,0,12,Toscana,ITI1
2021-01-17,COMIRNATY Vaccino a mRNA contro COVID-19,090627,COVID19 - Ospedale Mugello,TOS,60-69,4,7,0,11,0,0,0,11,0,11,Toscana,ITI1
2021-01-17,COMIRNATY Vaccino a mRNA contro COVID-19,090627,COVID19 - Ospedale Mugello,TOS,70-79,1,0,0,0,1,0,0,1,0,1,Toscana,ITI1
2021-01-17,COMIRNATY Vaccino a mRNA contro COVID-19,090627,COVID19 - Ospedale Mugello,TOS,80-89,0,1,0,1,0,0,0,1,0,1,Toscana,ITI1
2021-01-17,COMIRNATY Vaccino a mRNA contro COVID-19,090629,COVID19 - Ospedale SS. Maria Annunziata,TOS,20-29,6,11,0,14,3,0,0,17,0,17,Toscana,ITI1
2021-01-17,COMIRNATY Vaccino a mRNA contro COVID-19,090629,COVID19 - Ospedale SS. Maria Annunziata,TOS,30-39,7,15,0,17,5,0,0,22,0,22,Toscana,ITI1
2021-01-17,COMIRNATY Vaccino a mRNA contro COVID-19,090629,COVID19 - Ospedale SS. Maria Annunziata,TOS,40-49,11,19,0,22,8,0,0,30,0,30,Toscana,ITI1
2021-01-17,COMIRNATY Vaccino a mRNA contro COVID-19,090629,COVID19 - Ospedale SS. Maria Annunziata,TOS,50-59,11,31,0,28,14,0,0,42,0,42,Toscana,ITI1
2021-01-17,COMIRNATY Vaccino a mRNA contro COVID-19,090629,COVID19 - Ospedale SS. Maria Annunziata,TOS,60-69,22,9,0,20,11,0,0,31,0,31,Toscana,ITI1
2021-01-17,COMIRNATY Vaccino a mRNA contro COVID-19,090629,COVID19 - Ospedale SS. Maria Annunziata,TOS,70-79,6,1,0,4,3,0,0,7,0,7,Toscana,ITI1
2021-01-17,COMIRNATY Vaccino a mRNA contro COVID-19,090632,COVID19 - Ospedale Santa Maria Nuova,TOS,20-29,3,9,0,12,0,0,0,12,0,12,Toscana,ITI1
2021-01-17,COMIRNATY Vaccino a mRNA contro COVID-19,090632,COVID19 - Ospedale Santa Maria Nuova,TOS,30-39,4,13,0,17,0,0,0,17,0,17,Toscana,ITI1
2021-01-17,COMIRNATY Vaccino a mRNA contro COVID-19,090632,COVID19 - Ospedale Santa Maria Nuova,TOS,40-49,4,22,0,26,0,0,0,26,0,26,Toscana,ITI1
2021-01-17,COMIRNATY Vaccino a mRNA contro COVID-19,090632,COVID19 - Ospedale Santa Maria Nuova,TOS,50-59,7,17,0,24,0,0,0,24,0,24,Toscana,ITI1
2021-01-17,COMIRNATY Vaccino a mRNA contro COVID-19,090632,COVID19 - Ospedale Santa Maria Nuova,TOS,60-69,11,12,0,23,0,0,0,23,0,23,Toscana,ITI1
2021-01-17,COMIRNATY Vaccino a mRNA contro COVID-19,090637,COVID19 - Ospedale Amiata Val d'Orcia  Abbadia San Salvatore,TOS,30-39,1,0,0,0,1,0,0,1,0,1,Toscana,ITI1
2021-01-17,COMIRNATY Vaccino a mRNA contro COVID-19,090637,COVID19 - Ospedale Amiata Val d'Orcia  Abbadia San Salvatore,TOS,50-59,1,2,0,0,3,0,0,3,0,3,Toscana,ITI1
2021-01-17,COMIRNATY Vaccino a mRNA contro COVID-19,090637,COVID19 - Ospedale Amiata Val d'Orcia  Abbadia San Salvatore,TOS,60-69,3,5,0,6,2,0,0,8,0,8,Toscana,ITI1
2021-01-17,COMIRNATY Vaccino a mRNA contro COVID-19,090638,COVID19 - Ospedale di Campostaggia Poggibonsi,TOS,20-29,1,3,0,4,0,0,0,4,0,4,Toscana,ITI1
2021-01-17,COMIRNATY Vaccino a mRNA contro COVID-19,090638,COVID19 - Ospedale di Campostaggia Poggibonsi,TOS,30-39,4,8,0,12,0,0,0,12,0,12,Toscana,ITI1
2021-01-17,COMIRNATY Vaccino a mRNA contro COVID-19,090638,COVID19 - Ospedale di Campostaggia Poggibonsi,TOS,40-49,7,10,0,17,0,0,0,17,0,17,Toscana,ITI1
2021-01-17,COMIRNATY Vaccino a mRNA contro COVID-19,090638,COVID19 - Ospedale di Campostaggia Poggibonsi,TOS,50-59,5,28,0,33,0,0,0,33,0,33,Toscana,ITI1
2021-01-17,COMIRNATY Vaccino a mRNA contro COVID-19,090638,COVID19 - Ospedale di Campostaggia Poggibonsi,TOS,60-69,5,4,0,9,0,0,0,9,0,9,Toscana,ITI1
2021-01-17,COMIRNATY Vaccino a mRNA contro COVID-19,090640,Covid 19 - Ospedale Unico Versilia,TOS,20-29,1,8,0,9,0,0,0,9,0,9,Toscana,ITI1
2021-01-17,COMIRNATY Vaccino a mRNA contro COVID-19,090640,Covid 19 - Ospedale Unico Versilia,TOS,30-39,3,7,0,10,0,0,0,10,0,10,Toscana,ITI1
2021-01-17,COMIRNATY Vaccino a mRNA contro COVID-19,090640,Covid 19 - Ospedale Unico Versilia,TOS,40-49,5,20,0,25,0,0,0,25,0,25,Toscana,ITI1
2021-01-17,COMIRNATY Vaccino a mRNA contro COVID-19,090640,Covid 19 - Ospedale Unico Versilia,TOS,50-59,9,17,0,26,0,0,0,26,0,26,Toscana,ITI1
2021-01-17,COMIRNATY Vaccino a mRNA contro COVID-19,090640,Covid 19 - Ospedale Unico Versilia,TOS,60-69,6,12,0,18,0,0,0,18,0,18,Toscana,ITI1
2021-01-17,COMIRNATY Vaccino a mRNA contro COVID-19,090640,Covid 19 - Ospedale Unico Versilia,TOS,70-79,1,0,0,1,0,0,0,1,0,1,Toscana,ITI1
2021-01-17,COMIRNATY Vaccino a mRNA contro COVID-19,090641,COVID19 - Ospedale La Gruccia Montevarchi,TOS,30-39,1,6,0,7,0,0,0,7,0,7,Toscana,ITI1
2021-01-17,COMIRNATY Vaccino a mRNA contro COVID-19,090641,COVID19 - Ospedale La Gruccia Montevarchi,TOS,40-49,1,7,0,8,0,0,0,8,0,8,Toscana,ITI1
2021-01-17,COMIRNATY Vaccino a mRNA contro COVID-19,090641,COVID19 - Ospedale La Gruccia Montevarchi,TOS,50-59,6,20,0,26,0,0,0,26,0,26,Toscana,ITI1
2021-01-17,COMIRNATY Vaccino a mRNA contro COVID-19,090641,COVID19 - Ospedale La Gruccia Montevarchi,TOS,60-69,3,4,0,7,0,0,0,7,0,7,Toscana,ITI1
2021-01-17,COMIRNATY Vaccino a mRNA contro COVID-19,090901,COVID19 - AOU Pisana,TOS,16-19,0,2,0,1,1,0,0,2,0,2,Toscana,ITI1
2021-01-17,COMIRNATY Vaccino a mRNA contro COVID-19,090901,COVID19 - AOU Pisana,TOS,20-29,27,27,0,43,10,1,0,45,9,54,Toscana,ITI1
2021-01-17,COMIRNATY Vaccino a mRNA contro COVID-19,090901,COVID19 - AOU Pisana,TOS,30-39,16,29,0,40,5,0,0,36,9,45,Toscana,ITI1
2021-01-17,COMIRNATY Vaccino a mRNA contro COVID-19,090901,COVID19 - AOU Pisana,TOS,40-49,17,43,0,49,10,1,0,45,15,60,Toscana,ITI1
2021-01-17,COMIRNATY Vaccino a mRNA contro COVID-19,090901,COVID19 - AOU Pisana,TOS,50-59,16,41,0,42,15,0,0,44,13,57,Toscana,ITI1
2021-01-17,COMIRNATY Vaccino a mRNA contro COVID-19,090901,COVID19 - AOU Pisana,TOS,60-69,13,23,0,34,2,0,0,32,4,36,Toscana,ITI1
2021-01-17,COMIRNATY Vaccino a mRNA contro COVID-19,090901,COVID19 - AOU Pisana,TOS,70-79,4,0,0,4,0,0,0,4,0,4,Toscana,ITI1
2021-01-17,COMIRNATY Vaccino a mRNA contro COVID-19,090902,COVID19 - AOU Senese,TOS,16-19,1,2,0,0,3,0,0,3,0,3,Toscana,ITI1
2021-01-17,COMIRNATY Vaccino a mRNA contro COVID-19,090902,COVID19 - AOU Senese,TOS,20-29,9,28,0,17,19,1,0,37,0,37,Toscana,ITI1
2021-01-17,COMIRNATY Vaccino a mRNA contro COVID-19,090902,COVID19 - AOU Senese,TOS,30-39,12,18,0,20,10,0,0,30,0,30,Toscana,ITI1
2021-01-17,COMIRNATY Vaccino a mRNA contro COVID-19,090902,COVID19 - AOU Senese,TOS,40-49,14,26,0,25,15,0,0,40,0,40,Toscana,ITI1
2021-01-17,COMIRNATY Vaccino a mRNA contro COVID-19,090902,COVID19 - AOU Senese,TOS,50-59,9,28,0,27,10,0,0,37,0,37,Toscana,ITI1
2021-01-17,COMIRNATY Vaccino a mRNA contro COVID-19,090902,COVID19 - AOU Senese,TOS,60-69,8,11,0,13,6,0,0,19,0,19,Toscana,ITI1
2021-01-17,COMIRNATY Vaccino a mRNA contro COVID-19,090902,COVID19 - AOU Senese,TOS,70-79,1,0,0,1,0,0,0,1,0,1,Toscana,ITI1
2021-01-17,COMIRNATY Vaccino a mRNA contro COVID-19,11012E,COVID19 - Ospedale San Giuseppe,TOS,20-29,11,10,0,20,1,0,0,15,6,21,Toscana,ITI1
2021-01-17,COMIRNATY Vaccino a mRNA contro COVID-19,11012E,COVID19 - Ospedale San Giuseppe,TOS,30-39,12,16,0,26,2,0,0,18,10,28,Toscana,ITI1
2021-01-17,COMIRNATY Vaccino a mRNA contro COVID-19,11012E,COVID19 - Ospedale San Giuseppe,TOS,40-49,11,29,0,39,1,0,0,26,14,40,Toscana,ITI1
2021-01-17,COMIRNATY Vaccino a mRNA contro COVID-19,11012E,COVID19 - Ospedale San Giuseppe,TOS,50-59,14,29,0,39,4,0,0,30,13,43,Toscana,ITI1
2021-01-17,COMIRNATY Vaccino a mRNA contro COVID-19,11012E,COVID19 - Ospedale San Giuseppe,TOS,60-69,7,9,0,15,0,1,0,10,6,16,Toscana,ITI1
2021-01-17,COMIRNATY Vaccino a mRNA contro COVID-19,11012E,COVID19 - Ospedale San Giuseppe,TOS,70-79,1,1,0,2,0,0,0,2,0,2,Toscana,ITI1
2021-01-17,COMIRNATY Vaccino a mRNA contro COVID-19,12031A,PRESIDIO AULLA,TOS,20-29,0,2,0,1,1,0,0,2,0,2,Toscana,ITI1
2021-01-17,COMIRNATY Vaccino a mRNA contro COVID-19,12031A,PRESIDIO AULLA,TOS,30-39,4,1,0,4,1,0,0,5,0,5,Toscana,ITI1
2021-01-17,COMIRNATY Vaccino a mRNA contro COVID-19,12031A,PRESIDIO AULLA,TOS,40-49,0,7,0,6,1,0,0,7,0,7,Toscana,ITI1
2021-01-17,COMIRNATY Vaccino a mRNA contro COVID-19,12031A,PRESIDIO AULLA,TOS,50-59,1,12,0,7,6,0,0,13,0,13,Toscana,ITI1
2021-01-17,COMIRNATY Vaccino a mRNA contro COVID-19,12031A,PRESIDIO AULLA,TOS,60-69,0,3,0,2,1,0,0,3,0,3,Toscana,ITI1
2021-01-17,COMIRNATY Vaccino a mRNA contro COVID-19,12034I,R.S.A. MARINA DI LEVANTE,TOS,80-89,1,0,0,0,0,1,0,1,0,1,Toscana,ITI1
2021-01-17,COMIRNATY Vaccino a mRNA contro COVID-19,13021A,COVID19 - Ospedale S.Giovanni di Dio,TOS,16-19,2,1,0,0,0,3,0,3,0,3,Toscana,ITI1
2021-01-17,COMIRNATY Vaccino a mRNA contro COVID-19,13021A,COVID19 - Ospedale S.Giovanni di Dio,TOS,20-29,6,10,0,11,0,5,0,13,3,16,Toscana,ITI1
2021-01-17,COMIRNATY Vaccino a mRNA contro COVID-19,13021A,COVID19 - Ospedale S.Giovanni di Dio,TOS,30-39,18,28,0,36,0,10,0,24,22,46,Toscana,ITI1
2021-01-17,COMIRNATY Vaccino a mRNA contro COVID-19,13021A,COVID19 - Ospedale S.Giovanni di Dio,TOS,40-49,19,16,0,25,0,10,0,26,9,35,Toscana,ITI1
2021-01-17,COMIRNATY Vaccino a mRNA contro COVID-19,13021A,COVID19 - Ospedale S.Giovanni di Dio,TOS,50-59,27,42,0,59,0,10,0,49,20,69,Toscana,ITI1
2021-01-17,COMIRNATY Vaccino a mRNA contro COVID-19,13021A,COVID19 - Ospedale S.Giovanni di Dio,TOS,60-69,22,19,0,39,0,2,0,23,18,41,Toscana,ITI1
2021-01-17,COMIRNATY Vaccino a mRNA contro COVID-19,13334I,Covid19 - RSA SANATRIX,TOS,30-39,1,0,0,1,0,0,0,1,0,1,Toscana,ITI1
2021-01-17,COMIRNATY Vaccino a mRNA contro COVID-19,13334I,Covid19 - RSA SANATRIX,TOS,40-49,0,1,0,1,0,0,0,1,0,1,Toscana,ITI1
2021-01-17,COMIRNATY Vaccino a mRNA contro COVID-19,13334I,Covid19 - RSA SANATRIX,TOS,50-59,0,2,0,2,0,0,0,2,0,2,Toscana,ITI1
2021-01-17,COMIRNATY Vaccino a mRNA contro COVID-19,13334I,Covid19 - RSA SANATRIX,TOS,60-69,1,0,0,0,0,1,0,1,0,1,Toscana,ITI1
2021-01-17,COMIRNATY Vaccino a mRNA contro COVID-19,13334I,Covid19 - RSA SANATRIX,TOS,70-79,0,3,0,0,0,3,0,3,0,3,Toscana,ITI1
2021-01-17,COMIRNATY Vaccino a mRNA contro COVID-19,13334I,Covid19 - RSA SANATRIX,TOS,80-89,1,10,0,0,0,11,0,11,0,11,Toscana,ITI1
2021-01-17,COMIRNATY Vaccino a mRNA contro COVID-19,13334I,Covid19 - RSA SANATRIX,TOS,90+,0,5,0,0,0,5,0,5,0,5,Toscana,ITI1
2021-01-17,COMIRNATY Vaccino a mRNA contro COVID-19,22011A,PRESIDIO MASSA CENTRO,TOS,20-29,3,4,0,6,1,0,0,7,0,7,Toscana,ITI1
2021-01-17,COMIRNATY Vaccino a mRNA contro COVID-19,22011A,PRESIDIO MASSA CENTRO,TOS,30-39,4,6,0,8,2,0,0,10,0,10,Toscana,ITI1
2021-01-17,COMIRNATY Vaccino a mRNA contro COVID-19,22011A,PRESIDIO MASSA CENTRO,TOS,40-49,8,20,0,17,11,0,0,28,0,28,Toscana,ITI1
2021-01-17,COMIRNATY Vaccino a mRNA contro COVID-19,22011A,PRESIDIO MASSA CENTRO,TOS,50-59,11,19,0,21,9,0,0,30,0,30,Toscana,ITI1
2021-01-17,COMIRNATY Vaccino a mRNA contro COVID-19,22011A,PRESIDIO MASSA CENTRO,TOS,60-69,8,7,0,13,2,0,0,15,0,15,Toscana,ITI1
2021-01-17,COMIRNATY Vaccino a mRNA contro COVID-19,60804I,COVID19 - RSA ASP  MONTEDOMINI,TOS,50-59,5,3,0,0,0,8,0,1,7,8,Toscana,ITI1
2021-01-17,COMIRNATY Vaccino a mRNA contro COVID-19,ND,RA Asilo Boutini Bourke,TOS,60-69,1,1,0,1,0,1,0,2,0,2,Toscana,ITI1
2021-01-17,COMIRNATY Vaccino a mRNA contro COVID-19,ND,RA Asilo Boutini Bourke,TOS,70-79,1,5,0,0,0,6,0,6,0,6,Toscana,ITI1
2021-01-17,COMIRNATY Vaccino a mRNA contro COVID-19,ND,RA Asilo Boutini Bourke,TOS,80-89,0,14,0,0,0,14,0,14,0,14,Toscana,ITI1
2021-01-17,COMIRNATY Vaccino a mRNA contro COVID-19,ND,RA Asilo Boutini Bourke,TOS,90+,1,19,0,0,0,20,0,20,0,20,Toscana,ITI1
2021-01-17,COMIRNATY Vaccino a mRNA contro COVID-19,ND,RA Casa Simoni,TOS,20-29,1,0,0,1,0,0,0,1,0,1,Toscana,ITI1
2021-01-17,COMIRNATY Vaccino a mRNA contro COVID-19,ND,RA Casa Simoni,TOS,40-49,0,1,0,0,0,1,0,1,0,1,Toscana,ITI1
2021-01-17,COMIRNATY Vaccino a mRNA contro COVID-19,ND,RA Casa Simoni,TOS,50-59,2,3,0,2,0,3,0,5,0,5,Toscana,ITI1
2021-01-17,COMIRNATY Vaccino a mRNA contro COVID-19,ND,RA Casa Simoni,TOS,60-69,1,2,0,1,0,2,0,3,0,3,Toscana,ITI1
2021-01-17,COMIRNATY Vaccino a mRNA contro COVID-19,ND,RA Casa Simoni,TOS,70-79,1,2,0,0,0,3,0,3,0,3,Toscana,ITI1
2021-01-17,COMIRNATY Vaccino a mRNA contro COVID-19,ND,RA Casa Simoni,TOS,80-89,1,2,0,0,0,3,0,3,0,3,Toscana,ITI1
2021-01-17,COMIRNATY Vaccino a mRNA contro COVID-19,ND,RA Casa Simoni,TOS,90+,0,1,0,0,0,1,0,1,0,1,Toscana,ITI1
