TML_DTA_SOMM,TML_VAX_FORNITORE,TML_COD_STRUTTURA,TML_DES_STRUTTURA,TML_AREA,TML_FASCIA_ETA,TML_SESSO_M,TML_SESSO_F,TML_GRAVIDANZA,TML_CAT_OSS,TML_CAT_PERSONALE,TML_CAT_RSA_OSPITI,TML_CAT_ALTRO,TML_DOSE_1,TML_DOSE_2,TML_TOT_SOMM,TML_REGIONE,TML_NUTS
2020-12-27,PF/BT,50501,"BELLUNO ""DRIVE-IN""",VEN,20-29,1,4,0,5,0,0,0,5,0,5,Veneto,ITH3
2020-12-27,PF/BT,50501,"BELLUNO ""DRIVE-IN""",VEN,30-39,1,0,0,1,0,0,0,1,0,1,Veneto,ITH3
2020-12-27,PF/BT,50501,"BELLUNO ""DRIVE-IN""",VEN,40-49,0,6,0,6,0,0,0,6,0,6,Veneto,ITH3
2020-12-27,PF/BT,50501,"BELLUNO ""DRIVE-IN""",VEN,50-59,4,4,0,8,0,0,0,8,0,8,Veneto,ITH3
2020-12-27,PF/BT,50501,"BELLUNO ""DRIVE-IN""",VEN,60-69,2,2,0,4,0,0,0,4,0,4,Veneto,ITH3
2020-12-27,PF/BT,50501,FELTRE ADULTI,VEN,20-29,0,1,0,1,0,0,0,1,0,1,Veneto,ITH3
2020-12-27,PF/BT,50501,FELTRE ADULTI,VEN,30-39,2,2,0,4,0,0,0,4,0,4,Veneto,ITH3
2020-12-27,PF/BT,50501,FELTRE ADULTI,VEN,40-49,1,2,0,3,0,0,0,3,0,3,Veneto,ITH3
2020-12-27,PF/BT,50501,FELTRE ADULTI,VEN,50-59,2,5,0,7,0,0,0,7,0,7,Veneto,ITH3
2020-12-27,PF/BT,50501,FELTRE ADULTI,VEN,60-69,3,2,0,5,0,0,0,5,0,5,Veneto,ITH3
2020-12-27,PF/BT,5050201,OSPEDALE CA' FONCELLO,VEN,20-29,2,4,0,6,0,0,0,6,0,6,Veneto,ITH3
2020-12-27,PF/BT,5050201,OSPEDALE CA' FONCELLO,VEN,30-39,12,10,0,22,0,0,0,22,0,22,Veneto,ITH3
2020-12-27,PF/BT,5050201,OSPEDALE CA' FONCELLO,VEN,40-49,6,16,0,22,0,0,0,22,0,22,Veneto,ITH3
2020-12-27,PF/BT,5050201,OSPEDALE CA' FONCELLO,VEN,50-59,14,28,0,42,0,0,0,42,0,42,Veneto,ITH3
2020-12-27,PF/BT,5050201,OSPEDALE CA' FONCELLO,VEN,60-69,8,5,0,13,0,0,0,13,0,13,Veneto,ITH3
2020-12-27,PF/BT,50503,CHIOGGIA,VEN,40-49,1,3,0,4,0,0,0,4,0,4,Veneto,ITH3
2020-12-27,PF/BT,50503,CHIOGGIA,VEN,50-59,1,5,0,6,0,0,0,6,0,6,Veneto,ITH3
2020-12-27,PF/BT,50503,CHIOGGIA,VEN,60-69,4,1,0,5,0,0,0,5,0,5,Veneto,ITH3
2020-12-27,PF/BT,50503,S.I.S.P. MESTRE,VEN,20-29,0,3,0,3,0,0,0,3,0,3,Veneto,ITH3
2020-12-27,PF/BT,50503,S.I.S.P. MESTRE,VEN,30-39,5,1,0,6,0,0,0,6,0,6,Veneto,ITH3
2020-12-27,PF/BT,50503,S.I.S.P. MESTRE,VEN,40-49,1,6,0,7,0,0,0,7,0,7,Veneto,ITH3
2020-12-27,PF/BT,50503,S.I.S.P. MESTRE,VEN,50-59,3,5,0,8,0,0,0,8,0,8,Veneto,ITH3
2020-12-27,PF/BT,50503,S.I.S.P. MESTRE,VEN,60-69,7,4,0,11,0,0,0,11,0,11,Veneto,ITH3
2020-12-27,PF/BT,50503,S.I.S.P. VENEZIA,VEN,20-29,1,1,0,2,0,0,0,2,0,2,Veneto,ITH3
2020-12-27,PF/BT,50503,S.I.S.P. VENEZIA,VEN,30-39,4,0,0,4,0,0,0,4,0,4,Veneto,ITH3
2020-12-27,PF/BT,50503,S.I.S.P. VENEZIA,VEN,40-49,2,0,0,2,0,0,0,2,0,2,Veneto,ITH3
2020-12-27,PF/BT,50503,S.I.S.P. VENEZIA,VEN,50-59,5,1,0,6,0,0,0,6,0,6,Veneto,ITH3
2020-12-27,PF/BT,50503,S.I.S.P. VENEZIA,VEN,60-69,1,0,0,1,0,0,0,1,0,1,Veneto,ITH3
2020-12-27,PF/BT,50503,SISP DOLO ADULTI,VEN,20-29,2,2,0,4,0,0,0,4,0,4,Veneto,ITH3
2020-12-27,PF/BT,50503,SISP DOLO ADULTI,VEN,30-39,3,1,0,4,0,0,0,4,0,4,Veneto,ITH3
2020-12-27,PF/BT,50503,SISP DOLO ADULTI,VEN,40-49,4,4,0,8,0,0,0,8,0,8,Veneto,ITH3
2020-12-27,PF/BT,50503,SISP DOLO ADULTI,VEN,50-59,8,8,0,16,0,0,0,16,0,16,Veneto,ITH3
2020-12-27,PF/BT,50503,SISP DOLO ADULTI,VEN,60-69,9,3,0,12,0,0,0,12,0,12,Veneto,ITH3
2020-12-27,PF/BT,50503,SISP DOLO ADULTI,VEN,70-79,1,0,0,1,0,0,0,1,0,1,Veneto,ITH3
2020-12-27,PF/BT,50504,CA' SAVIO,VEN,20-29,0,4,0,4,0,0,0,4,0,4,Veneto,ITH3
2020-12-27,PF/BT,50504,CA' SAVIO,VEN,30-39,3,2,0,5,0,0,0,5,0,5,Veneto,ITH3
2020-12-27,PF/BT,50504,CA' SAVIO,VEN,40-49,5,7,0,12,0,0,0,12,0,12,Veneto,ITH3
2020-12-27,PF/BT,50504,CA' SAVIO,VEN,50-59,6,12,0,18,0,0,0,18,0,18,Veneto,ITH3
2020-12-27,PF/BT,50504,CA' SAVIO,VEN,60-69,6,0,0,6,0,0,0,6,0,6,Veneto,ITH3
2020-12-27,PF/BT,50505,TRECENTA,VEN,30-39,2,7,0,9,0,0,0,9,0,9,Veneto,ITH3
2020-12-27,PF/BT,50505,TRECENTA,VEN,40-49,2,9,0,11,0,0,0,11,0,11,Veneto,ITH3
2020-12-27,PF/BT,50505,TRECENTA,VEN,50-59,7,10,0,17,0,0,0,17,0,17,Veneto,ITH3
2020-12-27,PF/BT,50505,TRECENTA,VEN,60-69,2,1,0,3,0,0,0,3,0,3,Veneto,ITH3
2020-12-27,PF/BT,50506,AZ OSPEDALIERA DI PADOVA MAL. INFET.E TR,VEN,40-49,2,7,0,9,0,0,0,9,0,9,Veneto,ITH3
2020-12-27,PF/BT,50506,AZ OSPEDALIERA DI PADOVA MAL. INFET.E TR,VEN,50-59,15,38,0,52,0,0,1,53,0,53,Veneto,ITH3
2020-12-27,PF/BT,50506,AZ OSPEDALIERA DI PADOVA MAL. INFET.E TR,VEN,60-69,17,12,0,29,0,0,0,29,0,29,Veneto,ITH3
2020-12-27,PF/BT,50506,CITTADELLA (S.I.S.P.),VEN,20-29,1,0,0,1,0,0,0,1,0,1,Veneto,ITH3
2020-12-27,PF/BT,50506,CITTADELLA (S.I.S.P.),VEN,30-39,1,2,0,3,0,0,0,3,0,3,Veneto,ITH3
2020-12-27,PF/BT,50506,CITTADELLA (S.I.S.P.),VEN,40-49,4,3,0,7,0,0,0,7,0,7,Veneto,ITH3
2020-12-27,PF/BT,50506,CITTADELLA (S.I.S.P.),VEN,50-59,7,23,0,30,0,0,0,30,0,30,Veneto,ITH3
2020-12-27,PF/BT,50506,CITTADELLA (S.I.S.P.),VEN,60-69,9,5,0,14,0,0,0,14,0,14,Veneto,ITH3
2020-12-27,PF/BT,50506,SCHIAVONIA AMBULATORIO,VEN,20-29,1,5,0,6,0,0,0,6,0,6,Veneto,ITH3
2020-12-27,PF/BT,50506,SCHIAVONIA AMBULATORIO,VEN,30-39,2,0,0,2,0,0,0,2,0,2,Veneto,ITH3
2020-12-27,PF/BT,50506,SCHIAVONIA AMBULATORIO,VEN,40-49,1,0,0,1,0,0,0,1,0,1,Veneto,ITH3
2020-12-27,PF/BT,50506,SCHIAVONIA AMBULATORIO,VEN,50-59,12,21,0,33,0,0,0,33,0,33,Veneto,ITH3
2020-12-27,PF/BT,50506,SCHIAVONIA AMBULATORIO,VEN,60-69,9,4,0,13,0,0,0,13,0,13,Veneto,ITH3
2020-12-27,PF/BT,50507,DIPARTIMENTO DI PREVENZIONE,VEN,20-29,1,3,0,4,0,0,0,4,0,4,Veneto,ITH3
2020-12-27,PF/BT,50507,DIPARTIMENTO DI PREVENZIONE,VEN,30-39,2,6,0,8,0,0,0,8,0,8,Veneto,ITH3
2020-12-27,PF/BT,50507,DIPARTIMENTO DI PREVENZIONE,VEN,40-49,0,4,0,4,0,0,0,4,0,4,Veneto,ITH3
2020-12-27,PF/BT,50507,DIPARTIMENTO DI PREVENZIONE,VEN,50-59,2,5,0,7,0,0,0,7,0,7,Veneto,ITH3
2020-12-27,PF/BT,50507,DIPARTIMENTO DI PREVENZIONE,VEN,60-69,1,1,0,2,0,0,0,2,0,2,Veneto,ITH3
2020-12-27,PF/BT,50507,THIENE,VEN,20-29,0,1,0,1,0,0,0,1,0,1,Veneto,ITH3
2020-12-27,PF/BT,50507,THIENE,VEN,30-39,2,4,0,6,0,0,0,6,0,6,Veneto,ITH3
2020-12-27,PF/BT,50507,THIENE,VEN,40-49,4,3,0,7,0,0,0,7,0,7,Veneto,ITH3
2020-12-27,PF/BT,50507,THIENE,VEN,50-59,0,2,0,2,0,0,0,2,0,2,Veneto,ITH3
2020-12-27,PF/BT,50507,THIENE,VEN,60-69,4,0,0,4,0,0,0,4,0,4,Veneto,ITH3
2020-12-27,PF/BT,50508,SISP IV NOVEMBRE,VEN,20-29,3,4,0,7,0,0,0,7,0,7,Veneto,ITH3
2020-12-27,PF/BT,50508,SISP IV NOVEMBRE,VEN,30-39,7,4,0,11,0,0,0,11,0,11,Veneto,ITH3
2020-12-27,PF/BT,50508,SISP IV NOVEMBRE,VEN,40-49,7,12,0,19,0,0,0,19,0,19,Veneto,ITH3
2020-12-27,PF/BT,50508,SISP IV NOVEMBRE,VEN,50-59,12,16,0,27,0,0,1,28,0,28,Veneto,ITH3
2020-12-27,PF/BT,50508,SISP IV NOVEMBRE,VEN,60-69,19,6,0,25,0,0,0,25,0,25,Veneto,ITH3
2020-12-27,PF/BT,50509,VILLAFRANCA,VEN,20-29,5,14,0,19,0,0,0,19,0,19,Veneto,ITH3
2020-12-27,PF/BT,50509,VILLAFRANCA,VEN,30-39,7,8,0,15,0,0,0,15,0,15,Veneto,ITH3
2020-12-27,PF/BT,50509,VILLAFRANCA,VEN,40-49,5,8,0,13,0,0,0,13,0,13,Veneto,ITH3
2020-12-27,PF/BT,50509,VILLAFRANCA,VEN,50-59,9,19,0,28,0,0,0,28,0,28,Veneto,ITH3
2020-12-27,PF/BT,50509,VILLAFRANCA,VEN,60-69,11,3,0,14,0,0,0,14,0,14,Veneto,ITH3
2020-12-27,PF/BT,50509,VILLAFRANCA,VEN,70-79,1,0,0,1,0,0,0,1,0,1,Veneto,ITH3
2020-12-27,PF/BT,5091201,AOUIVR,VEN,20-29,3,8,0,11,0,0,0,11,0,11,Veneto,ITH3
2020-12-27,PF/BT,5091201,AOUIVR,VEN,30-39,11,6,0,17,0,0,0,17,0,17,Veneto,ITH3
2020-12-27,PF/BT,5091201,AOUIVR,VEN,40-49,5,13,0,18,0,0,0,18,0,18,Veneto,ITH3
2020-12-27,PF/BT,5091201,AOUIVR,VEN,50-59,15,13,0,28,0,0,0,28,0,28,Veneto,ITH3
2020-12-27,PF/BT,5091201,AOUIVR,VEN,60-69,15,1,0,16,0,0,0,16,0,16,Veneto,ITH3
2020-12-27,PF/BT,5095201,IOV,VEN,20-29,2,0,0,2,0,0,0,2,0,2,Veneto,ITH3
2020-12-27,PF/BT,5095201,IOV,VEN,30-39,2,4,0,6,0,0,0,6,0,6,Veneto,ITH3
2020-12-27,PF/BT,5095201,IOV,VEN,40-49,1,3,0,4,0,0,0,4,0,4,Veneto,ITH3
2020-12-27,PF/BT,5095201,IOV,VEN,50-59,0,2,0,2,0,0,0,2,0,2,Veneto,ITH3
2020-12-27,PF/BT,5095201,IOV,VEN,60-69,5,1,0,6,0,0,0,6,0,6,Veneto,ITH3
2020-12-30,PF/BT,0,Mancante,VEN,30-39,0,1,0,1,0,0,0,1,0,1,Veneto,ITH3
2020-12-30,PF/BT,42816,C.S.A. 'SAN GIUSEPPE',VEN,20-29,0,2,0,2,0,0,0,2,0,2,Veneto,ITH3
2020-12-30,PF/BT,42816,C.S.A. 'SAN GIUSEPPE',VEN,30-39,0,4,0,4,0,0,0,4,0,4,Veneto,ITH3
2020-12-30,PF/BT,42816,C.S.A. 'SAN GIUSEPPE',VEN,40-49,1,10,0,8,3,0,0,11,0,11,Veneto,ITH3
2020-12-30,PF/BT,42816,C.S.A. 'SAN GIUSEPPE',VEN,50-59,2,7,0,5,4,0,0,9,0,9,Veneto,ITH3
2020-12-30,PF/BT,42816,C.S.A. 'SAN GIUSEPPE',VEN,60-69,3,1,0,1,0,3,0,4,0,4,Veneto,ITH3
2020-12-30,PF/BT,42816,C.S.A. 'SAN GIUSEPPE',VEN,70-79,2,0,0,0,0,2,0,2,0,2,Veneto,ITH3
2020-12-30,PF/BT,42816,C.S.A. 'SAN GIUSEPPE',VEN,80-89,6,7,0,0,0,13,0,13,0,13,Veneto,ITH3
2020-12-30,PF/BT,42816,C.S.A. 'SAN GIUSEPPE',VEN,90+,1,3,0,0,0,4,0,4,0,4,Veneto,ITH3
2020-12-30,PF/BT,5014,CASA DI RIPOSO GAGGIA LANTE BELLUNO,VEN,20-29,4,3,0,7,0,0,0,7,0,7,Veneto,ITH3
2020-12-30,PF/BT,5014,CASA DI RIPOSO GAGGIA LANTE BELLUNO,VEN,30-39,1,4,0,5,0,0,0,5,0,5,Veneto,ITH3
2020-12-30,PF/BT,5014,CASA DI RIPOSO GAGGIA LANTE BELLUNO,VEN,40-49,0,6,0,6,0,0,0,6,0,6,Veneto,ITH3
2020-12-30,PF/BT,5014,CASA DI RIPOSO GAGGIA LANTE BELLUNO,VEN,50-59,0,15,0,14,1,0,0,15,0,15,Veneto,ITH3
2020-12-30,PF/BT,5014,CASA DI RIPOSO GAGGIA LANTE BELLUNO,VEN,60-69,0,5,0,4,0,1,0,5,0,5,Veneto,ITH3
2020-12-30,PF/BT,5014,CASA DI RIPOSO GAGGIA LANTE BELLUNO,VEN,70-79,2,4,0,0,0,6,0,6,0,6,Veneto,ITH3
2020-12-30,PF/BT,5014,CASA DI RIPOSO GAGGIA LANTE BELLUNO,VEN,80-89,4,3,0,0,0,7,0,7,0,7,Veneto,ITH3
2020-12-30,PF/BT,5014,CASA DI RIPOSO GAGGIA LANTE BELLUNO,VEN,90+,1,2,0,0,0,3,0,3,0,3,Veneto,ITH3
2020-12-30,PF/BT,50501,AGORDO - SERVIZIO IGIENE,VEN,20-29,2,2,0,4,0,0,0,4,0,4,Veneto,ITH3
2020-12-30,PF/BT,50501,AGORDO - SERVIZIO IGIENE,VEN,30-39,5,3,0,8,0,0,0,8,0,8,Veneto,ITH3
2020-12-30,PF/BT,50501,AGORDO - SERVIZIO IGIENE,VEN,40-49,5,11,0,16,0,0,0,16,0,16,Veneto,ITH3
2020-12-30,PF/BT,50501,AGORDO - SERVIZIO IGIENE,VEN,50-59,5,22,0,27,0,0,0,27,0,27,Veneto,ITH3
2020-12-30,PF/BT,50501,AGORDO - SERVIZIO IGIENE,VEN,60-69,2,3,0,5,0,0,0,5,0,5,Veneto,ITH3
2020-12-30,PF/BT,50501,"BELLUNO ""DRIVE-IN""",VEN,20-29,0,3,0,3,0,0,0,3,0,3,Veneto,ITH3
2020-12-30,PF/BT,50501,"BELLUNO ""DRIVE-IN""",VEN,30-39,3,3,0,6,0,0,0,6,0,6,Veneto,ITH3
2020-12-30,PF/BT,50501,"BELLUNO ""DRIVE-IN""",VEN,40-49,5,5,0,10,0,0,0,10,0,10,Veneto,ITH3
2020-12-30,PF/BT,50501,"BELLUNO ""DRIVE-IN""",VEN,50-59,5,8,0,13,0,0,0,13,0,13,Veneto,ITH3
2020-12-30,PF/BT,50501,"BELLUNO ""DRIVE-IN""",VEN,60-69,8,1,0,9,0,0,0,9,0,9,Veneto,ITH3
2020-12-30,PF/BT,50501,FELTRE,VEN,20-29,3,8,0,7,4,0,0,11,0,11,Veneto,ITH3
2020-12-30,PF/BT,50501,FELTRE,VEN,30-39,4,6,0,10,0,0,0,10,0,10,Veneto,ITH3
2020-12-30,PF/BT,50501,FELTRE,VEN,40-49,4,16,0,20,0,0,0,20,0,20,Veneto,ITH3
2020-12-30,PF/BT,50501,FELTRE,VEN,50-59,7,9,0,16,0,0,0,16,0,16,Veneto,ITH3
2020-12-30,PF/BT,50501,FELTRE,VEN,60-69,2,0,0,2,0,0,0,2,0,2,Veneto,ITH3
2020-12-30,PF/BT,50503,MEDICINA PREVENTIVA MESTRE,VEN,20-29,0,1,0,1,0,0,0,1,0,1,Veneto,ITH3
2020-12-30,PF/BT,50503,MEDICINA PREVENTIVA MESTRE,VEN,30-39,2,1,0,3,0,0,0,3,0,3,Veneto,ITH3
2020-12-30,PF/BT,50503,MEDICINA PREVENTIVA MESTRE,VEN,40-49,2,5,0,7,0,0,0,7,0,7,Veneto,ITH3
2020-12-30,PF/BT,50503,MEDICINA PREVENTIVA MESTRE,VEN,50-59,1,9,0,10,0,0,0,10,0,10,Veneto,ITH3
2020-12-30,PF/BT,50503,MEDICINA PREVENTIVA MESTRE,VEN,60-69,3,0,0,3,0,0,0,3,0,3,Veneto,ITH3
2020-12-30,PF/BT,50507,DIPARTIMENTO DI PREVENZIONE,VEN,20-29,0,1,0,1,0,0,0,1,0,1,Veneto,ITH3
2020-12-30,PF/BT,50507,DIPARTIMENTO DI PREVENZIONE,VEN,30-39,9,13,0,22,0,0,0,22,0,22,Veneto,ITH3
2020-12-30,PF/BT,50507,DIPARTIMENTO DI PREVENZIONE,VEN,40-49,11,14,0,25,0,0,0,25,0,25,Veneto,ITH3
2020-12-30,PF/BT,50507,DIPARTIMENTO DI PREVENZIONE,VEN,50-59,12,17,0,29,0,0,0,29,0,29,Veneto,ITH3
2020-12-30,PF/BT,50507,DIPARTIMENTO DI PREVENZIONE,VEN,60-69,6,0,0,6,0,0,0,6,0,6,Veneto,ITH3
2020-12-30,PF/BT,50507,THIENE,VEN,20-29,0,2,0,2,0,0,0,2,0,2,Veneto,ITH3
2020-12-30,PF/BT,50507,THIENE,VEN,30-39,3,8,0,11,0,0,0,11,0,11,Veneto,ITH3
2020-12-30,PF/BT,50507,THIENE,VEN,40-49,3,24,0,27,0,0,0,27,0,27,Veneto,ITH3
2020-12-30,PF/BT,50507,THIENE,VEN,50-59,1,10,0,11,0,0,0,11,0,11,Veneto,ITH3
2020-12-30,PF/BT,50507,THIENE,VEN,60-69,2,2,0,4,0,0,0,4,0,4,Veneto,ITH3
2020-12-30,PF/BT,50508,SISP IV NOVEMBRE,VEN,20-29,5,16,0,17,0,0,4,21,0,21,Veneto,ITH3
2020-12-30,PF/BT,50508,SISP IV NOVEMBRE,VEN,30-39,19,32,0,49,0,0,2,51,0,51,Veneto,ITH3
2020-12-30,PF/BT,50508,SISP IV NOVEMBRE,VEN,40-49,26,53,0,71,0,0,8,79,0,79,Veneto,ITH3
2020-12-30,PF/BT,50508,SISP IV NOVEMBRE,VEN,50-59,34,53,0,77,0,0,10,87,0,87,Veneto,ITH3
2020-12-30,PF/BT,50508,SISP IV NOVEMBRE,VEN,60-69,19,15,0,26,0,0,8,34,0,34,Veneto,ITH3
2020-12-31,PF/BT,132225,C.R. 'A. PENASA' - VALLI,VEN,20-29,0,1,0,1,0,0,0,1,0,1,Veneto,ITH3
2020-12-31,PF/BT,132225,C.R. 'A. PENASA' - VALLI,VEN,30-39,2,3,0,5,0,0,0,5,0,5,Veneto,ITH3
2020-12-31,PF/BT,132225,C.R. 'A. PENASA' - VALLI,VEN,40-49,0,3,0,3,0,0,0,3,0,3,Veneto,ITH3
2020-12-31,PF/BT,132225,C.R. 'A. PENASA' - VALLI,VEN,50-59,0,6,0,6,0,0,0,6,0,6,Veneto,ITH3
2020-12-31,PF/BT,132225,C.R. 'A. PENASA' - VALLI,VEN,70-79,1,2,0,0,0,3,0,3,0,3,Veneto,ITH3
2020-12-31,PF/BT,132225,C.R. 'A. PENASA' - VALLI,VEN,80-89,8,12,0,0,0,20,0,20,0,20,Veneto,ITH3
2020-12-31,PF/BT,132225,C.R. 'A. PENASA' - VALLI,VEN,90+,4,20,0,0,0,24,0,24,0,24,Veneto,ITH3
2020-12-31,PF/BT,132231,C.R.'LA CASA CHARITAS' - SCHIO,VEN,20-29,0,1,0,1,0,0,0,1,0,1,Veneto,ITH3
2020-12-31,PF/BT,132231,C.R.'LA CASA CHARITAS' - SCHIO,VEN,30-39,0,1,0,1,0,0,0,1,0,1,Veneto,ITH3
2020-12-31,PF/BT,132231,C.R.'LA CASA CHARITAS' - SCHIO,VEN,40-49,0,2,0,2,0,0,0,2,0,2,Veneto,ITH3
2020-12-31,PF/BT,132231,C.R.'LA CASA CHARITAS' - SCHIO,VEN,50-59,0,7,0,5,2,0,0,7,0,7,Veneto,ITH3
2020-12-31,PF/BT,132231,C.R.'LA CASA CHARITAS' - SCHIO,VEN,60-69,2,1,0,2,0,1,0,3,0,3,Veneto,ITH3
2020-12-31,PF/BT,132231,C.R.'LA CASA CHARITAS' - SCHIO,VEN,70-79,0,4,0,0,0,4,0,4,0,4,Veneto,ITH3
2020-12-31,PF/BT,132231,C.R.'LA CASA CHARITAS' - SCHIO,VEN,80-89,0,6,0,0,0,6,0,6,0,6,Veneto,ITH3
2020-12-31,PF/BT,132231,C.R.'LA CASA CHARITAS' - SCHIO,VEN,90+,0,10,0,0,0,10,0,10,0,10,Veneto,ITH3
2020-12-31,PF/BT,42816,C.S.A. 'SAN GIUSEPPE',VEN,60-69,0,1,0,0,0,1,0,1,0,1,Veneto,ITH3
2020-12-31,PF/BT,42816,C.S.A. 'SAN GIUSEPPE',VEN,70-79,0,1,0,0,0,1,0,1,0,1,Veneto,ITH3
2020-12-31,PF/BT,42816,C.S.A. 'SAN GIUSEPPE',VEN,80-89,0,2,0,0,0,2,0,2,0,2,Veneto,ITH3
2020-12-31,PF/BT,42816,C.S.A. 'SAN GIUSEPPE',VEN,90+,0,1,0,0,0,1,0,1,0,1,Veneto,ITH3
2020-12-31,PF/BT,42820,C.S.A. 'CASA CHARITAS',VEN,16-19,1,0,0,0,1,0,0,1,0,1,Veneto,ITH3
2020-12-31,PF/BT,42820,C.S.A. 'CASA CHARITAS',VEN,20-29,2,1,0,3,0,0,0,3,0,3,Veneto,ITH3
2020-12-31,PF/BT,42820,C.S.A. 'CASA CHARITAS',VEN,30-39,0,6,0,4,2,0,0,6,0,6,Veneto,ITH3
2020-12-31,PF/BT,42820,C.S.A. 'CASA CHARITAS',VEN,40-49,1,6,0,6,1,0,0,7,0,7,Veneto,ITH3
2020-12-31,PF/BT,42820,C.S.A. 'CASA CHARITAS',VEN,50-59,4,16,0,13,5,2,0,20,0,20,Veneto,ITH3
2020-12-31,PF/BT,42820,C.S.A. 'CASA CHARITAS',VEN,60-69,1,5,0,2,0,4,0,6,0,6,Veneto,ITH3
2020-12-31,PF/BT,42820,C.S.A. 'CASA CHARITAS',VEN,70-79,6,5,0,0,0,11,0,11,0,11,Veneto,ITH3
2020-12-31,PF/BT,42820,C.S.A. 'CASA CHARITAS',VEN,80-89,7,11,0,0,0,18,0,18,0,18,Veneto,ITH3
2020-12-31,PF/BT,42820,C.S.A. 'CASA CHARITAS',VEN,90+,1,21,0,0,0,22,0,22,0,22,Veneto,ITH3
2020-12-31,PF/BT,445366,C. SERV.RES.ANZ.-NAZARET,VEN,20-29,1,4,0,4,1,0,0,5,0,5,Veneto,ITH3
2020-12-31,PF/BT,445366,C. SERV.RES.ANZ.-NAZARET,VEN,30-39,1,4,0,4,1,0,0,5,0,5,Veneto,ITH3
2020-12-31,PF/BT,445366,C. SERV.RES.ANZ.-NAZARET,VEN,40-49,3,10,0,9,4,0,0,13,0,13,Veneto,ITH3
2020-12-31,PF/BT,445366,C. SERV.RES.ANZ.-NAZARET,VEN,50-59,5,18,0,14,9,0,0,23,0,23,Veneto,ITH3
2020-12-31,PF/BT,445366,C. SERV.RES.ANZ.-NAZARET,VEN,60-69,3,4,0,6,1,0,0,7,0,7,Veneto,ITH3
2020-12-31,PF/BT,445366,C. SERV.RES.ANZ.-NAZARET,VEN,70-79,1,0,0,1,0,0,0,1,0,1,Veneto,ITH3
2020-12-31,PF/BT,5014,CASA DI RIPOSO GAGGIA LANTE BELLUNO,VEN,20-29,1,8,0,8,1,0,0,9,0,9,Veneto,ITH3
2020-12-31,PF/BT,5014,CASA DI RIPOSO GAGGIA LANTE BELLUNO,VEN,30-39,2,7,0,5,4,0,0,9,0,9,Veneto,ITH3
2020-12-31,PF/BT,5014,CASA DI RIPOSO GAGGIA LANTE BELLUNO,VEN,40-49,6,14,0,11,9,0,0,20,0,20,Veneto,ITH3
2020-12-31,PF/BT,5014,CASA DI RIPOSO GAGGIA LANTE BELLUNO,VEN,50-59,5,17,0,7,13,2,0,22,0,22,Veneto,ITH3
2020-12-31,PF/BT,5014,CASA DI RIPOSO GAGGIA LANTE BELLUNO,VEN,60-69,0,6,0,3,3,0,0,6,0,6,Veneto,ITH3
2020-12-31,PF/BT,5014,CASA DI RIPOSO GAGGIA LANTE BELLUNO,VEN,70-79,2,7,0,0,0,9,0,9,0,9,Veneto,ITH3
2020-12-31,PF/BT,5014,CASA DI RIPOSO GAGGIA LANTE BELLUNO,VEN,80-89,6,10,0,0,0,16,0,16,0,16,Veneto,ITH3
2020-12-31,PF/BT,5014,CASA DI RIPOSO GAGGIA LANTE BELLUNO,VEN,90+,0,17,0,0,0,17,0,17,0,17,Veneto,ITH3
2020-12-31,PF/BT,5019,CASA DI SOGGIORNO- LIMANA-,VEN,20-29,2,1,0,3,0,0,0,3,0,3,Veneto,ITH3
2020-12-31,PF/BT,5019,CASA DI SOGGIORNO- LIMANA-,VEN,40-49,0,3,0,2,1,0,0,3,0,3,Veneto,ITH3
2020-12-31,PF/BT,5019,CASA DI SOGGIORNO- LIMANA-,VEN,50-59,1,5,0,6,0,0,0,6,0,6,Veneto,ITH3
2020-12-31,PF/BT,5019,CASA DI SOGGIORNO- LIMANA-,VEN,60-69,1,3,0,2,0,2,0,4,0,4,Veneto,ITH3
2020-12-31,PF/BT,5019,CASA DI SOGGIORNO- LIMANA-,VEN,70-79,2,1,0,0,0,3,0,3,0,3,Veneto,ITH3
2020-12-31,PF/BT,5019,CASA DI SOGGIORNO- LIMANA-,VEN,80-89,0,6,0,0,0,6,0,6,0,6,Veneto,ITH3
2020-12-31,PF/BT,5019,CASA DI SOGGIORNO- LIMANA-,VEN,90+,0,4,0,0,0,4,0,4,0,4,Veneto,ITH3
2020-12-31,PF/BT,50501,"BELLUNO ""DRIVE-IN""",VEN,20-29,1,7,0,8,0,0,0,8,0,8,Veneto,ITH3
2020-12-31,PF/BT,50501,"BELLUNO ""DRIVE-IN""",VEN,30-39,12,10,0,22,0,0,0,22,0,22,Veneto,ITH3
2020-12-31,PF/BT,50501,"BELLUNO ""DRIVE-IN""",VEN,40-49,5,24,0,29,0,0,0,29,0,29,Veneto,ITH3
2020-12-31,PF/BT,50501,"BELLUNO ""DRIVE-IN""",VEN,50-59,8,30,0,37,0,0,1,38,0,38,Veneto,ITH3
2020-12-31,PF/BT,50501,"BELLUNO ""DRIVE-IN""",VEN,60-69,7,7,0,14,0,0,0,14,0,14,Veneto,ITH3
2020-12-31,PF/BT,50501,FELTRE,VEN,20-29,5,8,0,13,0,0,0,13,0,13,Veneto,ITH3
2020-12-31,PF/BT,50501,FELTRE,VEN,30-39,9,12,0,21,0,0,0,21,0,21,Veneto,ITH3
2020-12-31,PF/BT,50501,FELTRE,VEN,40-49,7,23,0,30,0,0,0,30,0,30,Veneto,ITH3
2020-12-31,PF/BT,50501,FELTRE,VEN,50-59,13,22,0,33,1,0,1,35,0,35,Veneto,ITH3
2020-12-31,PF/BT,50501,FELTRE,VEN,60-69,4,5,0,9,0,0,0,9,0,9,Veneto,ITH3
2020-12-31,PF/BT,50501,PIEVE DI CADORE,VEN,30-39,5,4,0,9,0,0,0,9,0,9,Veneto,ITH3
2020-12-31,PF/BT,50501,PIEVE DI CADORE,VEN,40-49,6,13,0,18,1,0,0,19,0,19,Veneto,ITH3
2020-12-31,PF/BT,50501,PIEVE DI CADORE,VEN,50-59,14,17,0,30,1,0,0,31,0,31,Veneto,ITH3
2020-12-31,PF/BT,50501,PIEVE DI CADORE,VEN,60-69,5,2,0,7,0,0,0,7,0,7,Veneto,ITH3
2020-12-31,PF/BT,50503,CHIOGGIA,VEN,20-29,0,1,0,1,0,0,0,1,0,1,Veneto,ITH3
2020-12-31,PF/BT,50503,CHIOGGIA,VEN,30-39,2,3,0,5,0,0,0,5,0,5,Veneto,ITH3
2020-12-31,PF/BT,50503,CHIOGGIA,VEN,40-49,3,9,0,12,0,0,0,12,0,12,Veneto,ITH3
2020-12-31,PF/BT,50503,CHIOGGIA,VEN,50-59,5,9,0,14,0,0,0,14,0,14,Veneto,ITH3
2020-12-31,PF/BT,50503,CHIOGGIA,VEN,60-69,7,3,0,10,0,0,0,10,0,10,Veneto,ITH3
2020-12-31,PF/BT,50503,MEDICINA PREVENTIVA MESTRE,VEN,20-29,0,4,0,4,0,0,0,4,0,4,Veneto,ITH3
2020-12-31,PF/BT,50503,MEDICINA PREVENTIVA MESTRE,VEN,30-39,7,9,0,16,0,0,0,16,0,16,Veneto,ITH3
2020-12-31,PF/BT,50503,MEDICINA PREVENTIVA MESTRE,VEN,40-49,10,23,0,33,0,0,0,33,0,33,Veneto,ITH3
2020-12-31,PF/BT,50503,MEDICINA PREVENTIVA MESTRE,VEN,50-59,8,33,0,41,0,0,0,41,0,41,Veneto,ITH3
2020-12-31,PF/BT,50503,MEDICINA PREVENTIVA MESTRE,VEN,60-69,8,7,0,15,0,0,0,15,0,15,Veneto,ITH3
2020-12-31,PF/BT,50503,OCVE - PRONTO SOCCORSO,VEN,20-29,1,3,0,4,0,0,0,4,0,4,Veneto,ITH3
2020-12-31,PF/BT,50503,OCVE - PRONTO SOCCORSO,VEN,40-49,4,3,0,7,0,0,0,7,0,7,Veneto,ITH3
2020-12-31,PF/BT,50503,OCVE - PRONTO SOCCORSO,VEN,50-59,3,7,0,10,0,0,0,10,0,10,Veneto,ITH3
2020-12-31,PF/BT,50503,OCVE - PRONTO SOCCORSO,VEN,60-69,3,0,0,3,0,0,0,3,0,3,Veneto,ITH3
2020-12-31,PF/BT,50503,SISP DOLO ADULTI,VEN,20-29,2,3,0,5,0,0,0,5,0,5,Veneto,ITH3
2020-12-31,PF/BT,50503,SISP DOLO ADULTI,VEN,30-39,3,6,0,9,0,0,0,9,0,9,Veneto,ITH3
2020-12-31,PF/BT,50503,SISP DOLO ADULTI,VEN,40-49,4,5,0,9,0,0,0,9,0,9,Veneto,ITH3
2020-12-31,PF/BT,50503,SISP DOLO ADULTI,VEN,50-59,2,20,0,22,0,0,0,22,0,22,Veneto,ITH3
2020-12-31,PF/BT,50503,SISP DOLO ADULTI,VEN,60-69,4,3,0,7,0,0,0,7,0,7,Veneto,ITH3
2020-12-31,PF/BT,50504,OSPEDALE CIVILE SAN DONA',VEN,20-29,4,13,0,17,0,0,0,17,0,17,Veneto,ITH3
2020-12-31,PF/BT,50504,OSPEDALE CIVILE SAN DONA',VEN,30-39,6,11,0,17,0,0,0,17,0,17,Veneto,ITH3
2020-12-31,PF/BT,50504,OSPEDALE CIVILE SAN DONA',VEN,40-49,3,24,0,27,0,0,0,27,0,27,Veneto,ITH3
2020-12-31,PF/BT,50504,OSPEDALE CIVILE SAN DONA',VEN,50-59,8,40,0,47,1,0,0,48,0,48,Veneto,ITH3
2020-12-31,PF/BT,50504,OSPEDALE CIVILE SAN DONA',VEN,60-69,6,15,0,20,1,0,0,21,0,21,Veneto,ITH3
2020-12-31,PF/BT,50504,SANTO STINO DI LIVENZA,VEN,20-29,6,14,0,20,0,0,0,20,0,20,Veneto,ITH3
2020-12-31,PF/BT,50504,SANTO STINO DI LIVENZA,VEN,30-39,12,12,0,24,0,0,0,24,0,24,Veneto,ITH3
2020-12-31,PF/BT,50504,SANTO STINO DI LIVENZA,VEN,40-49,13,27,0,40,0,0,0,40,0,40,Veneto,ITH3
2020-12-31,PF/BT,50504,SANTO STINO DI LIVENZA,VEN,50-59,9,44,0,53,0,0,0,53,0,53,Veneto,ITH3
2020-12-31,PF/BT,50504,SANTO STINO DI LIVENZA,VEN,60-69,5,5,0,10,0,0,0,10,0,10,Veneto,ITH3
2020-12-31,PF/BT,50505,ADRIA,VEN,20-29,3,7,0,9,0,0,1,10,0,10,Veneto,ITH3
2020-12-31,PF/BT,50505,ADRIA,VEN,30-39,5,13,0,18,0,0,0,18,0,18,Veneto,ITH3
2020-12-31,PF/BT,50505,ADRIA,VEN,40-49,12,31,0,43,0,0,0,43,0,43,Veneto,ITH3
2020-12-31,PF/BT,50505,ADRIA,VEN,50-59,10,28,0,38,0,0,0,38,0,38,Veneto,ITH3
2020-12-31,PF/BT,50505,ADRIA,VEN,60-69,7,3,0,10,0,0,0,10,0,10,Veneto,ITH3
2020-12-31,PF/BT,50505,ADRIA,VEN,70-79,1,0,0,1,0,0,0,1,0,1,Veneto,ITH3
2020-12-31,PF/BT,50505,TRECENTA,VEN,20-29,5,12,0,17,0,0,0,17,0,17,Veneto,ITH3
2020-12-31,PF/BT,50505,TRECENTA,VEN,30-39,1,14,0,15,0,0,0,15,0,15,Veneto,ITH3
2020-12-31,PF/BT,50505,TRECENTA,VEN,40-49,8,16,0,24,0,0,0,24,0,24,Veneto,ITH3
2020-12-31,PF/BT,50505,TRECENTA,VEN,50-59,12,23,0,35,0,0,0,35,0,35,Veneto,ITH3
2020-12-31,PF/BT,50505,TRECENTA,VEN,60-69,18,10,0,28,0,0,0,28,0,28,Veneto,ITH3
2020-12-31,PF/BT,50505,TRECENTA,VEN,70-79,1,0,0,1,0,0,0,1,0,1,Veneto,ITH3
2020-12-31,PF/BT,5050501,PRESIDIO OSPEDALIERO ROVIGO,VEN,20-29,2,13,0,15,0,0,0,15,0,15,Veneto,ITH3
2020-12-31,PF/BT,5050501,PRESIDIO OSPEDALIERO ROVIGO,VEN,30-39,15,23,0,38,0,0,0,38,0,38,Veneto,ITH3
2020-12-31,PF/BT,5050501,PRESIDIO OSPEDALIERO ROVIGO,VEN,40-49,16,29,0,45,0,0,0,45,0,45,Veneto,ITH3
2020-12-31,PF/BT,5050501,PRESIDIO OSPEDALIERO ROVIGO,VEN,50-59,19,41,0,60,0,0,0,60,0,60,Veneto,ITH3
2020-12-31,PF/BT,5050501,PRESIDIO OSPEDALIERO ROVIGO,VEN,60-69,13,8,0,21,0,0,0,21,0,21,Veneto,ITH3
2020-12-31,PF/BT,5050501,PRESIDIO OSPEDALIERO ROVIGO,VEN,70-79,1,0,0,1,0,0,0,1,0,1,Veneto,ITH3
2020-12-31,PF/BT,50506,AZ OSPEDALIERA DI PADOVA MAL. INFET.E TR,VEN,20-29,3,10,0,13,0,0,0,13,0,13,Veneto,ITH3
2020-12-31,PF/BT,50506,AZ OSPEDALIERA DI PADOVA MAL. INFET.E TR,VEN,30-39,13,17,0,29,0,0,1,30,0,30,Veneto,ITH3
2020-12-31,PF/BT,50506,AZ OSPEDALIERA DI PADOVA MAL. INFET.E TR,VEN,40-49,12,24,0,36,0,0,0,36,0,36,Veneto,ITH3
2020-12-31,PF/BT,50506,AZ OSPEDALIERA DI PADOVA MAL. INFET.E TR,VEN,50-59,3,8,0,11,0,0,0,11,0,11,Veneto,ITH3
2020-12-31,PF/BT,50506,AZ OSPEDALIERA DI PADOVA MAL. INFET.E TR,VEN,60-69,4,2,0,5,0,0,1,6,0,6,Veneto,ITH3
2020-12-31,PF/BT,50506,CAMPOSAMPIERO MEDICO COMPETENT,VEN,20-29,0,2,0,2,0,0,0,2,0,2,Veneto,ITH3
2020-12-31,PF/BT,50506,CAMPOSAMPIERO MEDICO COMPETENT,VEN,30-39,0,5,0,5,0,0,0,5,0,5,Veneto,ITH3
2020-12-31,PF/BT,50506,CAMPOSAMPIERO MEDICO COMPETENT,VEN,40-49,3,4,0,7,0,0,0,7,0,7,Veneto,ITH3
2020-12-31,PF/BT,50506,CAMPOSAMPIERO MEDICO COMPETENT,VEN,50-59,1,3,0,4,0,0,0,4,0,4,Veneto,ITH3
2020-12-31,PF/BT,50506,CAMPOSAMPIERO MEDICO COMPETENT,VEN,60-69,4,3,0,7,0,0,0,7,0,7,Veneto,ITH3
2020-12-31,PF/BT,50506,CITTADELLA MEDICO COMPETENTE,VEN,20-29,1,1,0,2,0,0,0,2,0,2,Veneto,ITH3
2020-12-31,PF/BT,50506,CITTADELLA MEDICO COMPETENTE,VEN,30-39,5,7,0,12,0,0,0,12,0,12,Veneto,ITH3
2020-12-31,PF/BT,50506,CITTADELLA MEDICO COMPETENTE,VEN,40-49,3,4,0,7,0,0,0,7,0,7,Veneto,ITH3
2020-12-31,PF/BT,50506,CITTADELLA MEDICO COMPETENTE,VEN,50-59,1,5,0,5,0,0,1,6,0,6,Veneto,ITH3
2020-12-31,PF/BT,50506,CITTADELLA MEDICO COMPETENTE,VEN,60-69,2,1,0,3,0,0,0,3,0,3,Veneto,ITH3
2020-12-31,PF/BT,50506,DIRIGENZA MEDICA P.D.SACCO,VEN,20-29,2,2,0,4,0,0,0,4,0,4,Veneto,ITH3
2020-12-31,PF/BT,50506,DIRIGENZA MEDICA P.D.SACCO,VEN,30-39,3,4,0,7,0,0,0,7,0,7,Veneto,ITH3
2020-12-31,PF/BT,50506,DIRIGENZA MEDICA P.D.SACCO,VEN,40-49,2,9,0,11,0,0,0,11,0,11,Veneto,ITH3
2020-12-31,PF/BT,50506,DIRIGENZA MEDICA P.D.SACCO,VEN,50-59,3,4,0,7,0,0,0,7,0,7,Veneto,ITH3
2020-12-31,PF/BT,50506,DIRIGENZA MEDICA P.D.SACCO,VEN,60-69,1,0,0,1,0,0,0,1,0,1,Veneto,ITH3
2020-12-31,PF/BT,50506,MONTAGNANA,VEN,20-29,6,3,0,9,0,0,0,9,0,9,Veneto,ITH3
2020-12-31,PF/BT,50506,MONTAGNANA,VEN,30-39,2,4,0,6,0,0,0,6,0,6,Veneto,ITH3
2020-12-31,PF/BT,50506,MONTAGNANA,VEN,40-49,2,10,0,11,1,0,0,12,0,12,Veneto,ITH3
2020-12-31,PF/BT,50506,MONTAGNANA,VEN,50-59,4,7,0,9,2,0,0,11,0,11,Veneto,ITH3
2020-12-31,PF/BT,50506,MONTAGNANA,VEN,60-69,4,0,0,4,0,0,0,4,0,4,Veneto,ITH3
2020-12-31,PF/BT,50506,SCHIAVONIA AMBULATORIO,VEN,20-29,1,5,0,6,0,0,0,6,0,6,Veneto,ITH3
2020-12-31,PF/BT,50506,SCHIAVONIA AMBULATORIO,VEN,30-39,3,7,0,10,0,0,0,10,0,10,Veneto,ITH3
2020-12-31,PF/BT,50506,SCHIAVONIA AMBULATORIO,VEN,40-49,5,13,0,18,0,0,0,18,0,18,Veneto,ITH3
2020-12-31,PF/BT,50506,SCHIAVONIA AMBULATORIO,VEN,50-59,8,17,0,25,0,0,0,25,0,25,Veneto,ITH3
2020-12-31,PF/BT,50506,SCHIAVONIA AMBULATORIO,VEN,60-69,5,2,0,7,0,0,0,7,0,7,Veneto,ITH3
2020-12-31,PF/BT,50507,DIPARTIMENTO DI PREVENZIONE,VEN,20-29,0,7,0,6,0,1,0,7,0,7,Veneto,ITH3
2020-12-31,PF/BT,50507,DIPARTIMENTO DI PREVENZIONE,VEN,30-39,0,3,0,3,0,0,0,3,0,3,Veneto,ITH3
2020-12-31,PF/BT,50507,DIPARTIMENTO DI PREVENZIONE,VEN,40-49,0,4,0,3,1,0,0,4,0,4,Veneto,ITH3
2020-12-31,PF/BT,50507,DIPARTIMENTO DI PREVENZIONE,VEN,50-59,2,3,0,1,4,0,0,5,0,5,Veneto,ITH3
2020-12-31,PF/BT,50507,DIPARTIMENTO DI PREVENZIONE,VEN,60-69,0,4,0,2,2,0,0,4,0,4,Veneto,ITH3
2020-12-31,PF/BT,50507,DIPARTIMENTO DI PREVENZIONE,VEN,70-79,0,6,0,0,0,6,0,6,0,6,Veneto,ITH3
2020-12-31,PF/BT,50507,DIPARTIMENTO DI PREVENZIONE,VEN,80-89,0,20,0,1,0,19,0,20,0,20,Veneto,ITH3
2020-12-31,PF/BT,50507,DIPARTIMENTO DI PREVENZIONE,VEN,90+,0,16,0,0,0,16,0,16,0,16,Veneto,ITH3
2020-12-31,PF/BT,50507,EX OSPEDALE - BOLDRINI,VEN,20-29,18,24,0,41,0,0,1,42,0,42,Veneto,ITH3
2020-12-31,PF/BT,50507,EX OSPEDALE - BOLDRINI,VEN,30-39,7,21,0,28,0,0,0,28,0,28,Veneto,ITH3
2020-12-31,PF/BT,50507,EX OSPEDALE - BOLDRINI,VEN,40-49,8,28,0,36,0,0,0,36,0,36,Veneto,ITH3
2020-12-31,PF/BT,50507,EX OSPEDALE - BOLDRINI,VEN,50-59,16,56,0,72,0,0,0,72,0,72,Veneto,ITH3
2020-12-31,PF/BT,50507,EX OSPEDALE - BOLDRINI,VEN,60-69,42,24,0,66,0,0,0,66,0,66,Veneto,ITH3
2020-12-31,PF/BT,50507,H BASSANO,VEN,20-29,4,21,0,25,0,0,0,25,0,25,Veneto,ITH3
2020-12-31,PF/BT,50507,H BASSANO,VEN,30-39,14,17,0,31,0,0,0,31,0,31,Veneto,ITH3
2020-12-31,PF/BT,50507,H BASSANO,VEN,40-49,12,47,0,59,0,0,0,59,0,59,Veneto,ITH3
2020-12-31,PF/BT,50507,H BASSANO,VEN,50-59,29,41,0,70,0,0,0,70,0,70,Veneto,ITH3
2020-12-31,PF/BT,50507,H BASSANO,VEN,60-69,12,2,0,14,0,0,0,14,0,14,Veneto,ITH3
2020-12-31,PF/BT,50507,H MAROSTICA,VEN,20-29,7,14,0,20,0,0,1,21,0,21,Veneto,ITH3
2020-12-31,PF/BT,50507,H MAROSTICA,VEN,30-39,5,7,0,11,0,0,1,12,0,12,Veneto,ITH3
2020-12-31,PF/BT,50507,H MAROSTICA,VEN,40-49,5,10,0,15,0,0,0,15,0,15,Veneto,ITH3
2020-12-31,PF/BT,50507,H MAROSTICA,VEN,50-59,8,19,0,27,0,0,0,27,0,27,Veneto,ITH3
2020-12-31,PF/BT,50507,H MAROSTICA,VEN,60-69,31,15,0,46,0,0,0,46,0,46,Veneto,ITH3
2020-12-31,PF/BT,50507,THIENE,VEN,20-29,3,16,0,19,0,0,0,19,0,19,Veneto,ITH3
2020-12-31,PF/BT,50507,THIENE,VEN,30-39,6,13,0,18,0,0,1,19,0,19,Veneto,ITH3
2020-12-31,PF/BT,50507,THIENE,VEN,40-49,18,37,0,55,0,0,0,55,0,55,Veneto,ITH3
2020-12-31,PF/BT,50507,THIENE,VEN,50-59,15,27,0,42,0,0,0,42,0,42,Veneto,ITH3
2020-12-31,PF/BT,50507,THIENE,VEN,60-69,3,2,0,5,0,0,0,5,0,5,Veneto,ITH3
2020-12-31,PF/BT,50508,ARZIGNANO,VEN,20-29,1,10,0,11,0,0,0,11,0,11,Veneto,ITH3
2020-12-31,PF/BT,50508,ARZIGNANO,VEN,30-39,13,17,0,29,0,0,1,30,0,30,Veneto,ITH3
2020-12-31,PF/BT,50508,ARZIGNANO,VEN,40-49,12,22,0,34,0,0,0,34,0,34,Veneto,ITH3
2020-12-31,PF/BT,50508,ARZIGNANO,VEN,50-59,16,36,0,51,0,0,1,52,0,52,Veneto,ITH3
2020-12-31,PF/BT,50508,ARZIGNANO,VEN,60-69,8,0,0,8,0,0,0,8,0,8,Veneto,ITH3
2020-12-31,PF/BT,50508,ARZIGNANO,VEN,70-79,1,0,0,1,0,0,0,1,0,1,Veneto,ITH3
2020-12-31,PF/BT,50508,SISP IV NOVEMBRE,VEN,20-29,8,35,0,43,0,0,0,43,0,43,Veneto,ITH3
2020-12-31,PF/BT,50508,SISP IV NOVEMBRE,VEN,30-39,33,53,0,85,0,0,1,86,0,86,Veneto,ITH3
2020-12-31,PF/BT,50508,SISP IV NOVEMBRE,VEN,40-49,16,74,0,90,0,0,0,90,0,90,Veneto,ITH3
2020-12-31,PF/BT,50508,SISP IV NOVEMBRE,VEN,50-59,43,70,0,108,0,0,5,113,0,113,Veneto,ITH3
2020-12-31,PF/BT,50508,SISP IV NOVEMBRE,VEN,60-69,15,16,0,29,0,0,2,31,0,31,Veneto,ITH3
2020-12-31,PF/BT,611160,CASA DI RIPOSO 'A. GALVAN',VEN,20-29,3,2,0,4,1,0,0,5,0,5,Veneto,ITH3
2020-12-31,PF/BT,611160,CASA DI RIPOSO 'A. GALVAN',VEN,30-39,0,2,0,1,1,0,0,2,0,2,Veneto,ITH3
2020-12-31,PF/BT,611160,CASA DI RIPOSO 'A. GALVAN',VEN,40-49,1,7,0,6,2,0,0,8,0,8,Veneto,ITH3
2020-12-31,PF/BT,611160,CASA DI RIPOSO 'A. GALVAN',VEN,50-59,3,7,0,5,5,0,0,10,0,10,Veneto,ITH3
2020-12-31,PF/BT,611160,CASA DI RIPOSO 'A. GALVAN',VEN,60-69,9,2,0,6,2,3,0,11,0,11,Veneto,ITH3
2020-12-31,PF/BT,611160,CASA DI RIPOSO 'A. GALVAN',VEN,70-79,2,1,0,0,0,3,0,3,0,3,Veneto,ITH3
2020-12-31,PF/BT,611160,CASA DI RIPOSO 'A. GALVAN',VEN,80-89,3,6,0,0,0,9,0,9,0,9,Veneto,ITH3
2020-12-31,PF/BT,611160,CASA DI RIPOSO 'A. GALVAN',VEN,90+,1,4,0,0,0,5,0,5,0,5,Veneto,ITH3
2021-01-01,PF/BT,5001700,OSPEDALE SACRO CUORE DI NEGRAR,VEN,20-29,7,15,0,22,0,0,0,22,0,22,Veneto,ITH3
2021-01-01,PF/BT,5001700,OSPEDALE SACRO CUORE DI NEGRAR,VEN,30-39,16,15,0,31,0,0,0,31,0,31,Veneto,ITH3
2021-01-01,PF/BT,5001700,OSPEDALE SACRO CUORE DI NEGRAR,VEN,40-49,10,23,0,31,2,0,0,33,0,33,Veneto,ITH3
2021-01-01,PF/BT,5001700,OSPEDALE SACRO CUORE DI NEGRAR,VEN,50-59,8,17,0,23,2,0,0,25,0,25,Veneto,ITH3
2021-01-01,PF/BT,5001700,OSPEDALE SACRO CUORE DI NEGRAR,VEN,60-69,7,3,0,10,0,0,0,10,0,10,Veneto,ITH3
2021-01-01,PF/BT,5050201,OSPEDALE CA' FONCELLO,VEN,20-29,27,59,0,86,0,0,0,86,0,86,Veneto,ITH3
2021-01-01,PF/BT,5050201,OSPEDALE CA' FONCELLO,VEN,30-39,67,125,0,191,0,0,1,192,0,192,Veneto,ITH3
2021-01-01,PF/BT,5050201,OSPEDALE CA' FONCELLO,VEN,40-49,64,216,0,280,0,0,0,280,0,280,Veneto,ITH3
2021-01-01,PF/BT,5050201,OSPEDALE CA' FONCELLO,VEN,50-59,94,265,0,359,0,0,0,359,0,359,Veneto,ITH3
2021-01-01,PF/BT,5050201,OSPEDALE CA' FONCELLO,VEN,60-69,49,38,0,87,0,0,0,87,0,87,Veneto,ITH3
2021-01-01,PF/BT,50503,CHIOGGIA,VEN,20-29,0,1,0,1,0,0,0,1,0,1,Veneto,ITH3
2021-01-01,PF/BT,50503,CHIOGGIA,VEN,30-39,3,3,0,6,0,0,0,6,0,6,Veneto,ITH3
2021-01-01,PF/BT,50503,CHIOGGIA,VEN,40-49,6,7,0,13,0,0,0,13,0,13,Veneto,ITH3
2021-01-01,PF/BT,50503,CHIOGGIA,VEN,50-59,5,11,0,16,0,0,0,16,0,16,Veneto,ITH3
2021-01-01,PF/BT,50503,CHIOGGIA,VEN,60-69,3,3,0,6,0,0,0,6,0,6,Veneto,ITH3
2021-01-01,PF/BT,50504,CA' SAVIO,VEN,20-29,5,14,0,19,0,0,0,19,0,19,Veneto,ITH3
2021-01-01,PF/BT,50504,CA' SAVIO,VEN,30-39,3,16,0,19,0,0,0,19,0,19,Veneto,ITH3
2021-01-01,PF/BT,50504,CA' SAVIO,VEN,40-49,8,19,0,27,0,0,0,27,0,27,Veneto,ITH3
2021-01-01,PF/BT,50504,CA' SAVIO,VEN,50-59,6,23,0,29,0,0,0,29,0,29,Veneto,ITH3
2021-01-01,PF/BT,50504,CA' SAVIO,VEN,60-69,3,5,0,8,0,0,0,8,0,8,Veneto,ITH3
2021-01-01,PF/BT,50507,H BASSANO,VEN,20-29,4,11,0,15,0,0,0,15,0,15,Veneto,ITH3
2021-01-01,PF/BT,50507,H BASSANO,VEN,30-39,14,15,0,28,1,0,0,29,0,29,Veneto,ITH3
2021-01-01,PF/BT,50507,H BASSANO,VEN,40-49,7,18,0,24,1,0,0,25,0,25,Veneto,ITH3
2021-01-01,PF/BT,50507,H BASSANO,VEN,50-59,9,15,0,22,2,0,0,24,0,24,Veneto,ITH3
2021-01-01,PF/BT,50507,H BASSANO,VEN,60-69,5,4,0,8,1,0,0,9,0,9,Veneto,ITH3
2021-01-01,PF/BT,50507,H MAROSTICA,VEN,20-29,2,2,0,4,0,0,0,4,0,4,Veneto,ITH3
2021-01-01,PF/BT,50507,H MAROSTICA,VEN,30-39,3,2,0,5,0,0,0,5,0,5,Veneto,ITH3
2021-01-01,PF/BT,50507,H MAROSTICA,VEN,40-49,1,9,0,10,0,0,0,10,0,10,Veneto,ITH3
2021-01-01,PF/BT,50507,H MAROSTICA,VEN,50-59,2,20,0,22,0,0,0,22,0,22,Veneto,ITH3
2021-01-01,PF/BT,50507,H MAROSTICA,VEN,60-69,9,9,0,18,0,0,0,18,0,18,Veneto,ITH3
2021-01-01,PF/BT,50507,THIENE,VEN,20-29,1,3,0,4,0,0,0,4,0,4,Veneto,ITH3
2021-01-01,PF/BT,50507,THIENE,VEN,30-39,3,13,0,16,0,0,0,16,0,16,Veneto,ITH3
2021-01-01,PF/BT,50507,THIENE,VEN,40-49,6,23,0,29,0,0,0,29,0,29,Veneto,ITH3
2021-01-01,PF/BT,50507,THIENE,VEN,50-59,9,24,0,33,0,0,0,33,0,33,Veneto,ITH3
2021-01-01,PF/BT,50507,THIENE,VEN,60-69,4,4,0,8,0,0,0,8,0,8,Veneto,ITH3
2021-01-02,PF/BT,0,Mancante,VEN,30-39,0,1,0,1,0,0,0,1,0,1,Veneto,ITH3
2021-01-02,PF/BT,132230,C.R. 'S.GIUSEPPE' - PEDEMONTE,VEN,20-29,1,4,0,3,2,0,0,5,0,5,Veneto,ITH3
2021-01-02,PF/BT,132230,C.R. 'S.GIUSEPPE' - PEDEMONTE,VEN,30-39,1,7,0,4,4,0,0,8,0,8,Veneto,ITH3
2021-01-02,PF/BT,132230,C.R. 'S.GIUSEPPE' - PEDEMONTE,VEN,40-49,0,10,0,9,1,0,0,10,0,10,Veneto,ITH3
2021-01-02,PF/BT,132230,C.R. 'S.GIUSEPPE' - PEDEMONTE,VEN,50-59,0,11,0,5,6,0,0,11,0,11,Veneto,ITH3
2021-01-02,PF/BT,132230,C.R. 'S.GIUSEPPE' - PEDEMONTE,VEN,60-69,2,0,0,1,0,1,0,2,0,2,Veneto,ITH3
2021-01-02,PF/BT,132230,C.R. 'S.GIUSEPPE' - PEDEMONTE,VEN,70-79,2,3,0,0,0,5,0,5,0,5,Veneto,ITH3
2021-01-02,PF/BT,132230,C.R. 'S.GIUSEPPE' - PEDEMONTE,VEN,80-89,5,16,0,1,0,20,0,21,0,21,Veneto,ITH3
2021-01-02,PF/BT,132230,C.R. 'S.GIUSEPPE' - PEDEMONTE,VEN,90+,1,13,0,0,0,14,0,14,0,14,Veneto,ITH3
2021-01-02,PF/BT,200068,IPAB - RESIDENZA MONTE CROCETTA,VEN,20-29,2,1,0,3,0,0,0,3,0,3,Veneto,ITH3
2021-01-02,PF/BT,200068,IPAB - RESIDENZA MONTE CROCETTA,VEN,30-39,1,3,0,4,0,0,0,4,0,4,Veneto,ITH3
2021-01-02,PF/BT,200068,IPAB - RESIDENZA MONTE CROCETTA,VEN,40-49,7,9,0,13,3,0,0,16,0,16,Veneto,ITH3
2021-01-02,PF/BT,200068,IPAB - RESIDENZA MONTE CROCETTA,VEN,50-59,6,19,0,25,0,0,0,25,0,25,Veneto,ITH3
2021-01-02,PF/BT,200068,IPAB - RESIDENZA MONTE CROCETTA,VEN,60-69,7,10,0,6,2,8,1,17,0,17,Veneto,ITH3
2021-01-02,PF/BT,200068,IPAB - RESIDENZA MONTE CROCETTA,VEN,70-79,4,11,0,0,0,15,0,15,0,15,Veneto,ITH3
2021-01-02,PF/BT,200068,IPAB - RESIDENZA MONTE CROCETTA,VEN,80-89,8,19,0,0,0,27,0,27,0,27,Veneto,ITH3
2021-01-02,PF/BT,200068,IPAB - RESIDENZA MONTE CROCETTA,VEN,90+,2,14,0,0,0,15,1,16,0,16,Veneto,ITH3
2021-01-02,PF/BT,363785,RESIDENZA PER ANZIANI 'STELLA MARINA',VEN,20-29,8,7,0,14,1,0,0,15,0,15,Veneto,ITH3
2021-01-02,PF/BT,363785,RESIDENZA PER ANZIANI 'STELLA MARINA',VEN,30-39,9,5,0,14,0,0,0,14,0,14,Veneto,ITH3
2021-01-02,PF/BT,363785,RESIDENZA PER ANZIANI 'STELLA MARINA',VEN,40-49,5,10,0,14,1,0,0,15,0,15,Veneto,ITH3
2021-01-02,PF/BT,363785,RESIDENZA PER ANZIANI 'STELLA MARINA',VEN,50-59,3,7,0,8,1,1,0,10,0,10,Veneto,ITH3
2021-01-02,PF/BT,363785,RESIDENZA PER ANZIANI 'STELLA MARINA',VEN,60-69,5,5,0,4,1,5,0,10,0,10,Veneto,ITH3
2021-01-02,PF/BT,363785,RESIDENZA PER ANZIANI 'STELLA MARINA',VEN,70-79,3,3,0,0,0,6,0,6,0,6,Veneto,ITH3
2021-01-02,PF/BT,363785,RESIDENZA PER ANZIANI 'STELLA MARINA',VEN,80-89,9,34,0,0,0,43,0,43,0,43,Veneto,ITH3
2021-01-02,PF/BT,363785,RESIDENZA PER ANZIANI 'STELLA MARINA',VEN,90+,4,22,0,0,0,26,0,26,0,26,Veneto,ITH3
2021-01-02,PF/BT,42827,C.S.A. 'SOTERIA',VEN,20-29,0,2,0,0,2,0,0,2,0,2,Veneto,ITH3
2021-01-02,PF/BT,42827,C.S.A. 'SOTERIA',VEN,30-39,4,6,0,7,2,1,0,10,0,10,Veneto,ITH3
2021-01-02,PF/BT,42827,C.S.A. 'SOTERIA',VEN,40-49,2,11,0,10,3,0,0,13,0,13,Veneto,ITH3
2021-01-02,PF/BT,42827,C.S.A. 'SOTERIA',VEN,50-59,2,14,0,7,6,3,0,16,0,16,Veneto,ITH3
2021-01-02,PF/BT,42827,C.S.A. 'SOTERIA',VEN,60-69,6,3,0,0,4,5,0,9,0,9,Veneto,ITH3
2021-01-02,PF/BT,42827,C.S.A. 'SOTERIA',VEN,70-79,4,5,0,0,0,9,0,9,0,9,Veneto,ITH3
2021-01-02,PF/BT,42827,C.S.A. 'SOTERIA',VEN,80-89,8,13,0,0,1,20,0,21,0,21,Veneto,ITH3
2021-01-02,PF/BT,42827,C.S.A. 'SOTERIA',VEN,90+,4,18,0,0,0,22,0,22,0,22,Veneto,ITH3
2021-01-02,PF/BT,445366,C. SERV.RES.ANZ.-NAZARET,VEN,20-29,2,2,0,4,0,0,0,4,0,4,Veneto,ITH3
2021-01-02,PF/BT,445366,C. SERV.RES.ANZ.-NAZARET,VEN,30-39,0,1,0,1,0,0,0,1,0,1,Veneto,ITH3
2021-01-02,PF/BT,445366,C. SERV.RES.ANZ.-NAZARET,VEN,40-49,1,8,0,6,3,0,0,9,0,9,Veneto,ITH3
2021-01-02,PF/BT,445366,C. SERV.RES.ANZ.-NAZARET,VEN,50-59,2,10,0,10,2,0,0,12,0,12,Veneto,ITH3
2021-01-02,PF/BT,445366,C. SERV.RES.ANZ.-NAZARET,VEN,60-69,0,3,0,3,0,0,0,3,0,3,Veneto,ITH3
2021-01-02,PF/BT,486013,CENTRO SERVIZI PER ANZIANI VILLA FIORITA,VEN,20-29,7,4,0,11,0,0,0,11,0,11,Veneto,ITH3
2021-01-02,PF/BT,486013,CENTRO SERVIZI PER ANZIANI VILLA FIORITA,VEN,30-39,1,7,0,4,4,0,0,8,0,8,Veneto,ITH3
2021-01-02,PF/BT,486013,CENTRO SERVIZI PER ANZIANI VILLA FIORITA,VEN,40-49,5,15,0,10,10,0,0,20,0,20,Veneto,ITH3
2021-01-02,PF/BT,486013,CENTRO SERVIZI PER ANZIANI VILLA FIORITA,VEN,50-59,4,9,0,3,10,0,0,13,0,13,Veneto,ITH3
2021-01-02,PF/BT,486013,CENTRO SERVIZI PER ANZIANI VILLA FIORITA,VEN,60-69,1,1,0,1,1,0,0,2,0,2,Veneto,ITH3
2021-01-02,PF/BT,5001700,OSPEDALE SACRO CUORE DI NEGRAR,VEN,20-29,4,14,0,18,0,0,0,18,0,18,Veneto,ITH3
2021-01-02,PF/BT,5001700,OSPEDALE SACRO CUORE DI NEGRAR,VEN,30-39,12,13,0,25,0,0,0,25,0,25,Veneto,ITH3
2021-01-02,PF/BT,5001700,OSPEDALE SACRO CUORE DI NEGRAR,VEN,40-49,11,11,0,22,0,0,0,22,0,22,Veneto,ITH3
2021-01-02,PF/BT,5001700,OSPEDALE SACRO CUORE DI NEGRAR,VEN,50-59,13,7,0,20,0,0,0,20,0,20,Veneto,ITH3
2021-01-02,PF/BT,5001700,OSPEDALE SACRO CUORE DI NEGRAR,VEN,60-69,3,2,0,5,0,0,0,5,0,5,Veneto,ITH3
2021-01-02,PF/BT,50501,"BELLUNO ""DRIVE-IN""",VEN,20-29,1,6,0,7,0,0,0,7,0,7,Veneto,ITH3
2021-01-02,PF/BT,50501,"BELLUNO ""DRIVE-IN""",VEN,30-39,4,7,0,11,0,0,0,11,0,11,Veneto,ITH3
2021-01-02,PF/BT,50501,"BELLUNO ""DRIVE-IN""",VEN,40-49,4,14,0,18,0,0,0,18,0,18,Veneto,ITH3
2021-01-02,PF/BT,50501,"BELLUNO ""DRIVE-IN""",VEN,50-59,4,8,0,12,0,0,0,12,0,12,Veneto,ITH3
2021-01-02,PF/BT,50501,"BELLUNO ""DRIVE-IN""",VEN,60-69,2,1,0,3,0,0,0,3,0,3,Veneto,ITH3
2021-01-02,PF/BT,50501,FELTRE,VEN,20-29,3,10,0,13,0,0,0,13,0,13,Veneto,ITH3
2021-01-02,PF/BT,50501,FELTRE,VEN,30-39,5,10,0,14,1,0,0,15,0,15,Veneto,ITH3
2021-01-02,PF/BT,50501,FELTRE,VEN,40-49,9,20,0,28,1,0,0,29,0,29,Veneto,ITH3
2021-01-02,PF/BT,50501,FELTRE,VEN,50-59,9,24,0,32,1,0,0,33,0,33,Veneto,ITH3
2021-01-02,PF/BT,50501,FELTRE,VEN,60-69,5,8,0,12,1,0,0,13,0,13,Veneto,ITH3
2021-01-02,PF/BT,50501,PIEVE DI CADORE,VEN,30-39,1,2,0,3,0,0,0,3,0,3,Veneto,ITH3
2021-01-02,PF/BT,50501,PIEVE DI CADORE,VEN,40-49,1,3,0,2,0,0,2,4,0,4,Veneto,ITH3
2021-01-02,PF/BT,50501,PIEVE DI CADORE,VEN,50-59,3,10,0,8,0,0,5,13,0,13,Veneto,ITH3
2021-01-02,PF/BT,50501,PIEVE DI CADORE,VEN,60-69,4,0,0,3,0,0,1,4,0,4,Veneto,ITH3
2021-01-02,PF/BT,5050201,OSPEDALE CA' FONCELLO,VEN,20-29,35,97,0,132,0,0,0,132,0,132,Veneto,ITH3
2021-01-02,PF/BT,5050201,OSPEDALE CA' FONCELLO,VEN,30-39,67,147,0,214,0,0,0,214,0,214,Veneto,ITH3
2021-01-02,PF/BT,5050201,OSPEDALE CA' FONCELLO,VEN,40-49,68,209,0,277,0,0,0,277,0,277,Veneto,ITH3
2021-01-02,PF/BT,5050201,OSPEDALE CA' FONCELLO,VEN,50-59,68,232,0,300,0,0,0,300,0,300,Veneto,ITH3
2021-01-02,PF/BT,5050201,OSPEDALE CA' FONCELLO,VEN,60-69,36,33,0,69,0,0,0,69,0,69,Veneto,ITH3
2021-01-02,PF/BT,5050201,OSPEDALE CA' FONCELLO,VEN,70-79,3,0,0,3,0,0,0,3,0,3,Veneto,ITH3
2021-01-02,PF/BT,50503,MED.PREV - CHIOGGIA,VEN,20-29,3,4,0,7,0,0,0,7,0,7,Veneto,ITH3
2021-01-02,PF/BT,50503,MED.PREV - CHIOGGIA,VEN,30-39,2,4,0,6,0,0,0,6,0,6,Veneto,ITH3
2021-01-02,PF/BT,50503,MED.PREV - CHIOGGIA,VEN,40-49,3,13,0,16,0,0,0,16,0,16,Veneto,ITH3
2021-01-02,PF/BT,50503,MED.PREV - CHIOGGIA,VEN,50-59,5,13,0,18,0,0,0,18,0,18,Veneto,ITH3
2021-01-02,PF/BT,50503,MED.PREV - CHIOGGIA,VEN,60-69,6,1,0,7,0,0,0,7,0,7,Veneto,ITH3
2021-01-02,PF/BT,50503,MEDICINA PREVENTIVA MESTRE,VEN,20-29,8,11,0,19,0,0,0,19,0,19,Veneto,ITH3
2021-01-02,PF/BT,50503,MEDICINA PREVENTIVA MESTRE,VEN,30-39,11,19,0,30,0,0,0,30,0,30,Veneto,ITH3
2021-01-02,PF/BT,50503,MEDICINA PREVENTIVA MESTRE,VEN,40-49,16,41,0,57,0,0,0,57,0,57,Veneto,ITH3
2021-01-02,PF/BT,50503,MEDICINA PREVENTIVA MESTRE,VEN,50-59,21,45,0,66,0,0,0,66,0,66,Veneto,ITH3
2021-01-02,PF/BT,50503,MEDICINA PREVENTIVA MESTRE,VEN,60-69,19,6,0,25,0,0,0,25,0,25,Veneto,ITH3
2021-01-02,PF/BT,50503,MEDICINA PREVENTIVA MESTRE,VEN,70-79,1,0,0,1,0,0,0,1,0,1,Veneto,ITH3
2021-01-02,PF/BT,50503,MEDICINA PREVENTIVA VENEZIA,VEN,20-29,11,13,0,24,0,0,0,24,0,24,Veneto,ITH3
2021-01-02,PF/BT,50503,MEDICINA PREVENTIVA VENEZIA,VEN,30-39,7,11,0,18,0,0,0,18,0,18,Veneto,ITH3
2021-01-02,PF/BT,50503,MEDICINA PREVENTIVA VENEZIA,VEN,40-49,9,11,0,20,0,0,0,20,0,20,Veneto,ITH3
2021-01-02,PF/BT,50503,MEDICINA PREVENTIVA VENEZIA,VEN,50-59,4,19,0,23,0,0,0,23,0,23,Veneto,ITH3
2021-01-02,PF/BT,50503,MEDICINA PREVENTIVA VENEZIA,VEN,60-69,5,5,0,10,0,0,0,10,0,10,Veneto,ITH3
2021-01-02,PF/BT,50503,MEDICINA PREVENTIVA VENEZIA,VEN,70-79,1,0,0,1,0,0,0,1,0,1,Veneto,ITH3
2021-01-02,PF/BT,50503,SISP DOLO ADULTI,VEN,20-29,8,10,0,18,0,0,0,18,0,18,Veneto,ITH3
2021-01-02,PF/BT,50503,SISP DOLO ADULTI,VEN,30-39,8,15,0,23,0,0,0,23,0,23,Veneto,ITH3
2021-01-02,PF/BT,50503,SISP DOLO ADULTI,VEN,40-49,12,13,0,25,0,0,0,25,0,25,Veneto,ITH3
2021-01-02,PF/BT,50503,SISP DOLO ADULTI,VEN,50-59,9,25,0,34,0,0,0,34,0,34,Veneto,ITH3
2021-01-02,PF/BT,50503,SISP DOLO ADULTI,VEN,60-69,5,1,0,6,0,0,0,6,0,6,Veneto,ITH3
2021-01-02,PF/BT,50503,SISP DOLO ADULTI,VEN,70-79,2,0,0,2,0,0,0,2,0,2,Veneto,ITH3
2021-01-02,PF/BT,50504,OSPEDALE CIVILE SAN DONA',VEN,20-29,2,9,0,11,0,0,0,11,0,11,Veneto,ITH3
2021-01-02,PF/BT,50504,OSPEDALE CIVILE SAN DONA',VEN,30-39,4,13,0,17,0,0,0,17,0,17,Veneto,ITH3
2021-01-02,PF/BT,50504,OSPEDALE CIVILE SAN DONA',VEN,40-49,12,22,0,33,0,0,1,34,0,34,Veneto,ITH3
2021-01-02,PF/BT,50504,OSPEDALE CIVILE SAN DONA',VEN,50-59,12,42,0,54,0,0,0,54,0,54,Veneto,ITH3
2021-01-02,PF/BT,50504,OSPEDALE CIVILE SAN DONA',VEN,60-69,4,3,0,7,0,0,0,7,0,7,Veneto,ITH3
2021-01-02,PF/BT,50504,PORTOGRUARO,VEN,20-29,5,12,0,16,1,0,0,17,0,17,Veneto,ITH3
2021-01-02,PF/BT,50504,PORTOGRUARO,VEN,30-39,3,5,0,7,0,0,1,8,0,8,Veneto,ITH3
2021-01-02,PF/BT,50504,PORTOGRUARO,VEN,40-49,4,16,0,20,0,0,0,20,0,20,Veneto,ITH3
2021-01-02,PF/BT,50504,PORTOGRUARO,VEN,50-59,6,19,0,25,0,0,0,25,0,25,Veneto,ITH3
2021-01-02,PF/BT,50504,PORTOGRUARO,VEN,60-69,9,4,0,13,0,0,0,13,0,13,Veneto,ITH3
2021-01-02,PF/BT,50504,PORTOGRUARO,VEN,70-79,1,0,0,1,0,0,0,1,0,1,Veneto,ITH3
2021-01-02,PF/BT,50505,ADRIA,VEN,20-29,3,2,0,5,0,0,0,5,0,5,Veneto,ITH3
2021-01-02,PF/BT,50505,ADRIA,VEN,30-39,7,9,0,16,0,0,0,16,0,16,Veneto,ITH3
2021-01-02,PF/BT,50505,ADRIA,VEN,40-49,4,18,0,22,0,0,0,22,0,22,Veneto,ITH3
2021-01-02,PF/BT,50505,ADRIA,VEN,50-59,17,30,0,47,0,0,0,47,0,47,Veneto,ITH3
2021-01-02,PF/BT,50505,ADRIA,VEN,60-69,22,8,0,30,0,0,0,30,0,30,Veneto,ITH3
2021-01-02,PF/BT,50505,MAGAZZINO MED. COMPETENTE 05,VEN,20-29,1,2,0,3,0,0,0,3,0,3,Veneto,ITH3
2021-01-02,PF/BT,50505,MAGAZZINO MED. COMPETENTE 05,VEN,30-39,1,5,0,3,3,0,0,6,0,6,Veneto,ITH3
2021-01-02,PF/BT,50505,MAGAZZINO MED. COMPETENTE 05,VEN,40-49,1,2,0,2,1,0,0,3,0,3,Veneto,ITH3
2021-01-02,PF/BT,50505,MAGAZZINO MED. COMPETENTE 05,VEN,50-59,2,5,0,5,2,0,0,7,0,7,Veneto,ITH3
2021-01-02,PF/BT,50505,MAGAZZINO MED. COMPETENTE 05,VEN,70-79,1,0,0,1,0,0,0,1,0,1,Veneto,ITH3
2021-01-02,PF/BT,50505,TRECENTA,VEN,20-29,3,5,0,8,0,0,0,8,0,8,Veneto,ITH3
2021-01-02,PF/BT,50505,TRECENTA,VEN,30-39,3,18,0,21,0,0,0,21,0,21,Veneto,ITH3
2021-01-02,PF/BT,50505,TRECENTA,VEN,40-49,12,24,0,34,0,0,2,36,0,36,Veneto,ITH3
2021-01-02,PF/BT,50505,TRECENTA,VEN,50-59,4,33,0,35,0,0,2,37,0,37,Veneto,ITH3
2021-01-02,PF/BT,50505,TRECENTA,VEN,60-69,11,11,0,21,0,0,1,22,0,22,Veneto,ITH3
2021-01-02,PF/BT,50505,TRECENTA,VEN,70-79,1,0,0,0,0,0,1,1,0,1,Veneto,ITH3
2021-01-02,PF/BT,5050501,PRESIDIO OSPEDALIERO ROVIGO,VEN,20-29,5,14,0,19,0,0,0,19,0,19,Veneto,ITH3
2021-01-02,PF/BT,5050501,PRESIDIO OSPEDALIERO ROVIGO,VEN,30-39,10,12,0,22,0,0,0,22,0,22,Veneto,ITH3
2021-01-02,PF/BT,5050501,PRESIDIO OSPEDALIERO ROVIGO,VEN,40-49,7,24,0,31,0,0,0,31,0,31,Veneto,ITH3
2021-01-02,PF/BT,5050501,PRESIDIO OSPEDALIERO ROVIGO,VEN,50-59,7,42,0,48,1,0,0,49,0,49,Veneto,ITH3
2021-01-02,PF/BT,5050501,PRESIDIO OSPEDALIERO ROVIGO,VEN,60-69,42,22,0,63,0,1,0,64,0,64,Veneto,ITH3
2021-01-02,PF/BT,5050501,PRESIDIO OSPEDALIERO ROVIGO,VEN,70-79,1,0,0,1,0,0,0,1,0,1,Veneto,ITH3
2021-01-02,PF/BT,50506,AZ OSPEDALIERA DI PADOVA MAL. INFET.E TR,VEN,20-29,25,85,0,110,0,0,0,110,0,110,Veneto,ITH3
2021-01-02,PF/BT,50506,AZ OSPEDALIERA DI PADOVA MAL. INFET.E TR,VEN,30-39,49,66,0,114,0,0,1,115,0,115,Veneto,ITH3
2021-01-02,PF/BT,50506,AZ OSPEDALIERA DI PADOVA MAL. INFET.E TR,VEN,40-49,41,73,0,114,0,0,0,114,0,114,Veneto,ITH3
2021-01-02,PF/BT,50506,AZ OSPEDALIERA DI PADOVA MAL. INFET.E TR,VEN,50-59,37,87,0,124,0,0,0,124,0,124,Veneto,ITH3
2021-01-02,PF/BT,50506,AZ OSPEDALIERA DI PADOVA MAL. INFET.E TR,VEN,60-69,25,24,0,49,0,0,0,49,0,49,Veneto,ITH3
2021-01-02,PF/BT,50506,AZ OSPEDALIERA DI PADOVA MAL. INFET.E TR,VEN,70-79,1,0,0,1,0,0,0,1,0,1,Veneto,ITH3
2021-01-02,PF/BT,50506,CAMPOSAMPIERO MEDICO COMPETENT,VEN,20-29,0,5,0,5,0,0,0,5,0,5,Veneto,ITH3
2021-01-02,PF/BT,50506,CAMPOSAMPIERO MEDICO COMPETENT,VEN,30-39,2,5,0,7,0,0,0,7,0,7,Veneto,ITH3
2021-01-02,PF/BT,50506,CAMPOSAMPIERO MEDICO COMPETENT,VEN,40-49,1,4,0,5,0,0,0,5,0,5,Veneto,ITH3
2021-01-02,PF/BT,50506,CAMPOSAMPIERO MEDICO COMPETENT,VEN,50-59,1,4,0,5,0,0,0,5,0,5,Veneto,ITH3
2021-01-02,PF/BT,50506,CAMPOSAMPIERO MEDICO COMPETENT,VEN,60-69,0,1,0,1,0,0,0,1,0,1,Veneto,ITH3
2021-01-02,PF/BT,50506,CITTADELLA MEDICO COMPETENTE,VEN,20-29,3,6,0,9,0,0,0,9,0,9,Veneto,ITH3
2021-01-02,PF/BT,50506,CITTADELLA MEDICO COMPETENTE,VEN,30-39,5,8,0,13,0,0,0,13,0,13,Veneto,ITH3
2021-01-02,PF/BT,50506,CITTADELLA MEDICO COMPETENTE,VEN,40-49,3,14,0,17,0,0,0,17,0,17,Veneto,ITH3
2021-01-02,PF/BT,50506,CITTADELLA MEDICO COMPETENTE,VEN,50-59,6,11,0,17,0,0,0,17,0,17,Veneto,ITH3
2021-01-02,PF/BT,50506,CITTADELLA MEDICO COMPETENTE,VEN,60-69,1,3,0,4,0,0,0,4,0,4,Veneto,ITH3
2021-01-02,PF/BT,50506,DIRIGENZA MEDICA P.D.SACCO,VEN,20-29,3,8,0,11,0,0,0,11,0,11,Veneto,ITH3
2021-01-02,PF/BT,50506,DIRIGENZA MEDICA P.D.SACCO,VEN,30-39,3,6,0,9,0,0,0,9,0,9,Veneto,ITH3
2021-01-02,PF/BT,50506,DIRIGENZA MEDICA P.D.SACCO,VEN,40-49,4,5,0,9,0,0,0,9,0,9,Veneto,ITH3
2021-01-02,PF/BT,50506,DIRIGENZA MEDICA P.D.SACCO,VEN,50-59,6,3,0,9,0,0,0,9,0,9,Veneto,ITH3
2021-01-02,PF/BT,50506,DIRIGENZA MEDICA P.D.SACCO,VEN,60-69,2,2,0,4,0,0,0,4,0,4,Veneto,ITH3
2021-01-02,PF/BT,50506,MONTAGNANA,VEN,20-29,1,3,0,4,0,0,0,4,0,4,Veneto,ITH3
2021-01-02,PF/BT,50506,MONTAGNANA,VEN,30-39,2,8,0,8,2,0,0,10,0,10,Veneto,ITH3
2021-01-02,PF/BT,50506,MONTAGNANA,VEN,40-49,3,8,0,8,3,0,0,11,0,11,Veneto,ITH3
2021-01-02,PF/BT,50506,MONTAGNANA,VEN,50-59,4,13,0,16,1,0,0,17,0,17,Veneto,ITH3
2021-01-02,PF/BT,50506,MONTAGNANA,VEN,60-69,9,7,0,13,3,0,0,16,0,16,Veneto,ITH3
2021-01-02,PF/BT,50506,MONTAGNANA,VEN,70-79,1,0,0,1,0,0,0,1,0,1,Veneto,ITH3
2021-01-02,PF/BT,50506,MONTAGNANA,VEN,90+,1,0,0,0,0,0,1,1,0,1,Veneto,ITH3
2021-01-02,PF/BT,50506,SCHIAVONIA AMBULATORIO,VEN,20-29,4,7,0,11,0,0,0,11,0,11,Veneto,ITH3
2021-01-02,PF/BT,50506,SCHIAVONIA AMBULATORIO,VEN,30-39,5,4,0,9,0,0,0,9,0,9,Veneto,ITH3
2021-01-02,PF/BT,50506,SCHIAVONIA AMBULATORIO,VEN,40-49,7,15,0,22,0,0,0,22,0,22,Veneto,ITH3
2021-01-02,PF/BT,50506,SCHIAVONIA AMBULATORIO,VEN,50-59,5,14,0,19,0,0,0,19,0,19,Veneto,ITH3
2021-01-02,PF/BT,50506,SCHIAVONIA AMBULATORIO,VEN,60-69,4,1,0,5,0,0,0,5,0,5,Veneto,ITH3
2021-01-02,PF/BT,50507,H BASSANO,VEN,20-29,5,12,0,17,0,0,0,17,0,17,Veneto,ITH3
2021-01-02,PF/BT,50507,H BASSANO,VEN,30-39,1,9,0,9,1,0,0,10,0,10,Veneto,ITH3
2021-01-02,PF/BT,50507,H BASSANO,VEN,40-49,6,18,0,23,1,0,0,24,0,24,Veneto,ITH3
2021-01-02,PF/BT,50507,H BASSANO,VEN,50-59,5,18,0,22,1,0,0,23,0,23,Veneto,ITH3
2021-01-02,PF/BT,50507,H BASSANO,VEN,60-69,5,6,0,10,1,0,0,11,0,11,Veneto,ITH3
2021-01-02,PF/BT,50507,H MAROSTICA,VEN,20-29,0,3,0,3,0,0,0,3,0,3,Veneto,ITH3
2021-01-02,PF/BT,50507,H MAROSTICA,VEN,30-39,0,2,0,2,0,0,0,2,0,2,Veneto,ITH3
2021-01-02,PF/BT,50507,H MAROSTICA,VEN,40-49,1,0,0,1,0,0,0,1,0,1,Veneto,ITH3
2021-01-02,PF/BT,50507,H MAROSTICA,VEN,50-59,0,5,0,5,0,0,0,5,0,5,Veneto,ITH3
2021-01-02,PF/BT,50507,H MAROSTICA,VEN,60-69,1,6,0,6,1,0,0,7,0,7,Veneto,ITH3
2021-01-02,PF/BT,50507,THIENE,VEN,20-29,2,4,0,5,0,0,1,6,0,6,Veneto,ITH3
2021-01-02,PF/BT,50507,THIENE,VEN,30-39,3,15,0,18,0,0,0,18,0,18,Veneto,ITH3
2021-01-02,PF/BT,50507,THIENE,VEN,40-49,8,20,0,28,0,0,0,28,0,28,Veneto,ITH3
2021-01-02,PF/BT,50507,THIENE,VEN,50-59,9,43,0,52,0,0,0,52,0,52,Veneto,ITH3
2021-01-02,PF/BT,50507,THIENE,VEN,60-69,5,1,0,6,0,0,0,6,0,6,Veneto,ITH3
2021-01-02,PF/BT,50508,SISP IV NOVEMBRE,VEN,20-29,12,44,0,54,0,0,2,56,0,56,Veneto,ITH3
2021-01-02,PF/BT,50508,SISP IV NOVEMBRE,VEN,30-39,18,45,0,62,0,0,1,63,0,63,Veneto,ITH3
2021-01-02,PF/BT,50508,SISP IV NOVEMBRE,VEN,40-49,17,53,0,66,0,0,4,70,0,70,Veneto,ITH3
2021-01-02,PF/BT,50508,SISP IV NOVEMBRE,VEN,50-59,22,73,0,86,0,0,9,95,0,95,Veneto,ITH3
2021-01-02,PF/BT,50508,SISP IV NOVEMBRE,VEN,60-69,35,16,0,48,0,0,3,51,0,51,Veneto,ITH3
2021-01-02,PF/BT,50508,SISP IV NOVEMBRE,VEN,70-79,1,1,0,2,0,0,0,2,0,2,Veneto,ITH3
2021-01-02,PF/BT,50508,VALDAGNO,VEN,20-29,6,4,0,10,0,0,0,10,0,10,Veneto,ITH3
2021-01-02,PF/BT,50508,VALDAGNO,VEN,30-39,4,12,0,15,0,0,1,16,0,16,Veneto,ITH3
2021-01-02,PF/BT,50508,VALDAGNO,VEN,40-49,14,27,0,39,0,0,2,41,0,41,Veneto,ITH3
2021-01-02,PF/BT,50508,VALDAGNO,VEN,50-59,18,50,0,63,0,0,5,68,0,68,Veneto,ITH3
2021-01-02,PF/BT,50508,VALDAGNO,VEN,60-69,18,12,0,28,0,0,2,30,0,30,Veneto,ITH3
2021-01-02,PF/BT,50508,VALDAGNO,VEN,70-79,1,0,0,1,0,0,0,1,0,1,Veneto,ITH3
2021-01-02,PF/BT,50509,LEGNAGO,VEN,16-19,0,1,0,0,1,0,0,1,0,1,Veneto,ITH3
2021-01-02,PF/BT,50509,LEGNAGO,VEN,20-29,7,17,0,24,0,0,0,24,0,24,Veneto,ITH3
2021-01-02,PF/BT,50509,LEGNAGO,VEN,30-39,20,31,0,47,4,0,0,51,0,51,Veneto,ITH3
2021-01-02,PF/BT,50509,LEGNAGO,VEN,40-49,23,54,0,71,6,0,0,77,0,77,Veneto,ITH3
2021-01-02,PF/BT,50509,LEGNAGO,VEN,50-59,19,45,0,55,6,0,3,64,0,64,Veneto,ITH3
2021-01-02,PF/BT,50509,LEGNAGO,VEN,60-69,17,5,0,13,9,0,0,22,0,22,Veneto,ITH3
2021-01-02,PF/BT,50509,LEGNAGO,VEN,70-79,3,0,0,0,3,0,0,3,0,3,Veneto,ITH3
2021-01-02,PF/BT,50509,SAN BONIFACIO,VEN,20-29,6,22,0,28,0,0,0,28,0,28,Veneto,ITH3
2021-01-02,PF/BT,50509,SAN BONIFACIO,VEN,30-39,16,33,0,48,1,0,0,49,0,49,Veneto,ITH3
2021-01-02,PF/BT,50509,SAN BONIFACIO,VEN,40-49,27,60,0,79,8,0,0,87,0,87,Veneto,ITH3
2021-01-02,PF/BT,50509,SAN BONIFACIO,VEN,50-59,19,40,0,53,6,0,0,59,0,59,Veneto,ITH3
2021-01-02,PF/BT,50509,SAN BONIFACIO,VEN,60-69,18,7,0,21,4,0,0,25,0,25,Veneto,ITH3
2021-01-02,PF/BT,50509,SAN BONIFACIO,VEN,70-79,3,0,0,3,0,0,0,3,0,3,Veneto,ITH3
2021-01-02,PF/BT,50509,VILLAFRANCA,VEN,20-29,8,26,0,34,0,0,0,34,0,34,Veneto,ITH3
2021-01-02,PF/BT,50509,VILLAFRANCA,VEN,30-39,13,19,0,32,0,0,0,32,0,32,Veneto,ITH3
2021-01-02,PF/BT,50509,VILLAFRANCA,VEN,40-49,17,70,0,85,2,0,0,87,0,87,Veneto,ITH3
2021-01-02,PF/BT,50509,VILLAFRANCA,VEN,50-59,25,86,0,111,0,0,0,111,0,111,Veneto,ITH3
2021-01-02,PF/BT,50509,VILLAFRANCA,VEN,60-69,16,8,0,22,2,0,0,24,0,24,Veneto,ITH3
2021-01-02,PF/BT,5095201,IOV,VEN,20-29,0,10,0,10,0,0,0,10,0,10,Veneto,ITH3
2021-01-02,PF/BT,5095201,IOV,VEN,30-39,5,10,0,15,0,0,0,15,0,15,Veneto,ITH3
2021-01-02,PF/BT,5095201,IOV,VEN,40-49,6,10,0,16,0,0,0,16,0,16,Veneto,ITH3
2021-01-02,PF/BT,5095201,IOV,VEN,50-59,2,12,0,14,0,0,0,14,0,14,Veneto,ITH3
2021-01-02,PF/BT,5095201,IOV,VEN,60-69,1,4,0,5,0,0,0,5,0,5,Veneto,ITH3
2021-01-02,PF/BT,610947,CONGR. SUORE CARITA' SS. CAPITANIO E GEROSA CASA DI RIPOSO MARIA BAMBINA,VEN,20-29,2,4,0,5,1,0,0,6,0,6,Veneto,ITH3
2021-01-02,PF/BT,610947,CONGR. SUORE CARITA' SS. CAPITANIO E GEROSA CASA DI RIPOSO MARIA BAMBINA,VEN,30-39,7,10,0,14,3,0,0,17,0,17,Veneto,ITH3
2021-01-02,PF/BT,610947,CONGR. SUORE CARITA' SS. CAPITANIO E GEROSA CASA DI RIPOSO MARIA BAMBINA,VEN,40-49,1,10,0,10,1,0,0,11,0,11,Veneto,ITH3
2021-01-02,PF/BT,610947,CONGR. SUORE CARITA' SS. CAPITANIO E GEROSA CASA DI RIPOSO MARIA BAMBINA,VEN,50-59,0,17,0,14,3,0,0,17,0,17,Veneto,ITH3
2021-01-02,PF/BT,610947,CONGR. SUORE CARITA' SS. CAPITANIO E GEROSA CASA DI RIPOSO MARIA BAMBINA,VEN,60-69,1,7,0,5,2,1,0,8,0,8,Veneto,ITH3
2021-01-02,PF/BT,610947,CONGR. SUORE CARITA' SS. CAPITANIO E GEROSA CASA DI RIPOSO MARIA BAMBINA,VEN,70-79,0,8,0,0,4,4,0,8,0,8,Veneto,ITH3
2021-01-02,PF/BT,610947,CONGR. SUORE CARITA' SS. CAPITANIO E GEROSA CASA DI RIPOSO MARIA BAMBINA,VEN,80-89,0,30,0,0,4,26,0,30,0,30,Veneto,ITH3
2021-01-02,PF/BT,610947,CONGR. SUORE CARITA' SS. CAPITANIO E GEROSA CASA DI RIPOSO MARIA BAMBINA,VEN,90+,0,26,0,0,0,26,0,26,0,26,Veneto,ITH3
2021-01-02,PF/BT,682301,RSA ISTITUTI POLESANI DI FICAROLO,VEN,40-49,0,1,0,1,0,0,0,1,0,1,Veneto,ITH3
2021-01-02,PF/BT,682302,RSA SAN MARTINO CASTELMASSA,VEN,40-49,0,1,0,1,0,0,0,1,0,1,Veneto,ITH3
2021-01-02,PF/BT,683003,CENTRO SERV.SOC.VILLA RESEMINI,VEN,30-39,0,1,0,1,0,0,0,1,0,1,Veneto,ITH3
2021-01-02,PF/BT,683003,CENTRO SERV.SOC.VILLA RESEMINI,VEN,50-59,0,1,0,0,1,0,0,1,0,1,Veneto,ITH3
2021-01-02,PF/BT,683004,CASA S. ANTONIO TRECENTA,VEN,20-29,2,4,0,3,3,0,0,6,0,6,Veneto,ITH3
2021-01-02,PF/BT,683004,CASA S. ANTONIO TRECENTA,VEN,30-39,3,11,0,8,6,0,0,14,0,14,Veneto,ITH3
2021-01-02,PF/BT,683004,CASA S. ANTONIO TRECENTA,VEN,40-49,2,19,0,14,7,0,0,21,0,21,Veneto,ITH3
2021-01-02,PF/BT,683004,CASA S. ANTONIO TRECENTA,VEN,50-59,1,26,0,15,12,0,0,27,0,27,Veneto,ITH3
2021-01-02,PF/BT,683004,CASA S. ANTONIO TRECENTA,VEN,60-69,2,4,0,2,2,2,0,6,0,6,Veneto,ITH3
2021-01-02,PF/BT,683004,CASA S. ANTONIO TRECENTA,VEN,70-79,5,9,0,0,1,13,0,14,0,14,Veneto,ITH3
2021-01-02,PF/BT,683004,CASA S. ANTONIO TRECENTA,VEN,80-89,2,30,0,0,0,32,0,32,0,32,Veneto,ITH3
2021-01-02,PF/BT,683004,CASA S. ANTONIO TRECENTA,VEN,90+,4,29,0,0,0,33,0,33,0,33,Veneto,ITH3
2021-01-02,PF/BT,683009,CASA DI RIPOSO DI BADIA POL.,VEN,30-39,0,1,0,1,0,0,0,1,0,1,Veneto,ITH3
2021-01-02,PF/BT,683012,CASA DI RIPOSO LA QUIETE DI FIESSO UMBERTIANO,VEN,20-29,0,2,0,2,0,0,0,2,0,2,Veneto,ITH3
2021-01-02,PF/BT,683012,CASA DI RIPOSO LA QUIETE DI FIESSO UMBERTIANO,VEN,30-39,1,4,0,5,0,0,0,5,0,5,Veneto,ITH3
2021-01-02,PF/BT,683012,CASA DI RIPOSO LA QUIETE DI FIESSO UMBERTIANO,VEN,40-49,0,2,0,2,0,0,0,2,0,2,Veneto,ITH3
2021-01-02,PF/BT,683012,CASA DI RIPOSO LA QUIETE DI FIESSO UMBERTIANO,VEN,50-59,0,4,0,4,0,0,0,4,0,4,Veneto,ITH3
2021-01-02,PF/BT,683012,CASA DI RIPOSO LA QUIETE DI FIESSO UMBERTIANO,VEN,60-69,3,0,0,1,1,1,0,3,0,3,Veneto,ITH3
2021-01-02,PF/BT,683012,CASA DI RIPOSO LA QUIETE DI FIESSO UMBERTIANO,VEN,70-79,1,3,0,0,0,4,0,4,0,4,Veneto,ITH3
2021-01-02,PF/BT,683012,CASA DI RIPOSO LA QUIETE DI FIESSO UMBERTIANO,VEN,80-89,6,10,0,0,0,16,0,16,0,16,Veneto,ITH3
2021-01-02,PF/BT,683012,CASA DI RIPOSO LA QUIETE DI FIESSO UMBERTIANO,VEN,90+,5,14,0,0,0,19,0,19,0,19,Veneto,ITH3
2021-01-02,PF/BT,683014,CASA SACRA FAMIGLIA FRATTA PO,VEN,90+,0,1,0,0,0,1,0,1,0,1,Veneto,ITH3
2021-01-02,PF/BT,683026,RESIDENZA ANNI AZZURRI S.ANNA,VEN,20-29,0,1,0,1,0,0,0,1,0,1,Veneto,ITH3
2021-01-02,PF/BT,721011,CENTRO SERVIZI VILLA TAMERICI - Porto Viro,VEN,40-49,1,0,0,1,0,0,0,1,0,1,Veneto,ITH3
2021-01-02,PF/BT,721011,CENTRO SERVIZI VILLA TAMERICI - Porto Viro,VEN,60-69,2,4,0,0,0,6,0,6,0,6,Veneto,ITH3
2021-01-02,PF/BT,721011,CENTRO SERVIZI VILLA TAMERICI - Porto Viro,VEN,70-79,2,14,0,0,0,16,0,16,0,16,Veneto,ITH3
2021-01-02,PF/BT,721011,CENTRO SERVIZI VILLA TAMERICI - Porto Viro,VEN,80-89,5,28,0,0,0,33,0,33,0,33,Veneto,ITH3
2021-01-02,PF/BT,721011,CENTRO SERVIZI VILLA TAMERICI - Porto Viro,VEN,90+,6,27,0,0,0,33,0,33,0,33,Veneto,ITH3
2021-01-02,PF/BT,721013,CENTRO SERVIZI ANZIANI ADRIA,VEN,40-49,1,0,0,1,0,0,0,1,0,1,Veneto,ITH3
2021-01-02,PF/BT,721013,CENTRO SERVIZI ANZIANI ADRIA,VEN,50-59,0,1,0,1,0,0,0,1,0,1,Veneto,ITH3
2021-01-02,PF/BT,721027,RSA 'IL GABBIANO' - Porto Viro,VEN,20-29,0,2,0,1,1,0,0,2,0,2,Veneto,ITH3
2021-01-02,PF/BT,721027,RSA 'IL GABBIANO' - Porto Viro,VEN,30-39,1,6,0,6,1,0,0,7,0,7,Veneto,ITH3
2021-01-02,PF/BT,721027,RSA 'IL GABBIANO' - Porto Viro,VEN,40-49,0,13,0,10,3,0,0,13,0,13,Veneto,ITH3
2021-01-02,PF/BT,721027,RSA 'IL GABBIANO' - Porto Viro,VEN,50-59,0,14,0,8,6,0,0,14,0,14,Veneto,ITH3
2021-01-02,PF/BT,721027,RSA 'IL GABBIANO' - Porto Viro,VEN,60-69,0,8,0,3,5,0,0,8,0,8,Veneto,ITH3
2021-01-02,PF/BT,845237,RSA DI CURA E REC. CASA NOGARE,VEN,50-59,0,1,0,0,0,1,0,1,0,1,Veneto,ITH3
2021-01-02,PF/BT,845237,RSA DI CURA E REC. CASA NOGARE,VEN,60-69,5,1,0,0,0,6,0,6,0,6,Veneto,ITH3
2021-01-02,PF/BT,845237,RSA DI CURA E REC. CASA NOGARE,VEN,70-79,3,1,0,0,0,4,0,4,0,4,Veneto,ITH3
2021-01-02,PF/BT,845237,RSA DI CURA E REC. CASA NOGARE,VEN,80-89,6,4,0,0,0,10,0,10,0,10,Veneto,ITH3
2021-01-02,PF/BT,845237,RSA DI CURA E REC. CASA NOGARE,VEN,90+,5,2,0,0,0,7,0,7,0,7,Veneto,ITH3
2021-01-03,PF/BT,0,Mancante,VEN,20-29,1,0,0,1,0,0,0,1,0,1,Veneto,ITH3
2021-01-03,PF/BT,132237,C.R. LA CASA - VALBELLA,VEN,20-29,0,5,0,5,0,0,0,5,0,5,Veneto,ITH3
2021-01-03,PF/BT,132237,C.R. LA CASA - VALBELLA,VEN,30-39,1,5,0,4,2,0,0,6,0,6,Veneto,ITH3
2021-01-03,PF/BT,132237,C.R. LA CASA - VALBELLA,VEN,40-49,0,13,0,9,4,0,0,13,0,13,Veneto,ITH3
2021-01-03,PF/BT,132237,C.R. LA CASA - VALBELLA,VEN,50-59,0,26,0,21,5,0,0,26,0,26,Veneto,ITH3
2021-01-03,PF/BT,132237,C.R. LA CASA - VALBELLA,VEN,60-69,0,6,0,3,1,2,0,6,0,6,Veneto,ITH3
2021-01-03,PF/BT,132237,C.R. LA CASA - VALBELLA,VEN,70-79,7,15,0,0,0,22,0,22,0,22,Veneto,ITH3
2021-01-03,PF/BT,132237,C.R. LA CASA - VALBELLA,VEN,80-89,9,38,0,0,0,47,0,47,0,47,Veneto,ITH3
2021-01-03,PF/BT,132237,C.R. LA CASA - VALBELLA,VEN,90+,1,19,0,0,0,20,0,20,0,20,Veneto,ITH3
2021-01-03,PF/BT,162514,CASA DI RIP. VILLA MARGHERITA-FOND. MARZOTTO,VEN,20-29,0,1,0,1,0,0,0,1,0,1,Veneto,ITH3
2021-01-03,PF/BT,162514,CASA DI RIP. VILLA MARGHERITA-FOND. MARZOTTO,VEN,30-39,1,5,0,5,1,0,0,6,0,6,Veneto,ITH3
2021-01-03,PF/BT,162514,CASA DI RIP. VILLA MARGHERITA-FOND. MARZOTTO,VEN,40-49,0,12,0,5,7,0,0,12,0,12,Veneto,ITH3
2021-01-03,PF/BT,162514,CASA DI RIP. VILLA MARGHERITA-FOND. MARZOTTO,VEN,50-59,1,11,0,7,5,0,0,12,0,12,Veneto,ITH3
2021-01-03,PF/BT,162514,CASA DI RIP. VILLA MARGHERITA-FOND. MARZOTTO,VEN,60-69,0,2,0,1,1,0,0,2,0,2,Veneto,ITH3
2021-01-03,PF/BT,162514,CASA DI RIP. VILLA MARGHERITA-FOND. MARZOTTO,VEN,70-79,1,2,0,0,0,3,0,3,0,3,Veneto,ITH3
2021-01-03,PF/BT,162514,CASA DI RIP. VILLA MARGHERITA-FOND. MARZOTTO,VEN,80-89,4,18,0,0,0,22,0,22,0,22,Veneto,ITH3
2021-01-03,PF/BT,162514,CASA DI RIP. VILLA MARGHERITA-FOND. MARZOTTO,VEN,90+,2,26,0,0,0,28,0,28,0,28,Veneto,ITH3
2021-01-03,PF/BT,5001700,OSPEDALE SACRO CUORE DI NEGRAR,VEN,20-29,8,40,0,47,1,0,0,48,0,48,Veneto,ITH3
2021-01-03,PF/BT,5001700,OSPEDALE SACRO CUORE DI NEGRAR,VEN,30-39,23,31,0,54,0,0,0,54,0,54,Veneto,ITH3
2021-01-03,PF/BT,5001700,OSPEDALE SACRO CUORE DI NEGRAR,VEN,40-49,22,35,0,57,0,0,0,57,0,57,Veneto,ITH3
2021-01-03,PF/BT,5001700,OSPEDALE SACRO CUORE DI NEGRAR,VEN,50-59,15,33,0,48,0,0,0,48,0,48,Veneto,ITH3
2021-01-03,PF/BT,5001700,OSPEDALE SACRO CUORE DI NEGRAR,VEN,60-69,11,9,0,20,0,0,0,20,0,20,Veneto,ITH3
2021-01-03,PF/BT,5001700,OSPEDALE SACRO CUORE DI NEGRAR,VEN,70-79,1,0,0,1,0,0,0,1,0,1,Veneto,ITH3
2021-01-03,PF/BT,50501,"BELLUNO ""DRIVE-IN""",VEN,20-29,10,12,0,22,0,0,0,22,0,22,Veneto,ITH3
2021-01-03,PF/BT,50501,"BELLUNO ""DRIVE-IN""",VEN,30-39,12,9,0,21,0,0,0,21,0,21,Veneto,ITH3
2021-01-03,PF/BT,50501,"BELLUNO ""DRIVE-IN""",VEN,40-49,3,11,0,14,0,0,0,14,0,14,Veneto,ITH3
2021-01-03,PF/BT,50501,"BELLUNO ""DRIVE-IN""",VEN,50-59,13,21,0,34,0,0,0,34,0,34,Veneto,ITH3
2021-01-03,PF/BT,50501,"BELLUNO ""DRIVE-IN""",VEN,60-69,52,20,0,72,0,0,0,72,0,72,Veneto,ITH3
2021-01-03,PF/BT,50501,"BELLUNO ""DRIVE-IN""",VEN,70-79,4,0,0,4,0,0,0,4,0,4,Veneto,ITH3
2021-01-03,PF/BT,50502,MONTEBELLUNA,VEN,20-29,1,9,0,10,0,0,0,10,0,10,Veneto,ITH3
2021-01-03,PF/BT,50502,MONTEBELLUNA,VEN,30-39,3,6,0,9,0,0,0,9,0,9,Veneto,ITH3
2021-01-03,PF/BT,50502,MONTEBELLUNA,VEN,40-49,6,14,0,20,0,0,0,20,0,20,Veneto,ITH3
2021-01-03,PF/BT,50502,MONTEBELLUNA,VEN,50-59,4,29,0,31,2,0,0,33,0,33,Veneto,ITH3
2021-01-03,PF/BT,50502,MONTEBELLUNA,VEN,60-69,6,3,0,9,0,0,0,9,0,9,Veneto,ITH3
2021-01-03,PF/BT,50502,VITTORIO,VEN,16-19,1,0,0,0,1,0,0,1,0,1,Veneto,ITH3
2021-01-03,PF/BT,50502,VITTORIO,VEN,20-29,10,36,0,41,5,0,0,46,0,46,Veneto,ITH3
2021-01-03,PF/BT,50502,VITTORIO,VEN,30-39,21,44,0,63,2,0,0,65,0,65,Veneto,ITH3
2021-01-03,PF/BT,50502,VITTORIO,VEN,40-49,27,85,0,103,9,0,0,112,0,112,Veneto,ITH3
2021-01-03,PF/BT,50502,VITTORIO,VEN,50-59,46,121,0,149,17,0,1,167,0,167,Veneto,ITH3
2021-01-03,PF/BT,50502,VITTORIO,VEN,60-69,21,24,0,37,8,0,0,45,0,45,Veneto,ITH3
2021-01-03,PF/BT,5050201,OSPEDALE CA' FONCELLO,VEN,20-29,10,46,0,55,1,0,0,56,0,56,Veneto,ITH3
2021-01-03,PF/BT,5050201,OSPEDALE CA' FONCELLO,VEN,30-39,21,28,0,49,0,0,0,49,0,49,Veneto,ITH3
2021-01-03,PF/BT,5050201,OSPEDALE CA' FONCELLO,VEN,40-49,18,54,0,68,4,0,0,72,0,72,Veneto,ITH3
2021-01-03,PF/BT,5050201,OSPEDALE CA' FONCELLO,VEN,50-59,18,81,0,88,11,0,0,99,0,99,Veneto,ITH3
2021-01-03,PF/BT,5050201,OSPEDALE CA' FONCELLO,VEN,60-69,12,13,0,25,0,0,0,25,0,25,Veneto,ITH3
2021-01-03,PF/BT,5050201,OSPEDALE CA' FONCELLO,VEN,70-79,1,0,0,1,0,0,0,1,0,1,Veneto,ITH3
2021-01-03,PF/BT,5050207,OSPEDALE MONTEBELLUNA,VEN,20-29,19,71,0,87,2,0,1,90,0,90,Veneto,ITH3
2021-01-03,PF/BT,5050207,OSPEDALE MONTEBELLUNA,VEN,30-39,28,84,0,111,0,0,1,112,0,112,Veneto,ITH3
2021-01-03,PF/BT,5050207,OSPEDALE MONTEBELLUNA,VEN,40-49,28,148,0,172,3,0,1,176,0,176,Veneto,ITH3
2021-01-03,PF/BT,5050207,OSPEDALE MONTEBELLUNA,VEN,50-59,61,181,0,232,7,0,3,242,0,242,Veneto,ITH3
2021-01-03,PF/BT,5050207,OSPEDALE MONTEBELLUNA,VEN,60-69,27,30,0,54,3,0,0,57,0,57,Veneto,ITH3
2021-01-03,PF/BT,50503,CAMPONOGARA ADULTI,VEN,30-39,0,4,0,4,0,0,0,4,0,4,Veneto,ITH3
2021-01-03,PF/BT,50503,CAMPONOGARA ADULTI,VEN,40-49,4,8,0,12,0,0,0,12,0,12,Veneto,ITH3
2021-01-03,PF/BT,50503,CAMPONOGARA ADULTI,VEN,50-59,2,13,0,15,0,0,0,15,0,15,Veneto,ITH3
2021-01-03,PF/BT,50503,CAMPONOGARA ADULTI,VEN,60-69,2,2,0,4,0,0,0,4,0,4,Veneto,ITH3
2021-01-03,PF/BT,50503,MED.PREV - CHIOGGIA,VEN,20-29,0,2,0,2,0,0,0,2,0,2,Veneto,ITH3
2021-01-03,PF/BT,50503,MED.PREV - CHIOGGIA,VEN,30-39,2,4,0,6,0,0,0,6,0,6,Veneto,ITH3
2021-01-03,PF/BT,50503,MED.PREV - CHIOGGIA,VEN,40-49,4,10,0,14,0,0,0,14,0,14,Veneto,ITH3
2021-01-03,PF/BT,50503,MED.PREV - CHIOGGIA,VEN,50-59,3,14,0,17,0,0,0,17,0,17,Veneto,ITH3
2021-01-03,PF/BT,50503,MED.PREV - CHIOGGIA,VEN,60-69,2,1,0,3,0,0,0,3,0,3,Veneto,ITH3
2021-01-03,PF/BT,50503,MEDICINA PREVENTIVA MESTRE,VEN,20-29,7,22,0,29,0,0,0,29,0,29,Veneto,ITH3
2021-01-03,PF/BT,50503,MEDICINA PREVENTIVA MESTRE,VEN,30-39,12,32,0,44,0,0,0,44,0,44,Veneto,ITH3
2021-01-03,PF/BT,50503,MEDICINA PREVENTIVA MESTRE,VEN,40-49,20,53,0,72,0,0,1,73,0,73,Veneto,ITH3
2021-01-03,PF/BT,50503,MEDICINA PREVENTIVA MESTRE,VEN,50-59,29,69,0,98,0,0,0,98,0,98,Veneto,ITH3
2021-01-03,PF/BT,50503,MEDICINA PREVENTIVA MESTRE,VEN,60-69,11,9,0,20,0,0,0,20,0,20,Veneto,ITH3
2021-01-03,PF/BT,50503,MEDICINA PREVENTIVA VENEZIA,VEN,20-29,8,19,0,26,1,0,0,27,0,27,Veneto,ITH3
2021-01-03,PF/BT,50503,MEDICINA PREVENTIVA VENEZIA,VEN,30-39,15,18,0,31,2,0,0,33,0,33,Veneto,ITH3
2021-01-03,PF/BT,50503,MEDICINA PREVENTIVA VENEZIA,VEN,40-49,12,28,0,38,2,0,0,40,0,40,Veneto,ITH3
2021-01-03,PF/BT,50503,MEDICINA PREVENTIVA VENEZIA,VEN,50-59,13,25,0,38,0,0,0,38,0,38,Veneto,ITH3
2021-01-03,PF/BT,50503,MEDICINA PREVENTIVA VENEZIA,VEN,60-69,10,2,0,12,0,0,0,12,0,12,Veneto,ITH3
2021-01-03,PF/BT,50503,S.I.S.P. MESTRE,VEN,20-29,1,2,0,3,0,0,0,3,0,3,Veneto,ITH3
2021-01-03,PF/BT,50503,S.I.S.P. MESTRE,VEN,30-39,1,3,0,3,1,0,0,4,0,4,Veneto,ITH3
2021-01-03,PF/BT,50503,S.I.S.P. MESTRE,VEN,40-49,1,24,0,25,0,0,0,25,0,25,Veneto,ITH3
2021-01-03,PF/BT,50503,S.I.S.P. MESTRE,VEN,50-59,4,40,0,43,1,0,0,44,0,44,Veneto,ITH3
2021-01-03,PF/BT,50503,S.I.S.P. MESTRE,VEN,60-69,1,7,0,8,0,0,0,8,0,8,Veneto,ITH3
2021-01-03,PF/BT,50503,SISP DOLO ADULTI,VEN,16-19,1,0,0,1,0,0,0,1,0,1,Veneto,ITH3
2021-01-03,PF/BT,50503,SISP DOLO ADULTI,VEN,20-29,9,17,0,26,0,0,0,26,0,26,Veneto,ITH3
2021-01-03,PF/BT,50503,SISP DOLO ADULTI,VEN,30-39,15,18,0,33,0,0,0,33,0,33,Veneto,ITH3
2021-01-03,PF/BT,50503,SISP DOLO ADULTI,VEN,40-49,18,52,0,70,0,0,0,70,0,70,Veneto,ITH3
2021-01-03,PF/BT,50503,SISP DOLO ADULTI,VEN,50-59,27,62,0,88,0,0,1,89,0,89,Veneto,ITH3
2021-01-03,PF/BT,50503,SISP DOLO ADULTI,VEN,60-69,14,16,0,30,0,0,0,30,0,30,Veneto,ITH3
2021-01-03,PF/BT,50503,SISP DOLO ADULTI,VEN,70-79,2,0,0,2,0,0,0,2,0,2,Veneto,ITH3
2021-01-03,PF/BT,50504,SAN DONA DI PIAVE SISP,VEN,20-29,14,12,0,25,0,0,1,26,0,26,Veneto,ITH3
2021-01-03,PF/BT,50504,SAN DONA DI PIAVE SISP,VEN,30-39,5,5,0,10,0,0,0,10,0,10,Veneto,ITH3
2021-01-03,PF/BT,50504,SAN DONA DI PIAVE SISP,VEN,40-49,3,11,0,14,0,0,0,14,0,14,Veneto,ITH3
2021-01-03,PF/BT,50504,SAN DONA DI PIAVE SISP,VEN,50-59,6,14,0,20,0,0,0,20,0,20,Veneto,ITH3
2021-01-03,PF/BT,50504,SAN DONA DI PIAVE SISP,VEN,60-69,9,4,0,13,0,0,0,13,0,13,Veneto,ITH3
2021-01-03,PF/BT,50504,SAN DONA DI PIAVE SISP,VEN,70-79,0,1,0,1,0,0,0,1,0,1,Veneto,ITH3
2021-01-03,PF/BT,50504,SANTO STINO DI LIVENZA,VEN,20-29,7,16,0,23,0,0,0,23,0,23,Veneto,ITH3
2021-01-03,PF/BT,50504,SANTO STINO DI LIVENZA,VEN,30-39,5,22,0,27,0,0,0,27,0,27,Veneto,ITH3
2021-01-03,PF/BT,50504,SANTO STINO DI LIVENZA,VEN,40-49,12,34,0,46,0,0,0,46,0,46,Veneto,ITH3
2021-01-03,PF/BT,50504,SANTO STINO DI LIVENZA,VEN,50-59,17,52,0,67,1,0,1,69,0,69,Veneto,ITH3
2021-01-03,PF/BT,50504,SANTO STINO DI LIVENZA,VEN,60-69,7,7,0,13,1,0,0,14,0,14,Veneto,ITH3
2021-01-03,PF/BT,50504,SANTO STINO DI LIVENZA,VEN,70-79,1,0,0,1,0,0,0,1,0,1,Veneto,ITH3
2021-01-03,PF/BT,50505,ADRIA,VEN,40-49,1,0,0,0,1,0,0,1,0,1,Veneto,ITH3
2021-01-03,PF/BT,50505,MAGAZZINO MED. COMPETENTE 05,VEN,30-39,0,2,0,1,1,0,0,2,0,2,Veneto,ITH3
2021-01-03,PF/BT,50505,MAGAZZINO MED. COMPETENTE 05,VEN,40-49,0,1,0,0,1,0,0,1,0,1,Veneto,ITH3
2021-01-03,PF/BT,5050501,PRESIDIO OSPEDALIERO ROVIGO,VEN,20-29,0,1,0,1,0,0,0,1,0,1,Veneto,ITH3
2021-01-03,PF/BT,5050501,PRESIDIO OSPEDALIERO ROVIGO,VEN,30-39,1,2,0,2,1,0,0,3,0,3,Veneto,ITH3
2021-01-03,PF/BT,5050501,PRESIDIO OSPEDALIERO ROVIGO,VEN,50-59,2,2,0,4,0,0,0,4,0,4,Veneto,ITH3
2021-01-03,PF/BT,50506,CAMPOSAMPIERO MEDICO COMPETENT,VEN,20-29,1,6,0,7,0,0,0,7,0,7,Veneto,ITH3
2021-01-03,PF/BT,50506,CAMPOSAMPIERO MEDICO COMPETENT,VEN,30-39,0,4,0,4,0,0,0,4,0,4,Veneto,ITH3
2021-01-03,PF/BT,50506,CAMPOSAMPIERO MEDICO COMPETENT,VEN,40-49,1,3,0,3,1,0,0,4,0,4,Veneto,ITH3
2021-01-03,PF/BT,50506,CAMPOSAMPIERO MEDICO COMPETENT,VEN,50-59,2,4,0,6,0,0,0,6,0,6,Veneto,ITH3
2021-01-03,PF/BT,50506,CAMPOSAMPIERO MEDICO COMPETENT,VEN,60-69,1,2,0,3,0,0,0,3,0,3,Veneto,ITH3
2021-01-03,PF/BT,50506,CITTADELLA MEDICO COMPETENTE,VEN,20-29,1,4,0,5,0,0,0,5,0,5,Veneto,ITH3
2021-01-03,PF/BT,50506,CITTADELLA MEDICO COMPETENTE,VEN,30-39,8,17,0,25,0,0,0,25,0,25,Veneto,ITH3
2021-01-03,PF/BT,50506,CITTADELLA MEDICO COMPETENTE,VEN,40-49,13,23,0,36,0,0,0,36,0,36,Veneto,ITH3
2021-01-03,PF/BT,50506,CITTADELLA MEDICO COMPETENTE,VEN,50-59,12,22,0,29,5,0,0,34,0,34,Veneto,ITH3
2021-01-03,PF/BT,50506,CITTADELLA MEDICO COMPETENTE,VEN,60-69,6,3,0,9,0,0,0,9,0,9,Veneto,ITH3
2021-01-03,PF/BT,50506,DIRIGENZA MEDICA P.D.SACCO,VEN,20-29,5,6,0,11,0,0,0,11,0,11,Veneto,ITH3
2021-01-03,PF/BT,50506,DIRIGENZA MEDICA P.D.SACCO,VEN,30-39,3,5,0,8,0,0,0,8,0,8,Veneto,ITH3
2021-01-03,PF/BT,50506,DIRIGENZA MEDICA P.D.SACCO,VEN,40-49,3,8,0,11,0,0,0,11,0,11,Veneto,ITH3
2021-01-03,PF/BT,50506,DIRIGENZA MEDICA P.D.SACCO,VEN,50-59,3,7,0,10,0,0,0,10,0,10,Veneto,ITH3
2021-01-03,PF/BT,50506,DIRIGENZA MEDICA P.D.SACCO,VEN,60-69,1,1,0,2,0,0,0,2,0,2,Veneto,ITH3
2021-01-03,PF/BT,50506,MONSELICE,VEN,20-29,3,3,0,6,0,0,0,6,0,6,Veneto,ITH3
2021-01-03,PF/BT,50506,MONSELICE,VEN,30-39,5,3,0,6,1,0,1,8,0,8,Veneto,ITH3
2021-01-03,PF/BT,50506,MONSELICE,VEN,40-49,3,7,0,9,1,0,0,10,0,10,Veneto,ITH3
2021-01-03,PF/BT,50506,MONSELICE,VEN,50-59,8,11,0,14,5,0,0,19,0,19,Veneto,ITH3
2021-01-03,PF/BT,50506,MONSELICE,VEN,60-69,15,7,0,20,2,0,0,22,0,22,Veneto,ITH3
2021-01-03,PF/BT,50506,SCHIAVONIA AMBULATORIO,VEN,20-29,0,4,0,4,0,0,0,4,0,4,Veneto,ITH3
2021-01-03,PF/BT,50506,SCHIAVONIA AMBULATORIO,VEN,30-39,3,9,0,12,0,0,0,12,0,12,Veneto,ITH3
2021-01-03,PF/BT,50506,SCHIAVONIA AMBULATORIO,VEN,40-49,5,28,0,33,0,0,0,33,0,33,Veneto,ITH3
2021-01-03,PF/BT,50506,SCHIAVONIA AMBULATORIO,VEN,50-59,4,10,0,14,0,0,0,14,0,14,Veneto,ITH3
2021-01-03,PF/BT,50506,SCHIAVONIA AMBULATORIO,VEN,60-69,2,1,0,3,0,0,0,3,0,3,Veneto,ITH3
2021-01-03,PF/BT,50507,H BASSANO,VEN,20-29,3,15,0,18,0,0,0,18,0,18,Veneto,ITH3
2021-01-03,PF/BT,50507,H BASSANO,VEN,30-39,2,10,0,12,0,0,0,12,0,12,Veneto,ITH3
2021-01-03,PF/BT,50507,H BASSANO,VEN,40-49,7,18,0,23,2,0,0,25,0,25,Veneto,ITH3
2021-01-03,PF/BT,50507,H BASSANO,VEN,50-59,3,9,0,12,0,0,0,12,0,12,Veneto,ITH3
2021-01-03,PF/BT,50507,H BASSANO,VEN,60-69,1,2,0,3,0,0,0,3,0,3,Veneto,ITH3
2021-01-03,PF/BT,50507,THIENE,VEN,20-29,2,2,0,4,0,0,0,4,0,4,Veneto,ITH3
2021-01-03,PF/BT,50507,THIENE,VEN,30-39,2,4,0,6,0,0,0,6,0,6,Veneto,ITH3
2021-01-03,PF/BT,50507,THIENE,VEN,40-49,5,15,0,20,0,0,0,20,0,20,Veneto,ITH3
2021-01-03,PF/BT,50507,THIENE,VEN,50-59,8,13,0,21,0,0,0,21,0,21,Veneto,ITH3
2021-01-03,PF/BT,50507,THIENE,VEN,60-69,0,4,0,4,0,0,0,4,0,4,Veneto,ITH3
2021-01-03,PF/BT,50507,THIENE,VEN,70-79,1,0,0,1,0,0,0,1,0,1,Veneto,ITH3
2021-01-03,PF/BT,50508,ARZIGNANO,VEN,20-29,8,6,0,14,0,0,0,14,0,14,Veneto,ITH3
2021-01-03,PF/BT,50508,ARZIGNANO,VEN,30-39,3,22,0,24,0,0,1,25,0,25,Veneto,ITH3
2021-01-03,PF/BT,50508,ARZIGNANO,VEN,40-49,8,32,0,38,0,0,2,40,0,40,Veneto,ITH3
2021-01-03,PF/BT,50508,ARZIGNANO,VEN,50-59,13,51,0,58,0,0,6,64,0,64,Veneto,ITH3
2021-01-03,PF/BT,50508,ARZIGNANO,VEN,60-69,20,9,0,26,0,0,3,29,0,29,Veneto,ITH3
2021-01-03,PF/BT,50508,SISP IV NOVEMBRE,VEN,20-29,11,38,0,48,0,0,1,49,0,49,Veneto,ITH3
2021-01-03,PF/BT,50508,SISP IV NOVEMBRE,VEN,30-39,28,34,0,61,0,0,1,62,0,62,Veneto,ITH3
2021-01-03,PF/BT,50508,SISP IV NOVEMBRE,VEN,40-49,24,67,0,84,0,0,7,91,0,91,Veneto,ITH3
2021-01-03,PF/BT,50508,SISP IV NOVEMBRE,VEN,50-59,21,65,0,81,0,0,5,86,0,86,Veneto,ITH3
2021-01-03,PF/BT,50508,SISP IV NOVEMBRE,VEN,60-69,16,17,0,30,0,0,3,33,0,33,Veneto,ITH3
2021-01-03,PF/BT,50508,SISP IV NOVEMBRE,VEN,70-79,4,0,0,4,0,0,0,4,0,4,Veneto,ITH3
2021-01-03,PF/BT,50509,LEGNAGO,VEN,16-19,0,1,0,0,1,0,0,1,0,1,Veneto,ITH3
2021-01-03,PF/BT,50509,LEGNAGO,VEN,20-29,13,24,0,28,9,0,0,37,0,37,Veneto,ITH3
2021-01-03,PF/BT,50509,LEGNAGO,VEN,30-39,21,30,0,36,14,0,1,51,0,51,Veneto,ITH3
2021-01-03,PF/BT,50509,LEGNAGO,VEN,40-49,14,38,0,41,9,0,2,52,0,52,Veneto,ITH3
2021-01-03,PF/BT,50509,LEGNAGO,VEN,50-59,26,61,0,61,26,0,0,87,0,87,Veneto,ITH3
2021-01-03,PF/BT,50509,LEGNAGO,VEN,60-69,26,10,0,28,8,0,0,36,0,36,Veneto,ITH3
2021-01-03,PF/BT,50509,LEGNAGO,VEN,70-79,1,1,0,2,0,0,0,2,0,2,Veneto,ITH3
2021-01-03,PF/BT,50509,SAN BONIFACIO,VEN,20-29,9,13,0,18,4,0,0,22,0,22,Veneto,ITH3
2021-01-03,PF/BT,50509,SAN BONIFACIO,VEN,30-39,12,28,0,31,9,0,0,40,0,40,Veneto,ITH3
2021-01-03,PF/BT,50509,SAN BONIFACIO,VEN,40-49,14,29,0,33,10,0,0,43,0,43,Veneto,ITH3
2021-01-03,PF/BT,50509,SAN BONIFACIO,VEN,50-59,14,42,0,38,18,0,0,56,0,56,Veneto,ITH3
2021-01-03,PF/BT,50509,SAN BONIFACIO,VEN,60-69,19,8,0,19,8,0,0,27,0,27,Veneto,ITH3
2021-01-03,PF/BT,50509,SAN BONIFACIO,VEN,70-79,3,0,0,0,3,0,0,3,0,3,Veneto,ITH3
2021-01-03,PF/BT,50509,VILLAFRANCA,VEN,16-19,3,0,0,3,0,0,0,3,0,3,Veneto,ITH3
2021-01-03,PF/BT,50509,VILLAFRANCA,VEN,20-29,18,28,0,45,1,0,0,46,0,46,Veneto,ITH3
2021-01-03,PF/BT,50509,VILLAFRANCA,VEN,30-39,15,23,0,38,0,0,0,38,0,38,Veneto,ITH3
2021-01-03,PF/BT,50509,VILLAFRANCA,VEN,40-49,19,39,0,58,0,0,0,58,0,58,Veneto,ITH3
2021-01-03,PF/BT,50509,VILLAFRANCA,VEN,50-59,20,73,0,93,0,0,0,93,0,93,Veneto,ITH3
2021-01-03,PF/BT,50509,VILLAFRANCA,VEN,60-69,17,13,0,30,0,0,0,30,0,30,Veneto,ITH3
2021-01-03,PF/BT,50509,VILLAFRANCA,VEN,70-79,2,0,0,2,0,0,0,2,0,2,Veneto,ITH3
2021-01-03,PF/BT,521609,IPAB 'ANDREA DANIELATO',VEN,20-29,3,7,0,6,4,0,0,10,0,10,Veneto,ITH3
2021-01-03,PF/BT,521609,IPAB 'ANDREA DANIELATO',VEN,30-39,2,5,0,5,2,0,0,7,0,7,Veneto,ITH3
2021-01-03,PF/BT,521609,IPAB 'ANDREA DANIELATO',VEN,40-49,0,11,0,5,6,0,0,11,0,11,Veneto,ITH3
2021-01-03,PF/BT,521609,IPAB 'ANDREA DANIELATO',VEN,50-59,2,20,0,13,9,0,0,22,0,22,Veneto,ITH3
2021-01-03,PF/BT,521609,IPAB 'ANDREA DANIELATO',VEN,60-69,2,4,0,3,1,2,0,6,0,6,Veneto,ITH3
2021-01-03,PF/BT,521609,IPAB 'ANDREA DANIELATO',VEN,70-79,3,2,0,0,0,5,0,5,0,5,Veneto,ITH3
2021-01-03,PF/BT,521609,IPAB 'ANDREA DANIELATO',VEN,80-89,4,3,0,0,0,7,0,7,0,7,Veneto,ITH3
2021-01-03,PF/BT,521609,IPAB 'ANDREA DANIELATO',VEN,90+,0,9,0,0,0,9,0,9,0,9,Veneto,ITH3
2021-01-03,PF/BT,683028,CENTRO SERVIZI CITTA' DI ROVIGO,VEN,20-29,3,2,0,3,2,0,0,5,0,5,Veneto,ITH3
2021-01-03,PF/BT,683028,CENTRO SERVIZI CITTA' DI ROVIGO,VEN,30-39,4,8,0,10,2,0,0,12,0,12,Veneto,ITH3
2021-01-03,PF/BT,683028,CENTRO SERVIZI CITTA' DI ROVIGO,VEN,40-49,4,10,0,14,0,0,0,14,0,14,Veneto,ITH3
2021-01-03,PF/BT,683028,CENTRO SERVIZI CITTA' DI ROVIGO,VEN,50-59,0,11,0,8,3,0,0,11,0,11,Veneto,ITH3
2021-01-03,PF/BT,683028,CENTRO SERVIZI CITTA' DI ROVIGO,VEN,60-69,0,2,0,0,0,2,0,2,0,2,Veneto,ITH3
2021-01-03,PF/BT,683028,CENTRO SERVIZI CITTA' DI ROVIGO,VEN,70-79,2,7,0,0,0,9,0,9,0,9,Veneto,ITH3
2021-01-03,PF/BT,683028,CENTRO SERVIZI CITTA' DI ROVIGO,VEN,80-89,7,29,0,0,0,36,0,36,0,36,Veneto,ITH3
2021-01-03,PF/BT,683028,CENTRO SERVIZI CITTA' DI ROVIGO,VEN,90+,4,31,0,0,0,35,0,35,0,35,Veneto,ITH3
2021-01-04,PF/BT,0,Mancante,VEN,30-39,0,1,0,1,0,0,0,1,0,1,Veneto,ITH3
2021-01-04,PF/BT,0,Mancante,VEN,40-49,1,0,0,1,0,0,0,1,0,1,Veneto,ITH3
2021-01-04,PF/BT,132241,C.R. 'VILLA MIARI' - SANTORSO,VEN,20-29,1,5,0,6,0,0,0,6,0,6,Veneto,ITH3
2021-01-04,PF/BT,132241,C.R. 'VILLA MIARI' - SANTORSO,VEN,30-39,1,4,0,5,0,0,0,5,0,5,Veneto,ITH3
2021-01-04,PF/BT,132241,C.R. 'VILLA MIARI' - SANTORSO,VEN,40-49,6,14,0,18,0,2,0,20,0,20,Veneto,ITH3
2021-01-04,PF/BT,132241,C.R. 'VILLA MIARI' - SANTORSO,VEN,50-59,14,19,0,19,0,13,1,33,0,33,Veneto,ITH3
2021-01-04,PF/BT,132241,C.R. 'VILLA MIARI' - SANTORSO,VEN,60-69,3,12,0,4,0,11,0,15,0,15,Veneto,ITH3
2021-01-04,PF/BT,132241,C.R. 'VILLA MIARI' - SANTORSO,VEN,70-79,7,4,0,0,0,11,0,11,0,11,Veneto,ITH3
2021-01-04,PF/BT,132241,C.R. 'VILLA MIARI' - SANTORSO,VEN,80-89,4,8,0,0,0,12,0,12,0,12,Veneto,ITH3
2021-01-04,PF/BT,132241,C.R. 'VILLA MIARI' - SANTORSO,VEN,90+,3,4,0,0,0,7,0,7,0,7,Veneto,ITH3
2021-01-04,PF/BT,162450,CASA DI RIPOSO VILLA SERENA VALDAGNO,VEN,16-19,0,1,0,0,1,0,0,1,0,1,Veneto,ITH3
2021-01-04,PF/BT,162450,CASA DI RIPOSO VILLA SERENA VALDAGNO,VEN,20-29,0,10,0,8,2,0,0,10,0,10,Veneto,ITH3
2021-01-04,PF/BT,162450,CASA DI RIPOSO VILLA SERENA VALDAGNO,VEN,30-39,5,11,0,13,3,0,0,16,0,16,Veneto,ITH3
2021-01-04,PF/BT,162450,CASA DI RIPOSO VILLA SERENA VALDAGNO,VEN,40-49,3,33,0,21,14,1,0,36,0,36,Veneto,ITH3
2021-01-04,PF/BT,162450,CASA DI RIPOSO VILLA SERENA VALDAGNO,VEN,50-59,8,39,0,32,11,4,0,47,0,47,Veneto,ITH3
2021-01-04,PF/BT,162450,CASA DI RIPOSO VILLA SERENA VALDAGNO,VEN,60-69,1,17,0,8,4,6,0,18,0,18,Veneto,ITH3
2021-01-04,PF/BT,162450,CASA DI RIPOSO VILLA SERENA VALDAGNO,VEN,70-79,9,10,0,0,0,19,0,19,0,19,Veneto,ITH3
2021-01-04,PF/BT,162450,CASA DI RIPOSO VILLA SERENA VALDAGNO,VEN,80-89,24,32,0,0,0,56,0,56,0,56,Veneto,ITH3
2021-01-04,PF/BT,162450,CASA DI RIPOSO VILLA SERENA VALDAGNO,VEN,90+,4,31,0,0,0,35,0,35,0,35,Veneto,ITH3
2021-01-04,PF/BT,208038,CASA DI RIPOSO SUORE MAESTRE DI S. DOROTEA FIGLIE DEI SACRI CUORI,VEN,20-29,0,8,0,6,2,0,0,8,0,8,Veneto,ITH3
2021-01-04,PF/BT,208038,CASA DI RIPOSO SUORE MAESTRE DI S. DOROTEA FIGLIE DEI SACRI CUORI,VEN,30-39,0,9,0,6,3,0,0,9,0,9,Veneto,ITH3
2021-01-04,PF/BT,208038,CASA DI RIPOSO SUORE MAESTRE DI S. DOROTEA FIGLIE DEI SACRI CUORI,VEN,40-49,0,29,0,24,5,0,0,29,0,29,Veneto,ITH3
2021-01-04,PF/BT,208038,CASA DI RIPOSO SUORE MAESTRE DI S. DOROTEA FIGLIE DEI SACRI CUORI,VEN,50-59,2,21,0,12,11,0,0,23,0,23,Veneto,ITH3
2021-01-04,PF/BT,208038,CASA DI RIPOSO SUORE MAESTRE DI S. DOROTEA FIGLIE DEI SACRI CUORI,VEN,60-69,3,8,0,6,5,0,0,11,0,11,Veneto,ITH3
2021-01-04,PF/BT,208038,CASA DI RIPOSO SUORE MAESTRE DI S. DOROTEA FIGLIE DEI SACRI CUORI,VEN,70-79,0,25,0,2,7,16,0,25,0,25,Veneto,ITH3
2021-01-04,PF/BT,208038,CASA DI RIPOSO SUORE MAESTRE DI S. DOROTEA FIGLIE DEI SACRI CUORI,VEN,80-89,0,55,0,0,2,53,0,55,0,55,Veneto,ITH3
2021-01-04,PF/BT,208038,CASA DI RIPOSO SUORE MAESTRE DI S. DOROTEA FIGLIE DEI SACRI CUORI,VEN,90+,0,31,0,0,0,31,0,31,0,31,Veneto,ITH3
2021-01-04,PF/BT,244016,CENTRO DI SERVIZI RESIDENZIALE 'FONDAZIONE CASA PER ANZIANI' - PIEVE DI SOLIGO,VEN,20-29,4,11,0,13,2,0,0,15,0,15,Veneto,ITH3
2021-01-04,PF/BT,244016,CENTRO DI SERVIZI RESIDENZIALE 'FONDAZIONE CASA PER ANZIANI' - PIEVE DI SOLIGO,VEN,30-39,4,7,0,6,5,0,0,11,0,11,Veneto,ITH3
2021-01-04,PF/BT,244016,CENTRO DI SERVIZI RESIDENZIALE 'FONDAZIONE CASA PER ANZIANI' - PIEVE DI SOLIGO,VEN,40-49,2,14,0,9,7,0,0,16,0,16,Veneto,ITH3
2021-01-04,PF/BT,244016,CENTRO DI SERVIZI RESIDENZIALE 'FONDAZIONE CASA PER ANZIANI' - PIEVE DI SOLIGO,VEN,50-59,5,12,0,8,8,1,0,17,0,17,Veneto,ITH3
2021-01-04,PF/BT,244016,CENTRO DI SERVIZI RESIDENZIALE 'FONDAZIONE CASA PER ANZIANI' - PIEVE DI SOLIGO,VEN,60-69,4,8,0,0,5,7,0,12,0,12,Veneto,ITH3
2021-01-04,PF/BT,244016,CENTRO DI SERVIZI RESIDENZIALE 'FONDAZIONE CASA PER ANZIANI' - PIEVE DI SOLIGO,VEN,70-79,12,14,0,0,1,25,0,26,0,26,Veneto,ITH3
2021-01-04,PF/BT,244016,CENTRO DI SERVIZI RESIDENZIALE 'FONDAZIONE CASA PER ANZIANI' - PIEVE DI SOLIGO,VEN,80-89,10,25,0,0,0,35,0,35,0,35,Veneto,ITH3
2021-01-04,PF/BT,244016,CENTRO DI SERVIZI RESIDENZIALE 'FONDAZIONE CASA PER ANZIANI' - PIEVE DI SOLIGO,VEN,90+,6,30,0,0,0,36,0,36,0,36,Veneto,ITH3
2021-01-04,PF/BT,363707,RESIDENZA PER ANZIANI 'G. FRANCESCON',VEN,20-29,1,8,0,9,0,0,0,9,0,9,Veneto,ITH3
2021-01-04,PF/BT,363707,RESIDENZA PER ANZIANI 'G. FRANCESCON',VEN,30-39,3,9,0,11,1,0,0,12,0,12,Veneto,ITH3
2021-01-04,PF/BT,363707,RESIDENZA PER ANZIANI 'G. FRANCESCON',VEN,40-49,4,16,0,18,2,0,0,20,0,20,Veneto,ITH3
2021-01-04,PF/BT,363707,RESIDENZA PER ANZIANI 'G. FRANCESCON',VEN,50-59,4,17,0,17,0,4,0,21,0,21,Veneto,ITH3
2021-01-04,PF/BT,363707,RESIDENZA PER ANZIANI 'G. FRANCESCON',VEN,60-69,10,15,0,12,0,13,0,25,0,25,Veneto,ITH3
2021-01-04,PF/BT,363707,RESIDENZA PER ANZIANI 'G. FRANCESCON',VEN,70-79,10,14,0,0,0,24,0,24,0,24,Veneto,ITH3
2021-01-04,PF/BT,363707,RESIDENZA PER ANZIANI 'G. FRANCESCON',VEN,80-89,19,31,0,0,0,50,0,50,0,50,Veneto,ITH3
2021-01-04,PF/BT,363707,RESIDENZA PER ANZIANI 'G. FRANCESCON',VEN,90+,4,29,0,0,0,33,0,33,0,33,Veneto,ITH3
2021-01-04,PF/BT,42816,C.S.A. 'SAN GIUSEPPE',VEN,40-49,1,3,0,3,1,0,0,4,0,4,Veneto,ITH3
2021-01-04,PF/BT,42816,C.S.A. 'SAN GIUSEPPE',VEN,50-59,2,0,0,0,2,0,0,2,0,2,Veneto,ITH3
2021-01-04,PF/BT,42816,C.S.A. 'SAN GIUSEPPE',VEN,60-69,0,2,0,1,1,0,0,2,0,2,Veneto,ITH3
2021-01-04,PF/BT,42816,C.S.A. 'SAN GIUSEPPE',VEN,70-79,3,1,0,0,0,4,0,4,0,4,Veneto,ITH3
2021-01-04,PF/BT,42816,C.S.A. 'SAN GIUSEPPE',VEN,80-89,6,12,0,0,0,18,0,18,0,18,Veneto,ITH3
2021-01-04,PF/BT,42816,C.S.A. 'SAN GIUSEPPE',VEN,90+,3,18,0,0,0,21,0,21,0,21,Veneto,ITH3
2021-01-04,PF/BT,445330,C. SERV.RES.ANZ.-CA'DEI FIORI,VEN,20-29,1,2,0,3,0,0,0,3,0,3,Veneto,ITH3
2021-01-04,PF/BT,445330,C. SERV.RES.ANZ.-CA'DEI FIORI,VEN,30-39,0,4,0,2,2,0,0,4,0,4,Veneto,ITH3
2021-01-04,PF/BT,445330,C. SERV.RES.ANZ.-CA'DEI FIORI,VEN,40-49,0,5,0,5,0,0,0,5,0,5,Veneto,ITH3
2021-01-04,PF/BT,445330,C. SERV.RES.ANZ.-CA'DEI FIORI,VEN,50-59,2,12,0,8,6,0,0,14,0,14,Veneto,ITH3
2021-01-04,PF/BT,445330,C. SERV.RES.ANZ.-CA'DEI FIORI,VEN,60-69,1,0,0,0,0,1,0,1,0,1,Veneto,ITH3
2021-01-04,PF/BT,445330,C. SERV.RES.ANZ.-CA'DEI FIORI,VEN,70-79,1,3,0,0,0,4,0,4,0,4,Veneto,ITH3
2021-01-04,PF/BT,445330,C. SERV.RES.ANZ.-CA'DEI FIORI,VEN,80-89,1,14,0,0,0,15,0,15,0,15,Veneto,ITH3
2021-01-04,PF/BT,445330,C. SERV.RES.ANZ.-CA'DEI FIORI,VEN,90+,2,13,0,0,0,15,0,15,0,15,Veneto,ITH3
2021-01-04,PF/BT,445366,C. SERV.RES.ANZ.-NAZARET,VEN,20-29,0,1,0,1,0,0,0,1,0,1,Veneto,ITH3
2021-01-04,PF/BT,445366,C. SERV.RES.ANZ.-NAZARET,VEN,30-39,1,3,0,4,0,0,0,4,0,4,Veneto,ITH3
2021-01-04,PF/BT,445366,C. SERV.RES.ANZ.-NAZARET,VEN,40-49,1,7,0,7,1,0,0,8,0,8,Veneto,ITH3
2021-01-04,PF/BT,445366,C. SERV.RES.ANZ.-NAZARET,VEN,50-59,0,5,0,5,0,0,0,5,0,5,Veneto,ITH3
2021-01-04,PF/BT,445366,C. SERV.RES.ANZ.-NAZARET,VEN,60-69,2,0,0,1,0,1,0,2,0,2,Veneto,ITH3
2021-01-04,PF/BT,445366,C. SERV.RES.ANZ.-NAZARET,VEN,70-79,1,3,0,0,0,4,0,4,0,4,Veneto,ITH3
2021-01-04,PF/BT,445366,C. SERV.RES.ANZ.-NAZARET,VEN,80-89,3,8,0,0,0,11,0,11,0,11,Veneto,ITH3
2021-01-04,PF/BT,445366,C. SERV.RES.ANZ.-NAZARET,VEN,90+,3,5,0,0,0,8,0,8,0,8,Veneto,ITH3
2021-01-04,PF/BT,486003,C.D.R. 'S.M. BATTUTI' - NOALE,VEN,20-29,4,10,0,12,2,0,0,14,0,14,Veneto,ITH3
2021-01-04,PF/BT,486003,C.D.R. 'S.M. BATTUTI' - NOALE,VEN,30-39,2,7,0,6,3,0,0,9,0,9,Veneto,ITH3
2021-01-04,PF/BT,486003,C.D.R. 'S.M. BATTUTI' - NOALE,VEN,40-49,0,4,0,3,1,0,0,4,0,4,Veneto,ITH3
2021-01-04,PF/BT,486003,C.D.R. 'S.M. BATTUTI' - NOALE,VEN,50-59,0,8,0,7,1,0,0,8,0,8,Veneto,ITH3
2021-01-04,PF/BT,486003,C.D.R. 'S.M. BATTUTI' - NOALE,VEN,60-69,1,5,0,2,1,3,0,6,0,6,Veneto,ITH3
2021-01-04,PF/BT,486003,C.D.R. 'S.M. BATTUTI' - NOALE,VEN,70-79,3,7,0,0,0,10,0,10,0,10,Veneto,ITH3
2021-01-04,PF/BT,486003,C.D.R. 'S.M. BATTUTI' - NOALE,VEN,80-89,7,21,0,0,0,28,0,28,0,28,Veneto,ITH3
2021-01-04,PF/BT,486003,C.D.R. 'S.M. BATTUTI' - NOALE,VEN,90+,1,26,0,0,0,27,0,27,0,27,Veneto,ITH3
2021-01-04,PF/BT,486010,CASA DI RIPOSO 'ANNI SERENI' - SCORZE',VEN,40-49,0,1,0,1,0,0,0,1,0,1,Veneto,ITH3
2021-01-04,PF/BT,486010,CASA DI RIPOSO 'ANNI SERENI' - SCORZE',VEN,50-59,0,1,0,0,1,0,0,1,0,1,Veneto,ITH3
2021-01-04,PF/BT,486010,CASA DI RIPOSO 'ANNI SERENI' - SCORZE',VEN,70-79,2,1,0,0,0,3,0,3,0,3,Veneto,ITH3
2021-01-04,PF/BT,486010,CASA DI RIPOSO 'ANNI SERENI' - SCORZE',VEN,80-89,0,1,0,0,0,1,0,1,0,1,Veneto,ITH3
2021-01-04,PF/BT,5001700,OSPEDALE SACRO CUORE DI NEGRAR,VEN,20-29,5,25,0,30,0,0,0,30,0,30,Veneto,ITH3
2021-01-04,PF/BT,5001700,OSPEDALE SACRO CUORE DI NEGRAR,VEN,30-39,16,32,0,44,4,0,0,48,0,48,Veneto,ITH3
2021-01-04,PF/BT,5001700,OSPEDALE SACRO CUORE DI NEGRAR,VEN,40-49,11,32,0,39,4,0,0,43,0,43,Veneto,ITH3
2021-01-04,PF/BT,5001700,OSPEDALE SACRO CUORE DI NEGRAR,VEN,50-59,16,26,0,40,2,0,0,42,0,42,Veneto,ITH3
2021-01-04,PF/BT,5001700,OSPEDALE SACRO CUORE DI NEGRAR,VEN,60-69,11,7,0,17,1,0,0,18,0,18,Veneto,ITH3
2021-01-04,PF/BT,5001700,OSPEDALE SACRO CUORE DI NEGRAR,VEN,70-79,1,0,0,1,0,0,0,1,0,1,Veneto,ITH3
2021-01-04,PF/BT,5002200,OSPEDALE P. PEDERZOLI,VEN,20-29,5,7,0,12,0,0,0,12,0,12,Veneto,ITH3
2021-01-04,PF/BT,5002200,OSPEDALE P. PEDERZOLI,VEN,30-39,5,4,0,9,0,0,0,9,0,9,Veneto,ITH3
2021-01-04,PF/BT,5002200,OSPEDALE P. PEDERZOLI,VEN,40-49,3,3,0,6,0,0,0,6,0,6,Veneto,ITH3
2021-01-04,PF/BT,5002200,OSPEDALE P. PEDERZOLI,VEN,50-59,1,7,0,8,0,0,0,8,0,8,Veneto,ITH3
2021-01-04,PF/BT,5002200,OSPEDALE P. PEDERZOLI,VEN,60-69,7,0,0,7,0,0,0,7,0,7,Veneto,ITH3
2021-01-04,PF/BT,50501,"BELLUNO ""DRIVE-IN""",VEN,20-29,0,12,0,12,0,0,0,12,0,12,Veneto,ITH3
2021-01-04,PF/BT,50501,"BELLUNO ""DRIVE-IN""",VEN,30-39,2,8,0,9,1,0,0,10,0,10,Veneto,ITH3
2021-01-04,PF/BT,50501,"BELLUNO ""DRIVE-IN""",VEN,40-49,8,24,0,28,4,0,0,32,0,32,Veneto,ITH3
2021-01-04,PF/BT,50501,"BELLUNO ""DRIVE-IN""",VEN,50-59,7,27,0,31,3,0,0,34,0,34,Veneto,ITH3
2021-01-04,PF/BT,50501,"BELLUNO ""DRIVE-IN""",VEN,60-69,6,10,0,10,5,1,0,16,0,16,Veneto,ITH3
2021-01-04,PF/BT,50501,"BELLUNO ""DRIVE-IN""",VEN,70-79,0,2,0,0,0,2,0,2,0,2,Veneto,ITH3
2021-01-04,PF/BT,50501,"BELLUNO ""DRIVE-IN""",VEN,80-89,2,9,0,0,0,11,0,11,0,11,Veneto,ITH3
2021-01-04,PF/BT,50501,"BELLUNO ""DRIVE-IN""",VEN,90+,0,2,0,0,0,2,0,2,0,2,Veneto,ITH3
2021-01-04,PF/BT,50501,FELTRE,VEN,40-49,0,1,0,1,0,0,0,1,0,1,Veneto,ITH3
2021-01-04,PF/BT,50501,FELTRE,VEN,50-59,0,2,0,2,0,0,0,2,0,2,Veneto,ITH3
2021-01-04,PF/BT,50503,CAMPONOGARA ADULTI,VEN,20-29,0,4,0,4,0,0,0,4,0,4,Veneto,ITH3
2021-01-04,PF/BT,50503,CAMPONOGARA ADULTI,VEN,30-39,0,12,0,12,0,0,0,12,0,12,Veneto,ITH3
2021-01-04,PF/BT,50503,CAMPONOGARA ADULTI,VEN,40-49,2,21,0,23,0,0,0,23,0,23,Veneto,ITH3
2021-01-04,PF/BT,50503,CAMPONOGARA ADULTI,VEN,50-59,0,36,0,36,0,0,0,36,0,36,Veneto,ITH3
2021-01-04,PF/BT,50503,CAMPONOGARA ADULTI,VEN,60-69,7,8,0,15,0,0,0,15,0,15,Veneto,ITH3
2021-01-04,PF/BT,50503,MED.PREV - CHIOGGIA,VEN,20-29,8,9,0,17,0,0,0,17,0,17,Veneto,ITH3
2021-01-04,PF/BT,50503,MED.PREV - CHIOGGIA,VEN,30-39,3,10,0,13,0,0,0,13,0,13,Veneto,ITH3
2021-01-04,PF/BT,50503,MED.PREV - CHIOGGIA,VEN,40-49,10,38,0,48,0,0,0,48,0,48,Veneto,ITH3
2021-01-04,PF/BT,50503,MED.PREV - CHIOGGIA,VEN,50-59,14,45,0,59,0,0,0,59,0,59,Veneto,ITH3
2021-01-04,PF/BT,50503,MED.PREV - CHIOGGIA,VEN,60-69,8,11,0,19,0,0,0,19,0,19,Veneto,ITH3
2021-01-04,PF/BT,50503,MEDICINA PREVENTIVA MESTRE,VEN,20-29,15,21,0,36,0,0,0,36,0,36,Veneto,ITH3
2021-01-04,PF/BT,50503,MEDICINA PREVENTIVA MESTRE,VEN,30-39,38,52,0,90,0,0,0,90,0,90,Veneto,ITH3
2021-01-04,PF/BT,50503,MEDICINA PREVENTIVA MESTRE,VEN,40-49,28,70,0,98,0,0,0,98,0,98,Veneto,ITH3
2021-01-04,PF/BT,50503,MEDICINA PREVENTIVA MESTRE,VEN,50-59,41,105,0,146,0,0,0,146,0,146,Veneto,ITH3
2021-01-04,PF/BT,50503,MEDICINA PREVENTIVA MESTRE,VEN,60-69,14,15,0,29,0,0,0,29,0,29,Veneto,ITH3
2021-01-04,PF/BT,50503,MEDICINA PREVENTIVA MESTRE,VEN,70-79,1,0,0,1,0,0,0,1,0,1,Veneto,ITH3
2021-01-04,PF/BT,50503,MEDICINA PREVENTIVA VENEZIA,VEN,20-29,7,24,0,30,1,0,0,31,0,31,Veneto,ITH3
2021-01-04,PF/BT,50503,MEDICINA PREVENTIVA VENEZIA,VEN,30-39,14,24,0,36,2,0,0,38,0,38,Veneto,ITH3
2021-01-04,PF/BT,50503,MEDICINA PREVENTIVA VENEZIA,VEN,40-49,19,42,0,61,0,0,0,61,0,61,Veneto,ITH3
2021-01-04,PF/BT,50503,MEDICINA PREVENTIVA VENEZIA,VEN,50-59,26,66,0,85,7,0,0,92,0,92,Veneto,ITH3
2021-01-04,PF/BT,50503,MEDICINA PREVENTIVA VENEZIA,VEN,60-69,15,18,0,29,4,0,0,33,0,33,Veneto,ITH3
2021-01-04,PF/BT,50503,MEDICINA PREVENTIVA VENEZIA,VEN,70-79,9,0,0,9,0,0,0,9,0,9,Veneto,ITH3
2021-01-04,PF/BT,50503,S.I.S.P. MESTRE,VEN,16-19,2,1,0,3,0,0,0,3,0,3,Veneto,ITH3
2021-01-04,PF/BT,50503,S.I.S.P. MESTRE,VEN,20-29,32,44,0,75,0,0,1,76,0,76,Veneto,ITH3
2021-01-04,PF/BT,50503,S.I.S.P. MESTRE,VEN,30-39,15,24,0,38,1,0,0,39,0,39,Veneto,ITH3
2021-01-04,PF/BT,50503,S.I.S.P. MESTRE,VEN,40-49,18,35,0,53,0,0,0,53,0,53,Veneto,ITH3
2021-01-04,PF/BT,50503,S.I.S.P. MESTRE,VEN,50-59,27,75,0,99,2,0,1,102,0,102,Veneto,ITH3
2021-01-04,PF/BT,50503,S.I.S.P. MESTRE,VEN,60-69,21,14,0,34,0,0,1,35,0,35,Veneto,ITH3
2021-01-04,PF/BT,50503,S.I.S.P. MESTRE,VEN,70-79,2,0,0,2,0,0,0,2,0,2,Veneto,ITH3
2021-01-04,PF/BT,50503,S.I.S.P. MESTRE,VEN,90+,1,0,0,0,0,0,1,1,0,1,Veneto,ITH3
2021-01-04,PF/BT,50503,S.I.S.P. VENEZIA,VEN,20-29,0,1,0,0,1,0,0,1,0,1,Veneto,ITH3
2021-01-04,PF/BT,50503,S.I.S.P. VENEZIA,VEN,30-39,1,1,0,2,0,0,0,2,0,2,Veneto,ITH3
2021-01-04,PF/BT,50503,S.I.S.P. VENEZIA,VEN,40-49,3,12,0,11,4,0,0,15,0,15,Veneto,ITH3
2021-01-04,PF/BT,50503,S.I.S.P. VENEZIA,VEN,50-59,6,19,0,23,2,0,0,25,0,25,Veneto,ITH3
2021-01-04,PF/BT,50503,S.I.S.P. VENEZIA,VEN,60-69,9,8,0,17,0,0,0,17,0,17,Veneto,ITH3
2021-01-04,PF/BT,50503,SISP DOLO ADULTI,VEN,20-29,7,10,0,17,0,0,0,17,0,17,Veneto,ITH3
2021-01-04,PF/BT,50503,SISP DOLO ADULTI,VEN,30-39,12,28,0,40,0,0,0,40,0,40,Veneto,ITH3
2021-01-04,PF/BT,50503,SISP DOLO ADULTI,VEN,40-49,16,36,0,52,0,0,0,52,0,52,Veneto,ITH3
2021-01-04,PF/BT,50503,SISP DOLO ADULTI,VEN,50-59,23,51,0,74,0,0,0,74,0,74,Veneto,ITH3
2021-01-04,PF/BT,50503,SISP DOLO ADULTI,VEN,60-69,20,8,0,27,0,0,1,28,0,28,Veneto,ITH3
2021-01-04,PF/BT,50504,SANTO STINO DI LIVENZA,VEN,20-29,2,4,0,6,0,0,0,6,0,6,Veneto,ITH3
2021-01-04,PF/BT,50504,SANTO STINO DI LIVENZA,VEN,30-39,2,1,0,3,0,0,0,3,0,3,Veneto,ITH3
2021-01-04,PF/BT,50504,SANTO STINO DI LIVENZA,VEN,50-59,0,2,0,2,0,0,0,2,0,2,Veneto,ITH3
2021-01-04,PF/BT,50504,SANTO STINO DI LIVENZA,VEN,70-79,0,1,0,0,0,1,0,1,0,1,Veneto,ITH3
2021-01-04,PF/BT,5050501,PRESIDIO OSPEDALIERO ROVIGO,VEN,20-29,3,6,0,9,0,0,0,9,0,9,Veneto,ITH3
2021-01-04,PF/BT,5050501,PRESIDIO OSPEDALIERO ROVIGO,VEN,30-39,8,9,0,17,0,0,0,17,0,17,Veneto,ITH3
2021-01-04,PF/BT,5050501,PRESIDIO OSPEDALIERO ROVIGO,VEN,40-49,6,23,0,29,0,0,0,29,0,29,Veneto,ITH3
2021-01-04,PF/BT,5050501,PRESIDIO OSPEDALIERO ROVIGO,VEN,50-59,10,29,0,39,0,0,0,39,0,39,Veneto,ITH3
2021-01-04,PF/BT,5050501,PRESIDIO OSPEDALIERO ROVIGO,VEN,60-69,6,2,0,8,0,0,0,8,0,8,Veneto,ITH3
2021-01-04,PF/BT,50506,AZ OSPEDALIERA DI PADOVA MAL. INFET.E TR,VEN,20-29,4,5,0,9,0,0,0,9,0,9,Veneto,ITH3
2021-01-04,PF/BT,50506,AZ OSPEDALIERA DI PADOVA MAL. INFET.E TR,VEN,30-39,4,4,0,8,0,0,0,8,0,8,Veneto,ITH3
2021-01-04,PF/BT,50506,AZ OSPEDALIERA DI PADOVA MAL. INFET.E TR,VEN,40-49,7,11,0,18,0,0,0,18,0,18,Veneto,ITH3
2021-01-04,PF/BT,50506,AZ OSPEDALIERA DI PADOVA MAL. INFET.E TR,VEN,50-59,8,13,0,21,0,0,0,21,0,21,Veneto,ITH3
2021-01-04,PF/BT,50506,AZ OSPEDALIERA DI PADOVA MAL. INFET.E TR,VEN,60-69,2,2,0,4,0,0,0,4,0,4,Veneto,ITH3
2021-01-04,PF/BT,50506,CAMPOSAMPIERO MEDICO COMPETENT,VEN,20-29,4,11,0,15,0,0,0,15,0,15,Veneto,ITH3
2021-01-04,PF/BT,50506,CAMPOSAMPIERO MEDICO COMPETENT,VEN,30-39,10,18,0,28,0,0,0,28,0,28,Veneto,ITH3
2021-01-04,PF/BT,50506,CAMPOSAMPIERO MEDICO COMPETENT,VEN,40-49,2,18,0,20,0,0,0,20,0,20,Veneto,ITH3
2021-01-04,PF/BT,50506,CAMPOSAMPIERO MEDICO COMPETENT,VEN,50-59,5,6,0,11,0,0,0,11,0,11,Veneto,ITH3
2021-01-04,PF/BT,50506,CAMPOSAMPIERO MEDICO COMPETENT,VEN,60-69,1,3,0,4,0,0,0,4,0,4,Veneto,ITH3
2021-01-04,PF/BT,50506,CITTADELLA MEDICO COMPETENTE,VEN,20-29,3,13,0,16,0,0,0,16,0,16,Veneto,ITH3
2021-01-04,PF/BT,50506,CITTADELLA MEDICO COMPETENTE,VEN,30-39,6,19,0,24,1,0,0,25,0,25,Veneto,ITH3
2021-01-04,PF/BT,50506,CITTADELLA MEDICO COMPETENTE,VEN,40-49,5,17,0,21,1,0,0,22,0,22,Veneto,ITH3
2021-01-04,PF/BT,50506,CITTADELLA MEDICO COMPETENTE,VEN,50-59,9,25,0,32,2,0,0,34,0,34,Veneto,ITH3
2021-01-04,PF/BT,50506,CITTADELLA MEDICO COMPETENTE,VEN,60-69,7,9,0,14,2,0,0,16,0,16,Veneto,ITH3
2021-01-04,PF/BT,50506,CITTADELLA MEDICO COMPETENTE,VEN,70-79,0,1,0,1,0,0,0,1,0,1,Veneto,ITH3
2021-01-04,PF/BT,50506,COLLI VACC. ADULTI,VEN,20-29,1,2,0,3,0,0,0,3,0,3,Veneto,ITH3
2021-01-04,PF/BT,50506,COLLI VACC. ADULTI,VEN,30-39,3,3,0,6,0,0,0,6,0,6,Veneto,ITH3
2021-01-04,PF/BT,50506,COLLI VACC. ADULTI,VEN,40-49,2,8,0,9,0,0,1,10,0,10,Veneto,ITH3
2021-01-04,PF/BT,50506,COLLI VACC. ADULTI,VEN,50-59,4,14,0,17,0,0,1,18,0,18,Veneto,ITH3
2021-01-04,PF/BT,50506,COLLI VACC. ADULTI,VEN,60-69,7,8,0,15,0,0,0,15,0,15,Veneto,ITH3
2021-01-04,PF/BT,50506,DIRIGENZA MEDICA P.D.SACCO,VEN,20-29,4,17,0,21,0,0,0,21,0,21,Veneto,ITH3
2021-01-04,PF/BT,50506,DIRIGENZA MEDICA P.D.SACCO,VEN,30-39,7,12,0,19,0,0,0,19,0,19,Veneto,ITH3
2021-01-04,PF/BT,50506,DIRIGENZA MEDICA P.D.SACCO,VEN,40-49,4,12,0,16,0,0,0,16,0,16,Veneto,ITH3
2021-01-04,PF/BT,50506,DIRIGENZA MEDICA P.D.SACCO,VEN,50-59,9,16,0,25,0,0,0,25,0,25,Veneto,ITH3
2021-01-04,PF/BT,50506,DIRIGENZA MEDICA P.D.SACCO,VEN,60-69,2,0,0,2,0,0,0,2,0,2,Veneto,ITH3
2021-01-04,PF/BT,50506,IGIENE PUBBLICA RUBANO,VEN,20-29,1,3,0,4,0,0,0,4,0,4,Veneto,ITH3
2021-01-04,PF/BT,50506,IGIENE PUBBLICA RUBANO,VEN,30-39,0,4,0,4,0,0,0,4,0,4,Veneto,ITH3
2021-01-04,PF/BT,50506,IGIENE PUBBLICA RUBANO,VEN,40-49,1,7,0,8,0,0,0,8,0,8,Veneto,ITH3
2021-01-04,PF/BT,50506,IGIENE PUBBLICA RUBANO,VEN,50-59,7,14,0,21,0,0,0,21,0,21,Veneto,ITH3
2021-01-04,PF/BT,50506,IGIENE PUBBLICA RUBANO,VEN,60-69,6,5,0,11,0,0,0,11,0,11,Veneto,ITH3
2021-01-04,PF/BT,50506,MONSELICE,VEN,20-29,2,6,0,8,0,0,0,8,0,8,Veneto,ITH3
2021-01-04,PF/BT,50506,MONSELICE,VEN,30-39,4,9,0,11,2,0,0,13,0,13,Veneto,ITH3
2021-01-04,PF/BT,50506,MONSELICE,VEN,40-49,8,19,0,22,5,0,0,27,0,27,Veneto,ITH3
2021-01-04,PF/BT,50506,MONSELICE,VEN,50-59,13,43,0,42,13,0,1,56,0,56,Veneto,ITH3
2021-01-04,PF/BT,50506,MONSELICE,VEN,60-69,13,14,0,23,4,0,0,27,0,27,Veneto,ITH3
2021-01-04,PF/BT,50506,MONTAGNANA,VEN,20-29,0,1,0,1,0,0,0,1,0,1,Veneto,ITH3
2021-01-04,PF/BT,50506,MONTAGNANA,VEN,30-39,1,5,0,6,0,0,0,6,0,6,Veneto,ITH3
2021-01-04,PF/BT,50506,MONTAGNANA,VEN,40-49,1,2,0,3,0,0,0,3,0,3,Veneto,ITH3
2021-01-04,PF/BT,50506,MONTAGNANA,VEN,50-59,0,8,0,8,0,0,0,8,0,8,Veneto,ITH3
2021-01-04,PF/BT,50506,MONTAGNANA,VEN,60-69,3,3,0,6,0,0,0,6,0,6,Veneto,ITH3
2021-01-04,PF/BT,50506,PIAZZOLA SUL BRENTA,VEN,20-29,1,2,0,3,0,0,0,3,0,3,Veneto,ITH3
2021-01-04,PF/BT,50506,PIAZZOLA SUL BRENTA,VEN,30-39,1,2,0,3,0,0,0,3,0,3,Veneto,ITH3
2021-01-04,PF/BT,50506,PIAZZOLA SUL BRENTA,VEN,40-49,0,2,0,2,0,0,0,2,0,2,Veneto,ITH3
2021-01-04,PF/BT,50506,PIAZZOLA SUL BRENTA,VEN,50-59,8,12,0,20,0,0,0,20,0,20,Veneto,ITH3
2021-01-04,PF/BT,50506,PIAZZOLA SUL BRENTA,VEN,60-69,15,4,0,19,0,0,0,19,0,19,Veneto,ITH3
2021-01-04,PF/BT,50506,PIOVE DI SACCO C/O DISTRETTO,VEN,20-29,1,2,0,3,0,0,0,3,0,3,Veneto,ITH3
2021-01-04,PF/BT,50506,PIOVE DI SACCO C/O DISTRETTO,VEN,30-39,4,2,0,6,0,0,0,6,0,6,Veneto,ITH3
2021-01-04,PF/BT,50506,PIOVE DI SACCO C/O DISTRETTO,VEN,40-49,2,5,0,7,0,0,0,7,0,7,Veneto,ITH3
2021-01-04,PF/BT,50506,PIOVE DI SACCO C/O DISTRETTO,VEN,50-59,1,8,0,9,0,0,0,9,0,9,Veneto,ITH3
2021-01-04,PF/BT,50506,PIOVE DI SACCO C/O DISTRETTO,VEN,60-69,3,1,0,4,0,0,0,4,0,4,Veneto,ITH3
2021-01-04,PF/BT,50506,SCHIAVONIA AMBULATORIO,VEN,20-29,2,10,0,12,0,0,0,12,0,12,Veneto,ITH3
2021-01-04,PF/BT,50506,SCHIAVONIA AMBULATORIO,VEN,30-39,7,16,0,22,0,0,1,23,0,23,Veneto,ITH3
2021-01-04,PF/BT,50506,SCHIAVONIA AMBULATORIO,VEN,40-49,11,37,0,48,0,0,0,48,0,48,Veneto,ITH3
2021-01-04,PF/BT,50506,SCHIAVONIA AMBULATORIO,VEN,50-59,12,29,0,40,0,0,1,41,0,41,Veneto,ITH3
2021-01-04,PF/BT,50506,SCHIAVONIA AMBULATORIO,VEN,60-69,4,6,0,10,0,0,0,10,0,10,Veneto,ITH3
2021-01-04,PF/BT,50506,SET.IGIENE PUBBLICA EPID.E PROF. MAL.INF,VEN,16-19,0,1,0,0,1,0,0,1,0,1,Veneto,ITH3
2021-01-04,PF/BT,50506,SET.IGIENE PUBBLICA EPID.E PROF. MAL.INF,VEN,20-29,1,11,0,10,2,0,0,12,0,12,Veneto,ITH3
2021-01-04,PF/BT,50506,SET.IGIENE PUBBLICA EPID.E PROF. MAL.INF,VEN,30-39,1,0,0,1,0,0,0,1,0,1,Veneto,ITH3
2021-01-04,PF/BT,50506,SET.IGIENE PUBBLICA EPID.E PROF. MAL.INF,VEN,40-49,0,1,0,1,0,0,0,1,0,1,Veneto,ITH3
2021-01-04,PF/BT,50506,SET.IGIENE PUBBLICA EPID.E PROF. MAL.INF,VEN,50-59,0,6,0,5,1,0,0,6,0,6,Veneto,ITH3
2021-01-04,PF/BT,50506,SET.IGIENE PUBBLICA EPID.E PROF. MAL.INF,VEN,60-69,0,2,0,2,0,0,0,2,0,2,Veneto,ITH3
2021-01-04,PF/BT,50506,VIA SCROVEGNI ANTI INFLUENZALE,VEN,20-29,1,0,0,1,0,0,0,1,0,1,Veneto,ITH3
2021-01-04,PF/BT,50506,VIA SCROVEGNI ANTI INFLUENZALE,VEN,40-49,0,1,0,1,0,0,0,1,0,1,Veneto,ITH3
2021-01-04,PF/BT,50506,VIA SCROVEGNI ANTI INFLUENZALE,VEN,50-59,1,10,0,11,0,0,0,11,0,11,Veneto,ITH3
2021-01-04,PF/BT,50506,VIA SCROVEGNI ANTI INFLUENZALE,VEN,60-69,2,3,0,5,0,0,0,5,0,5,Veneto,ITH3
2021-01-04,PF/BT,50506,VIA TEMANZA ANTI INFLUENZALE,VEN,30-39,1,1,0,2,0,0,0,2,0,2,Veneto,ITH3
2021-01-04,PF/BT,50506,VIA TEMANZA ANTI INFLUENZALE,VEN,40-49,1,2,0,3,0,0,0,3,0,3,Veneto,ITH3
2021-01-04,PF/BT,50506,VIA TEMANZA ANTI INFLUENZALE,VEN,50-59,6,9,0,15,0,0,0,15,0,15,Veneto,ITH3
2021-01-04,PF/BT,50506,VIA TEMANZA ANTI INFLUENZALE,VEN,60-69,7,3,0,10,0,0,0,10,0,10,Veneto,ITH3
2021-01-04,PF/BT,50507,DIPARTIMENTO DI PREVENZIONE,VEN,20-29,0,2,0,2,0,0,0,2,0,2,Veneto,ITH3
2021-01-04,PF/BT,50507,DIPARTIMENTO DI PREVENZIONE,VEN,30-39,0,1,0,1,0,0,0,1,0,1,Veneto,ITH3
2021-01-04,PF/BT,50507,DIPARTIMENTO DI PREVENZIONE,VEN,40-49,0,2,0,2,0,0,0,2,0,2,Veneto,ITH3
2021-01-04,PF/BT,50507,DIPARTIMENTO DI PREVENZIONE,VEN,50-59,0,2,0,2,0,0,0,2,0,2,Veneto,ITH3
2021-01-04,PF/BT,50507,EX OSPEDALE - BOLDRINI,VEN,20-29,2,3,0,5,0,0,0,5,0,5,Veneto,ITH3
2021-01-04,PF/BT,50507,EX OSPEDALE - BOLDRINI,VEN,30-39,5,14,0,19,0,0,0,19,0,19,Veneto,ITH3
2021-01-04,PF/BT,50507,EX OSPEDALE - BOLDRINI,VEN,40-49,7,25,0,32,0,0,0,32,0,32,Veneto,ITH3
2021-01-04,PF/BT,50507,EX OSPEDALE - BOLDRINI,VEN,50-59,11,38,0,49,0,0,0,49,0,49,Veneto,ITH3
2021-01-04,PF/BT,50507,EX OSPEDALE - BOLDRINI,VEN,60-69,4,5,0,9,0,0,0,9,0,9,Veneto,ITH3
2021-01-04,PF/BT,50507,EX OSPEDALE - BOLDRINI,VEN,70-79,5,0,0,5,0,0,0,5,0,5,Veneto,ITH3
2021-01-04,PF/BT,50507,H BASSANO,VEN,20-29,1,10,0,9,2,0,0,11,0,11,Veneto,ITH3
2021-01-04,PF/BT,50507,H BASSANO,VEN,30-39,6,13,0,17,2,0,0,19,0,19,Veneto,ITH3
2021-01-04,PF/BT,50507,H BASSANO,VEN,40-49,5,26,0,25,6,0,0,31,0,31,Veneto,ITH3
2021-01-04,PF/BT,50507,H BASSANO,VEN,50-59,14,30,0,27,17,0,0,44,0,44,Veneto,ITH3
2021-01-04,PF/BT,50507,H BASSANO,VEN,60-69,8,12,0,13,7,0,0,20,0,20,Veneto,ITH3
2021-01-04,PF/BT,50507,H BASSANO,VEN,70-79,1,0,0,0,1,0,0,1,0,1,Veneto,ITH3
2021-01-04,PF/BT,50507,THIENE,VEN,20-29,0,5,0,5,0,0,0,5,0,5,Veneto,ITH3
2021-01-04,PF/BT,50507,THIENE,VEN,30-39,7,8,0,15,0,0,0,15,0,15,Veneto,ITH3
2021-01-04,PF/BT,50507,THIENE,VEN,40-49,8,14,0,22,0,0,0,22,0,22,Veneto,ITH3
2021-01-04,PF/BT,50507,THIENE,VEN,50-59,9,24,0,33,0,0,0,33,0,33,Veneto,ITH3
2021-01-04,PF/BT,50507,THIENE,VEN,60-69,2,2,0,4,0,0,0,4,0,4,Veneto,ITH3
2021-01-04,PF/BT,50508,NOVENTA VICENTINA,VEN,20-29,4,9,0,13,0,0,0,13,0,13,Veneto,ITH3
2021-01-04,PF/BT,50508,NOVENTA VICENTINA,VEN,30-39,5,13,0,18,0,0,0,18,0,18,Veneto,ITH3
2021-01-04,PF/BT,50508,NOVENTA VICENTINA,VEN,40-49,11,20,0,30,0,0,1,31,0,31,Veneto,ITH3
2021-01-04,PF/BT,50508,NOVENTA VICENTINA,VEN,50-59,23,43,0,56,0,0,10,66,0,66,Veneto,ITH3
2021-01-04,PF/BT,50508,NOVENTA VICENTINA,VEN,60-69,20,11,0,25,0,0,6,31,0,31,Veneto,ITH3
2021-01-04,PF/BT,50508,SISP IV NOVEMBRE,VEN,20-29,10,43,0,48,3,0,2,53,0,53,Veneto,ITH3
2021-01-04,PF/BT,50508,SISP IV NOVEMBRE,VEN,30-39,17,55,0,69,0,0,3,72,0,72,Veneto,ITH3
2021-01-04,PF/BT,50508,SISP IV NOVEMBRE,VEN,40-49,32,70,0,87,1,0,14,102,0,102,Veneto,ITH3
2021-01-04,PF/BT,50508,SISP IV NOVEMBRE,VEN,50-59,38,96,0,116,1,0,17,134,0,134,Veneto,ITH3
2021-01-04,PF/BT,50508,SISP IV NOVEMBRE,VEN,60-69,30,16,0,41,0,0,5,46,0,46,Veneto,ITH3
2021-01-04,PF/BT,50508,SISP IV NOVEMBRE,VEN,70-79,1,0,0,1,0,0,0,1,0,1,Veneto,ITH3
2021-01-04,PF/BT,50508,TORRI DI QUARTESOLO,VEN,20-29,1,0,0,1,0,0,0,1,0,1,Veneto,ITH3
2021-01-04,PF/BT,50509,LEGNAGO,VEN,20-29,10,13,0,22,0,0,1,23,0,23,Veneto,ITH3
2021-01-04,PF/BT,50509,LEGNAGO,VEN,30-39,17,52,0,59,6,0,4,69,0,69,Veneto,ITH3
2021-01-04,PF/BT,50509,LEGNAGO,VEN,40-49,23,70,0,79,8,0,6,93,0,93,Veneto,ITH3
2021-01-04,PF/BT,50509,LEGNAGO,VEN,50-59,28,93,0,85,26,0,10,121,0,121,Veneto,ITH3
2021-01-04,PF/BT,50509,LEGNAGO,VEN,60-69,27,24,0,34,12,0,5,51,0,51,Veneto,ITH3
2021-01-04,PF/BT,50509,LEGNAGO,VEN,70-79,1,0,0,1,0,0,0,1,0,1,Veneto,ITH3
2021-01-04,PF/BT,50509,SAN BONIFACIO,VEN,20-29,11,15,0,23,3,0,0,26,0,26,Veneto,ITH3
2021-01-04,PF/BT,50509,SAN BONIFACIO,VEN,30-39,20,35,0,53,2,0,0,55,0,55,Veneto,ITH3
2021-01-04,PF/BT,50509,SAN BONIFACIO,VEN,40-49,15,54,0,65,4,0,0,69,0,69,Veneto,ITH3
2021-01-04,PF/BT,50509,SAN BONIFACIO,VEN,50-59,27,86,0,83,30,0,0,113,0,113,Veneto,ITH3
2021-01-04,PF/BT,50509,SAN BONIFACIO,VEN,60-69,17,15,0,32,0,0,0,32,0,32,Veneto,ITH3
2021-01-04,PF/BT,5091201,AOUIVR,VEN,20-29,53,91,0,144,0,0,0,144,0,144,Veneto,ITH3
2021-01-04,PF/BT,5091201,AOUIVR,VEN,30-39,80,105,0,185,0,0,0,185,0,185,Veneto,ITH3
2021-01-04,PF/BT,5091201,AOUIVR,VEN,40-49,46,87,0,133,0,0,0,133,0,133,Veneto,ITH3
2021-01-04,PF/BT,5091201,AOUIVR,VEN,50-59,37,86,0,123,0,0,0,123,0,123,Veneto,ITH3
2021-01-04,PF/BT,5091201,AOUIVR,VEN,60-69,26,13,0,39,0,0,0,39,0,39,Veneto,ITH3
2021-01-04,PF/BT,5095201,IOV,VEN,30-39,2,2,0,4,0,0,0,4,0,4,Veneto,ITH3
2021-01-04,PF/BT,5095201,IOV,VEN,40-49,2,7,0,9,0,0,0,9,0,9,Veneto,ITH3
2021-01-04,PF/BT,5095201,IOV,VEN,50-59,4,6,0,10,0,0,0,10,0,10,Veneto,ITH3
2021-01-04,PF/BT,5095201,IOV,VEN,60-69,4,2,0,6,0,0,0,6,0,6,Veneto,ITH3
2021-01-04,PF/BT,5095201,IOV,VEN,70-79,1,0,0,1,0,0,0,1,0,1,Veneto,ITH3
2021-01-04,PF/BT,521630,R.S.A. 'IL GIRASOLE',VEN,20-29,2,9,0,11,0,0,0,11,0,11,Veneto,ITH3
2021-01-04,PF/BT,521630,R.S.A. 'IL GIRASOLE',VEN,30-39,0,18,0,16,2,0,0,18,0,18,Veneto,ITH3
2021-01-04,PF/BT,521630,R.S.A. 'IL GIRASOLE',VEN,40-49,2,37,0,31,8,0,0,39,0,39,Veneto,ITH3
2021-01-04,PF/BT,521630,R.S.A. 'IL GIRASOLE',VEN,50-59,6,48,0,32,22,0,0,54,0,54,Veneto,ITH3
2021-01-04,PF/BT,521630,R.S.A. 'IL GIRASOLE',VEN,60-69,3,14,0,10,7,0,0,17,0,17,Veneto,ITH3
2021-01-04,PF/BT,521630,R.S.A. 'IL GIRASOLE',VEN,70-79,1,0,0,0,1,0,0,1,0,1,Veneto,ITH3
2021-01-04,PF/BT,610955,OPSA - OPERA PROVVIDENZA S.ANTONIO DISABILI,VEN,20-29,1,1,0,2,0,0,0,2,0,2,Veneto,ITH3
2021-01-04,PF/BT,610955,OPSA - OPERA PROVVIDENZA S.ANTONIO DISABILI,VEN,40-49,1,2,0,2,0,1,0,3,0,3,Veneto,ITH3
2021-01-04,PF/BT,610955,OPSA - OPERA PROVVIDENZA S.ANTONIO DISABILI,VEN,50-59,2,0,0,1,0,1,0,2,0,2,Veneto,ITH3
2021-01-04,PF/BT,610955,OPSA - OPERA PROVVIDENZA S.ANTONIO DISABILI,VEN,60-69,3,0,0,0,0,3,0,3,0,3,Veneto,ITH3
2021-01-04,PF/BT,610955,OPSA - OPERA PROVVIDENZA S.ANTONIO DISABILI,VEN,70-79,1,0,0,0,0,1,0,1,0,1,Veneto,ITH3
2021-01-04,PF/BT,611054,OPSA - CASA SOCCIORNO MONS.BORTIGNON - RELIGIOSI,VEN,30-39,0,1,0,1,0,0,0,1,0,1,Veneto,ITH3
2021-01-04,PF/BT,611054,OPSA - CASA SOCCIORNO MONS.BORTIGNON - RELIGIOSI,VEN,50-59,2,0,0,1,0,0,1,2,0,2,Veneto,ITH3
2021-01-04,PF/BT,611054,OPSA - CASA SOCCIORNO MONS.BORTIGNON - RELIGIOSI,VEN,60-69,1,0,0,1,0,0,0,1,0,1,Veneto,ITH3
2021-01-04,PF/BT,611054,OPSA - CASA SOCCIORNO MONS.BORTIGNON - RELIGIOSI,VEN,70-79,1,0,0,0,0,0,1,1,0,1,Veneto,ITH3
2021-01-04,PF/BT,611198,OPSA - CASA MASSIMILIANO KOLBE,VEN,20-29,1,4,0,5,0,0,0,5,0,5,Veneto,ITH3
2021-01-04,PF/BT,611198,OPSA - CASA MASSIMILIANO KOLBE,VEN,30-39,3,2,0,4,0,0,1,5,0,5,Veneto,ITH3
2021-01-04,PF/BT,611198,OPSA - CASA MASSIMILIANO KOLBE,VEN,40-49,2,4,0,6,0,0,0,6,0,6,Veneto,ITH3
2021-01-04,PF/BT,611198,OPSA - CASA MASSIMILIANO KOLBE,VEN,50-59,6,2,0,7,0,0,1,8,0,8,Veneto,ITH3
2021-01-04,PF/BT,611198,OPSA - CASA MASSIMILIANO KOLBE,VEN,60-69,2,0,0,2,0,0,0,2,0,2,Veneto,ITH3
2021-01-04,PF/BT,84005,RESIDENZA PER ANZIANI 'MADONNINA',VEN,20-29,3,15,0,18,0,0,0,18,0,18,Veneto,ITH3
2021-01-04,PF/BT,84005,RESIDENZA PER ANZIANI 'MADONNINA',VEN,30-39,3,11,0,14,0,0,0,14,0,14,Veneto,ITH3
2021-01-04,PF/BT,84005,RESIDENZA PER ANZIANI 'MADONNINA',VEN,40-49,2,12,0,14,0,0,0,14,0,14,Veneto,ITH3
2021-01-04,PF/BT,84005,RESIDENZA PER ANZIANI 'MADONNINA',VEN,50-59,7,7,0,14,0,0,0,14,0,14,Veneto,ITH3
2021-01-04,PF/BT,84005,RESIDENZA PER ANZIANI 'MADONNINA',VEN,60-69,1,4,0,3,0,2,0,5,0,5,Veneto,ITH3
2021-01-04,PF/BT,84005,RESIDENZA PER ANZIANI 'MADONNINA',VEN,70-79,11,15,0,2,0,24,0,26,0,26,Veneto,ITH3
2021-01-04,PF/BT,84005,RESIDENZA PER ANZIANI 'MADONNINA',VEN,80-89,11,53,0,1,0,63,0,64,0,64,Veneto,ITH3
2021-01-04,PF/BT,84005,RESIDENZA PER ANZIANI 'MADONNINA',VEN,90+,4,33,0,0,0,37,0,37,0,37,Veneto,ITH3
2021-01-04,PF/BT,845237,RSA DI CURA E REC. CASA NOGARE,VEN,60-69,4,2,0,0,0,6,0,6,0,6,Veneto,ITH3
2021-01-04,PF/BT,845237,RSA DI CURA E REC. CASA NOGARE,VEN,70-79,3,0,0,0,0,3,0,3,0,3,Veneto,ITH3
2021-01-04,PF/BT,845237,RSA DI CURA E REC. CASA NOGARE,VEN,80-89,6,7,0,0,0,13,0,13,0,13,Veneto,ITH3
2021-01-04,PF/BT,845237,RSA DI CURA E REC. CASA NOGARE,VEN,90+,3,3,0,0,0,6,0,6,0,6,Veneto,ITH3
2021-01-05,PF/BT,0,Mancante,VEN,20-29,0,1,0,1,0,0,0,1,0,1,Veneto,ITH3
2021-01-05,PF/BT,132228,C.R. COMUNALE - CALTRANO,VEN,20-29,0,1,0,1,0,0,0,1,0,1,Veneto,ITH3
2021-01-05,PF/BT,132228,C.R. COMUNALE - CALTRANO,VEN,30-39,0,1,0,1,0,0,0,1,0,1,Veneto,ITH3
2021-01-05,PF/BT,132228,C.R. COMUNALE - CALTRANO,VEN,40-49,0,3,0,3,0,0,0,3,0,3,Veneto,ITH3
2021-01-05,PF/BT,132228,C.R. COMUNALE - CALTRANO,VEN,50-59,1,14,0,13,2,0,0,15,0,15,Veneto,ITH3
2021-01-05,PF/BT,132228,C.R. COMUNALE - CALTRANO,VEN,60-69,1,1,0,0,1,1,0,2,0,2,Veneto,ITH3
2021-01-05,PF/BT,132228,C.R. COMUNALE - CALTRANO,VEN,70-79,1,5,0,0,0,6,0,6,0,6,Veneto,ITH3
2021-01-05,PF/BT,132228,C.R. COMUNALE - CALTRANO,VEN,80-89,5,9,0,0,0,14,0,14,0,14,Veneto,ITH3
2021-01-05,PF/BT,132228,C.R. COMUNALE - CALTRANO,VEN,90+,2,15,0,0,0,17,0,17,0,17,Veneto,ITH3
2021-01-05,PF/BT,132241,C.R. 'VILLA MIARI' - SANTORSO,VEN,60-69,1,0,0,0,0,1,0,1,0,1,Veneto,ITH3
2021-01-05,PF/BT,162448,CASA DI RIPOSO S. G. BATTISTA MONTEBELLO,VEN,20-29,3,15,0,14,4,0,0,18,0,18,Veneto,ITH3
2021-01-05,PF/BT,162448,CASA DI RIPOSO S. G. BATTISTA MONTEBELLO,VEN,30-39,2,8,0,6,4,0,0,10,0,10,Veneto,ITH3
2021-01-05,PF/BT,162448,CASA DI RIPOSO S. G. BATTISTA MONTEBELLO,VEN,40-49,1,17,0,10,8,0,0,18,0,18,Veneto,ITH3
2021-01-05,PF/BT,162448,CASA DI RIPOSO S. G. BATTISTA MONTEBELLO,VEN,50-59,10,25,0,18,12,5,0,35,0,35,Veneto,ITH3
2021-01-05,PF/BT,162448,CASA DI RIPOSO S. G. BATTISTA MONTEBELLO,VEN,60-69,4,10,0,6,1,7,0,14,0,14,Veneto,ITH3
2021-01-05,PF/BT,162448,CASA DI RIPOSO S. G. BATTISTA MONTEBELLO,VEN,70-79,7,15,0,0,0,22,0,22,0,22,Veneto,ITH3
2021-01-05,PF/BT,162448,CASA DI RIPOSO S. G. BATTISTA MONTEBELLO,VEN,80-89,9,28,0,0,0,37,0,37,0,37,Veneto,ITH3
2021-01-05,PF/BT,162448,CASA DI RIPOSO S. G. BATTISTA MONTEBELLO,VEN,90+,4,22,0,0,0,26,0,26,0,26,Veneto,ITH3
2021-01-05,PF/BT,162487,CASA DI RIPOSO 'RESIDENZA IL GIARDINO' RECOARO,VEN,30-39,1,3,0,2,2,0,0,4,0,4,Veneto,ITH3
2021-01-05,PF/BT,162487,CASA DI RIPOSO 'RESIDENZA IL GIARDINO' RECOARO,VEN,40-49,2,10,0,11,1,0,0,12,0,12,Veneto,ITH3
2021-01-05,PF/BT,162487,CASA DI RIPOSO 'RESIDENZA IL GIARDINO' RECOARO,VEN,50-59,2,5,0,5,1,1,0,7,0,7,Veneto,ITH3
2021-01-05,PF/BT,162487,CASA DI RIPOSO 'RESIDENZA IL GIARDINO' RECOARO,VEN,60-69,1,0,0,0,0,1,0,1,0,1,Veneto,ITH3
2021-01-05,PF/BT,162487,CASA DI RIPOSO 'RESIDENZA IL GIARDINO' RECOARO,VEN,70-79,2,3,0,0,0,5,0,5,0,5,Veneto,ITH3
2021-01-05,PF/BT,162487,CASA DI RIPOSO 'RESIDENZA IL GIARDINO' RECOARO,VEN,80-89,3,10,0,0,0,13,0,13,0,13,Veneto,ITH3
2021-01-05,PF/BT,162487,CASA DI RIPOSO 'RESIDENZA IL GIARDINO' RECOARO,VEN,90+,1,7,0,0,0,8,0,8,0,8,Veneto,ITH3
2021-01-05,PF/BT,208018,IPAB - RESIDENZA SALVI,VEN,20-29,4,4,0,7,1,0,0,8,0,8,Veneto,ITH3
2021-01-05,PF/BT,208018,IPAB - RESIDENZA SALVI,VEN,30-39,5,6,0,11,0,0,0,11,0,11,Veneto,ITH3
2021-01-05,PF/BT,208018,IPAB - RESIDENZA SALVI,VEN,40-49,0,10,0,10,0,0,0,10,0,10,Veneto,ITH3
2021-01-05,PF/BT,208018,IPAB - RESIDENZA SALVI,VEN,50-59,2,8,0,7,3,0,0,10,0,10,Veneto,ITH3
2021-01-05,PF/BT,208018,IPAB - RESIDENZA SALVI,VEN,60-69,1,1,0,1,0,1,0,2,0,2,Veneto,ITH3
2021-01-05,PF/BT,208018,IPAB - RESIDENZA SALVI,VEN,70-79,3,4,0,0,0,7,0,7,0,7,Veneto,ITH3
2021-01-05,PF/BT,208018,IPAB - RESIDENZA SALVI,VEN,80-89,8,19,0,0,0,27,0,27,0,27,Veneto,ITH3
2021-01-05,PF/BT,208018,IPAB - RESIDENZA SALVI,VEN,90+,4,22,0,0,0,26,0,26,0,26,Veneto,ITH3
2021-01-05,PF/BT,208039,RSA NOVELLO,VEN,16-19,1,1,0,0,2,0,0,2,0,2,Veneto,ITH3
2021-01-05,PF/BT,208039,RSA NOVELLO,VEN,20-29,1,2,0,1,2,0,0,3,0,3,Veneto,ITH3
2021-01-05,PF/BT,208039,RSA NOVELLO,VEN,30-39,0,2,0,1,1,0,0,2,0,2,Veneto,ITH3
2021-01-05,PF/BT,208039,RSA NOVELLO,VEN,40-49,1,1,0,2,0,0,0,2,0,2,Veneto,ITH3
2021-01-05,PF/BT,208039,RSA NOVELLO,VEN,50-59,2,7,0,2,7,0,0,9,0,9,Veneto,ITH3
2021-01-05,PF/BT,208039,RSA NOVELLO,VEN,60-69,3,1,0,3,1,0,0,4,0,4,Veneto,ITH3
2021-01-05,PF/BT,208039,RSA NOVELLO,VEN,70-79,3,0,0,0,1,2,0,3,0,3,Veneto,ITH3
2021-01-05,PF/BT,208039,RSA NOVELLO,VEN,80-89,13,0,0,0,0,13,0,13,0,13,Veneto,ITH3
2021-01-05,PF/BT,208039,RSA NOVELLO,VEN,90+,7,0,0,0,0,7,0,7,0,7,Veneto,ITH3
2021-01-05,PF/BT,323129,"CENTRO DI SERVIZI RESIDENZIALE ""GINO E PIERINA MARANI"" - VILLORBA",VEN,20-29,1,10,0,8,3,0,0,11,0,11,Veneto,ITH3
2021-01-05,PF/BT,323129,"CENTRO DI SERVIZI RESIDENZIALE ""GINO E PIERINA MARANI"" - VILLORBA",VEN,30-39,6,15,0,18,3,0,0,21,0,21,Veneto,ITH3
2021-01-05,PF/BT,323129,"CENTRO DI SERVIZI RESIDENZIALE ""GINO E PIERINA MARANI"" - VILLORBA",VEN,40-49,4,22,0,14,12,0,0,26,0,26,Veneto,ITH3
2021-01-05,PF/BT,323129,"CENTRO DI SERVIZI RESIDENZIALE ""GINO E PIERINA MARANI"" - VILLORBA",VEN,50-59,4,35,0,27,12,0,0,39,0,39,Veneto,ITH3
2021-01-05,PF/BT,323129,"CENTRO DI SERVIZI RESIDENZIALE ""GINO E PIERINA MARANI"" - VILLORBA",VEN,60-69,2,8,0,9,1,0,0,10,0,10,Veneto,ITH3
2021-01-05,PF/BT,323129,"CENTRO DI SERVIZI RESIDENZIALE ""GINO E PIERINA MARANI"" - VILLORBA",VEN,70-79,1,0,0,1,0,0,0,1,0,1,Veneto,ITH3
2021-01-05,PF/BT,363723,CENTRO SERVIZI PER ANZIANI 'I TIGLI',VEN,20-29,4,11,0,15,0,0,0,15,0,15,Veneto,ITH3
2021-01-05,PF/BT,363723,CENTRO SERVIZI PER ANZIANI 'I TIGLI',VEN,30-39,3,9,0,11,1,0,0,12,0,12,Veneto,ITH3
2021-01-05,PF/BT,363723,CENTRO SERVIZI PER ANZIANI 'I TIGLI',VEN,40-49,2,4,0,6,0,0,0,6,0,6,Veneto,ITH3
2021-01-05,PF/BT,363723,CENTRO SERVIZI PER ANZIANI 'I TIGLI',VEN,50-59,2,11,0,12,1,0,0,13,0,13,Veneto,ITH3
2021-01-05,PF/BT,363723,CENTRO SERVIZI PER ANZIANI 'I TIGLI',VEN,60-69,3,10,0,3,3,7,0,13,0,13,Veneto,ITH3
2021-01-05,PF/BT,363723,CENTRO SERVIZI PER ANZIANI 'I TIGLI',VEN,70-79,5,10,0,0,0,15,0,15,0,15,Veneto,ITH3
2021-01-05,PF/BT,363723,CENTRO SERVIZI PER ANZIANI 'I TIGLI',VEN,80-89,9,32,0,0,0,41,0,41,0,41,Veneto,ITH3
2021-01-05,PF/BT,363723,CENTRO SERVIZI PER ANZIANI 'I TIGLI',VEN,90+,5,39,0,0,0,44,0,44,0,44,Veneto,ITH3
2021-01-05,PF/BT,42815,C.S.A. 'SANT'ANTONIO ABATE',VEN,20-29,0,8,0,6,2,0,0,8,0,8,Veneto,ITH3
2021-01-05,PF/BT,42815,C.S.A. 'SANT'ANTONIO ABATE',VEN,30-39,1,1,0,0,1,0,1,2,0,2,Veneto,ITH3
2021-01-05,PF/BT,42815,C.S.A. 'SANT'ANTONIO ABATE',VEN,40-49,1,9,0,10,0,0,0,10,0,10,Veneto,ITH3
2021-01-05,PF/BT,42815,C.S.A. 'SANT'ANTONIO ABATE',VEN,50-59,3,11,0,12,2,0,0,14,0,14,Veneto,ITH3
2021-01-05,PF/BT,42815,C.S.A. 'SANT'ANTONIO ABATE',VEN,60-69,4,2,0,1,1,4,0,6,0,6,Veneto,ITH3
2021-01-05,PF/BT,42815,C.S.A. 'SANT'ANTONIO ABATE',VEN,70-79,5,4,0,0,1,8,0,9,0,9,Veneto,ITH3
2021-01-05,PF/BT,42815,C.S.A. 'SANT'ANTONIO ABATE',VEN,80-89,4,9,0,0,0,13,0,13,0,13,Veneto,ITH3
2021-01-05,PF/BT,42815,C.S.A. 'SANT'ANTONIO ABATE',VEN,90+,1,20,0,0,0,21,0,21,0,21,Veneto,ITH3
2021-01-05,PF/BT,445323,C. SERV.RES.ANZ.-S.M. DEL ROSARIO,VEN,20-29,1,2,0,3,0,0,0,3,0,3,Veneto,ITH3
2021-01-05,PF/BT,445323,C. SERV.RES.ANZ.-S.M. DEL ROSARIO,VEN,30-39,2,5,0,3,4,0,0,7,0,7,Veneto,ITH3
2021-01-05,PF/BT,445323,C. SERV.RES.ANZ.-S.M. DEL ROSARIO,VEN,40-49,1,7,0,5,3,0,0,8,0,8,Veneto,ITH3
2021-01-05,PF/BT,445323,C. SERV.RES.ANZ.-S.M. DEL ROSARIO,VEN,50-59,0,5,0,3,2,0,0,5,0,5,Veneto,ITH3
2021-01-05,PF/BT,445323,C. SERV.RES.ANZ.-S.M. DEL ROSARIO,VEN,60-69,1,1,0,1,0,1,0,2,0,2,Veneto,ITH3
2021-01-05,PF/BT,445323,C. SERV.RES.ANZ.-S.M. DEL ROSARIO,VEN,70-79,1,4,0,1,0,4,0,5,0,5,Veneto,ITH3
2021-01-05,PF/BT,445323,C. SERV.RES.ANZ.-S.M. DEL ROSARIO,VEN,80-89,3,8,0,0,0,11,0,11,0,11,Veneto,ITH3
2021-01-05,PF/BT,445323,C. SERV.RES.ANZ.-S.M. DEL ROSARIO,VEN,90+,1,12,0,0,0,13,0,13,0,13,Veneto,ITH3
2021-01-05,PF/BT,445366,C. SERV.RES.ANZ.-NAZARET,VEN,20-29,0,1,0,1,0,0,0,1,0,1,Veneto,ITH3
2021-01-05,PF/BT,445366,C. SERV.RES.ANZ.-NAZARET,VEN,30-39,1,4,0,4,1,0,0,5,0,5,Veneto,ITH3
2021-01-05,PF/BT,445366,C. SERV.RES.ANZ.-NAZARET,VEN,40-49,0,6,0,4,2,0,0,6,0,6,Veneto,ITH3
2021-01-05,PF/BT,445366,C. SERV.RES.ANZ.-NAZARET,VEN,50-59,1,8,0,4,5,0,0,9,0,9,Veneto,ITH3
2021-01-05,PF/BT,445366,C. SERV.RES.ANZ.-NAZARET,VEN,60-69,1,0,0,0,0,1,0,1,0,1,Veneto,ITH3
2021-01-05,PF/BT,445366,C. SERV.RES.ANZ.-NAZARET,VEN,70-79,0,2,0,0,0,2,0,2,0,2,Veneto,ITH3
2021-01-05,PF/BT,445366,C. SERV.RES.ANZ.-NAZARET,VEN,80-89,4,5,0,0,1,8,0,9,0,9,Veneto,ITH3
2021-01-05,PF/BT,445366,C. SERV.RES.ANZ.-NAZARET,VEN,90+,1,2,0,0,0,3,0,3,0,3,Veneto,ITH3
2021-01-05,PF/BT,486003,C.D.R. 'S.M. BATTUTI' - NOALE,VEN,20-29,2,8,0,9,1,0,0,10,0,10,Veneto,ITH3
2021-01-05,PF/BT,486003,C.D.R. 'S.M. BATTUTI' - NOALE,VEN,30-39,1,3,0,3,1,0,0,4,0,4,Veneto,ITH3
2021-01-05,PF/BT,486003,C.D.R. 'S.M. BATTUTI' - NOALE,VEN,40-49,0,4,0,0,4,0,0,4,0,4,Veneto,ITH3
2021-01-05,PF/BT,486003,C.D.R. 'S.M. BATTUTI' - NOALE,VEN,50-59,0,4,0,2,2,0,0,4,0,4,Veneto,ITH3
2021-01-05,PF/BT,486003,C.D.R. 'S.M. BATTUTI' - NOALE,VEN,60-69,1,3,0,3,1,0,0,4,0,4,Veneto,ITH3
2021-01-05,PF/BT,486003,C.D.R. 'S.M. BATTUTI' - NOALE,VEN,80-89,0,1,0,0,0,1,0,1,0,1,Veneto,ITH3
2021-01-05,PF/BT,486004,C.D.R. 'DON ALLEGRI' - SALZANO,VEN,20-29,4,4,0,7,1,0,0,8,0,8,Veneto,ITH3
2021-01-05,PF/BT,486004,C.D.R. 'DON ALLEGRI' - SALZANO,VEN,30-39,1,9,0,3,6,0,1,10,0,10,Veneto,ITH3
2021-01-05,PF/BT,486004,C.D.R. 'DON ALLEGRI' - SALZANO,VEN,40-49,4,10,0,8,6,0,0,14,0,14,Veneto,ITH3
2021-01-05,PF/BT,486004,C.D.R. 'DON ALLEGRI' - SALZANO,VEN,50-59,2,22,0,14,10,0,0,24,0,24,Veneto,ITH3
2021-01-05,PF/BT,486004,C.D.R. 'DON ALLEGRI' - SALZANO,VEN,60-69,2,14,0,10,6,0,0,16,0,16,Veneto,ITH3
2021-01-05,PF/BT,486004,C.D.R. 'DON ALLEGRI' - SALZANO,VEN,80-89,0,3,0,0,0,3,0,3,0,3,Veneto,ITH3
2021-01-05,PF/BT,486004,C.D.R. 'DON ALLEGRI' - SALZANO,VEN,90+,0,1,0,0,0,1,0,1,0,1,Veneto,ITH3
2021-01-05,PF/BT,5001700,OSPEDALE SACRO CUORE DI NEGRAR,VEN,20-29,12,32,0,39,5,0,0,44,0,44,Veneto,ITH3
2021-01-05,PF/BT,5001700,OSPEDALE SACRO CUORE DI NEGRAR,VEN,30-39,21,29,0,45,5,0,0,50,0,50,Veneto,ITH3
2021-01-05,PF/BT,5001700,OSPEDALE SACRO CUORE DI NEGRAR,VEN,40-49,16,37,0,43,10,0,0,53,0,53,Veneto,ITH3
2021-01-05,PF/BT,5001700,OSPEDALE SACRO CUORE DI NEGRAR,VEN,50-59,18,48,0,52,14,0,0,66,0,66,Veneto,ITH3
2021-01-05,PF/BT,5001700,OSPEDALE SACRO CUORE DI NEGRAR,VEN,60-69,10,13,0,19,4,0,0,23,0,23,Veneto,ITH3
2021-01-05,PF/BT,5001700,OSPEDALE SACRO CUORE DI NEGRAR,VEN,70-79,1,0,0,1,0,0,0,1,0,1,Veneto,ITH3
2021-01-05,PF/BT,5002200,OSPEDALE P. PEDERZOLI,VEN,20-29,5,11,0,16,0,0,0,16,0,16,Veneto,ITH3
2021-01-05,PF/BT,5002200,OSPEDALE P. PEDERZOLI,VEN,30-39,5,10,0,15,0,0,0,15,0,15,Veneto,ITH3
2021-01-05,PF/BT,5002200,OSPEDALE P. PEDERZOLI,VEN,40-49,6,15,0,21,0,0,0,21,0,21,Veneto,ITH3
2021-01-05,PF/BT,5002200,OSPEDALE P. PEDERZOLI,VEN,50-59,7,4,0,11,0,0,0,11,0,11,Veneto,ITH3
2021-01-05,PF/BT,5002200,OSPEDALE P. PEDERZOLI,VEN,60-69,3,0,0,3,0,0,0,3,0,3,Veneto,ITH3
2021-01-05,PF/BT,5002200,OSPEDALE P. PEDERZOLI,VEN,70-79,2,0,0,2,0,0,0,2,0,2,Veneto,ITH3
2021-01-05,PF/BT,50501,AGORDO - SERVIZIO IGIENE,VEN,20-29,0,1,0,1,0,0,0,1,0,1,Veneto,ITH3
2021-01-05,PF/BT,50501,AGORDO - SERVIZIO IGIENE,VEN,30-39,1,1,0,2,0,0,0,2,0,2,Veneto,ITH3
2021-01-05,PF/BT,50501,AGORDO - SERVIZIO IGIENE,VEN,40-49,2,6,0,6,2,0,0,8,0,8,Veneto,ITH3
2021-01-05,PF/BT,50501,AGORDO - SERVIZIO IGIENE,VEN,50-59,6,19,0,15,10,0,0,25,0,25,Veneto,ITH3
2021-01-05,PF/BT,50501,AGORDO - SERVIZIO IGIENE,VEN,60-69,2,6,0,4,4,0,0,8,0,8,Veneto,ITH3
2021-01-05,PF/BT,50501,AGORDO - SERVIZIO IGIENE,VEN,70-79,1,0,0,1,0,0,0,1,0,1,Veneto,ITH3
2021-01-05,PF/BT,50501,"BELLUNO ""DRIVE-IN""",VEN,20-29,3,7,0,10,0,0,0,10,0,10,Veneto,ITH3
2021-01-05,PF/BT,50501,"BELLUNO ""DRIVE-IN""",VEN,30-39,2,12,0,14,0,0,0,14,0,14,Veneto,ITH3
2021-01-05,PF/BT,50501,"BELLUNO ""DRIVE-IN""",VEN,40-49,1,17,0,18,0,0,0,18,0,18,Veneto,ITH3
2021-01-05,PF/BT,50501,"BELLUNO ""DRIVE-IN""",VEN,50-59,3,24,0,27,0,0,0,27,0,27,Veneto,ITH3
2021-01-05,PF/BT,50501,"BELLUNO ""DRIVE-IN""",VEN,60-69,2,1,0,3,0,0,0,3,0,3,Veneto,ITH3
2021-01-05,PF/BT,50501,BELLUNO AMBULATORIO N.15,VEN,20-29,1,2,0,3,0,0,0,3,0,3,Veneto,ITH3
2021-01-05,PF/BT,50501,BELLUNO AMBULATORIO N.15,VEN,30-39,0,1,0,1,0,0,0,1,0,1,Veneto,ITH3
2021-01-05,PF/BT,50501,BELLUNO AMBULATORIO N.15,VEN,50-59,0,1,0,1,0,0,0,1,0,1,Veneto,ITH3
2021-01-05,PF/BT,50501,BELLUNO AMBULATORIO N.15,VEN,60-69,1,0,0,1,0,0,0,1,0,1,Veneto,ITH3
2021-01-05,PF/BT,50501,FELTRE,VEN,20-29,5,16,0,21,0,0,0,21,0,21,Veneto,ITH3
2021-01-05,PF/BT,50501,FELTRE,VEN,30-39,4,18,0,22,0,0,0,22,0,22,Veneto,ITH3
2021-01-05,PF/BT,50501,FELTRE,VEN,40-49,7,21,0,28,0,0,0,28,0,28,Veneto,ITH3
2021-01-05,PF/BT,50501,FELTRE,VEN,50-59,8,31,0,39,0,0,0,39,0,39,Veneto,ITH3
2021-01-05,PF/BT,50501,FELTRE,VEN,60-69,10,3,0,13,0,0,0,13,0,13,Veneto,ITH3
2021-01-05,PF/BT,50501,FELTRE,VEN,70-79,4,0,0,4,0,0,0,4,0,4,Veneto,ITH3
2021-01-05,PF/BT,50501,PIEVE DI CADORE,VEN,20-29,0,4,0,4,0,0,0,4,0,4,Veneto,ITH3
2021-01-05,PF/BT,50501,PIEVE DI CADORE,VEN,30-39,0,6,0,3,3,0,0,6,0,6,Veneto,ITH3
2021-01-05,PF/BT,50501,PIEVE DI CADORE,VEN,40-49,2,7,0,8,1,0,0,9,0,9,Veneto,ITH3
2021-01-05,PF/BT,50501,PIEVE DI CADORE,VEN,50-59,0,9,0,7,2,0,0,9,0,9,Veneto,ITH3
2021-01-05,PF/BT,50501,PIEVE DI CADORE,VEN,60-69,2,4,0,4,1,1,0,6,0,6,Veneto,ITH3
2021-01-05,PF/BT,50501,PIEVE DI CADORE,VEN,70-79,1,4,0,0,0,5,0,5,0,5,Veneto,ITH3
2021-01-05,PF/BT,50501,PIEVE DI CADORE,VEN,80-89,6,14,0,0,0,20,0,20,0,20,Veneto,ITH3
2021-01-05,PF/BT,50501,PIEVE DI CADORE,VEN,90+,0,7,0,0,0,7,0,7,0,7,Veneto,ITH3
2021-01-05,PF/BT,50502,PREGANZIOL,VEN,20-29,2,7,0,9,0,0,0,9,0,9,Veneto,ITH3
2021-01-05,PF/BT,50502,PREGANZIOL,VEN,30-39,2,3,0,5,0,0,0,5,0,5,Veneto,ITH3
2021-01-05,PF/BT,50502,PREGANZIOL,VEN,40-49,5,5,0,10,0,0,0,10,0,10,Veneto,ITH3
2021-01-05,PF/BT,50502,PREGANZIOL,VEN,50-59,6,14,0,19,0,1,0,20,0,20,Veneto,ITH3
2021-01-05,PF/BT,50502,PREGANZIOL,VEN,60-69,4,7,0,11,0,0,0,11,0,11,Veneto,ITH3
2021-01-05,PF/BT,50502,PREGANZIOL,VEN,70-79,4,0,0,4,0,0,0,4,0,4,Veneto,ITH3
2021-01-05,PF/BT,50503,CAMPONOGARA ADULTI,VEN,30-39,0,2,0,2,0,0,0,2,0,2,Veneto,ITH3
2021-01-05,PF/BT,50503,CAMPONOGARA ADULTI,VEN,40-49,2,6,0,8,0,0,0,8,0,8,Veneto,ITH3
2021-01-05,PF/BT,50503,CAMPONOGARA ADULTI,VEN,50-59,1,19,0,20,0,0,0,20,0,20,Veneto,ITH3
2021-01-05,PF/BT,50503,CAMPONOGARA ADULTI,VEN,60-69,1,5,0,6,0,0,0,6,0,6,Veneto,ITH3
2021-01-05,PF/BT,50503,MED.PREV - CHIOGGIA,VEN,20-29,1,2,0,3,0,0,0,3,0,3,Veneto,ITH3
2021-01-05,PF/BT,50503,MED.PREV - CHIOGGIA,VEN,30-39,2,4,0,6,0,0,0,6,0,6,Veneto,ITH3
2021-01-05,PF/BT,50503,MED.PREV - CHIOGGIA,VEN,40-49,6,16,0,22,0,0,0,22,0,22,Veneto,ITH3
2021-01-05,PF/BT,50503,MED.PREV - CHIOGGIA,VEN,50-59,5,21,0,26,0,0,0,26,0,26,Veneto,ITH3
2021-01-05,PF/BT,50503,MED.PREV - CHIOGGIA,VEN,60-69,3,0,0,3,0,0,0,3,0,3,Veneto,ITH3
2021-01-05,PF/BT,50503,MEDICINA PREVENTIVA MESTRE,VEN,20-29,17,24,0,39,2,0,0,41,0,41,Veneto,ITH3
2021-01-05,PF/BT,50503,MEDICINA PREVENTIVA MESTRE,VEN,30-39,28,38,0,65,1,0,0,66,0,66,Veneto,ITH3
2021-01-05,PF/BT,50503,MEDICINA PREVENTIVA MESTRE,VEN,40-49,21,70,0,83,8,0,0,91,0,91,Veneto,ITH3
2021-01-05,PF/BT,50503,MEDICINA PREVENTIVA MESTRE,VEN,50-59,27,81,0,105,3,0,0,108,0,108,Veneto,ITH3
2021-01-05,PF/BT,50503,MEDICINA PREVENTIVA MESTRE,VEN,60-69,19,18,0,36,1,0,0,37,0,37,Veneto,ITH3
2021-01-05,PF/BT,50503,MEDICINA PREVENTIVA MESTRE,VEN,70-79,3,0,0,3,0,0,0,3,0,3,Veneto,ITH3
2021-01-05,PF/BT,50503,MEDICINA PREVENTIVA VENEZIA,VEN,20-29,6,12,0,16,2,0,0,18,0,18,Veneto,ITH3
2021-01-05,PF/BT,50503,MEDICINA PREVENTIVA VENEZIA,VEN,30-39,21,17,0,36,1,0,1,38,0,38,Veneto,ITH3
2021-01-05,PF/BT,50503,MEDICINA PREVENTIVA VENEZIA,VEN,40-49,14,26,0,35,4,0,1,40,0,40,Veneto,ITH3
2021-01-05,PF/BT,50503,MEDICINA PREVENTIVA VENEZIA,VEN,50-59,24,54,0,69,9,0,0,78,0,78,Veneto,ITH3
2021-01-05,PF/BT,50503,MEDICINA PREVENTIVA VENEZIA,VEN,60-69,17,12,0,26,3,0,0,29,0,29,Veneto,ITH3
2021-01-05,PF/BT,50503,MEDICINA PREVENTIVA VENEZIA,VEN,70-79,1,0,0,1,0,0,0,1,0,1,Veneto,ITH3
2021-01-05,PF/BT,50503,S.I.S.P. MESTRE,VEN,20-29,7,14,0,21,0,0,0,21,0,21,Veneto,ITH3
2021-01-05,PF/BT,50503,S.I.S.P. MESTRE,VEN,30-39,7,6,0,12,1,0,0,13,0,13,Veneto,ITH3
2021-01-05,PF/BT,50503,S.I.S.P. MESTRE,VEN,40-49,16,27,0,42,0,0,1,43,0,43,Veneto,ITH3
2021-01-05,PF/BT,50503,S.I.S.P. MESTRE,VEN,50-59,26,40,0,62,1,0,3,66,0,66,Veneto,ITH3
2021-01-05,PF/BT,50503,S.I.S.P. MESTRE,VEN,60-69,16,13,0,28,1,0,0,29,0,29,Veneto,ITH3
2021-01-05,PF/BT,50503,S.I.S.P. VENEZIA,VEN,20-29,6,1,0,7,0,0,0,7,0,7,Veneto,ITH3
2021-01-05,PF/BT,50503,S.I.S.P. VENEZIA,VEN,30-39,4,6,0,8,2,0,0,10,0,10,Veneto,ITH3
2021-01-05,PF/BT,50503,S.I.S.P. VENEZIA,VEN,40-49,2,7,0,8,1,0,0,9,0,9,Veneto,ITH3
2021-01-05,PF/BT,50503,S.I.S.P. VENEZIA,VEN,50-59,6,18,0,20,4,0,0,24,0,24,Veneto,ITH3
2021-01-05,PF/BT,50503,S.I.S.P. VENEZIA,VEN,60-69,26,8,0,33,1,0,0,34,0,34,Veneto,ITH3
2021-01-05,PF/BT,50503,SISP DOLO ADULTI,VEN,20-29,13,16,0,29,0,0,0,29,0,29,Veneto,ITH3
2021-01-05,PF/BT,50503,SISP DOLO ADULTI,VEN,30-39,13,16,0,28,0,0,1,29,0,29,Veneto,ITH3
2021-01-05,PF/BT,50503,SISP DOLO ADULTI,VEN,40-49,16,31,0,47,0,0,0,47,0,47,Veneto,ITH3
2021-01-05,PF/BT,50503,SISP DOLO ADULTI,VEN,50-59,15,53,0,68,0,0,0,68,0,68,Veneto,ITH3
2021-01-05,PF/BT,50503,SISP DOLO ADULTI,VEN,60-69,13,10,0,23,0,0,0,23,0,23,Veneto,ITH3
2021-01-05,PF/BT,50505,ADRIA,VEN,20-29,3,9,0,12,0,0,0,12,0,12,Veneto,ITH3
2021-01-05,PF/BT,50505,ADRIA,VEN,30-39,10,13,0,23,0,0,0,23,0,23,Veneto,ITH3
2021-01-05,PF/BT,50505,ADRIA,VEN,40-49,11,25,0,36,0,0,0,36,0,36,Veneto,ITH3
2021-01-05,PF/BT,50505,ADRIA,VEN,50-59,10,23,0,33,0,0,0,33,0,33,Veneto,ITH3
2021-01-05,PF/BT,50505,ADRIA,VEN,60-69,12,4,0,16,0,0,0,16,0,16,Veneto,ITH3
2021-01-05,PF/BT,50505,MAGAZZINO MED. COMPETENTE 05,VEN,16-19,0,1,0,1,0,0,0,1,0,1,Veneto,ITH3
2021-01-05,PF/BT,50505,MAGAZZINO MED. COMPETENTE 05,VEN,20-29,0,2,0,2,0,0,0,2,0,2,Veneto,ITH3
2021-01-05,PF/BT,50505,MAGAZZINO MED. COMPETENTE 05,VEN,30-39,0,3,0,2,1,0,0,3,0,3,Veneto,ITH3
2021-01-05,PF/BT,50505,MAGAZZINO MED. COMPETENTE 05,VEN,40-49,0,5,0,2,3,0,0,5,0,5,Veneto,ITH3
2021-01-05,PF/BT,50505,MAGAZZINO MED. COMPETENTE 05,VEN,60-69,2,0,0,1,0,1,0,2,0,2,Veneto,ITH3
2021-01-05,PF/BT,50505,MAGAZZINO MED. COMPETENTE 05,VEN,70-79,6,0,0,0,6,0,0,6,0,6,Veneto,ITH3
2021-01-05,PF/BT,50505,MAGAZZINO MED. COMPETENTE 05,VEN,80-89,1,0,0,0,1,0,0,1,0,1,Veneto,ITH3
2021-01-05,PF/BT,50505,TRECENTA,VEN,20-29,11,10,0,21,0,0,0,21,0,21,Veneto,ITH3
2021-01-05,PF/BT,50505,TRECENTA,VEN,30-39,10,14,0,24,0,0,0,24,0,24,Veneto,ITH3
2021-01-05,PF/BT,50505,TRECENTA,VEN,40-49,11,31,0,42,0,0,0,42,0,42,Veneto,ITH3
2021-01-05,PF/BT,50505,TRECENTA,VEN,50-59,12,24,0,36,0,0,0,36,0,36,Veneto,ITH3
2021-01-05,PF/BT,50505,TRECENTA,VEN,60-69,5,8,0,13,0,0,0,13,0,13,Veneto,ITH3
2021-01-05,PF/BT,50505,TRECENTA,VEN,70-79,1,0,0,1,0,0,0,1,0,1,Veneto,ITH3
2021-01-05,PF/BT,50505,TRECENTA,VEN,80-89,0,1,0,1,0,0,0,1,0,1,Veneto,ITH3
2021-01-05,PF/BT,5050501,PRESIDIO OSPEDALIERO ROVIGO,VEN,20-29,12,26,0,38,0,0,0,38,0,38,Veneto,ITH3
2021-01-05,PF/BT,5050501,PRESIDIO OSPEDALIERO ROVIGO,VEN,30-39,16,32,0,44,2,2,0,48,0,48,Veneto,ITH3
2021-01-05,PF/BT,5050501,PRESIDIO OSPEDALIERO ROVIGO,VEN,40-49,20,70,0,84,5,1,0,90,0,90,Veneto,ITH3
2021-01-05,PF/BT,5050501,PRESIDIO OSPEDALIERO ROVIGO,VEN,50-59,24,67,0,87,0,4,0,91,0,91,Veneto,ITH3
2021-01-05,PF/BT,5050501,PRESIDIO OSPEDALIERO ROVIGO,VEN,60-69,19,11,0,29,0,1,0,30,0,30,Veneto,ITH3
2021-01-05,PF/BT,5050501,PRESIDIO OSPEDALIERO ROVIGO,VEN,70-79,1,0,0,1,0,0,0,1,0,1,Veneto,ITH3
2021-01-05,PF/BT,50506,AZ OSPEDALIERA DI PADOVA MAL. INFET.E TR,VEN,20-29,11,18,0,29,0,0,0,29,0,29,Veneto,ITH3
2021-01-05,PF/BT,50506,AZ OSPEDALIERA DI PADOVA MAL. INFET.E TR,VEN,30-39,8,25,0,33,0,0,0,33,0,33,Veneto,ITH3
2021-01-05,PF/BT,50506,AZ OSPEDALIERA DI PADOVA MAL. INFET.E TR,VEN,40-49,10,24,0,34,0,0,0,34,0,34,Veneto,ITH3
2021-01-05,PF/BT,50506,AZ OSPEDALIERA DI PADOVA MAL. INFET.E TR,VEN,50-59,9,37,0,46,0,0,0,46,0,46,Veneto,ITH3
2021-01-05,PF/BT,50506,AZ OSPEDALIERA DI PADOVA MAL. INFET.E TR,VEN,60-69,9,16,0,25,0,0,0,25,0,25,Veneto,ITH3
2021-01-05,PF/BT,50506,AZ OSPEDALIERA DI PADOVA MAL. INFET.E TR,VEN,70-79,1,0,0,1,0,0,0,1,0,1,Veneto,ITH3
2021-01-05,PF/BT,50506,CAMPOSAMPIERO MEDICO COMPETENT,VEN,20-29,3,5,0,8,0,0,0,8,0,8,Veneto,ITH3
2021-01-05,PF/BT,50506,CAMPOSAMPIERO MEDICO COMPETENT,VEN,30-39,4,5,0,9,0,0,0,9,0,9,Veneto,ITH3
2021-01-05,PF/BT,50506,CAMPOSAMPIERO MEDICO COMPETENT,VEN,40-49,2,16,0,18,0,0,0,18,0,18,Veneto,ITH3
2021-01-05,PF/BT,50506,CAMPOSAMPIERO MEDICO COMPETENT,VEN,50-59,4,16,0,19,1,0,0,20,0,20,Veneto,ITH3
2021-01-05,PF/BT,50506,CAMPOSAMPIERO MEDICO COMPETENT,VEN,60-69,4,1,0,5,0,0,0,5,0,5,Veneto,ITH3
2021-01-05,PF/BT,50506,"CITTADELLA ""LE TORRI""",VEN,20-29,2,4,0,6,0,0,0,6,0,6,Veneto,ITH3
2021-01-05,PF/BT,50506,"CITTADELLA ""LE TORRI""",VEN,30-39,2,3,0,5,0,0,0,5,0,5,Veneto,ITH3
2021-01-05,PF/BT,50506,"CITTADELLA ""LE TORRI""",VEN,40-49,1,10,0,11,0,0,0,11,0,11,Veneto,ITH3
2021-01-05,PF/BT,50506,"CITTADELLA ""LE TORRI""",VEN,50-59,3,15,0,18,0,0,0,18,0,18,Veneto,ITH3
2021-01-05,PF/BT,50506,"CITTADELLA ""LE TORRI""",VEN,60-69,11,9,0,20,0,0,0,20,0,20,Veneto,ITH3
2021-01-05,PF/BT,50506,CITTADELLA MEDICO COMPETENTE,VEN,20-29,1,15,0,16,0,0,0,16,0,16,Veneto,ITH3
2021-01-05,PF/BT,50506,CITTADELLA MEDICO COMPETENTE,VEN,30-39,14,14,0,27,1,0,0,28,0,28,Veneto,ITH3
2021-01-05,PF/BT,50506,CITTADELLA MEDICO COMPETENTE,VEN,40-49,9,30,0,35,4,0,0,39,0,39,Veneto,ITH3
2021-01-05,PF/BT,50506,CITTADELLA MEDICO COMPETENTE,VEN,50-59,7,22,0,28,0,0,1,29,0,29,Veneto,ITH3
2021-01-05,PF/BT,50506,CITTADELLA MEDICO COMPETENTE,VEN,60-69,3,5,0,7,1,0,0,8,0,8,Veneto,ITH3
2021-01-05,PF/BT,50506,COLLI VACC. ADULTI,VEN,20-29,9,10,0,19,0,0,0,19,0,19,Veneto,ITH3
2021-01-05,PF/BT,50506,COLLI VACC. ADULTI,VEN,30-39,2,0,0,2,0,0,0,2,0,2,Veneto,ITH3
2021-01-05,PF/BT,50506,COLLI VACC. ADULTI,VEN,40-49,2,4,0,6,0,0,0,6,0,6,Veneto,ITH3
2021-01-05,PF/BT,50506,COLLI VACC. ADULTI,VEN,50-59,4,12,0,16,0,0,0,16,0,16,Veneto,ITH3
2021-01-05,PF/BT,50506,COLLI VACC. ADULTI,VEN,60-69,3,2,0,5,0,0,0,5,0,5,Veneto,ITH3
2021-01-05,PF/BT,50506,DIRIGENZA MEDICA P.D.SACCO,VEN,20-29,2,9,0,11,0,0,0,11,0,11,Veneto,ITH3
2021-01-05,PF/BT,50506,DIRIGENZA MEDICA P.D.SACCO,VEN,30-39,4,9,0,13,0,0,0,13,0,13,Veneto,ITH3
2021-01-05,PF/BT,50506,DIRIGENZA MEDICA P.D.SACCO,VEN,40-49,2,22,0,24,0,0,0,24,0,24,Veneto,ITH3
2021-01-05,PF/BT,50506,DIRIGENZA MEDICA P.D.SACCO,VEN,50-59,3,17,0,20,0,0,0,20,0,20,Veneto,ITH3
2021-01-05,PF/BT,50506,DIRIGENZA MEDICA P.D.SACCO,VEN,60-69,3,1,0,4,0,0,0,4,0,4,Veneto,ITH3
2021-01-05,PF/BT,50506,IGIENE PUBBLICA RUBANO,VEN,20-29,1,2,0,2,1,0,0,3,0,3,Veneto,ITH3
2021-01-05,PF/BT,50506,IGIENE PUBBLICA RUBANO,VEN,30-39,0,5,0,5,0,0,0,5,0,5,Veneto,ITH3
2021-01-05,PF/BT,50506,IGIENE PUBBLICA RUBANO,VEN,40-49,3,6,0,9,0,0,0,9,0,9,Veneto,ITH3
2021-01-05,PF/BT,50506,IGIENE PUBBLICA RUBANO,VEN,50-59,5,14,0,16,3,0,0,19,0,19,Veneto,ITH3
2021-01-05,PF/BT,50506,IGIENE PUBBLICA RUBANO,VEN,60-69,9,9,0,17,1,0,0,18,0,18,Veneto,ITH3
2021-01-05,PF/BT,50506,MONSELICE,VEN,20-29,0,3,0,3,0,0,0,3,0,3,Veneto,ITH3
2021-01-05,PF/BT,50506,MONSELICE,VEN,30-39,1,7,0,5,3,0,0,8,0,8,Veneto,ITH3
2021-01-05,PF/BT,50506,MONSELICE,VEN,40-49,0,8,0,6,2,0,0,8,0,8,Veneto,ITH3
2021-01-05,PF/BT,50506,MONSELICE,VEN,50-59,8,16,0,17,6,0,1,24,0,24,Veneto,ITH3
2021-01-05,PF/BT,50506,MONSELICE,VEN,60-69,16,7,0,17,2,0,4,23,0,23,Veneto,ITH3
2021-01-05,PF/BT,50506,SCHIAVONIA AMBULATORIO,VEN,20-29,3,10,0,13,0,0,0,13,0,13,Veneto,ITH3
2021-01-05,PF/BT,50506,SCHIAVONIA AMBULATORIO,VEN,30-39,8,17,0,25,0,0,0,25,0,25,Veneto,ITH3
2021-01-05,PF/BT,50506,SCHIAVONIA AMBULATORIO,VEN,40-49,17,25,0,40,0,0,2,42,0,42,Veneto,ITH3
2021-01-05,PF/BT,50506,SCHIAVONIA AMBULATORIO,VEN,50-59,17,49,0,64,0,0,2,66,0,66,Veneto,ITH3
2021-01-05,PF/BT,50506,SCHIAVONIA AMBULATORIO,VEN,60-69,8,8,0,16,0,0,0,16,0,16,Veneto,ITH3
2021-01-05,PF/BT,50506,SET.IGIENE PUBBLICA EPID.E PROF. MAL.INF,VEN,16-19,0,1,0,0,1,0,0,1,0,1,Veneto,ITH3
2021-01-05,PF/BT,50506,SET.IGIENE PUBBLICA EPID.E PROF. MAL.INF,VEN,20-29,3,7,0,8,2,0,0,10,0,10,Veneto,ITH3
2021-01-05,PF/BT,50506,SET.IGIENE PUBBLICA EPID.E PROF. MAL.INF,VEN,30-39,2,3,0,1,4,0,0,5,0,5,Veneto,ITH3
2021-01-05,PF/BT,50506,SET.IGIENE PUBBLICA EPID.E PROF. MAL.INF,VEN,40-49,3,2,0,2,3,0,0,5,0,5,Veneto,ITH3
2021-01-05,PF/BT,50506,SET.IGIENE PUBBLICA EPID.E PROF. MAL.INF,VEN,50-59,4,7,0,6,5,0,0,11,0,11,Veneto,ITH3
2021-01-05,PF/BT,50506,SET.IGIENE PUBBLICA EPID.E PROF. MAL.INF,VEN,60-69,7,6,0,7,5,0,1,13,0,13,Veneto,ITH3
2021-01-05,PF/BT,50506,SET.IGIENE PUBBLICA EPID.E PROF. MAL.INF,VEN,70-79,1,0,0,0,1,0,0,1,0,1,Veneto,ITH3
2021-01-05,PF/BT,50506,VIA SCROVEGNI ANTI INFLUENZALE,VEN,40-49,0,1,0,1,0,0,0,1,0,1,Veneto,ITH3
2021-01-05,PF/BT,50506,VIA SCROVEGNI ANTI INFLUENZALE,VEN,50-59,0,6,0,6,0,0,0,6,0,6,Veneto,ITH3
2021-01-05,PF/BT,50506,VIA SCROVEGNI ANTI INFLUENZALE,VEN,60-69,2,3,0,4,0,0,1,5,0,5,Veneto,ITH3
2021-01-05,PF/BT,50506,VIA TEMANZA ANTI INFLUENZALE,VEN,20-29,0,2,0,2,0,0,0,2,0,2,Veneto,ITH3
2021-01-05,PF/BT,50506,VIA TEMANZA ANTI INFLUENZALE,VEN,30-39,2,2,0,4,0,0,0,4,0,4,Veneto,ITH3
2021-01-05,PF/BT,50506,VIA TEMANZA ANTI INFLUENZALE,VEN,40-49,0,6,0,6,0,0,0,6,0,6,Veneto,ITH3
2021-01-05,PF/BT,50506,VIA TEMANZA ANTI INFLUENZALE,VEN,50-59,3,3,0,6,0,0,0,6,0,6,Veneto,ITH3
2021-01-05,PF/BT,50506,VIA TEMANZA ANTI INFLUENZALE,VEN,60-69,7,5,0,12,0,0,0,12,0,12,Veneto,ITH3
2021-01-05,PF/BT,50507,EX OSPEDALE - BOLDRINI,VEN,20-29,0,1,0,1,0,0,0,1,0,1,Veneto,ITH3
2021-01-05,PF/BT,50507,EX OSPEDALE - BOLDRINI,VEN,40-49,2,1,0,3,0,0,0,3,0,3,Veneto,ITH3
2021-01-05,PF/BT,50507,EX OSPEDALE - BOLDRINI,VEN,50-59,3,5,0,8,0,0,0,8,0,8,Veneto,ITH3
2021-01-05,PF/BT,50507,EX OSPEDALE - BOLDRINI,VEN,60-69,5,0,0,5,0,0,0,5,0,5,Veneto,ITH3
2021-01-05,PF/BT,50507,H BASSANO,VEN,20-29,2,6,0,7,1,0,0,8,0,8,Veneto,ITH3
2021-01-05,PF/BT,50507,H BASSANO,VEN,30-39,8,8,0,16,0,0,0,16,0,16,Veneto,ITH3
2021-01-05,PF/BT,50507,H BASSANO,VEN,40-49,5,25,0,27,3,0,0,30,0,30,Veneto,ITH3
2021-01-05,PF/BT,50507,H BASSANO,VEN,50-59,14,40,0,46,8,0,0,54,0,54,Veneto,ITH3
2021-01-05,PF/BT,50507,H BASSANO,VEN,60-69,5,7,0,9,3,0,0,12,0,12,Veneto,ITH3
2021-01-05,PF/BT,50507,THIENE,VEN,20-29,1,6,0,7,0,0,0,7,0,7,Veneto,ITH3
2021-01-05,PF/BT,50507,THIENE,VEN,30-39,3,13,0,16,0,0,0,16,0,16,Veneto,ITH3
2021-01-05,PF/BT,50507,THIENE,VEN,40-49,4,18,0,22,0,0,0,22,0,22,Veneto,ITH3
2021-01-05,PF/BT,50507,THIENE,VEN,50-59,9,42,0,51,0,0,0,51,0,51,Veneto,ITH3
2021-01-05,PF/BT,50507,THIENE,VEN,60-69,5,5,0,10,0,0,0,10,0,10,Veneto,ITH3
2021-01-05,PF/BT,50507,THIENE,VEN,70-79,1,0,0,1,0,0,0,1,0,1,Veneto,ITH3
2021-01-05,PF/BT,50508,ARZIGNANO,VEN,20-29,1,10,0,11,0,0,0,11,0,11,Veneto,ITH3
2021-01-05,PF/BT,50508,ARZIGNANO,VEN,30-39,7,22,0,27,0,0,2,29,0,29,Veneto,ITH3
2021-01-05,PF/BT,50508,ARZIGNANO,VEN,40-49,9,30,0,38,0,0,1,39,0,39,Veneto,ITH3
2021-01-05,PF/BT,50508,ARZIGNANO,VEN,50-59,12,41,0,43,0,0,10,53,0,53,Veneto,ITH3
2021-01-05,PF/BT,50508,ARZIGNANO,VEN,60-69,9,7,0,13,0,0,3,16,0,16,Veneto,ITH3
2021-01-05,PF/BT,50508,ARZIGNANO,VEN,70-79,1,0,0,1,0,0,0,1,0,1,Veneto,ITH3
2021-01-05,PF/BT,50508,SISP IV NOVEMBRE,VEN,20-29,10,37,0,47,0,0,0,47,0,47,Veneto,ITH3
2021-01-05,PF/BT,50508,SISP IV NOVEMBRE,VEN,30-39,22,42,0,62,0,0,2,64,0,64,Veneto,ITH3
2021-01-05,PF/BT,50508,SISP IV NOVEMBRE,VEN,40-49,24,65,0,79,0,0,10,89,0,89,Veneto,ITH3
2021-01-05,PF/BT,50508,SISP IV NOVEMBRE,VEN,50-59,20,85,0,86,2,0,17,105,0,105,Veneto,ITH3
2021-01-05,PF/BT,50508,SISP IV NOVEMBRE,VEN,60-69,15,19,0,28,0,0,6,34,0,34,Veneto,ITH3
2021-01-05,PF/BT,50508,SISP IV NOVEMBRE,VEN,70-79,2,0,0,2,0,0,0,2,0,2,Veneto,ITH3
2021-01-05,PF/BT,50509,LEGNAGO,VEN,20-29,5,18,0,18,4,0,1,23,0,23,Veneto,ITH3
2021-01-05,PF/BT,50509,LEGNAGO,VEN,30-39,19,31,0,42,5,0,3,50,0,50,Veneto,ITH3
2021-01-05,PF/BT,50509,LEGNAGO,VEN,40-49,14,73,0,75,9,0,3,87,0,87,Veneto,ITH3
2021-01-05,PF/BT,50509,LEGNAGO,VEN,50-59,20,138,0,106,35,0,17,158,0,158,Veneto,ITH3
2021-01-05,PF/BT,50509,LEGNAGO,VEN,60-69,22,24,0,38,6,0,2,46,0,46,Veneto,ITH3
2021-01-05,PF/BT,50509,LEGNAGO,VEN,70-79,1,0,0,0,1,0,0,1,0,1,Veneto,ITH3
2021-01-05,PF/BT,50509,SAN BONIFACIO,VEN,20-29,6,10,0,12,3,0,1,16,0,16,Veneto,ITH3
2021-01-05,PF/BT,50509,SAN BONIFACIO,VEN,30-39,14,37,0,49,2,0,0,51,0,51,Veneto,ITH3
2021-01-05,PF/BT,50509,SAN BONIFACIO,VEN,40-49,13,53,0,49,13,0,4,66,0,66,Veneto,ITH3
2021-01-05,PF/BT,50509,SAN BONIFACIO,VEN,50-59,20,94,0,83,25,0,6,114,0,114,Veneto,ITH3
2021-01-05,PF/BT,50509,SAN BONIFACIO,VEN,60-69,13,29,0,36,4,0,2,42,0,42,Veneto,ITH3
2021-01-05,PF/BT,5091201,AOUIVR,VEN,20-29,49,79,0,128,0,0,0,128,0,128,Veneto,ITH3
2021-01-05,PF/BT,5091201,AOUIVR,VEN,30-39,49,101,0,148,1,0,1,150,0,150,Veneto,ITH3
2021-01-05,PF/BT,5091201,AOUIVR,VEN,40-49,44,102,0,146,0,0,0,146,0,146,Veneto,ITH3
2021-01-05,PF/BT,5091201,AOUIVR,VEN,50-59,51,121,0,170,2,0,0,172,0,172,Veneto,ITH3
2021-01-05,PF/BT,5091201,AOUIVR,VEN,60-69,19,14,0,33,0,0,0,33,0,33,Veneto,ITH3
2021-01-05,PF/BT,5095201,IOV,VEN,20-29,1,9,0,10,0,0,0,10,0,10,Veneto,ITH3
2021-01-05,PF/BT,5095201,IOV,VEN,30-39,4,10,0,14,0,0,0,14,0,14,Veneto,ITH3
2021-01-05,PF/BT,5095201,IOV,VEN,40-49,4,9,0,13,0,0,0,13,0,13,Veneto,ITH3
2021-01-05,PF/BT,5095201,IOV,VEN,50-59,2,8,0,10,0,0,0,10,0,10,Veneto,ITH3
2021-01-05,PF/BT,5095201,IOV,VEN,60-69,0,1,0,1,0,0,0,1,0,1,Veneto,ITH3
2021-01-05,PF/BT,521630,R.S.A. 'IL GIRASOLE',VEN,20-29,0,1,0,1,0,0,0,1,0,1,Veneto,ITH3
2021-01-05,PF/BT,521630,R.S.A. 'IL GIRASOLE',VEN,40-49,0,3,0,2,1,0,0,3,0,3,Veneto,ITH3
2021-01-05,PF/BT,610952,O.I.C. CENTRO NAZARETH,VEN,20-29,0,1,0,1,0,0,0,1,0,1,Veneto,ITH3
2021-01-05,PF/BT,610952,O.I.C. CENTRO NAZARETH,VEN,80-89,0,1,0,0,0,1,0,1,0,1,Veneto,ITH3
2021-01-05,PF/BT,610955,OPSA - OPERA PROVVIDENZA S.ANTONIO DISABILI,VEN,20-29,0,2,0,2,0,0,0,2,0,2,Veneto,ITH3
2021-01-05,PF/BT,610955,OPSA - OPERA PROVVIDENZA S.ANTONIO DISABILI,VEN,30-39,3,6,0,3,1,4,1,9,0,9,Veneto,ITH3
2021-01-05,PF/BT,610955,OPSA - OPERA PROVVIDENZA S.ANTONIO DISABILI,VEN,40-49,14,6,0,12,2,2,4,20,0,20,Veneto,ITH3
2021-01-05,PF/BT,610955,OPSA - OPERA PROVVIDENZA S.ANTONIO DISABILI,VEN,50-59,8,17,0,4,4,12,5,25,0,25,Veneto,ITH3
2021-01-05,PF/BT,610955,OPSA - OPERA PROVVIDENZA S.ANTONIO DISABILI,VEN,60-69,10,12,0,0,2,20,0,22,0,22,Veneto,ITH3
2021-01-05,PF/BT,610955,OPSA - OPERA PROVVIDENZA S.ANTONIO DISABILI,VEN,70-79,4,10,0,0,1,13,0,14,0,14,Veneto,ITH3
2021-01-05,PF/BT,610955,OPSA - OPERA PROVVIDENZA S.ANTONIO DISABILI,VEN,80-89,1,3,0,0,0,4,0,4,0,4,Veneto,ITH3
2021-01-05,PF/BT,611138,CASA DI RIPOSO DI NOVENTA PADOVANA - CENTRO DIURNO 'LE MAGNOLIE',VEN,30-39,4,1,0,3,2,0,0,5,0,5,Veneto,ITH3
2021-01-05,PF/BT,611138,CASA DI RIPOSO DI NOVENTA PADOVANA - CENTRO DIURNO 'LE MAGNOLIE',VEN,40-49,1,6,0,6,1,0,0,7,0,7,Veneto,ITH3
2021-01-05,PF/BT,611138,CASA DI RIPOSO DI NOVENTA PADOVANA - CENTRO DIURNO 'LE MAGNOLIE',VEN,50-59,1,8,0,6,2,1,0,9,0,9,Veneto,ITH3
2021-01-05,PF/BT,611138,CASA DI RIPOSO DI NOVENTA PADOVANA - CENTRO DIURNO 'LE MAGNOLIE',VEN,60-69,0,2,0,0,2,0,0,2,0,2,Veneto,ITH3
2021-01-05,PF/BT,611138,CASA DI RIPOSO DI NOVENTA PADOVANA - CENTRO DIURNO 'LE MAGNOLIE',VEN,70-79,1,4,0,0,0,5,0,5,0,5,Veneto,ITH3
2021-01-05,PF/BT,611138,CASA DI RIPOSO DI NOVENTA PADOVANA - CENTRO DIURNO 'LE MAGNOLIE',VEN,80-89,3,17,0,0,0,20,0,20,0,20,Veneto,ITH3
2021-01-05,PF/BT,611138,CASA DI RIPOSO DI NOVENTA PADOVANA - CENTRO DIURNO 'LE MAGNOLIE',VEN,90+,1,14,0,0,0,15,0,15,0,15,Veneto,ITH3
2021-01-05,PF/BT,611198,OPSA - CASA MASSIMILIANO KOLBE,VEN,50-59,0,3,0,2,1,0,0,3,0,3,Veneto,ITH3
2021-01-05,PF/BT,611234,CASA DEI FONDATORI,VEN,20-29,2,4,0,5,1,0,0,6,0,6,Veneto,ITH3
2021-01-05,PF/BT,611234,CASA DEI FONDATORI,VEN,30-39,3,2,0,5,0,0,0,5,0,5,Veneto,ITH3
2021-01-05,PF/BT,611234,CASA DEI FONDATORI,VEN,40-49,5,9,0,12,2,0,0,14,0,14,Veneto,ITH3
2021-01-05,PF/BT,611234,CASA DEI FONDATORI,VEN,50-59,4,15,0,19,0,0,0,19,0,19,Veneto,ITH3
2021-01-05,PF/BT,611234,CASA DEI FONDATORI,VEN,60-69,2,3,0,4,0,1,0,5,0,5,Veneto,ITH3
2021-01-05,PF/BT,611234,CASA DEI FONDATORI,VEN,70-79,4,4,0,0,0,8,0,8,0,8,Veneto,ITH3
2021-01-05,PF/BT,611234,CASA DEI FONDATORI,VEN,80-89,14,34,0,0,0,48,0,48,0,48,Veneto,ITH3
2021-01-05,PF/BT,611234,CASA DEI FONDATORI,VEN,90+,9,55,0,0,0,64,0,64,0,64,Veneto,ITH3
2021-01-05,PF/BT,611243,CENTRO DI RIFERIMENTO PER LE GRAVI DISABILITA' E DISTIURBI DEL COMPORTAMENTO,VEN,20-29,2,2,0,1,1,2,0,4,0,4,Veneto,ITH3
2021-01-05,PF/BT,611243,CENTRO DI RIFERIMENTO PER LE GRAVI DISABILITA' E DISTIURBI DEL COMPORTAMENTO,VEN,30-39,0,1,0,1,0,0,0,1,0,1,Veneto,ITH3
2021-01-05,PF/BT,611243,CENTRO DI RIFERIMENTO PER LE GRAVI DISABILITA' E DISTIURBI DEL COMPORTAMENTO,VEN,40-49,7,2,0,0,3,6,0,9,0,9,Veneto,ITH3
2021-01-05,PF/BT,611243,CENTRO DI RIFERIMENTO PER LE GRAVI DISABILITA' E DISTIURBI DEL COMPORTAMENTO,VEN,50-59,4,5,0,1,3,5,0,9,0,9,Veneto,ITH3
2021-01-05,PF/BT,611243,CENTRO DI RIFERIMENTO PER LE GRAVI DISABILITA' E DISTIURBI DEL COMPORTAMENTO,VEN,60-69,6,0,0,0,0,6,0,6,0,6,Veneto,ITH3
2021-01-05,PF/BT,611243,CENTRO DI RIFERIMENTO PER LE GRAVI DISABILITA' E DISTIURBI DEL COMPORTAMENTO,VEN,70-79,0,5,0,0,0,5,0,5,0,5,Veneto,ITH3
2021-01-05,PF/BT,611243,CENTRO DI RIFERIMENTO PER LE GRAVI DISABILITA' E DISTIURBI DEL COMPORTAMENTO,VEN,80-89,0,2,0,0,0,2,0,2,0,2,Veneto,ITH3
2021-01-05,PF/BT,642095,CASA DI RIPOSO MONSELICE,VEN,20-29,1,3,0,2,2,0,0,4,0,4,Veneto,ITH3
2021-01-05,PF/BT,642095,CASA DI RIPOSO MONSELICE,VEN,30-39,3,6,0,3,6,0,0,9,0,9,Veneto,ITH3
2021-01-05,PF/BT,642095,CASA DI RIPOSO MONSELICE,VEN,40-49,2,13,0,9,6,0,0,15,0,15,Veneto,ITH3
2021-01-05,PF/BT,642095,CASA DI RIPOSO MONSELICE,VEN,50-59,5,17,0,14,7,1,0,22,0,22,Veneto,ITH3
2021-01-05,PF/BT,642095,CASA DI RIPOSO MONSELICE,VEN,60-69,6,10,0,8,7,1,0,16,0,16,Veneto,ITH3
2021-01-05,PF/BT,642095,CASA DI RIPOSO MONSELICE,VEN,70-79,6,5,0,1,0,10,0,11,0,11,Veneto,ITH3
2021-01-05,PF/BT,642095,CASA DI RIPOSO MONSELICE,VEN,80-89,1,6,0,0,0,7,0,7,0,7,Veneto,ITH3
2021-01-05,PF/BT,642095,CASA DI RIPOSO MONSELICE,VEN,90+,1,11,0,0,0,12,0,12,0,12,Veneto,ITH3
2021-01-05,PF/BT,642139,RSA BASE 'SERENI ORIZZONTI' CONSELVE,VEN,20-29,0,4,0,4,0,0,0,4,0,4,Veneto,ITH3
2021-01-05,PF/BT,642139,RSA BASE 'SERENI ORIZZONTI' CONSELVE,VEN,30-39,2,5,0,7,0,0,0,7,0,7,Veneto,ITH3
2021-01-05,PF/BT,642139,RSA BASE 'SERENI ORIZZONTI' CONSELVE,VEN,40-49,1,4,0,5,0,0,0,5,0,5,Veneto,ITH3
2021-01-05,PF/BT,642139,RSA BASE 'SERENI ORIZZONTI' CONSELVE,VEN,50-59,4,5,0,4,0,5,0,9,0,9,Veneto,ITH3
2021-01-05,PF/BT,642139,RSA BASE 'SERENI ORIZZONTI' CONSELVE,VEN,60-69,5,2,0,1,0,6,0,7,0,7,Veneto,ITH3
2021-01-05,PF/BT,642139,RSA BASE 'SERENI ORIZZONTI' CONSELVE,VEN,70-79,4,4,0,0,0,8,0,8,0,8,Veneto,ITH3
2021-01-05,PF/BT,642139,RSA BASE 'SERENI ORIZZONTI' CONSELVE,VEN,80-89,4,15,0,0,0,19,0,19,0,19,Veneto,ITH3
2021-01-05,PF/BT,642139,RSA BASE 'SERENI ORIZZONTI' CONSELVE,VEN,90+,2,11,0,0,0,13,0,13,0,13,Veneto,ITH3
2021-01-05,PF/BT,642143,CENTRO SERVIZI PERSONE NON AUTOSUFFICIENTI BOVOLENTA,VEN,70-79,0,2,0,0,0,2,0,2,0,2,Veneto,ITH3
2021-01-05,PF/BT,642143,CENTRO SERVIZI PERSONE NON AUTOSUFFICIENTI BOVOLENTA,VEN,80-89,4,17,0,0,0,21,0,21,0,21,Veneto,ITH3
2021-01-05,PF/BT,642143,CENTRO SERVIZI PERSONE NON AUTOSUFFICIENTI BOVOLENTA,VEN,90+,0,12,0,0,0,12,0,12,0,12,Veneto,ITH3
2021-01-05,PF/BT,683013,IRAS IST. RODIGINO DI ASS. SOC,VEN,40-49,0,1,0,1,0,0,0,1,0,1,Veneto,ITH3
2021-01-05,PF/BT,683013,IRAS IST. RODIGINO DI ASS. SOC,VEN,50-59,0,2,0,2,0,0,0,2,0,2,Veneto,ITH3
2021-01-05,PF/BT,683013,IRAS IST. RODIGINO DI ASS. SOC,VEN,60-69,1,1,0,2,0,0,0,2,0,2,Veneto,ITH3
2021-01-05,PF/BT,683015,CASA DI RIPOSO 'SAN GAETANO',VEN,20-29,1,4,0,2,3,0,0,5,0,5,Veneto,ITH3
2021-01-05,PF/BT,683015,CASA DI RIPOSO 'SAN GAETANO',VEN,30-39,1,6,0,4,3,0,0,7,0,7,Veneto,ITH3
2021-01-05,PF/BT,683015,CASA DI RIPOSO 'SAN GAETANO',VEN,40-49,3,6,0,4,5,0,0,9,0,9,Veneto,ITH3
2021-01-05,PF/BT,683015,CASA DI RIPOSO 'SAN GAETANO',VEN,50-59,4,12,0,8,6,2,0,16,0,16,Veneto,ITH3
2021-01-05,PF/BT,683015,CASA DI RIPOSO 'SAN GAETANO',VEN,60-69,0,2,0,1,1,0,0,2,0,2,Veneto,ITH3
2021-01-05,PF/BT,683015,CASA DI RIPOSO 'SAN GAETANO',VEN,70-79,5,1,0,0,0,6,0,6,0,6,Veneto,ITH3
2021-01-05,PF/BT,683015,CASA DI RIPOSO 'SAN GAETANO',VEN,80-89,7,13,0,0,0,20,0,20,0,20,Veneto,ITH3
2021-01-05,PF/BT,683015,CASA DI RIPOSO 'SAN GAETANO',VEN,90+,3,21,0,0,0,24,0,24,0,24,Veneto,ITH3
2021-01-05,PF/BT,721024,CASA DI RIPOSO OPERA PIA 'FRANCESCO BOTTONI' - PAPOZZE,VEN,30-39,0,6,0,3,3,0,0,6,0,6,Veneto,ITH3
2021-01-05,PF/BT,721024,CASA DI RIPOSO OPERA PIA 'FRANCESCO BOTTONI' - PAPOZZE,VEN,40-49,0,7,0,2,5,0,0,7,0,7,Veneto,ITH3
2021-01-05,PF/BT,721024,CASA DI RIPOSO OPERA PIA 'FRANCESCO BOTTONI' - PAPOZZE,VEN,50-59,2,6,0,6,1,1,0,8,0,8,Veneto,ITH3
2021-01-05,PF/BT,721024,CASA DI RIPOSO OPERA PIA 'FRANCESCO BOTTONI' - PAPOZZE,VEN,60-69,1,5,0,4,1,1,0,6,0,6,Veneto,ITH3
2021-01-05,PF/BT,721024,CASA DI RIPOSO OPERA PIA 'FRANCESCO BOTTONI' - PAPOZZE,VEN,70-79,2,5,0,0,0,7,0,7,0,7,Veneto,ITH3
2021-01-05,PF/BT,721024,CASA DI RIPOSO OPERA PIA 'FRANCESCO BOTTONI' - PAPOZZE,VEN,80-89,4,19,0,0,0,23,0,23,0,23,Veneto,ITH3
2021-01-05,PF/BT,721024,CASA DI RIPOSO OPERA PIA 'FRANCESCO BOTTONI' - PAPOZZE,VEN,90+,2,18,0,0,0,20,0,20,0,20,Veneto,ITH3
2021-01-05,PF/BT,721027,RSA 'IL GABBIANO' - Porto Viro,VEN,20-29,1,0,0,0,0,1,0,1,0,1,Veneto,ITH3
2021-01-05,PF/BT,721027,RSA 'IL GABBIANO' - Porto Viro,VEN,30-39,1,3,0,1,0,3,0,4,0,4,Veneto,ITH3
2021-01-05,PF/BT,721027,RSA 'IL GABBIANO' - Porto Viro,VEN,40-49,2,2,0,1,0,3,0,4,0,4,Veneto,ITH3
2021-01-05,PF/BT,721027,RSA 'IL GABBIANO' - Porto Viro,VEN,50-59,6,1,0,0,0,7,0,7,0,7,Veneto,ITH3
2021-01-05,PF/BT,721027,RSA 'IL GABBIANO' - Porto Viro,VEN,60-69,0,1,0,0,0,1,0,1,0,1,Veneto,ITH3
2021-01-05,PF/BT,768203,CENTRO SERVIZI PER ANZIANI LE BETULLE,VEN,20-29,0,7,0,6,1,0,0,7,0,7,Veneto,ITH3
2021-01-05,PF/BT,768203,CENTRO SERVIZI PER ANZIANI LE BETULLE,VEN,30-39,1,4,0,2,3,0,0,5,0,5,Veneto,ITH3
2021-01-05,PF/BT,768203,CENTRO SERVIZI PER ANZIANI LE BETULLE,VEN,40-49,3,5,0,4,4,0,0,8,0,8,Veneto,ITH3
2021-01-05,PF/BT,768203,CENTRO SERVIZI PER ANZIANI LE BETULLE,VEN,50-59,3,8,0,5,5,1,0,11,0,11,Veneto,ITH3
2021-01-05,PF/BT,768203,CENTRO SERVIZI PER ANZIANI LE BETULLE,VEN,60-69,1,7,0,3,5,0,0,8,0,8,Veneto,ITH3
2021-01-05,PF/BT,768203,CENTRO SERVIZI PER ANZIANI LE BETULLE,VEN,70-79,5,8,0,0,7,6,0,13,0,13,Veneto,ITH3
2021-01-05,PF/BT,768203,CENTRO SERVIZI PER ANZIANI LE BETULLE,VEN,80-89,6,10,0,0,0,16,0,16,0,16,Veneto,ITH3
2021-01-05,PF/BT,768203,CENTRO SERVIZI PER ANZIANI LE BETULLE,VEN,90+,2,28,0,0,1,29,0,30,0,30,Veneto,ITH3
2021-01-05,PF/BT,84001,O.I.C. - ASIAGO,VEN,20-29,0,4,0,2,2,0,0,4,0,4,Veneto,ITH3
2021-01-05,PF/BT,84001,O.I.C. - ASIAGO,VEN,30-39,2,7,0,7,2,0,0,9,0,9,Veneto,ITH3
2021-01-05,PF/BT,84001,O.I.C. - ASIAGO,VEN,40-49,4,4,0,4,4,0,0,8,0,8,Veneto,ITH3
2021-01-05,PF/BT,84001,O.I.C. - ASIAGO,VEN,50-59,7,14,0,11,7,3,0,21,0,21,Veneto,ITH3
2021-01-05,PF/BT,84001,O.I.C. - ASIAGO,VEN,60-69,7,9,0,4,1,11,0,16,0,16,Veneto,ITH3
2021-01-05,PF/BT,84001,O.I.C. - ASIAGO,VEN,70-79,4,3,0,0,0,7,0,7,0,7,Veneto,ITH3
2021-01-05,PF/BT,84001,O.I.C. - ASIAGO,VEN,80-89,2,8,0,0,0,10,0,10,0,10,Veneto,ITH3
2021-01-05,PF/BT,84001,O.I.C. - ASIAGO,VEN,90+,1,4,0,0,0,5,0,5,0,5,Veneto,ITH3
2021-01-05,PF/BT,845232,CASA DEL CLERO,VEN,70-79,1,0,0,0,0,1,0,1,0,1,Veneto,ITH3
2021-01-05,PF/BT,845232,CASA DEL CLERO,VEN,80-89,4,3,0,0,0,7,0,7,0,7,Veneto,ITH3
2021-01-05,PF/BT,845232,CASA DEL CLERO,VEN,90+,3,1,0,0,0,4,0,4,0,4,Veneto,ITH3
2021-01-05,PF/BT,845233,CASA PEREZ,VEN,50-59,2,0,0,0,0,2,0,2,0,2,Veneto,ITH3
2021-01-05,PF/BT,845233,CASA PEREZ,VEN,60-69,6,3,0,0,0,9,0,9,0,9,Veneto,ITH3
2021-01-05,PF/BT,845233,CASA PEREZ,VEN,70-79,5,4,0,0,0,9,0,9,0,9,Veneto,ITH3
2021-01-05,PF/BT,845234,CASA NOGARE',VEN,60-69,3,1,0,0,0,4,0,4,0,4,Veneto,ITH3
2021-01-05,PF/BT,845234,CASA NOGARE',VEN,70-79,1,2,0,0,0,3,0,3,0,3,Veneto,ITH3
2021-01-05,PF/BT,845234,CASA NOGARE',VEN,80-89,2,3,0,0,0,5,0,5,0,5,Veneto,ITH3
2021-01-05,PF/BT,845234,CASA NOGARE',VEN,90+,1,13,0,0,0,14,0,14,0,14,Veneto,ITH3
2021-01-05,PF/BT,845237,RSA DI CURA E REC. CASA NOGARE,VEN,50-59,1,0,0,0,0,1,0,1,0,1,Veneto,ITH3
2021-01-05,PF/BT,845237,RSA DI CURA E REC. CASA NOGARE,VEN,70-79,2,0,0,0,0,2,0,2,0,2,Veneto,ITH3
2021-01-05,PF/BT,845237,RSA DI CURA E REC. CASA NOGARE,VEN,80-89,1,0,0,0,0,1,0,1,0,1,Veneto,ITH3
2021-01-06,PF/BT,132227,C.R.'CASA NOSTRA' - VALDASTICO,VEN,20-29,0,4,0,2,2,0,0,4,0,4,Veneto,ITH3
2021-01-06,PF/BT,132227,C.R.'CASA NOSTRA' - VALDASTICO,VEN,30-39,3,3,0,3,3,0,0,6,0,6,Veneto,ITH3
2021-01-06,PF/BT,132227,C.R.'CASA NOSTRA' - VALDASTICO,VEN,40-49,2,12,0,9,5,0,0,14,0,14,Veneto,ITH3
2021-01-06,PF/BT,132227,C.R.'CASA NOSTRA' - VALDASTICO,VEN,50-59,1,15,0,9,6,1,0,16,0,16,Veneto,ITH3
2021-01-06,PF/BT,132227,C.R.'CASA NOSTRA' - VALDASTICO,VEN,60-69,2,3,0,0,4,1,0,5,0,5,Veneto,ITH3
2021-01-06,PF/BT,132227,C.R.'CASA NOSTRA' - VALDASTICO,VEN,70-79,4,5,0,0,0,9,0,9,0,9,Veneto,ITH3
2021-01-06,PF/BT,132227,C.R.'CASA NOSTRA' - VALDASTICO,VEN,80-89,7,15,0,0,0,22,0,22,0,22,Veneto,ITH3
2021-01-06,PF/BT,132227,C.R.'CASA NOSTRA' - VALDASTICO,VEN,90+,4,10,0,0,0,14,0,14,0,14,Veneto,ITH3
2021-01-06,PF/BT,208036,CASA DI RIPOSO PAOLA GIACONI BONAGURO,VEN,20-29,0,3,0,3,0,0,0,3,0,3,Veneto,ITH3
2021-01-06,PF/BT,208036,CASA DI RIPOSO PAOLA GIACONI BONAGURO,VEN,30-39,0,2,0,2,0,0,0,2,0,2,Veneto,ITH3
2021-01-06,PF/BT,208036,CASA DI RIPOSO PAOLA GIACONI BONAGURO,VEN,40-49,0,8,0,3,4,1,0,8,0,8,Veneto,ITH3
2021-01-06,PF/BT,208036,CASA DI RIPOSO PAOLA GIACONI BONAGURO,VEN,50-59,2,10,0,8,3,1,0,12,0,12,Veneto,ITH3
2021-01-06,PF/BT,208036,CASA DI RIPOSO PAOLA GIACONI BONAGURO,VEN,60-69,1,2,0,1,2,0,0,3,0,3,Veneto,ITH3
2021-01-06,PF/BT,208036,CASA DI RIPOSO PAOLA GIACONI BONAGURO,VEN,80-89,0,19,0,0,0,19,0,19,0,19,Veneto,ITH3
2021-01-06,PF/BT,208036,CASA DI RIPOSO PAOLA GIACONI BONAGURO,VEN,90+,1,10,0,0,0,11,0,11,0,11,Veneto,ITH3
2021-01-06,PF/BT,284007,"CENTRO DI SERVIZI RESIDENZIALE ""OPERE PIE D'ONIGO"" PEDEROBBA",VEN,20-29,3,6,0,7,0,2,0,9,0,9,Veneto,ITH3
2021-01-06,PF/BT,284007,"CENTRO DI SERVIZI RESIDENZIALE ""OPERE PIE D'ONIGO"" PEDEROBBA",VEN,30-39,4,17,0,16,3,1,1,21,0,21,Veneto,ITH3
2021-01-06,PF/BT,284007,"CENTRO DI SERVIZI RESIDENZIALE ""OPERE PIE D'ONIGO"" PEDEROBBA",VEN,40-49,13,50,0,48,10,5,0,63,0,63,Veneto,ITH3
2021-01-06,PF/BT,284007,"CENTRO DI SERVIZI RESIDENZIALE ""OPERE PIE D'ONIGO"" PEDEROBBA",VEN,50-59,18,65,0,49,19,15,0,83,0,83,Veneto,ITH3
2021-01-06,PF/BT,284007,"CENTRO DI SERVIZI RESIDENZIALE ""OPERE PIE D'ONIGO"" PEDEROBBA",VEN,60-69,10,22,0,8,7,17,0,32,0,32,Veneto,ITH3
2021-01-06,PF/BT,284007,"CENTRO DI SERVIZI RESIDENZIALE ""OPERE PIE D'ONIGO"" PEDEROBBA",VEN,70-79,18,8,0,1,1,24,0,26,0,26,Veneto,ITH3
2021-01-06,PF/BT,284007,"CENTRO DI SERVIZI RESIDENZIALE ""OPERE PIE D'ONIGO"" PEDEROBBA",VEN,80-89,11,27,0,0,0,38,0,38,0,38,Veneto,ITH3
2021-01-06,PF/BT,284007,"CENTRO DI SERVIZI RESIDENZIALE ""OPERE PIE D'ONIGO"" PEDEROBBA",VEN,90+,4,40,0,0,0,44,0,44,0,44,Veneto,ITH3
2021-01-06,PF/BT,363790,C. SERV.RES.ANZ.- CA' VIO,VEN,20-29,2,0,0,2,0,0,0,2,0,2,Veneto,ITH3
2021-01-06,PF/BT,363790,C. SERV.RES.ANZ.- CA' VIO,VEN,30-39,1,3,0,2,2,0,0,4,0,4,Veneto,ITH3
2021-01-06,PF/BT,363790,C. SERV.RES.ANZ.- CA' VIO,VEN,40-49,3,5,0,5,3,0,0,8,0,8,Veneto,ITH3
2021-01-06,PF/BT,363790,C. SERV.RES.ANZ.- CA' VIO,VEN,50-59,2,2,0,2,1,1,0,4,0,4,Veneto,ITH3
2021-01-06,PF/BT,363790,C. SERV.RES.ANZ.- CA' VIO,VEN,70-79,2,1,0,0,0,3,0,3,0,3,Veneto,ITH3
2021-01-06,PF/BT,363790,C. SERV.RES.ANZ.- CA' VIO,VEN,80-89,3,15,0,0,0,18,0,18,0,18,Veneto,ITH3
2021-01-06,PF/BT,363790,C. SERV.RES.ANZ.- CA' VIO,VEN,90+,1,19,0,0,0,20,0,20,0,20,Veneto,ITH3
2021-01-06,PF/BT,42822,CASA DI RIPOSO DI MEL - C.S.A. 'SBARDELLA',VEN,16-19,0,1,0,1,0,0,0,1,0,1,Veneto,ITH3
2021-01-06,PF/BT,42822,CASA DI RIPOSO DI MEL - C.S.A. 'SBARDELLA',VEN,20-29,2,12,0,14,0,0,0,14,0,14,Veneto,ITH3
2021-01-06,PF/BT,42822,CASA DI RIPOSO DI MEL - C.S.A. 'SBARDELLA',VEN,30-39,1,6,0,6,1,0,0,7,0,7,Veneto,ITH3
2021-01-06,PF/BT,42822,CASA DI RIPOSO DI MEL - C.S.A. 'SBARDELLA',VEN,40-49,3,13,0,10,6,0,0,16,0,16,Veneto,ITH3
2021-01-06,PF/BT,42822,CASA DI RIPOSO DI MEL - C.S.A. 'SBARDELLA',VEN,50-59,3,11,0,13,1,0,0,14,0,14,Veneto,ITH3
2021-01-06,PF/BT,42822,CASA DI RIPOSO DI MEL - C.S.A. 'SBARDELLA',VEN,60-69,0,2,0,1,1,0,0,2,0,2,Veneto,ITH3
2021-01-06,PF/BT,42826,C.S.A. COMUNALE,VEN,20-29,2,6,0,7,1,0,0,8,0,8,Veneto,ITH3
2021-01-06,PF/BT,42826,C.S.A. COMUNALE,VEN,30-39,4,5,0,8,1,0,0,9,0,9,Veneto,ITH3
2021-01-06,PF/BT,42826,C.S.A. COMUNALE,VEN,40-49,2,6,0,7,1,0,0,8,0,8,Veneto,ITH3
2021-01-06,PF/BT,42826,C.S.A. COMUNALE,VEN,50-59,2,5,0,7,0,0,0,7,0,7,Veneto,ITH3
2021-01-06,PF/BT,42826,C.S.A. COMUNALE,VEN,60-69,2,7,0,3,3,3,0,9,0,9,Veneto,ITH3
2021-01-06,PF/BT,42826,C.S.A. COMUNALE,VEN,70-79,4,0,0,0,0,4,0,4,0,4,Veneto,ITH3
2021-01-06,PF/BT,42826,C.S.A. COMUNALE,VEN,80-89,0,3,0,0,0,3,0,3,0,3,Veneto,ITH3
2021-01-06,PF/BT,42826,C.S.A. COMUNALE,VEN,90+,1,5,0,0,0,6,0,6,0,6,Veneto,ITH3
2021-01-06,PF/BT,486004,C.D.R. 'DON ALLEGRI' - SALZANO,VEN,40-49,0,1,0,0,1,0,0,1,0,1,Veneto,ITH3
2021-01-06,PF/BT,486004,C.D.R. 'DON ALLEGRI' - SALZANO,VEN,50-59,0,1,0,0,0,1,0,1,0,1,Veneto,ITH3
2021-01-06,PF/BT,486004,C.D.R. 'DON ALLEGRI' - SALZANO,VEN,60-69,2,3,0,0,0,5,0,5,0,5,Veneto,ITH3
2021-01-06,PF/BT,486004,C.D.R. 'DON ALLEGRI' - SALZANO,VEN,70-79,1,3,0,0,0,4,0,4,0,4,Veneto,ITH3
2021-01-06,PF/BT,486004,C.D.R. 'DON ALLEGRI' - SALZANO,VEN,80-89,4,24,0,0,0,28,0,28,0,28,Veneto,ITH3
2021-01-06,PF/BT,486004,C.D.R. 'DON ALLEGRI' - SALZANO,VEN,90+,1,25,0,0,0,26,0,26,0,26,Veneto,ITH3
2021-01-06,PF/BT,5001700,OSPEDALE SACRO CUORE DI NEGRAR,VEN,16-19,1,1,0,0,2,0,0,2,0,2,Veneto,ITH3
2021-01-06,PF/BT,5001700,OSPEDALE SACRO CUORE DI NEGRAR,VEN,20-29,17,35,0,40,11,0,1,52,0,52,Veneto,ITH3
2021-01-06,PF/BT,5001700,OSPEDALE SACRO CUORE DI NEGRAR,VEN,30-39,31,59,0,66,22,0,2,90,0,90,Veneto,ITH3
2021-01-06,PF/BT,5001700,OSPEDALE SACRO CUORE DI NEGRAR,VEN,40-49,29,35,0,48,14,0,2,64,0,64,Veneto,ITH3
2021-01-06,PF/BT,5001700,OSPEDALE SACRO CUORE DI NEGRAR,VEN,50-59,44,49,0,72,21,0,0,93,0,93,Veneto,ITH3
2021-01-06,PF/BT,5001700,OSPEDALE SACRO CUORE DI NEGRAR,VEN,60-69,20,11,0,23,8,0,0,31,0,31,Veneto,ITH3
2021-01-06,PF/BT,5001700,OSPEDALE SACRO CUORE DI NEGRAR,VEN,70-79,11,3,0,7,7,0,0,14,0,14,Veneto,ITH3
2021-01-06,PF/BT,5001700,OSPEDALE SACRO CUORE DI NEGRAR,VEN,80-89,3,1,0,0,4,0,0,4,0,4,Veneto,ITH3
2021-01-06,PF/BT,5002200,OSPEDALE P. PEDERZOLI,VEN,20-29,4,16,0,20,0,0,0,20,0,20,Veneto,ITH3
2021-01-06,PF/BT,5002200,OSPEDALE P. PEDERZOLI,VEN,30-39,12,8,0,20,0,0,0,20,0,20,Veneto,ITH3
2021-01-06,PF/BT,5002200,OSPEDALE P. PEDERZOLI,VEN,40-49,7,10,0,17,0,0,0,17,0,17,Veneto,ITH3
2021-01-06,PF/BT,5002200,OSPEDALE P. PEDERZOLI,VEN,50-59,1,10,0,11,0,0,0,11,0,11,Veneto,ITH3
2021-01-06,PF/BT,5002200,OSPEDALE P. PEDERZOLI,VEN,60-69,1,1,0,2,0,0,0,2,0,2,Veneto,ITH3
2021-01-06,PF/BT,5002200,OSPEDALE P. PEDERZOLI,VEN,70-79,1,1,0,1,0,0,1,2,0,2,Veneto,ITH3
2021-01-06,PF/BT,5020,CASA DI RIPOSO LONGARONE,VEN,20-29,1,1,0,2,0,0,0,2,0,2,Veneto,ITH3
2021-01-06,PF/BT,5020,CASA DI RIPOSO LONGARONE,VEN,30-39,0,3,0,2,1,0,0,3,0,3,Veneto,ITH3
2021-01-06,PF/BT,5020,CASA DI RIPOSO LONGARONE,VEN,40-49,1,4,0,3,2,0,0,5,0,5,Veneto,ITH3
2021-01-06,PF/BT,5020,CASA DI RIPOSO LONGARONE,VEN,50-59,1,11,0,8,4,0,0,12,0,12,Veneto,ITH3
2021-01-06,PF/BT,5020,CASA DI RIPOSO LONGARONE,VEN,60-69,0,3,0,3,0,0,0,3,0,3,Veneto,ITH3
2021-01-06,PF/BT,5020,CASA DI RIPOSO LONGARONE,VEN,80-89,1,4,0,0,0,5,0,5,0,5,Veneto,ITH3
2021-01-06,PF/BT,5020,CASA DI RIPOSO LONGARONE,VEN,90+,0,1,0,0,0,1,0,1,0,1,Veneto,ITH3
2021-01-06,PF/BT,50501,"BELLUNO ""DRIVE-IN""",VEN,20-29,1,6,0,7,0,0,0,7,0,7,Veneto,ITH3
2021-01-06,PF/BT,50501,"BELLUNO ""DRIVE-IN""",VEN,30-39,7,20,0,27,0,0,0,27,0,27,Veneto,ITH3
2021-01-06,PF/BT,50501,"BELLUNO ""DRIVE-IN""",VEN,40-49,5,16,0,21,0,0,0,21,0,21,Veneto,ITH3
2021-01-06,PF/BT,50501,"BELLUNO ""DRIVE-IN""",VEN,50-59,7,35,0,41,1,0,0,42,0,42,Veneto,ITH3
2021-01-06,PF/BT,50501,"BELLUNO ""DRIVE-IN""",VEN,60-69,5,8,0,13,0,0,0,13,0,13,Veneto,ITH3
2021-01-06,PF/BT,50501,FELTRE,VEN,20-29,3,7,0,8,2,0,0,10,0,10,Veneto,ITH3
2021-01-06,PF/BT,50501,FELTRE,VEN,30-39,8,10,0,18,0,0,0,18,0,18,Veneto,ITH3
2021-01-06,PF/BT,50501,FELTRE,VEN,40-49,7,27,0,21,13,0,0,34,0,34,Veneto,ITH3
2021-01-06,PF/BT,50501,FELTRE,VEN,50-59,11,35,0,31,15,0,0,46,0,46,Veneto,ITH3
2021-01-06,PF/BT,50501,FELTRE,VEN,60-69,7,8,0,11,4,0,0,15,0,15,Veneto,ITH3
2021-01-06,PF/BT,50501,FELTRE,VEN,70-79,3,0,0,3,0,0,0,3,0,3,Veneto,ITH3
2021-01-06,PF/BT,50502,CASTELFRANCO VENETO,VEN,20-29,12,66,0,72,6,0,0,78,0,78,Veneto,ITH3
2021-01-06,PF/BT,50502,CASTELFRANCO VENETO,VEN,30-39,28,74,0,90,12,0,0,102,0,102,Veneto,ITH3
2021-01-06,PF/BT,50502,CASTELFRANCO VENETO,VEN,40-49,43,154,0,182,15,0,0,197,0,197,Veneto,ITH3
2021-01-06,PF/BT,50502,CASTELFRANCO VENETO,VEN,50-59,59,167,0,191,35,0,0,226,0,226,Veneto,ITH3
2021-01-06,PF/BT,50502,CASTELFRANCO VENETO,VEN,60-69,35,29,0,52,12,0,0,64,0,64,Veneto,ITH3
2021-01-06,PF/BT,5050202,OSPEDALE ODERZO,VEN,20-29,7,25,0,31,1,0,0,32,0,32,Veneto,ITH3
2021-01-06,PF/BT,5050202,OSPEDALE ODERZO,VEN,30-39,14,41,0,53,2,0,0,55,0,55,Veneto,ITH3
2021-01-06,PF/BT,5050202,OSPEDALE ODERZO,VEN,40-49,23,68,0,84,7,0,0,91,0,91,Veneto,ITH3
2021-01-06,PF/BT,5050202,OSPEDALE ODERZO,VEN,50-59,37,127,0,131,33,0,0,164,0,164,Veneto,ITH3
2021-01-06,PF/BT,5050202,OSPEDALE ODERZO,VEN,60-69,25,14,0,34,5,0,0,39,0,39,Veneto,ITH3
2021-01-06,PF/BT,5050202,OSPEDALE ODERZO,VEN,70-79,1,2,0,3,0,0,0,3,0,3,Veneto,ITH3
2021-01-06,PF/BT,5050204,OSPEDALE CONEGLIANO,VEN,16-19,1,0,0,0,1,0,0,1,0,1,Veneto,ITH3
2021-01-06,PF/BT,5050204,OSPEDALE CONEGLIANO,VEN,20-29,23,92,0,111,4,0,0,115,0,115,Veneto,ITH3
2021-01-06,PF/BT,5050204,OSPEDALE CONEGLIANO,VEN,30-39,52,110,0,157,5,0,0,162,0,162,Veneto,ITH3
2021-01-06,PF/BT,5050204,OSPEDALE CONEGLIANO,VEN,40-49,61,155,0,202,12,0,2,216,0,216,Veneto,ITH3
2021-01-06,PF/BT,5050204,OSPEDALE CONEGLIANO,VEN,50-59,55,276,0,305,24,0,2,331,0,331,Veneto,ITH3
2021-01-06,PF/BT,5050204,OSPEDALE CONEGLIANO,VEN,60-69,49,39,0,75,13,0,0,88,0,88,Veneto,ITH3
2021-01-06,PF/BT,50503,CAMPONOGARA ADULTI,VEN,20-29,1,2,0,3,0,0,0,3,0,3,Veneto,ITH3
2021-01-06,PF/BT,50503,CAMPONOGARA ADULTI,VEN,30-39,1,5,0,6,0,0,0,6,0,6,Veneto,ITH3
2021-01-06,PF/BT,50503,CAMPONOGARA ADULTI,VEN,40-49,1,16,0,17,0,0,0,17,0,17,Veneto,ITH3
2021-01-06,PF/BT,50503,CAMPONOGARA ADULTI,VEN,50-59,5,24,0,29,0,0,0,29,0,29,Veneto,ITH3
2021-01-06,PF/BT,50503,CAMPONOGARA ADULTI,VEN,60-69,2,3,0,5,0,0,0,5,0,5,Veneto,ITH3
2021-01-06,PF/BT,50503,MED.PREV - CHIOGGIA,VEN,20-29,4,15,0,19,0,0,0,19,0,19,Veneto,ITH3
2021-01-06,PF/BT,50503,MED.PREV - CHIOGGIA,VEN,30-39,3,16,0,19,0,0,0,19,0,19,Veneto,ITH3
2021-01-06,PF/BT,50503,MED.PREV - CHIOGGIA,VEN,40-49,11,43,0,54,0,0,0,54,0,54,Veneto,ITH3
2021-01-06,PF/BT,50503,MED.PREV - CHIOGGIA,VEN,50-59,12,38,0,50,0,0,0,50,0,50,Veneto,ITH3
2021-01-06,PF/BT,50503,MED.PREV - CHIOGGIA,VEN,60-69,7,12,0,19,0,0,0,19,0,19,Veneto,ITH3
2021-01-06,PF/BT,50503,MED.PREV - CHIOGGIA,VEN,70-79,0,1,0,1,0,0,0,1,0,1,Veneto,ITH3
2021-01-06,PF/BT,50503,MEDICINA PREVENTIVA MESTRE,VEN,16-19,1,1,0,2,0,0,0,2,0,2,Veneto,ITH3
2021-01-06,PF/BT,50503,MEDICINA PREVENTIVA MESTRE,VEN,20-29,15,10,0,22,3,0,0,25,0,25,Veneto,ITH3
2021-01-06,PF/BT,50503,MEDICINA PREVENTIVA MESTRE,VEN,30-39,12,7,0,19,0,0,0,19,0,19,Veneto,ITH3
2021-01-06,PF/BT,50503,MEDICINA PREVENTIVA MESTRE,VEN,40-49,9,11,0,20,0,0,0,20,0,20,Veneto,ITH3
2021-01-06,PF/BT,50503,MEDICINA PREVENTIVA MESTRE,VEN,50-59,11,26,0,34,3,0,0,37,0,37,Veneto,ITH3
2021-01-06,PF/BT,50503,MEDICINA PREVENTIVA MESTRE,VEN,60-69,6,3,0,9,0,0,0,9,0,9,Veneto,ITH3
2021-01-06,PF/BT,50503,MEDICINA PREVENTIVA MESTRE,VEN,70-79,2,0,0,2,0,0,0,2,0,2,Veneto,ITH3
2021-01-06,PF/BT,50503,S.I.S.P. MESTRE,VEN,20-29,11,11,0,22,0,0,0,22,0,22,Veneto,ITH3
2021-01-06,PF/BT,50503,S.I.S.P. MESTRE,VEN,30-39,14,5,0,19,0,0,0,19,0,19,Veneto,ITH3
2021-01-06,PF/BT,50503,S.I.S.P. MESTRE,VEN,40-49,12,23,0,35,0,0,0,35,0,35,Veneto,ITH3
2021-01-06,PF/BT,50503,S.I.S.P. MESTRE,VEN,50-59,9,21,0,30,0,0,0,30,0,30,Veneto,ITH3
2021-01-06,PF/BT,50503,S.I.S.P. MESTRE,VEN,60-69,11,4,0,15,0,0,0,15,0,15,Veneto,ITH3
2021-01-06,PF/BT,50503,S.I.S.P. MESTRE,VEN,70-79,4,0,0,4,0,0,0,4,0,4,Veneto,ITH3
2021-01-06,PF/BT,50503,S.I.S.P. MESTRE,VEN,80-89,0,1,0,1,0,0,0,1,0,1,Veneto,ITH3
2021-01-06,PF/BT,50503,S.I.S.P. VENEZIA,VEN,20-29,4,5,0,3,6,0,0,9,0,9,Veneto,ITH3
2021-01-06,PF/BT,50503,S.I.S.P. VENEZIA,VEN,30-39,9,12,0,8,13,0,0,21,0,21,Veneto,ITH3
2021-01-06,PF/BT,50503,S.I.S.P. VENEZIA,VEN,40-49,3,11,0,5,9,0,0,14,0,14,Veneto,ITH3
2021-01-06,PF/BT,50503,S.I.S.P. VENEZIA,VEN,50-59,2,9,0,6,5,0,0,11,0,11,Veneto,ITH3
2021-01-06,PF/BT,50503,S.I.S.P. VENEZIA,VEN,60-69,2,3,0,2,3,0,0,5,0,5,Veneto,ITH3
2021-01-06,PF/BT,50503,SISP DOLO ADULTI,VEN,20-29,7,15,0,20,1,0,1,22,0,22,Veneto,ITH3
2021-01-06,PF/BT,50503,SISP DOLO ADULTI,VEN,30-39,7,19,0,24,2,0,0,26,0,26,Veneto,ITH3
2021-01-06,PF/BT,50503,SISP DOLO ADULTI,VEN,40-49,8,42,0,48,2,0,0,50,0,50,Veneto,ITH3
2021-01-06,PF/BT,50503,SISP DOLO ADULTI,VEN,50-59,10,44,0,54,0,0,0,54,0,54,Veneto,ITH3
2021-01-06,PF/BT,50503,SISP DOLO ADULTI,VEN,60-69,5,10,0,14,1,0,0,15,0,15,Veneto,ITH3
2021-01-06,PF/BT,50503,SISP DOLO ADULTI,VEN,70-79,1,0,0,1,0,0,0,1,0,1,Veneto,ITH3
2021-01-06,PF/BT,50504,OSPEDALE CIVILE SAN DONA',VEN,20-29,3,9,0,12,0,0,0,12,0,12,Veneto,ITH3
2021-01-06,PF/BT,50504,OSPEDALE CIVILE SAN DONA',VEN,30-39,10,13,0,23,0,0,0,23,0,23,Veneto,ITH3
2021-01-06,PF/BT,50504,OSPEDALE CIVILE SAN DONA',VEN,40-49,5,26,0,31,0,0,0,31,0,31,Veneto,ITH3
2021-01-06,PF/BT,50504,OSPEDALE CIVILE SAN DONA',VEN,50-59,6,39,0,45,0,0,0,45,0,45,Veneto,ITH3
2021-01-06,PF/BT,50504,OSPEDALE CIVILE SAN DONA',VEN,60-69,5,10,0,15,0,0,0,15,0,15,Veneto,ITH3
2021-01-06,PF/BT,50504,SANTO STINO DI LIVENZA,VEN,20-29,0,9,0,9,0,0,0,9,0,9,Veneto,ITH3
2021-01-06,PF/BT,50504,SANTO STINO DI LIVENZA,VEN,30-39,2,12,0,14,0,0,0,14,0,14,Veneto,ITH3
2021-01-06,PF/BT,50504,SANTO STINO DI LIVENZA,VEN,40-49,6,24,0,30,0,0,0,30,0,30,Veneto,ITH3
2021-01-06,PF/BT,50504,SANTO STINO DI LIVENZA,VEN,50-59,6,35,0,41,0,0,0,41,0,41,Veneto,ITH3
2021-01-06,PF/BT,50504,SANTO STINO DI LIVENZA,VEN,60-69,2,5,0,5,2,0,0,7,0,7,Veneto,ITH3
2021-01-06,PF/BT,50505,MAGAZZINO MED. COMPETENTE 05,VEN,20-29,0,1,0,1,0,0,0,1,0,1,Veneto,ITH3
2021-01-06,PF/BT,50505,MAGAZZINO MED. COMPETENTE 05,VEN,30-39,0,3,0,3,0,0,0,3,0,3,Veneto,ITH3
2021-01-06,PF/BT,50505,MAGAZZINO MED. COMPETENTE 05,VEN,40-49,0,7,0,6,1,0,0,7,0,7,Veneto,ITH3
2021-01-06,PF/BT,50505,MAGAZZINO MED. COMPETENTE 05,VEN,50-59,0,14,0,12,2,0,0,14,0,14,Veneto,ITH3
2021-01-06,PF/BT,50505,MAGAZZINO MED. COMPETENTE 05,VEN,60-69,0,3,0,3,0,0,0,3,0,3,Veneto,ITH3
2021-01-06,PF/BT,50505,TRECENTA,VEN,60-69,1,0,0,1,0,0,0,1,0,1,Veneto,ITH3
2021-01-06,PF/BT,5050501,Mancante,VEN,60-69,0,1,0,1,0,0,0,1,0,1,Veneto,ITH3
2021-01-06,PF/BT,5050501,PRESIDIO OSPEDALIERO ROVIGO,VEN,20-29,4,12,0,14,0,0,2,16,0,16,Veneto,ITH3
2021-01-06,PF/BT,5050501,PRESIDIO OSPEDALIERO ROVIGO,VEN,30-39,7,30,0,34,0,0,3,37,0,37,Veneto,ITH3
2021-01-06,PF/BT,5050501,PRESIDIO OSPEDALIERO ROVIGO,VEN,40-49,15,42,0,56,0,0,1,57,0,57,Veneto,ITH3
2021-01-06,PF/BT,5050501,PRESIDIO OSPEDALIERO ROVIGO,VEN,50-59,17,61,0,78,0,0,0,78,0,78,Veneto,ITH3
2021-01-06,PF/BT,5050501,PRESIDIO OSPEDALIERO ROVIGO,VEN,60-69,19,17,0,36,0,0,0,36,0,36,Veneto,ITH3
2021-01-06,PF/BT,5050501,PRESIDIO OSPEDALIERO ROVIGO,VEN,70-79,3,1,0,1,1,0,2,4,0,4,Veneto,ITH3
2021-01-06,PF/BT,50506,AZ OSPEDALIERA DI PADOVA MAL. INFET.E TR,VEN,20-29,52,62,0,114,0,0,0,114,0,114,Veneto,ITH3
2021-01-06,PF/BT,50506,AZ OSPEDALIERA DI PADOVA MAL. INFET.E TR,VEN,30-39,41,61,0,102,0,0,0,102,0,102,Veneto,ITH3
2021-01-06,PF/BT,50506,AZ OSPEDALIERA DI PADOVA MAL. INFET.E TR,VEN,40-49,26,58,0,84,0,0,0,84,0,84,Veneto,ITH3
2021-01-06,PF/BT,50506,AZ OSPEDALIERA DI PADOVA MAL. INFET.E TR,VEN,50-59,23,90,0,113,0,0,0,113,0,113,Veneto,ITH3
2021-01-06,PF/BT,50506,AZ OSPEDALIERA DI PADOVA MAL. INFET.E TR,VEN,60-69,27,15,0,42,0,0,0,42,0,42,Veneto,ITH3
2021-01-06,PF/BT,50506,AZ OSPEDALIERA DI PADOVA MAL. INFET.E TR,VEN,70-79,1,0,0,1,0,0,0,1,0,1,Veneto,ITH3
2021-01-06,PF/BT,50506,CAMPOSAMPIERO MEDICO COMPETENT,VEN,20-29,4,9,0,13,0,0,0,13,0,13,Veneto,ITH3
2021-01-06,PF/BT,50506,CAMPOSAMPIERO MEDICO COMPETENT,VEN,30-39,7,16,0,23,0,0,0,23,0,23,Veneto,ITH3
2021-01-06,PF/BT,50506,CAMPOSAMPIERO MEDICO COMPETENT,VEN,40-49,9,25,0,34,0,0,0,34,0,34,Veneto,ITH3
2021-01-06,PF/BT,50506,CAMPOSAMPIERO MEDICO COMPETENT,VEN,50-59,3,18,0,21,0,0,0,21,0,21,Veneto,ITH3
2021-01-06,PF/BT,50506,CAMPOSAMPIERO MEDICO COMPETENT,VEN,60-69,3,2,0,5,0,0,0,5,0,5,Veneto,ITH3
2021-01-06,PF/BT,50506,CITTADELLA MEDICO COMPETENTE,VEN,20-29,3,17,0,19,0,0,1,20,0,20,Veneto,ITH3
2021-01-06,PF/BT,50506,CITTADELLA MEDICO COMPETENTE,VEN,30-39,5,17,0,20,2,0,0,22,0,22,Veneto,ITH3
2021-01-06,PF/BT,50506,CITTADELLA MEDICO COMPETENTE,VEN,40-49,8,22,0,30,0,0,0,30,0,30,Veneto,ITH3
2021-01-06,PF/BT,50506,CITTADELLA MEDICO COMPETENTE,VEN,50-59,12,21,0,30,3,0,0,33,0,33,Veneto,ITH3
2021-01-06,PF/BT,50506,CITTADELLA MEDICO COMPETENTE,VEN,60-69,4,3,0,5,2,0,0,7,0,7,Veneto,ITH3
2021-01-06,PF/BT,50506,DIRIGENZA MEDICA P.D.SACCO,VEN,20-29,1,5,0,6,0,0,0,6,0,6,Veneto,ITH3
2021-01-06,PF/BT,50506,DIRIGENZA MEDICA P.D.SACCO,VEN,30-39,2,8,0,10,0,0,0,10,0,10,Veneto,ITH3
2021-01-06,PF/BT,50506,DIRIGENZA MEDICA P.D.SACCO,VEN,40-49,4,15,0,19,0,0,0,19,0,19,Veneto,ITH3
2021-01-06,PF/BT,50506,DIRIGENZA MEDICA P.D.SACCO,VEN,50-59,4,20,0,24,0,0,0,24,0,24,Veneto,ITH3
2021-01-06,PF/BT,50506,DIRIGENZA MEDICA P.D.SACCO,VEN,60-69,5,2,0,7,0,0,0,7,0,7,Veneto,ITH3
2021-01-06,PF/BT,50506,DISTR. 3 ALBIGNASEGO AMB.IGIEN,VEN,20-29,2,3,0,5,0,0,0,5,0,5,Veneto,ITH3
2021-01-06,PF/BT,50506,DISTR. 3 ALBIGNASEGO AMB.IGIEN,VEN,30-39,2,6,0,8,0,0,0,8,0,8,Veneto,ITH3
2021-01-06,PF/BT,50506,DISTR. 3 ALBIGNASEGO AMB.IGIEN,VEN,40-49,1,5,0,6,0,0,0,6,0,6,Veneto,ITH3
2021-01-06,PF/BT,50506,DISTR. 3 ALBIGNASEGO AMB.IGIEN,VEN,50-59,2,8,0,10,0,0,0,10,0,10,Veneto,ITH3
2021-01-06,PF/BT,50506,DISTR. 3 ALBIGNASEGO AMB.IGIEN,VEN,60-69,9,4,0,13,0,0,0,13,0,13,Veneto,ITH3
2021-01-06,PF/BT,50506,SCHIAVONIA AMBULATORIO,VEN,20-29,2,7,0,9,0,0,0,9,0,9,Veneto,ITH3
2021-01-06,PF/BT,50506,SCHIAVONIA AMBULATORIO,VEN,30-39,8,7,0,15,0,0,0,15,0,15,Veneto,ITH3
2021-01-06,PF/BT,50506,SCHIAVONIA AMBULATORIO,VEN,40-49,7,12,0,18,1,0,0,19,0,19,Veneto,ITH3
2021-01-06,PF/BT,50506,SCHIAVONIA AMBULATORIO,VEN,50-59,4,20,0,24,0,0,0,24,0,24,Veneto,ITH3
2021-01-06,PF/BT,50506,SCHIAVONIA AMBULATORIO,VEN,60-69,5,5,0,10,0,0,0,10,0,10,Veneto,ITH3
2021-01-06,PF/BT,50506,VIGONZA,VEN,20-29,2,3,0,5,0,0,0,5,0,5,Veneto,ITH3
2021-01-06,PF/BT,50506,VIGONZA,VEN,30-39,1,1,0,2,0,0,0,2,0,2,Veneto,ITH3
2021-01-06,PF/BT,50506,VIGONZA,VEN,40-49,0,4,0,4,0,0,0,4,0,4,Veneto,ITH3
2021-01-06,PF/BT,50506,VIGONZA,VEN,50-59,2,3,0,5,0,0,0,5,0,5,Veneto,ITH3
2021-01-06,PF/BT,50506,VIGONZA,VEN,60-69,8,6,0,14,0,0,0,14,0,14,Veneto,ITH3
2021-01-06,PF/BT,50507,DIPARTIMENTO DI PREVENZIONE,VEN,20-29,1,2,0,3,0,0,0,3,0,3,Veneto,ITH3
2021-01-06,PF/BT,50507,DIPARTIMENTO DI PREVENZIONE,VEN,50-59,0,4,0,4,0,0,0,4,0,4,Veneto,ITH3
2021-01-06,PF/BT,50507,DIPARTIMENTO DI PREVENZIONE,VEN,60-69,0,2,0,2,0,0,0,2,0,2,Veneto,ITH3
2021-01-06,PF/BT,50507,DIPARTIMENTO DI PREVENZIONE,VEN,70-79,1,0,0,1,0,0,0,1,0,1,Veneto,ITH3
2021-01-06,PF/BT,50507,DIPARTIMENTO DI PREVENZIONE,VEN,80-89,0,1,0,0,0,1,0,1,0,1,Veneto,ITH3
2021-01-06,PF/BT,50507,DIPARTIMENTO DI PREVENZIONE,VEN,90+,0,1,0,0,0,1,0,1,0,1,Veneto,ITH3
2021-01-06,PF/BT,50507,EX OSPEDALE - BOLDRINI,VEN,16-19,2,2,0,4,0,0,0,4,0,4,Veneto,ITH3
2021-01-06,PF/BT,50507,EX OSPEDALE - BOLDRINI,VEN,20-29,9,14,0,23,0,0,0,23,0,23,Veneto,ITH3
2021-01-06,PF/BT,50507,EX OSPEDALE - BOLDRINI,VEN,30-39,16,19,0,35,0,0,0,35,0,35,Veneto,ITH3
2021-01-06,PF/BT,50507,EX OSPEDALE - BOLDRINI,VEN,40-49,14,33,0,47,0,0,0,47,0,47,Veneto,ITH3
2021-01-06,PF/BT,50507,EX OSPEDALE - BOLDRINI,VEN,50-59,18,51,0,69,0,0,0,69,0,69,Veneto,ITH3
2021-01-06,PF/BT,50507,EX OSPEDALE - BOLDRINI,VEN,60-69,35,29,0,64,0,0,0,64,0,64,Veneto,ITH3
2021-01-06,PF/BT,50507,EX OSPEDALE - BOLDRINI,VEN,70-79,11,8,0,19,0,0,0,19,0,19,Veneto,ITH3
2021-01-06,PF/BT,50507,H BASSANO,VEN,16-19,0,1,0,0,1,0,0,1,0,1,Veneto,ITH3
2021-01-06,PF/BT,50507,H BASSANO,VEN,20-29,2,10,0,6,6,0,0,12,0,12,Veneto,ITH3
2021-01-06,PF/BT,50507,H BASSANO,VEN,30-39,4,7,0,4,7,0,0,11,0,11,Veneto,ITH3
2021-01-06,PF/BT,50507,H BASSANO,VEN,40-49,4,21,0,14,10,0,1,25,0,25,Veneto,ITH3
2021-01-06,PF/BT,50507,H BASSANO,VEN,50-59,6,16,0,12,10,0,0,22,0,22,Veneto,ITH3
2021-01-06,PF/BT,50507,H BASSANO,VEN,60-69,3,4,0,3,4,0,0,7,0,7,Veneto,ITH3
2021-01-06,PF/BT,50507,THIENE,VEN,20-29,0,3,0,3,0,0,0,3,0,3,Veneto,ITH3
2021-01-06,PF/BT,50507,THIENE,VEN,40-49,1,9,0,10,0,0,0,10,0,10,Veneto,ITH3
2021-01-06,PF/BT,50507,THIENE,VEN,50-59,1,10,0,11,0,0,0,11,0,11,Veneto,ITH3
2021-01-06,PF/BT,50507,THIENE,VEN,60-69,2,1,0,3,0,0,0,3,0,3,Veneto,ITH3
2021-01-06,PF/BT,50509,LEGNAGO,VEN,20-29,15,22,0,20,13,0,4,37,0,37,Veneto,ITH3
2021-01-06,PF/BT,50509,LEGNAGO,VEN,30-39,31,28,0,43,10,0,6,59,0,59,Veneto,ITH3
2021-01-06,PF/BT,50509,LEGNAGO,VEN,40-49,20,49,0,51,13,0,5,69,0,69,Veneto,ITH3
2021-01-06,PF/BT,50509,LEGNAGO,VEN,50-59,26,78,0,68,22,0,14,104,0,104,Veneto,ITH3
2021-01-06,PF/BT,50509,LEGNAGO,VEN,60-69,30,24,0,38,12,0,4,54,0,54,Veneto,ITH3
2021-01-06,PF/BT,50509,LEGNAGO,VEN,70-79,7,2,0,6,0,0,3,9,0,9,Veneto,ITH3
2021-01-06,PF/BT,50509,LEGNAGO,VEN,80-89,1,0,0,0,0,0,1,1,0,1,Veneto,ITH3
2021-01-06,PF/BT,50509,SAN BONIFACIO,VEN,20-29,9,14,0,20,2,0,1,23,0,23,Veneto,ITH3
2021-01-06,PF/BT,50509,SAN BONIFACIO,VEN,30-39,9,18,0,24,2,0,1,27,0,27,Veneto,ITH3
2021-01-06,PF/BT,50509,SAN BONIFACIO,VEN,40-49,11,58,0,62,3,0,4,69,0,69,Veneto,ITH3
2021-01-06,PF/BT,50509,SAN BONIFACIO,VEN,50-59,8,58,0,46,15,0,5,66,0,66,Veneto,ITH3
2021-01-06,PF/BT,50509,SAN BONIFACIO,VEN,60-69,16,16,0,26,5,0,1,32,0,32,Veneto,ITH3
2021-01-06,PF/BT,50509,SAN BONIFACIO,VEN,70-79,0,1,0,1,0,0,0,1,0,1,Veneto,ITH3
2021-01-06,PF/BT,50509,VILLAFRANCA,VEN,20-29,8,32,0,40,0,0,0,40,0,40,Veneto,ITH3
2021-01-06,PF/BT,50509,VILLAFRANCA,VEN,30-39,21,34,0,55,0,0,0,55,0,55,Veneto,ITH3
2021-01-06,PF/BT,50509,VILLAFRANCA,VEN,40-49,19,63,0,82,0,0,0,82,0,82,Veneto,ITH3
2021-01-06,PF/BT,50509,VILLAFRANCA,VEN,50-59,28,103,0,131,0,0,0,131,0,131,Veneto,ITH3
2021-01-06,PF/BT,50509,VILLAFRANCA,VEN,60-69,22,18,0,40,0,0,0,40,0,40,Veneto,ITH3
2021-01-06,PF/BT,5091201,AOUIVR,VEN,20-29,26,69,0,95,0,0,0,95,0,95,Veneto,ITH3
2021-01-06,PF/BT,5091201,AOUIVR,VEN,30-39,42,79,0,121,0,0,0,121,0,121,Veneto,ITH3
2021-01-06,PF/BT,5091201,AOUIVR,VEN,40-49,31,130,0,161,0,0,0,161,0,161,Veneto,ITH3
2021-01-06,PF/BT,5091201,AOUIVR,VEN,50-59,35,127,0,161,0,0,1,162,0,162,Veneto,ITH3
2021-01-06,PF/BT,5091201,AOUIVR,VEN,60-69,9,12,0,20,0,0,1,21,0,21,Veneto,ITH3
2021-01-06,PF/BT,5091201,AOUIVR,VEN,70-79,0,1,0,1,0,0,0,1,0,1,Veneto,ITH3
2021-01-06,PF/BT,5091201,AOUIVR,VEN,80-89,1,0,0,1,0,0,0,1,0,1,Veneto,ITH3
2021-01-06,PF/BT,563034,C.D.R. A.M. BONORA,VEN,40-49,1,0,0,0,0,1,0,1,0,1,Veneto,ITH3
2021-01-06,PF/BT,563034,C.D.R. A.M. BONORA,VEN,50-59,1,0,0,0,0,1,0,1,0,1,Veneto,ITH3
2021-01-06,PF/BT,563034,C.D.R. A.M. BONORA,VEN,60-69,5,3,0,1,0,7,0,8,0,8,Veneto,ITH3
2021-01-06,PF/BT,563034,C.D.R. A.M. BONORA,VEN,70-79,7,3,0,0,0,10,0,10,0,10,Veneto,ITH3
2021-01-06,PF/BT,563034,C.D.R. A.M. BONORA,VEN,80-89,8,13,0,0,0,21,0,21,0,21,Veneto,ITH3
2021-01-06,PF/BT,563034,C.D.R. A.M. BONORA,VEN,90+,1,18,0,0,0,19,0,19,0,19,Veneto,ITH3
2021-01-06,PF/BT,610955,OPSA - OPERA PROVVIDENZA S.ANTONIO DISABILI,VEN,20-29,4,0,0,1,0,3,0,4,0,4,Veneto,ITH3
2021-01-06,PF/BT,610955,OPSA - OPERA PROVVIDENZA S.ANTONIO DISABILI,VEN,30-39,1,0,0,0,0,1,0,1,0,1,Veneto,ITH3
2021-01-06,PF/BT,610955,OPSA - OPERA PROVVIDENZA S.ANTONIO DISABILI,VEN,40-49,8,12,0,14,0,6,0,20,0,20,Veneto,ITH3
2021-01-06,PF/BT,610955,OPSA - OPERA PROVVIDENZA S.ANTONIO DISABILI,VEN,50-59,19,17,0,25,0,11,0,36,0,36,Veneto,ITH3
2021-01-06,PF/BT,610955,OPSA - OPERA PROVVIDENZA S.ANTONIO DISABILI,VEN,60-69,10,10,0,7,1,12,0,20,0,20,Veneto,ITH3
2021-01-06,PF/BT,610955,OPSA - OPERA PROVVIDENZA S.ANTONIO DISABILI,VEN,70-79,1,3,0,0,1,3,0,4,0,4,Veneto,ITH3
2021-01-06,PF/BT,610955,OPSA - OPERA PROVVIDENZA S.ANTONIO DISABILI,VEN,80-89,0,2,0,0,0,2,0,2,0,2,Veneto,ITH3
2021-01-06,PF/BT,611138,CASA DI RIPOSO DI NOVENTA PADOVANA - CENTRO DIURNO 'LE MAGNOLIE',VEN,30-39,1,4,0,3,2,0,0,5,0,5,Veneto,ITH3
2021-01-06,PF/BT,611138,CASA DI RIPOSO DI NOVENTA PADOVANA - CENTRO DIURNO 'LE MAGNOLIE',VEN,40-49,1,4,0,2,3,0,0,5,0,5,Veneto,ITH3
2021-01-06,PF/BT,611138,CASA DI RIPOSO DI NOVENTA PADOVANA - CENTRO DIURNO 'LE MAGNOLIE',VEN,50-59,3,3,0,4,2,0,0,6,0,6,Veneto,ITH3
2021-01-06,PF/BT,611138,CASA DI RIPOSO DI NOVENTA PADOVANA - CENTRO DIURNO 'LE MAGNOLIE',VEN,60-69,1,1,0,1,1,0,0,2,0,2,Veneto,ITH3
2021-01-06,PF/BT,611145,OIC - CENTRO RESIDENZIALE CIVITAS VITAE,VEN,20-29,5,4,0,8,1,0,0,9,0,9,Veneto,ITH3
2021-01-06,PF/BT,611145,OIC - CENTRO RESIDENZIALE CIVITAS VITAE,VEN,30-39,3,3,0,6,0,0,0,6,0,6,Veneto,ITH3
2021-01-06,PF/BT,611145,OIC - CENTRO RESIDENZIALE CIVITAS VITAE,VEN,40-49,5,12,0,14,3,0,0,17,0,17,Veneto,ITH3
2021-01-06,PF/BT,611145,OIC - CENTRO RESIDENZIALE CIVITAS VITAE,VEN,50-59,8,16,0,19,5,0,0,24,0,24,Veneto,ITH3
2021-01-06,PF/BT,611145,OIC - CENTRO RESIDENZIALE CIVITAS VITAE,VEN,60-69,4,10,0,7,4,3,0,14,0,14,Veneto,ITH3
2021-01-06,PF/BT,611145,OIC - CENTRO RESIDENZIALE CIVITAS VITAE,VEN,70-79,2,6,0,0,0,8,0,8,0,8,Veneto,ITH3
2021-01-06,PF/BT,611145,OIC - CENTRO RESIDENZIALE CIVITAS VITAE,VEN,80-89,6,29,0,0,0,35,0,35,0,35,Veneto,ITH3
2021-01-06,PF/BT,611145,OIC - CENTRO RESIDENZIALE CIVITAS VITAE,VEN,90+,3,32,0,0,0,35,0,35,0,35,Veneto,ITH3
2021-01-06,PF/BT,611181,ISTITUTO CONFIGLIACHI - 'RESIDENZA BREDA',VEN,20-29,4,2,0,5,1,0,0,6,0,6,Veneto,ITH3
2021-01-06,PF/BT,611181,ISTITUTO CONFIGLIACHI - 'RESIDENZA BREDA',VEN,30-39,7,2,0,4,5,0,0,9,0,9,Veneto,ITH3
2021-01-06,PF/BT,611181,ISTITUTO CONFIGLIACHI - 'RESIDENZA BREDA',VEN,40-49,5,15,0,15,4,0,1,20,0,20,Veneto,ITH3
2021-01-06,PF/BT,611181,ISTITUTO CONFIGLIACHI - 'RESIDENZA BREDA',VEN,50-59,2,16,0,11,7,0,0,18,0,18,Veneto,ITH3
2021-01-06,PF/BT,611181,ISTITUTO CONFIGLIACHI - 'RESIDENZA BREDA',VEN,60-69,2,8,0,9,1,0,0,10,0,10,Veneto,ITH3
2021-01-06,PF/BT,611181,ISTITUTO CONFIGLIACHI - 'RESIDENZA BREDA',VEN,70-79,2,0,0,0,0,2,0,2,0,2,Veneto,ITH3
2021-01-06,PF/BT,611181,ISTITUTO CONFIGLIACHI - 'RESIDENZA BREDA',VEN,80-89,1,6,0,0,0,7,0,7,0,7,Veneto,ITH3
2021-01-06,PF/BT,611181,ISTITUTO CONFIGLIACHI - 'RESIDENZA BREDA',VEN,90+,2,5,0,0,0,7,0,7,0,7,Veneto,ITH3
2021-01-06,PF/BT,611198,OPSA - CASA MASSIMILIANO KOLBE,VEN,30-39,0,1,0,1,0,0,0,1,0,1,Veneto,ITH3
2021-01-06,PF/BT,611198,OPSA - CASA MASSIMILIANO KOLBE,VEN,50-59,0,1,0,1,0,0,0,1,0,1,Veneto,ITH3
2021-01-06,PF/BT,611243,CENTRO DI RIFERIMENTO PER LE GRAVI DISABILITA' E DISTIURBI DEL COMPORTAMENTO,VEN,20-29,3,0,0,0,0,3,0,3,0,3,Veneto,ITH3
2021-01-06,PF/BT,611243,CENTRO DI RIFERIMENTO PER LE GRAVI DISABILITA' E DISTIURBI DEL COMPORTAMENTO,VEN,30-39,3,0,0,0,0,3,0,3,0,3,Veneto,ITH3
2021-01-06,PF/BT,611243,CENTRO DI RIFERIMENTO PER LE GRAVI DISABILITA' E DISTIURBI DEL COMPORTAMENTO,VEN,40-49,4,0,0,0,0,4,0,4,0,4,Veneto,ITH3
2021-01-06,PF/BT,611243,CENTRO DI RIFERIMENTO PER LE GRAVI DISABILITA' E DISTIURBI DEL COMPORTAMENTO,VEN,50-59,4,0,0,0,0,4,0,4,0,4,Veneto,ITH3
2021-01-06,PF/BT,611243,CENTRO DI RIFERIMENTO PER LE GRAVI DISABILITA' E DISTIURBI DEL COMPORTAMENTO,VEN,60-69,2,0,0,0,0,2,0,2,0,2,Veneto,ITH3
2021-01-06,PF/BT,611243,CENTRO DI RIFERIMENTO PER LE GRAVI DISABILITA' E DISTIURBI DEL COMPORTAMENTO,VEN,70-79,1,0,0,0,0,1,0,1,0,1,Veneto,ITH3
2021-01-06,PF/BT,642143,CENTRO SERVIZI PERSONE NON AUTOSUFFICIENTI BOVOLENTA,VEN,20-29,0,12,0,11,1,0,0,12,0,12,Veneto,ITH3
2021-01-06,PF/BT,642143,CENTRO SERVIZI PERSONE NON AUTOSUFFICIENTI BOVOLENTA,VEN,30-39,3,3,0,5,1,0,0,6,0,6,Veneto,ITH3
2021-01-06,PF/BT,642143,CENTRO SERVIZI PERSONE NON AUTOSUFFICIENTI BOVOLENTA,VEN,40-49,0,7,0,7,0,0,0,7,0,7,Veneto,ITH3
2021-01-06,PF/BT,642143,CENTRO SERVIZI PERSONE NON AUTOSUFFICIENTI BOVOLENTA,VEN,50-59,0,5,0,2,3,0,0,5,0,5,Veneto,ITH3
2021-01-06,PF/BT,642143,CENTRO SERVIZI PERSONE NON AUTOSUFFICIENTI BOVOLENTA,VEN,60-69,1,1,0,1,1,0,0,2,0,2,Veneto,ITH3
2021-01-06,PF/BT,642143,CENTRO SERVIZI PERSONE NON AUTOSUFFICIENTI BOVOLENTA,VEN,70-79,0,3,0,0,0,3,0,3,0,3,Veneto,ITH3
2021-01-06,PF/BT,642143,CENTRO SERVIZI PERSONE NON AUTOSUFFICIENTI BOVOLENTA,VEN,80-89,2,10,0,0,0,12,0,12,0,12,Veneto,ITH3
2021-01-06,PF/BT,642143,CENTRO SERVIZI PERSONE NON AUTOSUFFICIENTI BOVOLENTA,VEN,90+,0,13,0,0,0,13,0,13,0,13,Veneto,ITH3
2021-01-06,PF/BT,682302,RSA SAN MARTINO CASTELMASSA,VEN,20-29,1,0,0,1,0,0,0,1,0,1,Veneto,ITH3
2021-01-06,PF/BT,682302,RSA SAN MARTINO CASTELMASSA,VEN,30-39,2,5,0,6,1,0,0,7,0,7,Veneto,ITH3
2021-01-06,PF/BT,682302,RSA SAN MARTINO CASTELMASSA,VEN,40-49,5,15,0,12,7,1,0,20,0,20,Veneto,ITH3
2021-01-06,PF/BT,682302,RSA SAN MARTINO CASTELMASSA,VEN,50-59,3,24,0,13,12,2,0,27,0,27,Veneto,ITH3
2021-01-06,PF/BT,682302,RSA SAN MARTINO CASTELMASSA,VEN,60-69,3,9,0,6,3,3,0,12,0,12,Veneto,ITH3
2021-01-06,PF/BT,682302,RSA SAN MARTINO CASTELMASSA,VEN,70-79,3,4,0,0,0,7,0,7,0,7,Veneto,ITH3
2021-01-06,PF/BT,682302,RSA SAN MARTINO CASTELMASSA,VEN,80-89,6,14,0,0,0,20,0,20,0,20,Veneto,ITH3
2021-01-06,PF/BT,682302,RSA SAN MARTINO CASTELMASSA,VEN,90+,4,17,0,0,0,21,0,21,0,21,Veneto,ITH3
2021-01-06,PF/BT,683011,CASA ALBERGO PER ANZIANI LENDI,VEN,20-29,0,1,0,1,0,0,0,1,0,1,Veneto,ITH3
2021-01-06,PF/BT,683011,CASA ALBERGO PER ANZIANI LENDI,VEN,30-39,1,4,0,5,0,0,0,5,0,5,Veneto,ITH3
2021-01-06,PF/BT,683011,CASA ALBERGO PER ANZIANI LENDI,VEN,40-49,0,4,0,3,1,0,0,4,0,4,Veneto,ITH3
2021-01-06,PF/BT,683011,CASA ALBERGO PER ANZIANI LENDI,VEN,50-59,1,2,0,3,0,0,0,3,0,3,Veneto,ITH3
2021-01-06,PF/BT,683011,CASA ALBERGO PER ANZIANI LENDI,VEN,60-69,0,1,0,1,0,0,0,1,0,1,Veneto,ITH3
2021-01-06,PF/BT,683014,CASA SACRA FAMIGLIA FRATTA PO,VEN,50-59,1,0,0,1,0,0,0,1,0,1,Veneto,ITH3
2021-01-06,PF/BT,721010,CASA DI RIPOSO MADONNA DEL VAIOLO - TAGLIO DI PO,VEN,20-29,0,2,0,1,1,0,0,2,0,2,Veneto,ITH3
2021-01-06,PF/BT,721010,CASA DI RIPOSO MADONNA DEL VAIOLO - TAGLIO DI PO,VEN,30-39,1,1,0,1,1,0,0,2,0,2,Veneto,ITH3
2021-01-06,PF/BT,721010,CASA DI RIPOSO MADONNA DEL VAIOLO - TAGLIO DI PO,VEN,40-49,1,8,0,8,1,0,0,9,0,9,Veneto,ITH3
2021-01-06,PF/BT,721010,CASA DI RIPOSO MADONNA DEL VAIOLO - TAGLIO DI PO,VEN,50-59,1,8,0,6,3,0,0,9,0,9,Veneto,ITH3
2021-01-06,PF/BT,721010,CASA DI RIPOSO MADONNA DEL VAIOLO - TAGLIO DI PO,VEN,60-69,0,5,0,3,1,1,0,5,0,5,Veneto,ITH3
2021-01-06,PF/BT,721010,CASA DI RIPOSO MADONNA DEL VAIOLO - TAGLIO DI PO,VEN,70-79,3,6,0,0,0,9,0,9,0,9,Veneto,ITH3
2021-01-06,PF/BT,721010,CASA DI RIPOSO MADONNA DEL VAIOLO - TAGLIO DI PO,VEN,80-89,5,16,0,0,0,21,0,21,0,21,Veneto,ITH3
2021-01-06,PF/BT,721010,CASA DI RIPOSO MADONNA DEL VAIOLO - TAGLIO DI PO,VEN,90+,1,14,0,0,0,15,0,15,0,15,Veneto,ITH3
2021-01-06,PF/BT,721014,CASA DI RIPOSO ING. PEDRELLI - ARIANO NEL POLESINE,VEN,30-39,0,2,0,2,0,0,0,2,0,2,Veneto,ITH3
2021-01-06,PF/BT,721014,CASA DI RIPOSO ING. PEDRELLI - ARIANO NEL POLESINE,VEN,40-49,1,1,0,2,0,0,0,2,0,2,Veneto,ITH3
2021-01-06,PF/BT,721014,CASA DI RIPOSO ING. PEDRELLI - ARIANO NEL POLESINE,VEN,50-59,2,1,0,1,1,1,0,3,0,3,Veneto,ITH3
2021-01-06,PF/BT,721014,CASA DI RIPOSO ING. PEDRELLI - ARIANO NEL POLESINE,VEN,60-69,1,0,0,0,0,1,0,1,0,1,Veneto,ITH3
2021-01-06,PF/BT,721014,CASA DI RIPOSO ING. PEDRELLI - ARIANO NEL POLESINE,VEN,70-79,0,3,0,0,0,3,0,3,0,3,Veneto,ITH3
2021-01-06,PF/BT,721014,CASA DI RIPOSO ING. PEDRELLI - ARIANO NEL POLESINE,VEN,80-89,2,15,0,0,0,17,0,17,0,17,Veneto,ITH3
2021-01-06,PF/BT,721014,CASA DI RIPOSO ING. PEDRELLI - ARIANO NEL POLESINE,VEN,90+,0,13,0,0,0,13,0,13,0,13,Veneto,ITH3
2021-01-06,PF/BT,721015,CASA DI RIPOSO VILLA AGOPIAN - CORBOLA,VEN,50-59,1,0,0,0,0,0,1,1,0,1,Veneto,ITH3
2021-01-06,PF/BT,721024,CASA DI RIPOSO OPERA PIA 'FRANCESCO BOTTONI' - PAPOZZE,VEN,30-39,0,1,0,1,0,0,0,1,0,1,Veneto,ITH3
2021-01-06,PF/BT,84011,CASA DI RIPOSO SAN PIO X - ROMANO,VEN,20-29,1,3,0,4,0,0,0,4,0,4,Veneto,ITH3
2021-01-06,PF/BT,84011,CASA DI RIPOSO SAN PIO X - ROMANO,VEN,30-39,3,7,0,4,6,0,0,10,0,10,Veneto,ITH3
2021-01-06,PF/BT,84011,CASA DI RIPOSO SAN PIO X - ROMANO,VEN,40-49,3,9,0,8,4,0,0,12,0,12,Veneto,ITH3
2021-01-06,PF/BT,84011,CASA DI RIPOSO SAN PIO X - ROMANO,VEN,50-59,6,8,0,5,9,0,0,14,0,14,Veneto,ITH3
2021-01-06,PF/BT,84011,CASA DI RIPOSO SAN PIO X - ROMANO,VEN,60-69,4,1,0,0,2,3,0,5,0,5,Veneto,ITH3
2021-01-06,PF/BT,84011,CASA DI RIPOSO SAN PIO X - ROMANO,VEN,70-79,2,8,0,0,0,10,0,10,0,10,Veneto,ITH3
2021-01-06,PF/BT,84011,CASA DI RIPOSO SAN PIO X - ROMANO,VEN,80-89,10,16,0,0,0,26,0,26,0,26,Veneto,ITH3
2021-01-06,PF/BT,84011,CASA DI RIPOSO SAN PIO X - ROMANO,VEN,90+,2,13,0,0,0,15,0,15,0,15,Veneto,ITH3
2021-01-06,PF/BT,845233,CASA PEREZ,VEN,50-59,2,1,0,0,0,3,0,3,0,3,Veneto,ITH3
2021-01-06,PF/BT,845233,CASA PEREZ,VEN,60-69,1,0,0,0,0,1,0,1,0,1,Veneto,ITH3
2021-01-06,PF/BT,845233,CASA PEREZ,VEN,70-79,4,0,0,0,0,4,0,4,0,4,Veneto,ITH3
2021-01-06,PF/BT,845234,CASA NOGARE',VEN,70-79,0,1,0,0,0,1,0,1,0,1,Veneto,ITH3
2021-01-06,PF/BT,845234,CASA NOGARE',VEN,80-89,0,1,0,0,0,1,0,1,0,1,Veneto,ITH3
2021-01-07,PF/BT,132226,C.R. 'O.I.C.' - THIENE,VEN,20-29,3,9,0,12,0,0,0,12,0,12,Veneto,ITH3
2021-01-07,PF/BT,132226,C.R. 'O.I.C.' - THIENE,VEN,30-39,3,16,0,19,0,0,0,19,0,19,Veneto,ITH3
2021-01-07,PF/BT,132226,C.R. 'O.I.C.' - THIENE,VEN,40-49,3,25,0,27,0,0,1,28,0,28,Veneto,ITH3
2021-01-07,PF/BT,132226,C.R. 'O.I.C.' - THIENE,VEN,50-59,8,38,0,46,0,0,0,46,0,46,Veneto,ITH3
2021-01-07,PF/BT,132226,C.R. 'O.I.C.' - THIENE,VEN,60-69,6,9,0,9,0,6,0,15,0,15,Veneto,ITH3
2021-01-07,PF/BT,132226,C.R. 'O.I.C.' - THIENE,VEN,70-79,3,10,0,0,0,13,0,13,0,13,Veneto,ITH3
2021-01-07,PF/BT,132226,C.R. 'O.I.C.' - THIENE,VEN,80-89,9,19,0,0,0,28,0,28,0,28,Veneto,ITH3
2021-01-07,PF/BT,132226,C.R. 'O.I.C.' - THIENE,VEN,90+,3,22,0,0,0,25,0,25,0,25,Veneto,ITH3
2021-01-07,PF/BT,132231,C.R.'LA CASA CHARITAS' - SCHIO,VEN,40-49,0,1,0,1,0,0,0,1,0,1,Veneto,ITH3
2021-01-07,PF/BT,132231,C.R.'LA CASA CHARITAS' - SCHIO,VEN,50-59,0,1,0,1,0,0,0,1,0,1,Veneto,ITH3
2021-01-07,PF/BT,162447,CASA DI RIPOSO VILLA SERENA TRISSINO,VEN,20-29,2,5,0,6,1,0,0,7,0,7,Veneto,ITH3
2021-01-07,PF/BT,162447,CASA DI RIPOSO VILLA SERENA TRISSINO,VEN,30-39,1,1,0,1,0,1,0,2,0,2,Veneto,ITH3
2021-01-07,PF/BT,162447,CASA DI RIPOSO VILLA SERENA TRISSINO,VEN,40-49,0,8,0,8,0,0,0,8,0,8,Veneto,ITH3
2021-01-07,PF/BT,162447,CASA DI RIPOSO VILLA SERENA TRISSINO,VEN,50-59,3,13,0,11,4,1,0,16,0,16,Veneto,ITH3
2021-01-07,PF/BT,162447,CASA DI RIPOSO VILLA SERENA TRISSINO,VEN,60-69,0,2,0,2,0,0,0,2,0,2,Veneto,ITH3
2021-01-07,PF/BT,162447,CASA DI RIPOSO VILLA SERENA TRISSINO,VEN,70-79,3,4,0,0,0,7,0,7,0,7,Veneto,ITH3
2021-01-07,PF/BT,162447,CASA DI RIPOSO VILLA SERENA TRISSINO,VEN,80-89,9,15,0,0,0,24,0,24,0,24,Veneto,ITH3
2021-01-07,PF/BT,162447,CASA DI RIPOSO VILLA SERENA TRISSINO,VEN,90+,1,12,0,0,0,13,0,13,0,13,Veneto,ITH3
2021-01-07,PF/BT,162496,CENTRO SERVIZI 'DON BRUZZO' GAMBELLARA,VEN,20-29,3,8,0,8,3,0,0,11,0,11,Veneto,ITH3
2021-01-07,PF/BT,162496,CENTRO SERVIZI 'DON BRUZZO' GAMBELLARA,VEN,30-39,1,6,0,2,5,0,0,7,0,7,Veneto,ITH3
2021-01-07,PF/BT,162496,CENTRO SERVIZI 'DON BRUZZO' GAMBELLARA,VEN,40-49,0,12,0,6,6,0,0,12,0,12,Veneto,ITH3
2021-01-07,PF/BT,162496,CENTRO SERVIZI 'DON BRUZZO' GAMBELLARA,VEN,50-59,0,8,0,1,6,1,0,8,0,8,Veneto,ITH3
2021-01-07,PF/BT,162496,CENTRO SERVIZI 'DON BRUZZO' GAMBELLARA,VEN,60-69,3,5,0,2,1,5,0,8,0,8,Veneto,ITH3
2021-01-07,PF/BT,162496,CENTRO SERVIZI 'DON BRUZZO' GAMBELLARA,VEN,70-79,4,8,0,0,1,11,0,12,0,12,Veneto,ITH3
2021-01-07,PF/BT,162496,CENTRO SERVIZI 'DON BRUZZO' GAMBELLARA,VEN,80-89,4,17,0,0,0,21,0,21,0,21,Veneto,ITH3
2021-01-07,PF/BT,162496,CENTRO SERVIZI 'DON BRUZZO' GAMBELLARA,VEN,90+,4,16,0,0,0,20,0,20,0,20,Veneto,ITH3
2021-01-07,PF/BT,208006,OPERA PIA RAGGIO DI SOLE CASA A. DE GIOVANNI,VEN,20-29,0,6,0,6,0,0,0,6,0,6,Veneto,ITH3
2021-01-07,PF/BT,208006,OPERA PIA RAGGIO DI SOLE CASA A. DE GIOVANNI,VEN,30-39,2,9,0,9,2,0,0,11,0,11,Veneto,ITH3
2021-01-07,PF/BT,208006,OPERA PIA RAGGIO DI SOLE CASA A. DE GIOVANNI,VEN,40-49,5,17,0,15,7,0,0,22,0,22,Veneto,ITH3
2021-01-07,PF/BT,208006,OPERA PIA RAGGIO DI SOLE CASA A. DE GIOVANNI,VEN,50-59,8,26,0,21,9,4,0,34,0,34,Veneto,ITH3
2021-01-07,PF/BT,208006,OPERA PIA RAGGIO DI SOLE CASA A. DE GIOVANNI,VEN,60-69,7,7,0,6,6,2,0,14,0,14,Veneto,ITH3
2021-01-07,PF/BT,208006,OPERA PIA RAGGIO DI SOLE CASA A. DE GIOVANNI,VEN,70-79,13,11,0,1,0,23,0,24,0,24,Veneto,ITH3
2021-01-07,PF/BT,208006,OPERA PIA RAGGIO DI SOLE CASA A. DE GIOVANNI,VEN,80-89,11,36,0,0,0,47,0,47,0,47,Veneto,ITH3
2021-01-07,PF/BT,208006,OPERA PIA RAGGIO DI SOLE CASA A. DE GIOVANNI,VEN,90+,5,27,0,0,0,32,0,32,0,32,Veneto,ITH3
2021-01-07,PF/BT,208018,IPAB - RESIDENZA SALVI,VEN,20-29,1,6,0,7,0,0,0,7,0,7,Veneto,ITH3
2021-01-07,PF/BT,208018,IPAB - RESIDENZA SALVI,VEN,30-39,0,2,0,2,0,0,0,2,0,2,Veneto,ITH3
2021-01-07,PF/BT,208018,IPAB - RESIDENZA SALVI,VEN,40-49,7,16,0,12,11,0,0,23,0,23,Veneto,ITH3
2021-01-07,PF/BT,208018,IPAB - RESIDENZA SALVI,VEN,50-59,15,47,0,39,20,3,0,62,0,62,Veneto,ITH3
2021-01-07,PF/BT,208018,IPAB - RESIDENZA SALVI,VEN,60-69,17,13,0,10,2,18,0,30,0,30,Veneto,ITH3
2021-01-07,PF/BT,208018,IPAB - RESIDENZA SALVI,VEN,70-79,14,12,0,0,0,26,0,26,0,26,Veneto,ITH3
2021-01-07,PF/BT,208018,IPAB - RESIDENZA SALVI,VEN,80-89,10,22,0,0,0,32,0,32,0,32,Veneto,ITH3
2021-01-07,PF/BT,208018,IPAB - RESIDENZA SALVI,VEN,90+,4,27,0,0,0,31,0,31,0,31,Veneto,ITH3
2021-01-07,PF/BT,284005,"CENTRO DI SERVIZI RESIDENZIALE ""VILLA BELVEDERE"" CROCETTA DEL MONTELLO",VEN,20-29,0,10,0,9,1,0,0,10,0,10,Veneto,ITH3
2021-01-07,PF/BT,284005,"CENTRO DI SERVIZI RESIDENZIALE ""VILLA BELVEDERE"" CROCETTA DEL MONTELLO",VEN,30-39,3,12,0,9,6,0,0,15,0,15,Veneto,ITH3
2021-01-07,PF/BT,284005,"CENTRO DI SERVIZI RESIDENZIALE ""VILLA BELVEDERE"" CROCETTA DEL MONTELLO",VEN,40-49,4,26,0,18,12,0,0,30,0,30,Veneto,ITH3
2021-01-07,PF/BT,284005,"CENTRO DI SERVIZI RESIDENZIALE ""VILLA BELVEDERE"" CROCETTA DEL MONTELLO",VEN,50-59,5,38,0,26,17,0,0,43,0,43,Veneto,ITH3
2021-01-07,PF/BT,284005,"CENTRO DI SERVIZI RESIDENZIALE ""VILLA BELVEDERE"" CROCETTA DEL MONTELLO",VEN,60-69,5,5,0,5,2,3,0,10,0,10,Veneto,ITH3
2021-01-07,PF/BT,284005,"CENTRO DI SERVIZI RESIDENZIALE ""VILLA BELVEDERE"" CROCETTA DEL MONTELLO",VEN,70-79,5,9,0,0,0,14,0,14,0,14,Veneto,ITH3
2021-01-07,PF/BT,284005,"CENTRO DI SERVIZI RESIDENZIALE ""VILLA BELVEDERE"" CROCETTA DEL MONTELLO",VEN,80-89,10,39,0,0,0,49,0,49,0,49,Veneto,ITH3
2021-01-07,PF/BT,284005,"CENTRO DI SERVIZI RESIDENZIALE ""VILLA BELVEDERE"" CROCETTA DEL MONTELLO",VEN,90+,4,28,0,0,0,32,0,32,0,32,Veneto,ITH3
2021-01-07,PF/BT,323216,"CENTRO DI SERVIZI RESIDENZIALE ""VILLA VITTORIA"" - SAN POLO DI PIAVE",VEN,20-29,0,5,0,4,1,0,0,5,0,5,Veneto,ITH3
2021-01-07,PF/BT,323216,"CENTRO DI SERVIZI RESIDENZIALE ""VILLA VITTORIA"" - SAN POLO DI PIAVE",VEN,30-39,0,4,0,1,3,0,0,4,0,4,Veneto,ITH3
2021-01-07,PF/BT,323216,"CENTRO DI SERVIZI RESIDENZIALE ""VILLA VITTORIA"" - SAN POLO DI PIAVE",VEN,40-49,1,3,0,2,2,0,0,4,0,4,Veneto,ITH3
2021-01-07,PF/BT,323216,"CENTRO DI SERVIZI RESIDENZIALE ""VILLA VITTORIA"" - SAN POLO DI PIAVE",VEN,50-59,4,16,0,11,9,0,0,20,0,20,Veneto,ITH3
2021-01-07,PF/BT,323216,"CENTRO DI SERVIZI RESIDENZIALE ""VILLA VITTORIA"" - SAN POLO DI PIAVE",VEN,60-69,2,2,0,3,1,0,0,4,0,4,Veneto,ITH3
2021-01-07,PF/BT,323216,"CENTRO DI SERVIZI RESIDENZIALE ""VILLA VITTORIA"" - SAN POLO DI PIAVE",VEN,70-79,2,5,0,0,2,5,0,7,0,7,Veneto,ITH3
2021-01-07,PF/BT,323216,"CENTRO DI SERVIZI RESIDENZIALE ""VILLA VITTORIA"" - SAN POLO DI PIAVE",VEN,80-89,10,23,0,0,0,33,0,33,0,33,Veneto,ITH3
2021-01-07,PF/BT,323216,"CENTRO DI SERVIZI RESIDENZIALE ""VILLA VITTORIA"" - SAN POLO DI PIAVE",VEN,90+,1,16,0,0,0,17,0,17,0,17,Veneto,ITH3
2021-01-07,PF/BT,323218,"CENTRO DI SERVIZI RESIDENZIALE ""GIUSEPPE MENEGAZZI"" - TREVISO",VEN,20-29,2,14,0,16,0,0,0,16,0,16,Veneto,ITH3
2021-01-07,PF/BT,323218,"CENTRO DI SERVIZI RESIDENZIALE ""GIUSEPPE MENEGAZZI"" - TREVISO",VEN,30-39,6,26,0,32,0,0,0,32,0,32,Veneto,ITH3
2021-01-07,PF/BT,323218,"CENTRO DI SERVIZI RESIDENZIALE ""GIUSEPPE MENEGAZZI"" - TREVISO",VEN,40-49,9,48,0,51,3,3,0,57,0,57,Veneto,ITH3
2021-01-07,PF/BT,323218,"CENTRO DI SERVIZI RESIDENZIALE ""GIUSEPPE MENEGAZZI"" - TREVISO",VEN,50-59,8,63,0,61,6,4,0,71,0,71,Veneto,ITH3
2021-01-07,PF/BT,323218,"CENTRO DI SERVIZI RESIDENZIALE ""GIUSEPPE MENEGAZZI"" - TREVISO",VEN,60-69,3,25,0,13,5,10,0,28,0,28,Veneto,ITH3
2021-01-07,PF/BT,323218,"CENTRO DI SERVIZI RESIDENZIALE ""GIUSEPPE MENEGAZZI"" - TREVISO",VEN,70-79,17,29,0,0,1,45,0,46,0,46,Veneto,ITH3
2021-01-07,PF/BT,323218,"CENTRO DI SERVIZI RESIDENZIALE ""GIUSEPPE MENEGAZZI"" - TREVISO",VEN,80-89,26,83,0,0,0,109,0,109,0,109,Veneto,ITH3
2021-01-07,PF/BT,323218,"CENTRO DI SERVIZI RESIDENZIALE ""GIUSEPPE MENEGAZZI"" - TREVISO",VEN,90+,5,56,0,0,0,61,0,61,0,61,Veneto,ITH3
2021-01-07,PF/BT,323231,"CENTRO DI SERVIZI RESIDENZIALE ""CASA ALBERGO"" - TREVISO",VEN,20-29,2,11,0,7,6,0,0,13,0,13,Veneto,ITH3
2021-01-07,PF/BT,323231,"CENTRO DI SERVIZI RESIDENZIALE ""CASA ALBERGO"" - TREVISO",VEN,30-39,5,20,0,17,8,0,0,25,0,25,Veneto,ITH3
2021-01-07,PF/BT,323231,"CENTRO DI SERVIZI RESIDENZIALE ""CASA ALBERGO"" - TREVISO",VEN,40-49,8,26,0,21,13,0,0,34,0,34,Veneto,ITH3
2021-01-07,PF/BT,323231,"CENTRO DI SERVIZI RESIDENZIALE ""CASA ALBERGO"" - TREVISO",VEN,50-59,18,24,0,27,15,0,0,42,0,42,Veneto,ITH3
2021-01-07,PF/BT,323231,"CENTRO DI SERVIZI RESIDENZIALE ""CASA ALBERGO"" - TREVISO",VEN,60-69,7,10,0,8,4,1,4,17,0,17,Veneto,ITH3
2021-01-07,PF/BT,323231,"CENTRO DI SERVIZI RESIDENZIALE ""CASA ALBERGO"" - TREVISO",VEN,70-79,6,26,0,0,0,8,24,32,0,32,Veneto,ITH3
2021-01-07,PF/BT,323231,"CENTRO DI SERVIZI RESIDENZIALE ""CASA ALBERGO"" - TREVISO",VEN,80-89,23,52,0,0,0,50,25,75,0,75,Veneto,ITH3
2021-01-07,PF/BT,323231,"CENTRO DI SERVIZI RESIDENZIALE ""CASA ALBERGO"" - TREVISO",VEN,90+,7,67,0,0,0,72,2,74,0,74,Veneto,ITH3
2021-01-07,PF/BT,323611,"CENTRO DI SERVIZI RESIDENZIALE ""RESIDENZE PER ANZIANI CITTÂ¿ DI TREVISO"" - TREVISO",VEN,20-29,0,2,0,2,0,0,0,2,0,2,Veneto,ITH3
2021-01-07,PF/BT,323611,"CENTRO DI SERVIZI RESIDENZIALE ""RESIDENZE PER ANZIANI CITTÂ¿ DI TREVISO"" - TREVISO",VEN,30-39,0,4,0,4,0,0,0,4,0,4,Veneto,ITH3
2021-01-07,PF/BT,323611,"CENTRO DI SERVIZI RESIDENZIALE ""RESIDENZE PER ANZIANI CITTÂ¿ DI TREVISO"" - TREVISO",VEN,40-49,2,2,0,4,0,0,0,4,0,4,Veneto,ITH3
2021-01-07,PF/BT,323611,"CENTRO DI SERVIZI RESIDENZIALE ""RESIDENZE PER ANZIANI CITTÂ¿ DI TREVISO"" - TREVISO",VEN,50-59,0,1,0,1,0,0,0,1,0,1,Veneto,ITH3
2021-01-07,PF/BT,323611,"CENTRO DI SERVIZI RESIDENZIALE ""RESIDENZE PER ANZIANI CITTÂ¿ DI TREVISO"" - TREVISO",VEN,60-69,0,1,0,1,0,0,0,1,0,1,Veneto,ITH3
2021-01-07,PF/BT,42821,CASA DI RIPOSO DI LENTIAI - C.S.A. 'ROSA ED ETTORE MIONE',VEN,20-29,0,1,0,1,0,0,0,1,0,1,Veneto,ITH3
2021-01-07,PF/BT,42821,CASA DI RIPOSO DI LENTIAI - C.S.A. 'ROSA ED ETTORE MIONE',VEN,30-39,0,2,0,1,1,0,0,2,0,2,Veneto,ITH3
2021-01-07,PF/BT,42821,CASA DI RIPOSO DI LENTIAI - C.S.A. 'ROSA ED ETTORE MIONE',VEN,40-49,3,6,0,7,2,0,0,9,0,9,Veneto,ITH3
2021-01-07,PF/BT,42821,CASA DI RIPOSO DI LENTIAI - C.S.A. 'ROSA ED ETTORE MIONE',VEN,50-59,0,9,0,6,3,0,0,9,0,9,Veneto,ITH3
2021-01-07,PF/BT,42821,CASA DI RIPOSO DI LENTIAI - C.S.A. 'ROSA ED ETTORE MIONE',VEN,70-79,1,4,0,0,0,5,0,5,0,5,Veneto,ITH3
2021-01-07,PF/BT,42821,CASA DI RIPOSO DI LENTIAI - C.S.A. 'ROSA ED ETTORE MIONE',VEN,80-89,0,3,0,0,0,3,0,3,0,3,Veneto,ITH3
2021-01-07,PF/BT,42821,CASA DI RIPOSO DI LENTIAI - C.S.A. 'ROSA ED ETTORE MIONE',VEN,90+,1,0,0,0,0,1,0,1,0,1,Veneto,ITH3
2021-01-07,PF/BT,42826,C.S.A. COMUNALE,VEN,20-29,1,9,0,9,1,0,0,10,0,10,Veneto,ITH3
2021-01-07,PF/BT,42826,C.S.A. COMUNALE,VEN,30-39,0,8,0,7,1,0,0,8,0,8,Veneto,ITH3
2021-01-07,PF/BT,42826,C.S.A. COMUNALE,VEN,40-49,1,13,0,8,6,0,0,14,0,14,Veneto,ITH3
2021-01-07,PF/BT,42826,C.S.A. COMUNALE,VEN,50-59,3,15,0,6,11,1,0,18,0,18,Veneto,ITH3
2021-01-07,PF/BT,42826,C.S.A. COMUNALE,VEN,60-69,5,4,0,2,2,5,0,9,0,9,Veneto,ITH3
2021-01-07,PF/BT,42826,C.S.A. COMUNALE,VEN,70-79,3,11,0,0,0,14,0,14,0,14,Veneto,ITH3
2021-01-07,PF/BT,42826,C.S.A. COMUNALE,VEN,80-89,2,20,0,0,0,22,0,22,0,22,Veneto,ITH3
2021-01-07,PF/BT,42826,C.S.A. COMUNALE,VEN,90+,1,24,0,0,0,25,0,25,0,25,Veneto,ITH3
2021-01-07,PF/BT,440101,POLIAMB. OSPEDALE VILLA SALUS,VEN,20-29,0,4,0,4,0,0,0,4,0,4,Veneto,ITH3
2021-01-07,PF/BT,440101,POLIAMB. OSPEDALE VILLA SALUS,VEN,30-39,2,1,0,2,1,0,0,3,0,3,Veneto,ITH3
2021-01-07,PF/BT,440101,POLIAMB. OSPEDALE VILLA SALUS,VEN,40-49,3,7,0,4,6,0,0,10,0,10,Veneto,ITH3
2021-01-07,PF/BT,440101,POLIAMB. OSPEDALE VILLA SALUS,VEN,50-59,8,8,0,7,9,0,0,16,0,16,Veneto,ITH3
2021-01-07,PF/BT,440101,POLIAMB. OSPEDALE VILLA SALUS,VEN,60-69,0,1,0,1,0,0,0,1,0,1,Veneto,ITH3
2021-01-07,PF/BT,440101,POLIAMB. OSPEDALE VILLA SALUS,VEN,70-79,0,1,0,1,0,0,0,1,0,1,Veneto,ITH3
2021-01-07,PF/BT,445323,C. SERV.RES.ANZ.-S.M. DEL ROSARIO,VEN,30-39,0,1,0,1,0,0,0,1,0,1,Veneto,ITH3
2021-01-07,PF/BT,445323,C. SERV.RES.ANZ.-S.M. DEL ROSARIO,VEN,40-49,1,0,0,0,1,0,0,1,0,1,Veneto,ITH3
2021-01-07,PF/BT,445323,C. SERV.RES.ANZ.-S.M. DEL ROSARIO,VEN,50-59,0,2,0,2,0,0,0,2,0,2,Veneto,ITH3
2021-01-07,PF/BT,445323,C. SERV.RES.ANZ.-S.M. DEL ROSARIO,VEN,60-69,1,0,0,1,0,0,0,1,0,1,Veneto,ITH3
2021-01-07,PF/BT,445323,C. SERV.RES.ANZ.-S.M. DEL ROSARIO,VEN,80-89,0,4,0,0,0,4,0,4,0,4,Veneto,ITH3
2021-01-07,PF/BT,445323,C. SERV.RES.ANZ.-S.M. DEL ROSARIO,VEN,90+,0,9,0,0,0,9,0,9,0,9,Veneto,ITH3
2021-01-07,PF/BT,445325,C. SERV.RES.ANZ.-S.LORENZO,VEN,30-39,1,2,0,3,0,0,0,3,0,3,Veneto,ITH3
2021-01-07,PF/BT,445325,C. SERV.RES.ANZ.-S.LORENZO,VEN,40-49,1,4,0,2,3,0,0,5,0,5,Veneto,ITH3
2021-01-07,PF/BT,445325,C. SERV.RES.ANZ.-S.LORENZO,VEN,50-59,4,4,0,1,7,0,0,8,0,8,Veneto,ITH3
2021-01-07,PF/BT,445325,C. SERV.RES.ANZ.-S.LORENZO,VEN,60-69,1,1,0,1,1,0,0,2,0,2,Veneto,ITH3
2021-01-07,PF/BT,445438,S.V.P. CENTRO SERV. ANTICA SCUOLA DEI BATTUTI,VEN,20-29,0,4,0,2,2,0,0,4,0,4,Veneto,ITH3
2021-01-07,PF/BT,445438,S.V.P. CENTRO SERV. ANTICA SCUOLA DEI BATTUTI,VEN,30-39,2,5,0,6,1,0,0,7,0,7,Veneto,ITH3
2021-01-07,PF/BT,445438,S.V.P. CENTRO SERV. ANTICA SCUOLA DEI BATTUTI,VEN,40-49,7,15,0,13,9,0,0,22,0,22,Veneto,ITH3
2021-01-07,PF/BT,445438,S.V.P. CENTRO SERV. ANTICA SCUOLA DEI BATTUTI,VEN,50-59,7,25,0,19,13,0,0,32,0,32,Veneto,ITH3
2021-01-07,PF/BT,445438,S.V.P. CENTRO SERV. ANTICA SCUOLA DEI BATTUTI,VEN,60-69,1,3,0,3,1,0,0,4,0,4,Veneto,ITH3
2021-01-07,PF/BT,486005,C.D.R. 'SAN GIUSEPPE' - SPINEA,VEN,20-29,0,3,0,2,0,0,1,3,0,3,Veneto,ITH3
2021-01-07,PF/BT,486005,C.D.R. 'SAN GIUSEPPE' - SPINEA,VEN,30-39,0,1,0,0,1,0,0,1,0,1,Veneto,ITH3
2021-01-07,PF/BT,486005,C.D.R. 'SAN GIUSEPPE' - SPINEA,VEN,40-49,0,2,0,1,1,0,0,2,0,2,Veneto,ITH3
2021-01-07,PF/BT,486005,C.D.R. 'SAN GIUSEPPE' - SPINEA,VEN,50-59,2,7,0,3,6,0,0,9,0,9,Veneto,ITH3
2021-01-07,PF/BT,486005,C.D.R. 'SAN GIUSEPPE' - SPINEA,VEN,60-69,1,3,0,1,2,0,1,4,0,4,Veneto,ITH3
2021-01-07,PF/BT,486005,C.D.R. 'SAN GIUSEPPE' - SPINEA,VEN,70-79,0,6,0,0,0,6,0,6,0,6,Veneto,ITH3
2021-01-07,PF/BT,486005,C.D.R. 'SAN GIUSEPPE' - SPINEA,VEN,80-89,0,24,0,0,0,23,1,24,0,24,Veneto,ITH3
2021-01-07,PF/BT,486005,C.D.R. 'SAN GIUSEPPE' - SPINEA,VEN,90+,0,11,0,0,0,11,0,11,0,11,Veneto,ITH3
2021-01-07,PF/BT,486013,CENTRO SERVIZI PER ANZIANI VILLA FIORITA,VEN,30-39,0,1,0,1,0,0,0,1,0,1,Veneto,ITH3
2021-01-07,PF/BT,486013,CENTRO SERVIZI PER ANZIANI VILLA FIORITA,VEN,50-59,2,1,0,2,0,1,0,3,0,3,Veneto,ITH3
2021-01-07,PF/BT,486013,CENTRO SERVIZI PER ANZIANI VILLA FIORITA,VEN,60-69,1,0,0,0,0,1,0,1,0,1,Veneto,ITH3
2021-01-07,PF/BT,486013,CENTRO SERVIZI PER ANZIANI VILLA FIORITA,VEN,70-79,0,4,0,0,0,4,0,4,0,4,Veneto,ITH3
2021-01-07,PF/BT,486013,CENTRO SERVIZI PER ANZIANI VILLA FIORITA,VEN,80-89,1,5,0,0,0,6,0,6,0,6,Veneto,ITH3
2021-01-07,PF/BT,486013,CENTRO SERVIZI PER ANZIANI VILLA FIORITA,VEN,90+,0,3,0,1,0,2,0,3,0,3,Veneto,ITH3
2021-01-07,PF/BT,5001700,OSPEDALE SACRO CUORE DI NEGRAR,VEN,20-29,5,20,0,21,4,0,0,25,0,25,Veneto,ITH3
2021-01-07,PF/BT,5001700,OSPEDALE SACRO CUORE DI NEGRAR,VEN,30-39,23,35,0,39,19,0,0,58,0,58,Veneto,ITH3
2021-01-07,PF/BT,5001700,OSPEDALE SACRO CUORE DI NEGRAR,VEN,40-49,17,44,0,37,24,0,0,61,0,61,Veneto,ITH3
2021-01-07,PF/BT,5001700,OSPEDALE SACRO CUORE DI NEGRAR,VEN,50-59,30,47,0,49,28,0,0,77,0,77,Veneto,ITH3
2021-01-07,PF/BT,5001700,OSPEDALE SACRO CUORE DI NEGRAR,VEN,60-69,6,11,0,12,5,0,0,17,0,17,Veneto,ITH3
2021-01-07,PF/BT,5001700,OSPEDALE SACRO CUORE DI NEGRAR,VEN,70-79,2,0,0,1,1,0,0,2,0,2,Veneto,ITH3
2021-01-07,PF/BT,5002200,OSPEDALE P. PEDERZOLI,VEN,20-29,6,11,0,17,0,0,0,17,0,17,Veneto,ITH3
2021-01-07,PF/BT,5002200,OSPEDALE P. PEDERZOLI,VEN,30-39,7,5,0,12,0,0,0,12,0,12,Veneto,ITH3
2021-01-07,PF/BT,5002200,OSPEDALE P. PEDERZOLI,VEN,40-49,3,16,0,19,0,0,0,19,0,19,Veneto,ITH3
2021-01-07,PF/BT,5002200,OSPEDALE P. PEDERZOLI,VEN,50-59,6,9,0,15,0,0,0,15,0,15,Veneto,ITH3
2021-01-07,PF/BT,5002200,OSPEDALE P. PEDERZOLI,VEN,60-69,4,1,0,5,0,0,0,5,0,5,Veneto,ITH3
2021-01-07,PF/BT,5002200,OSPEDALE P. PEDERZOLI,VEN,70-79,1,0,0,1,0,0,0,1,0,1,Veneto,ITH3
2021-01-07,PF/BT,50501,AGORDO - SERVIZIO IGIENE,VEN,20-29,1,0,0,1,0,0,0,1,0,1,Veneto,ITH3
2021-01-07,PF/BT,50501,AGORDO - SERVIZIO IGIENE,VEN,50-59,1,2,0,1,0,2,0,3,0,3,Veneto,ITH3
2021-01-07,PF/BT,50501,AGORDO - SERVIZIO IGIENE,VEN,60-69,2,3,0,0,0,5,0,5,0,5,Veneto,ITH3
2021-01-07,PF/BT,50501,AGORDO - SERVIZIO IGIENE,VEN,70-79,8,9,0,0,0,17,0,17,0,17,Veneto,ITH3
2021-01-07,PF/BT,50501,AGORDO - SERVIZIO IGIENE,VEN,80-89,10,31,0,0,0,41,0,41,0,41,Veneto,ITH3
2021-01-07,PF/BT,50501,AGORDO - SERVIZIO IGIENE,VEN,90+,7,34,0,0,0,41,0,41,0,41,Veneto,ITH3
2021-01-07,PF/BT,50501,"BELLUNO ""DRIVE-IN""",VEN,20-29,2,4,0,6,0,0,0,6,0,6,Veneto,ITH3
2021-01-07,PF/BT,50501,"BELLUNO ""DRIVE-IN""",VEN,30-39,8,11,0,19,0,0,0,19,0,19,Veneto,ITH3
2021-01-07,PF/BT,50501,"BELLUNO ""DRIVE-IN""",VEN,40-49,13,29,0,40,2,0,0,42,0,42,Veneto,ITH3
2021-01-07,PF/BT,50501,"BELLUNO ""DRIVE-IN""",VEN,50-59,12,47,0,57,2,0,0,59,0,59,Veneto,ITH3
2021-01-07,PF/BT,50501,"BELLUNO ""DRIVE-IN""",VEN,60-69,4,3,0,7,0,0,0,7,0,7,Veneto,ITH3
2021-01-07,PF/BT,50501,FELTRE,VEN,20-29,0,3,0,2,1,0,0,3,0,3,Veneto,ITH3
2021-01-07,PF/BT,50501,FELTRE,VEN,30-39,1,5,0,4,2,0,0,6,0,6,Veneto,ITH3
2021-01-07,PF/BT,50501,FELTRE,VEN,40-49,1,8,0,7,2,0,0,9,0,9,Veneto,ITH3
2021-01-07,PF/BT,50501,FELTRE,VEN,50-59,4,10,0,6,8,0,0,14,0,14,Veneto,ITH3
2021-01-07,PF/BT,50501,FELTRE,VEN,60-69,4,3,0,5,2,0,0,7,0,7,Veneto,ITH3
2021-01-07,PF/BT,50501,FELTRE,VEN,70-79,2,0,0,2,0,0,0,2,0,2,Veneto,ITH3
2021-01-07,PF/BT,50501,FELTRE,VEN,80-89,0,1,0,1,0,0,0,1,0,1,Veneto,ITH3
2021-01-07,PF/BT,50501,PIEVE DI CADORE,VEN,20-29,0,2,0,2,0,0,0,2,0,2,Veneto,ITH3
2021-01-07,PF/BT,50501,PIEVE DI CADORE,VEN,30-39,2,8,0,10,0,0,0,10,0,10,Veneto,ITH3
2021-01-07,PF/BT,50501,PIEVE DI CADORE,VEN,40-49,5,9,0,11,0,0,3,14,0,14,Veneto,ITH3
2021-01-07,PF/BT,50501,PIEVE DI CADORE,VEN,50-59,4,19,0,15,0,0,8,23,0,23,Veneto,ITH3
2021-01-07,PF/BT,50501,PIEVE DI CADORE,VEN,60-69,4,7,0,7,0,0,4,11,0,11,Veneto,ITH3
2021-01-07,PF/BT,50502,TREVISO,VEN,50-59,1,1,0,2,0,0,0,2,0,2,Veneto,ITH3
2021-01-07,PF/BT,50502,TREVISO,VEN,60-69,1,0,0,1,0,0,0,1,0,1,Veneto,ITH3
2021-01-07,PF/BT,5050207,OSPEDALE MONTEBELLUNA,VEN,50-59,1,1,0,2,0,0,0,2,0,2,Veneto,ITH3
2021-01-07,PF/BT,50503,CHIOGGIA,VEN,20-29,2,4,0,6,0,0,0,6,0,6,Veneto,ITH3
2021-01-07,PF/BT,50503,CHIOGGIA,VEN,30-39,2,7,0,9,0,0,0,9,0,9,Veneto,ITH3
2021-01-07,PF/BT,50503,CHIOGGIA,VEN,40-49,1,2,0,3,0,0,0,3,0,3,Veneto,ITH3
2021-01-07,PF/BT,50503,CHIOGGIA,VEN,50-59,6,5,0,11,0,0,0,11,0,11,Veneto,ITH3
2021-01-07,PF/BT,50503,CHIOGGIA,VEN,60-69,14,5,0,19,0,0,0,19,0,19,Veneto,ITH3
2021-01-07,PF/BT,50503,MED.PREV - CHIOGGIA,VEN,20-29,6,1,0,7,0,0,0,7,0,7,Veneto,ITH3
2021-01-07,PF/BT,50503,MED.PREV - CHIOGGIA,VEN,30-39,5,4,0,9,0,0,0,9,0,9,Veneto,ITH3
2021-01-07,PF/BT,50503,MED.PREV - CHIOGGIA,VEN,40-49,7,7,0,14,0,0,0,14,0,14,Veneto,ITH3
2021-01-07,PF/BT,50503,MED.PREV - CHIOGGIA,VEN,50-59,6,13,0,19,0,0,0,19,0,19,Veneto,ITH3
2021-01-07,PF/BT,50503,MED.PREV - CHIOGGIA,VEN,60-69,6,2,0,8,0,0,0,8,0,8,Veneto,ITH3
2021-01-07,PF/BT,50503,MED.PREV - CHIOGGIA,VEN,70-79,2,1,0,3,0,0,0,3,0,3,Veneto,ITH3
2021-01-07,PF/BT,50503,MEDICINA PREVENTIVA MESTRE,VEN,16-19,0,1,0,1,0,0,0,1,0,1,Veneto,ITH3
2021-01-07,PF/BT,50503,MEDICINA PREVENTIVA MESTRE,VEN,20-29,20,16,0,32,4,0,0,36,0,36,Veneto,ITH3
2021-01-07,PF/BT,50503,MEDICINA PREVENTIVA MESTRE,VEN,30-39,24,42,0,60,6,0,0,66,0,66,Veneto,ITH3
2021-01-07,PF/BT,50503,MEDICINA PREVENTIVA MESTRE,VEN,40-49,23,64,0,73,14,0,0,87,0,87,Veneto,ITH3
2021-01-07,PF/BT,50503,MEDICINA PREVENTIVA MESTRE,VEN,50-59,37,62,0,86,13,0,0,99,0,99,Veneto,ITH3
2021-01-07,PF/BT,50503,MEDICINA PREVENTIVA MESTRE,VEN,60-69,17,22,0,36,3,0,0,39,0,39,Veneto,ITH3
2021-01-07,PF/BT,50503,MEDICINA PREVENTIVA MESTRE,VEN,70-79,2,0,0,2,0,0,0,2,0,2,Veneto,ITH3
2021-01-07,PF/BT,50503,MEDICINA PREVENTIVA MESTRE,VEN,80-89,1,0,0,1,0,0,0,1,0,1,Veneto,ITH3
2021-01-07,PF/BT,50503,MEDICINA PREVENTIVA VENEZIA,VEN,20-29,7,7,0,11,3,0,0,14,0,14,Veneto,ITH3
2021-01-07,PF/BT,50503,MEDICINA PREVENTIVA VENEZIA,VEN,30-39,11,16,0,25,2,0,0,27,0,27,Veneto,ITH3
2021-01-07,PF/BT,50503,MEDICINA PREVENTIVA VENEZIA,VEN,40-49,31,19,0,40,9,0,1,50,0,50,Veneto,ITH3
2021-01-07,PF/BT,50503,MEDICINA PREVENTIVA VENEZIA,VEN,50-59,24,35,0,47,12,0,0,59,0,59,Veneto,ITH3
2021-01-07,PF/BT,50503,MEDICINA PREVENTIVA VENEZIA,VEN,60-69,7,9,0,13,3,0,0,16,0,16,Veneto,ITH3
2021-01-07,PF/BT,50503,MEDICINA PREVENTIVA VENEZIA,VEN,70-79,1,0,0,1,0,0,0,1,0,1,Veneto,ITH3
2021-01-07,PF/BT,50503,S.I.S.P. MESTRE,VEN,20-29,8,12,0,19,1,0,0,20,0,20,Veneto,ITH3
2021-01-07,PF/BT,50503,S.I.S.P. MESTRE,VEN,30-39,12,12,0,23,1,0,0,24,0,24,Veneto,ITH3
2021-01-07,PF/BT,50503,S.I.S.P. MESTRE,VEN,40-49,7,32,0,34,3,0,2,39,0,39,Veneto,ITH3
2021-01-07,PF/BT,50503,S.I.S.P. MESTRE,VEN,50-59,26,31,0,54,3,0,0,57,0,57,Veneto,ITH3
2021-01-07,PF/BT,50503,S.I.S.P. MESTRE,VEN,60-69,11,6,0,17,0,0,0,17,0,17,Veneto,ITH3
2021-01-07,PF/BT,50503,S.I.S.P. MESTRE,VEN,70-79,3,1,0,4,0,0,0,4,0,4,Veneto,ITH3
2021-01-07,PF/BT,50503,S.I.S.P. MESTRE,VEN,80-89,1,0,0,1,0,0,0,1,0,1,Veneto,ITH3
2021-01-07,PF/BT,50503,S.I.S.P. VENEZIA,VEN,20-29,2,1,0,1,2,0,0,3,0,3,Veneto,ITH3
2021-01-07,PF/BT,50503,S.I.S.P. VENEZIA,VEN,40-49,3,3,0,3,3,0,0,6,0,6,Veneto,ITH3
2021-01-07,PF/BT,50503,S.I.S.P. VENEZIA,VEN,50-59,3,7,0,7,3,0,0,10,0,10,Veneto,ITH3
2021-01-07,PF/BT,50503,S.I.S.P. VENEZIA,VEN,60-69,2,3,0,4,1,0,0,5,0,5,Veneto,ITH3
2021-01-07,PF/BT,50503,SISP DOLO ADULTI,VEN,20-29,2,10,0,12,0,0,0,12,0,12,Veneto,ITH3
2021-01-07,PF/BT,50503,SISP DOLO ADULTI,VEN,30-39,12,20,0,32,0,0,0,32,0,32,Veneto,ITH3
2021-01-07,PF/BT,50503,SISP DOLO ADULTI,VEN,40-49,4,27,0,31,0,0,0,31,0,31,Veneto,ITH3
2021-01-07,PF/BT,50503,SISP DOLO ADULTI,VEN,50-59,15,36,0,51,0,0,0,51,0,51,Veneto,ITH3
2021-01-07,PF/BT,50503,SISP DOLO ADULTI,VEN,60-69,6,5,0,11,0,0,0,11,0,11,Veneto,ITH3
2021-01-07,PF/BT,50503,SISP DOLO ADULTI,VEN,70-79,1,0,0,1,0,0,0,1,0,1,Veneto,ITH3
2021-01-07,PF/BT,50504,OSPEDALE CIVILE SAN DONA',VEN,20-29,3,13,0,16,0,0,0,16,0,16,Veneto,ITH3
2021-01-07,PF/BT,50504,OSPEDALE CIVILE SAN DONA',VEN,30-39,3,11,0,14,0,0,0,14,0,14,Veneto,ITH3
2021-01-07,PF/BT,50504,OSPEDALE CIVILE SAN DONA',VEN,40-49,11,22,0,30,3,0,0,33,0,33,Veneto,ITH3
2021-01-07,PF/BT,50504,OSPEDALE CIVILE SAN DONA',VEN,50-59,14,55,0,66,3,0,0,69,0,69,Veneto,ITH3
2021-01-07,PF/BT,50504,OSPEDALE CIVILE SAN DONA',VEN,60-69,6,11,0,16,1,0,0,17,0,17,Veneto,ITH3
2021-01-07,PF/BT,50504,OSPEDALE CIVILE SAN DONA',VEN,70-79,1,0,0,1,0,0,0,1,0,1,Veneto,ITH3
2021-01-07,PF/BT,50504,SANTO STINO DI LIVENZA,VEN,20-29,3,3,0,6,0,0,0,6,0,6,Veneto,ITH3
2021-01-07,PF/BT,50504,SANTO STINO DI LIVENZA,VEN,30-39,4,11,0,14,1,0,0,15,0,15,Veneto,ITH3
2021-01-07,PF/BT,50504,SANTO STINO DI LIVENZA,VEN,40-49,4,15,0,17,1,1,0,19,0,19,Veneto,ITH3
2021-01-07,PF/BT,50504,SANTO STINO DI LIVENZA,VEN,50-59,0,13,0,12,1,0,0,13,0,13,Veneto,ITH3
2021-01-07,PF/BT,50504,SANTO STINO DI LIVENZA,VEN,60-69,6,6,0,5,2,5,0,12,0,12,Veneto,ITH3
2021-01-07,PF/BT,50504,SANTO STINO DI LIVENZA,VEN,70-79,9,2,0,1,0,10,0,11,0,11,Veneto,ITH3
2021-01-07,PF/BT,50504,SANTO STINO DI LIVENZA,VEN,80-89,10,11,0,0,0,21,0,21,0,21,Veneto,ITH3
2021-01-07,PF/BT,50504,SANTO STINO DI LIVENZA,VEN,90+,2,27,0,0,0,29,0,29,0,29,Veneto,ITH3
2021-01-07,PF/BT,50505,ADRIA,VEN,20-29,6,14,0,20,0,0,0,20,0,20,Veneto,ITH3
2021-01-07,PF/BT,50505,ADRIA,VEN,30-39,5,10,0,15,0,0,0,15,0,15,Veneto,ITH3
2021-01-07,PF/BT,50505,ADRIA,VEN,40-49,9,24,0,33,0,0,0,33,0,33,Veneto,ITH3
2021-01-07,PF/BT,50505,ADRIA,VEN,50-59,10,24,0,34,0,0,0,34,0,34,Veneto,ITH3
2021-01-07,PF/BT,50505,ADRIA,VEN,60-69,11,7,0,18,0,0,0,18,0,18,Veneto,ITH3
2021-01-07,PF/BT,50505,TRECENTA,VEN,20-29,1,3,0,4,0,0,0,4,0,4,Veneto,ITH3
2021-01-07,PF/BT,50505,TRECENTA,VEN,30-39,1,9,0,10,0,0,0,10,0,10,Veneto,ITH3
2021-01-07,PF/BT,50505,TRECENTA,VEN,40-49,0,9,0,9,0,0,0,9,0,9,Veneto,ITH3
2021-01-07,PF/BT,50505,TRECENTA,VEN,50-59,3,9,0,12,0,0,0,12,0,12,Veneto,ITH3
2021-01-07,PF/BT,50505,TRECENTA,VEN,60-69,5,2,0,7,0,0,0,7,0,7,Veneto,ITH3
2021-01-07,PF/BT,5050501,Mancante,VEN,50-59,0,2,0,2,0,0,0,2,0,2,Veneto,ITH3
2021-01-07,PF/BT,5050501,PRESIDIO OSPEDALIERO ROVIGO,VEN,20-29,6,15,0,20,0,0,1,21,0,21,Veneto,ITH3
2021-01-07,PF/BT,5050501,PRESIDIO OSPEDALIERO ROVIGO,VEN,30-39,16,26,0,40,0,0,2,42,0,42,Veneto,ITH3
2021-01-07,PF/BT,5050501,PRESIDIO OSPEDALIERO ROVIGO,VEN,40-49,16,32,0,44,1,1,2,48,0,48,Veneto,ITH3
2021-01-07,PF/BT,5050501,PRESIDIO OSPEDALIERO ROVIGO,VEN,50-59,16,68,0,76,1,5,2,84,0,84,Veneto,ITH3
2021-01-07,PF/BT,5050501,PRESIDIO OSPEDALIERO ROVIGO,VEN,60-69,12,10,0,21,0,1,0,22,0,22,Veneto,ITH3
2021-01-07,PF/BT,50506,AZ OSPEDALIERA DI PADOVA MAL. INFET.E TR,VEN,20-29,10,19,0,29,0,0,0,29,0,29,Veneto,ITH3
2021-01-07,PF/BT,50506,AZ OSPEDALIERA DI PADOVA MAL. INFET.E TR,VEN,30-39,11,10,0,21,0,0,0,21,0,21,Veneto,ITH3
2021-01-07,PF/BT,50506,AZ OSPEDALIERA DI PADOVA MAL. INFET.E TR,VEN,40-49,10,27,0,37,0,0,0,37,0,37,Veneto,ITH3
2021-01-07,PF/BT,50506,AZ OSPEDALIERA DI PADOVA MAL. INFET.E TR,VEN,50-59,17,47,0,64,0,0,0,64,0,64,Veneto,ITH3
2021-01-07,PF/BT,50506,AZ OSPEDALIERA DI PADOVA MAL. INFET.E TR,VEN,60-69,7,9,0,16,0,0,0,16,0,16,Veneto,ITH3
2021-01-07,PF/BT,50506,AZ OSPEDALIERA DI PADOVA MAL. INFET.E TR,VEN,70-79,0,1,0,1,0,0,0,1,0,1,Veneto,ITH3
2021-01-07,PF/BT,50506,CAMPOSAMPIERO,VEN,20-29,6,15,0,21,0,0,0,21,0,21,Veneto,ITH3
2021-01-07,PF/BT,50506,CAMPOSAMPIERO,VEN,30-39,3,7,0,10,0,0,0,10,0,10,Veneto,ITH3
2021-01-07,PF/BT,50506,CAMPOSAMPIERO,VEN,40-49,2,13,0,15,0,0,0,15,0,15,Veneto,ITH3
2021-01-07,PF/BT,50506,CAMPOSAMPIERO,VEN,50-59,1,29,0,30,0,0,0,30,0,30,Veneto,ITH3
2021-01-07,PF/BT,50506,CAMPOSAMPIERO,VEN,60-69,11,15,0,26,0,0,0,26,0,26,Veneto,ITH3
2021-01-07,PF/BT,50506,CAMPOSAMPIERO (S.I.S.P.),VEN,50-59,1,1,0,1,1,0,0,2,0,2,Veneto,ITH3
2021-01-07,PF/BT,50506,CAMPOSAMPIERO MEDICO COMPETENT,VEN,20-29,4,4,0,8,0,0,0,8,0,8,Veneto,ITH3
2021-01-07,PF/BT,50506,CAMPOSAMPIERO MEDICO COMPETENT,VEN,30-39,7,12,0,19,0,0,0,19,0,19,Veneto,ITH3
2021-01-07,PF/BT,50506,CAMPOSAMPIERO MEDICO COMPETENT,VEN,40-49,6,24,0,30,0,0,0,30,0,30,Veneto,ITH3
2021-01-07,PF/BT,50506,CAMPOSAMPIERO MEDICO COMPETENT,VEN,50-59,8,23,0,29,2,0,0,31,0,31,Veneto,ITH3
2021-01-07,PF/BT,50506,CAMPOSAMPIERO MEDICO COMPETENT,VEN,60-69,7,7,0,14,0,0,0,14,0,14,Veneto,ITH3
2021-01-07,PF/BT,50506,CITTADELLA MEDICO COMPETENTE,VEN,20-29,6,17,0,22,1,0,0,23,0,23,Veneto,ITH3
2021-01-07,PF/BT,50506,CITTADELLA MEDICO COMPETENTE,VEN,30-39,5,13,0,14,1,0,3,18,0,18,Veneto,ITH3
2021-01-07,PF/BT,50506,CITTADELLA MEDICO COMPETENTE,VEN,40-49,7,16,0,21,1,0,1,23,0,23,Veneto,ITH3
2021-01-07,PF/BT,50506,CITTADELLA MEDICO COMPETENTE,VEN,50-59,9,27,0,24,7,0,5,36,0,36,Veneto,ITH3
2021-01-07,PF/BT,50506,CITTADELLA MEDICO COMPETENTE,VEN,60-69,3,10,0,8,2,0,3,13,0,13,Veneto,ITH3
2021-01-07,PF/BT,50506,CITTADELLA MEDICO COMPETENTE,VEN,70-79,1,0,0,1,0,0,0,1,0,1,Veneto,ITH3
2021-01-07,PF/BT,50506,COLLI VACC. ADULTI,VEN,20-29,1,2,0,1,0,0,2,3,0,3,Veneto,ITH3
2021-01-07,PF/BT,50506,COLLI VACC. ADULTI,VEN,30-39,1,6,0,6,0,0,1,7,0,7,Veneto,ITH3
2021-01-07,PF/BT,50506,COLLI VACC. ADULTI,VEN,40-49,2,12,0,14,0,0,0,14,0,14,Veneto,ITH3
2021-01-07,PF/BT,50506,COLLI VACC. ADULTI,VEN,50-59,7,20,0,24,3,0,0,27,0,27,Veneto,ITH3
2021-01-07,PF/BT,50506,COLLI VACC. ADULTI,VEN,60-69,2,4,0,6,0,0,0,6,0,6,Veneto,ITH3
2021-01-07,PF/BT,50506,DIRIGENZA MEDICA P.D.SACCO,VEN,20-29,1,7,0,8,0,0,0,8,0,8,Veneto,ITH3
2021-01-07,PF/BT,50506,DIRIGENZA MEDICA P.D.SACCO,VEN,30-39,2,10,0,12,0,0,0,12,0,12,Veneto,ITH3
2021-01-07,PF/BT,50506,DIRIGENZA MEDICA P.D.SACCO,VEN,40-49,6,19,0,25,0,0,0,25,0,25,Veneto,ITH3
2021-01-07,PF/BT,50506,DIRIGENZA MEDICA P.D.SACCO,VEN,50-59,13,18,0,31,0,0,0,31,0,31,Veneto,ITH3
2021-01-07,PF/BT,50506,DIRIGENZA MEDICA P.D.SACCO,VEN,60-69,2,6,0,8,0,0,0,8,0,8,Veneto,ITH3
2021-01-07,PF/BT,50506,SCHIAVONIA AMBULATORIO,VEN,20-29,3,3,0,6,0,0,0,6,0,6,Veneto,ITH3
2021-01-07,PF/BT,50506,SCHIAVONIA AMBULATORIO,VEN,30-39,4,9,0,13,0,0,0,13,0,13,Veneto,ITH3
2021-01-07,PF/BT,50506,SCHIAVONIA AMBULATORIO,VEN,40-49,5,22,0,27,0,0,0,27,0,27,Veneto,ITH3
2021-01-07,PF/BT,50506,SCHIAVONIA AMBULATORIO,VEN,50-59,6,25,0,30,1,0,0,31,0,31,Veneto,ITH3
2021-01-07,PF/BT,50506,SCHIAVONIA AMBULATORIO,VEN,60-69,2,10,0,12,0,0,0,12,0,12,Veneto,ITH3
2021-01-07,PF/BT,50506,VIA SCROVEGNI ANTI INFLUENZALE,VEN,40-49,0,2,0,2,0,0,0,2,0,2,Veneto,ITH3
2021-01-07,PF/BT,50506,VIA SCROVEGNI ANTI INFLUENZALE,VEN,50-59,0,4,0,4,0,0,0,4,0,4,Veneto,ITH3
2021-01-07,PF/BT,50506,VIA SCROVEGNI ANTI INFLUENZALE,VEN,60-69,0,6,0,5,1,0,0,6,0,6,Veneto,ITH3
2021-01-07,PF/BT,50506,VIA TEMANZA ANTI INFLUENZALE,VEN,20-29,0,1,0,1,0,0,0,1,0,1,Veneto,ITH3
2021-01-07,PF/BT,50506,VIA TEMANZA ANTI INFLUENZALE,VEN,30-39,0,2,0,2,0,0,0,2,0,2,Veneto,ITH3
2021-01-07,PF/BT,50506,VIA TEMANZA ANTI INFLUENZALE,VEN,40-49,0,4,0,4,0,0,0,4,0,4,Veneto,ITH3
2021-01-07,PF/BT,50506,VIA TEMANZA ANTI INFLUENZALE,VEN,50-59,3,8,0,11,0,0,0,11,0,11,Veneto,ITH3
2021-01-07,PF/BT,50506,VIA TEMANZA ANTI INFLUENZALE,VEN,60-69,6,6,0,12,0,0,0,12,0,12,Veneto,ITH3
2021-01-07,PF/BT,50507,DIPARTIMENTO DI PREVENZIONE,VEN,16-19,0,1,0,0,1,0,0,1,0,1,Veneto,ITH3
2021-01-07,PF/BT,50507,DIPARTIMENTO DI PREVENZIONE,VEN,20-29,1,1,0,1,1,0,0,2,0,2,Veneto,ITH3
2021-01-07,PF/BT,50507,DIPARTIMENTO DI PREVENZIONE,VEN,30-39,0,3,0,3,0,0,0,3,0,3,Veneto,ITH3
2021-01-07,PF/BT,50507,DIPARTIMENTO DI PREVENZIONE,VEN,40-49,0,2,0,1,1,0,0,2,0,2,Veneto,ITH3
2021-01-07,PF/BT,50507,DIPARTIMENTO DI PREVENZIONE,VEN,50-59,2,3,0,3,2,0,0,5,0,5,Veneto,ITH3
2021-01-07,PF/BT,50507,DIPARTIMENTO DI PREVENZIONE,VEN,60-69,0,1,0,1,0,0,0,1,0,1,Veneto,ITH3
2021-01-07,PF/BT,50507,EX OSPEDALE - BOLDRINI,VEN,16-19,0,1,0,1,0,0,0,1,0,1,Veneto,ITH3
2021-01-07,PF/BT,50507,EX OSPEDALE - BOLDRINI,VEN,20-29,5,6,0,11,0,0,0,11,0,11,Veneto,ITH3
2021-01-07,PF/BT,50507,EX OSPEDALE - BOLDRINI,VEN,30-39,5,9,0,14,0,0,0,14,0,14,Veneto,ITH3
2021-01-07,PF/BT,50507,EX OSPEDALE - BOLDRINI,VEN,40-49,12,22,0,34,0,0,0,34,0,34,Veneto,ITH3
2021-01-07,PF/BT,50507,EX OSPEDALE - BOLDRINI,VEN,50-59,14,34,0,48,0,0,0,48,0,48,Veneto,ITH3
2021-01-07,PF/BT,50507,EX OSPEDALE - BOLDRINI,VEN,60-69,13,10,0,23,0,0,0,23,0,23,Veneto,ITH3
2021-01-07,PF/BT,50507,H BASSANO,VEN,16-19,0,1,0,0,1,0,0,1,0,1,Veneto,ITH3
2021-01-07,PF/BT,50507,H BASSANO,VEN,20-29,1,7,0,4,4,0,0,8,0,8,Veneto,ITH3
2021-01-07,PF/BT,50507,H BASSANO,VEN,30-39,1,12,0,6,7,0,0,13,0,13,Veneto,ITH3
2021-01-07,PF/BT,50507,H BASSANO,VEN,40-49,7,25,0,19,13,0,0,32,0,32,Veneto,ITH3
2021-01-07,PF/BT,50507,H BASSANO,VEN,50-59,17,38,0,13,42,0,0,55,0,55,Veneto,ITH3
2021-01-07,PF/BT,50507,H BASSANO,VEN,60-69,7,8,0,6,9,0,0,15,0,15,Veneto,ITH3
2021-01-07,PF/BT,50507,H BASSANO,VEN,70-79,1,0,0,1,0,0,0,1,0,1,Veneto,ITH3
2021-01-07,PF/BT,50507,THIENE,VEN,20-29,2,7,0,9,0,0,0,9,0,9,Veneto,ITH3
2021-01-07,PF/BT,50507,THIENE,VEN,30-39,3,9,0,12,0,0,0,12,0,12,Veneto,ITH3
2021-01-07,PF/BT,50507,THIENE,VEN,40-49,1,13,0,14,0,0,0,14,0,14,Veneto,ITH3
2021-01-07,PF/BT,50507,THIENE,VEN,50-59,7,18,0,25,0,0,0,25,0,25,Veneto,ITH3
2021-01-07,PF/BT,50507,THIENE,VEN,60-69,3,8,0,11,0,0,0,11,0,11,Veneto,ITH3
2021-01-07,PF/BT,5050801,MED.COMP. - OSP. SAN BORTOLO,VEN,20-29,11,29,0,39,0,0,1,40,0,40,Veneto,ITH3
2021-01-07,PF/BT,5050801,MED.COMP. - OSP. SAN BORTOLO,VEN,30-39,23,49,0,64,0,0,8,72,0,72,Veneto,ITH3
2021-01-07,PF/BT,5050801,MED.COMP. - OSP. SAN BORTOLO,VEN,40-49,34,64,0,79,0,0,19,98,0,98,Veneto,ITH3
2021-01-07,PF/BT,5050801,MED.COMP. - OSP. SAN BORTOLO,VEN,50-59,23,93,0,98,2,0,16,116,0,116,Veneto,ITH3
2021-01-07,PF/BT,5050801,MED.COMP. - OSP. SAN BORTOLO,VEN,60-69,12,17,0,27,0,0,2,29,0,29,Veneto,ITH3
2021-01-07,PF/BT,5050801,MED.COMP. - OSP. SAN BORTOLO,VEN,70-79,2,1,0,3,0,0,0,3,0,3,Veneto,ITH3
2021-01-07,PF/BT,5050801,MED.COMP. - OSP. SAN BORTOLO,VEN,80-89,0,1,0,0,0,0,1,1,0,1,Veneto,ITH3
2021-01-07,PF/BT,5050806,MED.COMP. - OSP. NUOVO SAN LOR,VEN,20-29,1,14,0,15,0,0,0,15,0,15,Veneto,ITH3
2021-01-07,PF/BT,5050806,MED.COMP. - OSP. NUOVO SAN LOR,VEN,30-39,7,20,0,26,0,0,1,27,0,27,Veneto,ITH3
2021-01-07,PF/BT,5050806,MED.COMP. - OSP. NUOVO SAN LOR,VEN,40-49,7,53,0,57,0,0,3,60,0,60,Veneto,ITH3
2021-01-07,PF/BT,5050806,MED.COMP. - OSP. NUOVO SAN LOR,VEN,50-59,21,76,0,79,0,0,18,97,0,97,Veneto,ITH3
2021-01-07,PF/BT,5050806,MED.COMP. - OSP. NUOVO SAN LOR,VEN,60-69,16,20,0,30,2,0,4,36,0,36,Veneto,ITH3
2021-01-07,PF/BT,5050806,MED.COMP. - OSP. NUOVO SAN LOR,VEN,70-79,1,0,0,1,0,0,0,1,0,1,Veneto,ITH3
2021-01-07,PF/BT,5091201,AOUIVR,VEN,20-29,73,108,0,180,1,0,0,181,0,181,Veneto,ITH3
2021-01-07,PF/BT,5091201,AOUIVR,VEN,30-39,72,114,0,183,3,0,0,186,0,186,Veneto,ITH3
2021-01-07,PF/BT,5091201,AOUIVR,VEN,40-49,57,98,0,151,4,0,0,155,0,155,Veneto,ITH3
2021-01-07,PF/BT,5091201,AOUIVR,VEN,50-59,45,134,0,167,12,0,0,179,0,179,Veneto,ITH3
2021-01-07,PF/BT,5091201,AOUIVR,VEN,60-69,34,24,0,53,4,0,1,58,0,58,Veneto,ITH3
2021-01-07,PF/BT,5095201,IOV,VEN,20-29,1,20,0,21,0,0,0,21,0,21,Veneto,ITH3
2021-01-07,PF/BT,5095201,IOV,VEN,30-39,2,14,0,16,0,0,0,16,0,16,Veneto,ITH3
2021-01-07,PF/BT,5095201,IOV,VEN,40-49,1,11,0,12,0,0,0,12,0,12,Veneto,ITH3
2021-01-07,PF/BT,5095201,IOV,VEN,50-59,3,8,0,11,0,0,0,11,0,11,Veneto,ITH3
2021-01-07,PF/BT,5095201,IOV,VEN,60-69,1,0,0,1,0,0,0,1,0,1,Veneto,ITH3
2021-01-07,PF/BT,521630,R.S.A. 'IL GIRASOLE',VEN,40-49,0,1,0,1,0,0,0,1,0,1,Veneto,ITH3
2021-01-07,PF/BT,521630,R.S.A. 'IL GIRASOLE',VEN,50-59,1,2,0,3,0,0,0,3,0,3,Veneto,ITH3
2021-01-07,PF/BT,563022,C.D.R. VILLA IMPERIALE,VEN,30-39,0,1,0,1,0,0,0,1,0,1,Veneto,ITH3
2021-01-07,PF/BT,563022,C.D.R. VILLA IMPERIALE,VEN,40-49,0,4,0,4,0,0,0,4,0,4,Veneto,ITH3
2021-01-07,PF/BT,563022,C.D.R. VILLA IMPERIALE,VEN,50-59,0,1,0,0,0,1,0,1,0,1,Veneto,ITH3
2021-01-07,PF/BT,563022,C.D.R. VILLA IMPERIALE,VEN,60-69,1,2,0,0,0,3,0,3,0,3,Veneto,ITH3
2021-01-07,PF/BT,563022,C.D.R. VILLA IMPERIALE,VEN,70-79,7,2,0,1,0,8,0,9,0,9,Veneto,ITH3
2021-01-07,PF/BT,563022,C.D.R. VILLA IMPERIALE,VEN,80-89,4,13,0,0,0,17,0,17,0,17,Veneto,ITH3
2021-01-07,PF/BT,563022,C.D.R. VILLA IMPERIALE,VEN,90+,0,7,0,0,0,7,0,7,0,7,Veneto,ITH3
2021-01-07,PF/BT,563024,C.D.R. VILLA A.M. BRESSANIN,VEN,20-29,1,6,0,7,0,0,0,7,0,7,Veneto,ITH3
2021-01-07,PF/BT,563024,C.D.R. VILLA A.M. BRESSANIN,VEN,30-39,2,8,0,7,3,0,0,10,0,10,Veneto,ITH3
2021-01-07,PF/BT,563024,C.D.R. VILLA A.M. BRESSANIN,VEN,40-49,1,4,0,3,2,0,0,5,0,5,Veneto,ITH3
2021-01-07,PF/BT,563024,C.D.R. VILLA A.M. BRESSANIN,VEN,50-59,0,2,0,2,0,0,0,2,0,2,Veneto,ITH3
2021-01-07,PF/BT,563024,C.D.R. VILLA A.M. BRESSANIN,VEN,60-69,0,1,0,0,0,1,0,1,0,1,Veneto,ITH3
2021-01-07,PF/BT,563024,C.D.R. VILLA A.M. BRESSANIN,VEN,70-79,1,3,0,0,0,4,0,4,0,4,Veneto,ITH3
2021-01-07,PF/BT,563024,C.D.R. VILLA A.M. BRESSANIN,VEN,80-89,0,5,0,0,0,5,0,5,0,5,Veneto,ITH3
2021-01-07,PF/BT,563024,C.D.R. VILLA A.M. BRESSANIN,VEN,90+,1,6,0,0,0,7,0,7,0,7,Veneto,ITH3
2021-01-07,PF/BT,605602,CENTRO MED. FONIATRIA,VEN,20-29,2,6,0,8,0,0,0,8,0,8,Veneto,ITH3
2021-01-07,PF/BT,605602,CENTRO MED. FONIATRIA,VEN,30-39,3,10,0,13,0,0,0,13,0,13,Veneto,ITH3
2021-01-07,PF/BT,605602,CENTRO MED. FONIATRIA,VEN,40-49,2,13,0,15,0,0,0,15,0,15,Veneto,ITH3
2021-01-07,PF/BT,605602,CENTRO MED. FONIATRIA,VEN,50-59,2,10,0,12,0,0,0,12,0,12,Veneto,ITH3
2021-01-07,PF/BT,605602,CENTRO MED. FONIATRIA,VEN,60-69,1,2,0,3,0,0,0,3,0,3,Veneto,ITH3
2021-01-07,PF/BT,610955,OPSA - OPERA PROVVIDENZA S.ANTONIO DISABILI,VEN,40-49,0,3,0,0,0,3,0,3,0,3,Veneto,ITH3
2021-01-07,PF/BT,610955,OPSA - OPERA PROVVIDENZA S.ANTONIO DISABILI,VEN,60-69,4,3,0,1,0,6,0,7,0,7,Veneto,ITH3
2021-01-07,PF/BT,610955,OPSA - OPERA PROVVIDENZA S.ANTONIO DISABILI,VEN,70-79,0,5,0,0,0,5,0,5,0,5,Veneto,ITH3
2021-01-07,PF/BT,611138,CASA DI RIPOSO DI NOVENTA PADOVANA - CENTRO DIURNO 'LE MAGNOLIE',VEN,20-29,0,3,0,2,1,0,0,3,0,3,Veneto,ITH3
2021-01-07,PF/BT,611138,CASA DI RIPOSO DI NOVENTA PADOVANA - CENTRO DIURNO 'LE MAGNOLIE',VEN,30-39,0,4,0,4,0,0,0,4,0,4,Veneto,ITH3
2021-01-07,PF/BT,611138,CASA DI RIPOSO DI NOVENTA PADOVANA - CENTRO DIURNO 'LE MAGNOLIE',VEN,40-49,2,8,0,9,1,0,0,10,0,10,Veneto,ITH3
2021-01-07,PF/BT,611138,CASA DI RIPOSO DI NOVENTA PADOVANA - CENTRO DIURNO 'LE MAGNOLIE',VEN,50-59,1,5,0,6,0,0,0,6,0,6,Veneto,ITH3
2021-01-07,PF/BT,611138,CASA DI RIPOSO DI NOVENTA PADOVANA - CENTRO DIURNO 'LE MAGNOLIE',VEN,60-69,0,1,0,1,0,0,0,1,0,1,Veneto,ITH3
2021-01-07,PF/BT,611145,OIC - CENTRO RESIDENZIALE CIVITAS VITAE,VEN,20-29,2,12,0,13,1,0,0,14,0,14,Veneto,ITH3
2021-01-07,PF/BT,611145,OIC - CENTRO RESIDENZIALE CIVITAS VITAE,VEN,30-39,5,5,0,9,1,0,0,10,0,10,Veneto,ITH3
2021-01-07,PF/BT,611145,OIC - CENTRO RESIDENZIALE CIVITAS VITAE,VEN,40-49,4,25,0,22,7,0,0,29,0,29,Veneto,ITH3
2021-01-07,PF/BT,611145,OIC - CENTRO RESIDENZIALE CIVITAS VITAE,VEN,50-59,11,21,0,21,11,0,0,32,0,32,Veneto,ITH3
2021-01-07,PF/BT,611145,OIC - CENTRO RESIDENZIALE CIVITAS VITAE,VEN,60-69,3,5,0,7,1,0,0,8,0,8,Veneto,ITH3
2021-01-07,PF/BT,611164,CRAUP - CASA SOGGIORNO VIA S. ROCCO,VEN,20-29,1,5,0,6,0,0,0,6,0,6,Veneto,ITH3
2021-01-07,PF/BT,611164,CRAUP - CASA SOGGIORNO VIA S. ROCCO,VEN,30-39,1,2,0,2,0,1,0,3,0,3,Veneto,ITH3
2021-01-07,PF/BT,611164,CRAUP - CASA SOGGIORNO VIA S. ROCCO,VEN,40-49,0,19,0,15,2,2,0,19,0,19,Veneto,ITH3
2021-01-07,PF/BT,611164,CRAUP - CASA SOGGIORNO VIA S. ROCCO,VEN,50-59,4,15,0,9,8,2,0,19,0,19,Veneto,ITH3
2021-01-07,PF/BT,611164,CRAUP - CASA SOGGIORNO VIA S. ROCCO,VEN,60-69,2,6,0,4,2,2,0,8,0,8,Veneto,ITH3
2021-01-07,PF/BT,611164,CRAUP - CASA SOGGIORNO VIA S. ROCCO,VEN,70-79,2,2,0,0,1,3,0,4,0,4,Veneto,ITH3
2021-01-07,PF/BT,611164,CRAUP - CASA SOGGIORNO VIA S. ROCCO,VEN,80-89,3,2,0,0,0,5,0,5,0,5,Veneto,ITH3
2021-01-07,PF/BT,611164,CRAUP - CASA SOGGIORNO VIA S. ROCCO,VEN,90+,0,1,0,0,0,1,0,1,0,1,Veneto,ITH3
2021-01-07,PF/BT,611181,ISTITUTO CONFIGLIACHI - 'RESIDENZA BREDA',VEN,20-29,4,3,0,6,1,0,0,7,0,7,Veneto,ITH3
2021-01-07,PF/BT,611181,ISTITUTO CONFIGLIACHI - 'RESIDENZA BREDA',VEN,30-39,7,17,0,19,5,0,0,24,0,24,Veneto,ITH3
2021-01-07,PF/BT,611181,ISTITUTO CONFIGLIACHI - 'RESIDENZA BREDA',VEN,40-49,3,36,0,29,10,0,0,39,0,39,Veneto,ITH3
2021-01-07,PF/BT,611181,ISTITUTO CONFIGLIACHI - 'RESIDENZA BREDA',VEN,50-59,11,28,0,25,12,2,0,39,0,39,Veneto,ITH3
2021-01-07,PF/BT,611181,ISTITUTO CONFIGLIACHI - 'RESIDENZA BREDA',VEN,60-69,13,18,0,13,3,15,0,31,0,31,Veneto,ITH3
2021-01-07,PF/BT,611181,ISTITUTO CONFIGLIACHI - 'RESIDENZA BREDA',VEN,70-79,16,11,0,0,0,27,0,27,0,27,Veneto,ITH3
2021-01-07,PF/BT,611181,ISTITUTO CONFIGLIACHI - 'RESIDENZA BREDA',VEN,80-89,13,33,0,0,0,46,0,46,0,46,Veneto,ITH3
2021-01-07,PF/BT,611181,ISTITUTO CONFIGLIACHI - 'RESIDENZA BREDA',VEN,90+,4,41,0,0,0,45,0,45,0,45,Veneto,ITH3
2021-01-07,PF/BT,611198,OPSA - CASA MASSIMILIANO KOLBE,VEN,20-29,1,2,0,3,0,0,0,3,0,3,Veneto,ITH3
2021-01-07,PF/BT,611198,OPSA - CASA MASSIMILIANO KOLBE,VEN,30-39,2,7,0,9,0,0,0,9,0,9,Veneto,ITH3
2021-01-07,PF/BT,611198,OPSA - CASA MASSIMILIANO KOLBE,VEN,40-49,4,21,0,22,3,0,0,25,0,25,Veneto,ITH3
2021-01-07,PF/BT,611198,OPSA - CASA MASSIMILIANO KOLBE,VEN,50-59,10,17,0,18,9,0,0,27,0,27,Veneto,ITH3
2021-01-07,PF/BT,611198,OPSA - CASA MASSIMILIANO KOLBE,VEN,60-69,2,6,0,4,2,2,0,8,0,8,Veneto,ITH3
2021-01-07,PF/BT,611198,OPSA - CASA MASSIMILIANO KOLBE,VEN,70-79,4,7,0,0,1,10,0,11,0,11,Veneto,ITH3
2021-01-07,PF/BT,611198,OPSA - CASA MASSIMILIANO KOLBE,VEN,80-89,5,20,0,0,0,25,0,25,0,25,Veneto,ITH3
2021-01-07,PF/BT,611198,OPSA - CASA MASSIMILIANO KOLBE,VEN,90+,1,19,0,0,0,20,0,20,0,20,Veneto,ITH3
2021-01-07,PF/BT,611243,CENTRO DI RIFERIMENTO PER LE GRAVI DISABILITA' E DISTIURBI DEL COMPORTAMENTO,VEN,70-79,0,1,0,0,0,1,0,1,0,1,Veneto,ITH3
2021-01-07,PF/BT,642096,CASA DI RIPOSO MONTAGNANA,VEN,20-29,2,5,0,6,1,0,0,7,0,7,Veneto,ITH3
2021-01-07,PF/BT,642096,CASA DI RIPOSO MONTAGNANA,VEN,30-39,6,3,0,8,1,0,0,9,0,9,Veneto,ITH3
2021-01-07,PF/BT,642096,CASA DI RIPOSO MONTAGNANA,VEN,40-49,0,15,0,10,5,0,0,15,0,15,Veneto,ITH3
2021-01-07,PF/BT,642096,CASA DI RIPOSO MONTAGNANA,VEN,50-59,1,18,0,16,3,0,0,19,0,19,Veneto,ITH3
2021-01-07,PF/BT,642096,CASA DI RIPOSO MONTAGNANA,VEN,60-69,1,3,0,1,3,0,0,4,0,4,Veneto,ITH3
2021-01-07,PF/BT,683005,CASA DI RIPOSO S. SALVATORE,VEN,20-29,3,6,0,6,3,0,0,9,0,9,Veneto,ITH3
2021-01-07,PF/BT,683005,CASA DI RIPOSO S. SALVATORE,VEN,30-39,0,7,0,4,3,0,0,7,0,7,Veneto,ITH3
2021-01-07,PF/BT,683005,CASA DI RIPOSO S. SALVATORE,VEN,40-49,1,16,0,10,7,0,0,17,0,17,Veneto,ITH3
2021-01-07,PF/BT,683005,CASA DI RIPOSO S. SALVATORE,VEN,50-59,0,23,0,10,12,1,0,23,0,23,Veneto,ITH3
2021-01-07,PF/BT,683005,CASA DI RIPOSO S. SALVATORE,VEN,60-69,0,7,0,6,0,1,0,7,0,7,Veneto,ITH3
2021-01-07,PF/BT,683005,CASA DI RIPOSO S. SALVATORE,VEN,70-79,4,5,0,0,0,9,0,9,0,9,Veneto,ITH3
2021-01-07,PF/BT,683005,CASA DI RIPOSO S. SALVATORE,VEN,80-89,7,17,0,0,0,24,0,24,0,24,Veneto,ITH3
2021-01-07,PF/BT,683005,CASA DI RIPOSO S. SALVATORE,VEN,90+,3,32,0,0,0,35,0,35,0,35,Veneto,ITH3
2021-01-07,PF/BT,683010,CASA DI RIPOSO 'LA RESIDENCE',VEN,20-29,4,4,0,7,1,0,0,8,0,8,Veneto,ITH3
2021-01-07,PF/BT,683010,CASA DI RIPOSO 'LA RESIDENCE',VEN,30-39,1,8,0,9,0,0,0,9,0,9,Veneto,ITH3
2021-01-07,PF/BT,683010,CASA DI RIPOSO 'LA RESIDENCE',VEN,40-49,1,16,0,17,0,0,0,17,0,17,Veneto,ITH3
2021-01-07,PF/BT,683010,CASA DI RIPOSO 'LA RESIDENCE',VEN,50-59,1,40,0,41,0,0,0,41,0,41,Veneto,ITH3
2021-01-07,PF/BT,683010,CASA DI RIPOSO 'LA RESIDENCE',VEN,60-69,3,5,0,8,0,0,0,8,0,8,Veneto,ITH3
2021-01-07,PF/BT,683010,CASA DI RIPOSO 'LA RESIDENCE',VEN,70-79,1,0,0,1,0,0,0,1,0,1,Veneto,ITH3
2021-01-07,PF/BT,683011,CASA ALBERGO PER ANZIANI LENDI,VEN,20-29,1,0,0,1,0,0,0,1,0,1,Veneto,ITH3
2021-01-07,PF/BT,721013,CENTRO SERVIZI ANZIANI ADRIA,VEN,50-59,0,1,0,1,0,0,0,1,0,1,Veneto,ITH3
2021-01-07,PF/BT,768203,CENTRO SERVIZI PER ANZIANI LE BETULLE,VEN,16-19,0,1,0,0,1,0,0,1,0,1,Veneto,ITH3
2021-01-07,PF/BT,768203,CENTRO SERVIZI PER ANZIANI LE BETULLE,VEN,20-29,0,1,0,0,1,0,0,1,0,1,Veneto,ITH3
2021-01-07,PF/BT,768203,CENTRO SERVIZI PER ANZIANI LE BETULLE,VEN,30-39,0,1,0,1,0,0,0,1,0,1,Veneto,ITH3
2021-01-07,PF/BT,768203,CENTRO SERVIZI PER ANZIANI LE BETULLE,VEN,40-49,0,4,0,4,0,0,0,4,0,4,Veneto,ITH3
2021-01-07,PF/BT,768203,CENTRO SERVIZI PER ANZIANI LE BETULLE,VEN,50-59,2,0,0,0,2,0,0,2,0,2,Veneto,ITH3
2021-01-07,PF/BT,768203,CENTRO SERVIZI PER ANZIANI LE BETULLE,VEN,60-69,1,7,0,1,6,1,0,8,0,8,Veneto,ITH3
2021-01-07,PF/BT,768203,CENTRO SERVIZI PER ANZIANI LE BETULLE,VEN,70-79,3,1,0,0,3,1,0,4,0,4,Veneto,ITH3
2021-01-07,PF/BT,768203,CENTRO SERVIZI PER ANZIANI LE BETULLE,VEN,80-89,1,2,0,0,1,2,0,3,0,3,Veneto,ITH3
2021-01-07,PF/BT,802207,FONDAZIONE GOBETTI,VEN,20-29,0,3,0,2,1,0,0,3,0,3,Veneto,ITH3
2021-01-07,PF/BT,802207,FONDAZIONE GOBETTI,VEN,30-39,0,6,0,5,1,0,0,6,0,6,Veneto,ITH3
2021-01-07,PF/BT,802207,FONDAZIONE GOBETTI,VEN,40-49,4,4,0,5,3,0,0,8,0,8,Veneto,ITH3
2021-01-07,PF/BT,802207,FONDAZIONE GOBETTI,VEN,50-59,0,5,0,2,3,0,0,5,0,5,Veneto,ITH3
2021-01-07,PF/BT,802207,FONDAZIONE GOBETTI,VEN,60-69,2,3,0,2,0,3,0,5,0,5,Veneto,ITH3
2021-01-07,PF/BT,802207,FONDAZIONE GOBETTI,VEN,70-79,2,2,0,0,0,4,0,4,0,4,Veneto,ITH3
2021-01-07,PF/BT,802207,FONDAZIONE GOBETTI,VEN,80-89,2,16,0,0,0,18,0,18,0,18,Veneto,ITH3
2021-01-07,PF/BT,802207,FONDAZIONE GOBETTI,VEN,90+,1,10,0,0,0,11,0,11,0,11,Veneto,ITH3
2021-01-07,PF/BT,84001,O.I.C. - ASIAGO,VEN,30-39,0,2,0,2,0,0,0,2,0,2,Veneto,ITH3
2021-01-07,PF/BT,84003,CASA DI RIPOSO 'CASA GEROSA',VEN,20-29,5,9,0,14,0,0,0,14,0,14,Veneto,ITH3
2021-01-07,PF/BT,84003,CASA DI RIPOSO 'CASA GEROSA',VEN,30-39,0,13,0,12,1,0,0,13,0,13,Veneto,ITH3
2021-01-07,PF/BT,84003,CASA DI RIPOSO 'CASA GEROSA',VEN,40-49,2,15,0,12,5,0,0,17,0,17,Veneto,ITH3
2021-01-07,PF/BT,84003,CASA DI RIPOSO 'CASA GEROSA',VEN,50-59,4,16,0,8,11,1,0,20,0,20,Veneto,ITH3
2021-01-07,PF/BT,84003,CASA DI RIPOSO 'CASA GEROSA',VEN,60-69,3,4,0,2,2,3,0,7,0,7,Veneto,ITH3
2021-01-07,PF/BT,84003,CASA DI RIPOSO 'CASA GEROSA',VEN,70-79,6,9,0,2,1,12,0,15,0,15,Veneto,ITH3
2021-01-07,PF/BT,84003,CASA DI RIPOSO 'CASA GEROSA',VEN,80-89,4,45,0,1,5,43,0,49,0,49,Veneto,ITH3
2021-01-07,PF/BT,84003,CASA DI RIPOSO 'CASA GEROSA',VEN,90+,3,23,0,0,0,26,0,26,0,26,Veneto,ITH3
2021-01-07,PF/BT,84008,CASA DI RIPOSO CARTIGLIANO,VEN,20-29,0,9,0,8,1,0,0,9,0,9,Veneto,ITH3
2021-01-07,PF/BT,84008,CASA DI RIPOSO CARTIGLIANO,VEN,30-39,2,6,0,5,3,0,0,8,0,8,Veneto,ITH3
2021-01-07,PF/BT,84008,CASA DI RIPOSO CARTIGLIANO,VEN,40-49,1,8,0,5,4,0,0,9,0,9,Veneto,ITH3
2021-01-07,PF/BT,84008,CASA DI RIPOSO CARTIGLIANO,VEN,50-59,2,11,0,7,5,1,0,13,0,13,Veneto,ITH3
2021-01-07,PF/BT,84008,CASA DI RIPOSO CARTIGLIANO,VEN,60-69,5,7,0,4,3,5,0,12,0,12,Veneto,ITH3
2021-01-07,PF/BT,84008,CASA DI RIPOSO CARTIGLIANO,VEN,70-79,2,9,0,0,0,11,0,11,0,11,Veneto,ITH3
2021-01-07,PF/BT,84008,CASA DI RIPOSO CARTIGLIANO,VEN,80-89,7,21,0,0,0,28,0,28,0,28,Veneto,ITH3
2021-01-07,PF/BT,84008,CASA DI RIPOSO CARTIGLIANO,VEN,90+,2,17,0,0,0,19,0,19,0,19,Veneto,ITH3
2021-01-07,PF/BT,845232,CASA DEL CLERO,VEN,70-79,1,0,0,0,0,1,0,1,0,1,Veneto,ITH3
2021-01-07,PF/BT,845232,CASA DEL CLERO,VEN,80-89,2,1,0,0,0,3,0,3,0,3,Veneto,ITH3
2021-01-07,PF/BT,845233,CASA PEREZ,VEN,50-59,2,0,0,0,0,2,0,2,0,2,Veneto,ITH3
2021-01-07,PF/BT,845233,CASA PEREZ,VEN,60-69,2,4,0,0,0,6,0,6,0,6,Veneto,ITH3
2021-01-07,PF/BT,845233,CASA PEREZ,VEN,70-79,5,5,0,0,0,10,0,10,0,10,Veneto,ITH3
2021-01-07,PF/BT,845233,CASA PEREZ,VEN,80-89,1,2,0,0,0,3,0,3,0,3,Veneto,ITH3
2021-01-07,PF/BT,845233,CASA PEREZ,VEN,90+,0,1,0,0,0,1,0,1,0,1,Veneto,ITH3
2021-01-07,PF/BT,845234,CASA NOGARE',VEN,70-79,1,0,0,0,0,1,0,1,0,1,Veneto,ITH3
2021-01-07,PF/BT,845237,RSA DI CURA E REC. CASA NOGARE,VEN,60-69,1,0,0,0,0,1,0,1,0,1,Veneto,ITH3
2021-01-07,PF/BT,845237,RSA DI CURA E REC. CASA NOGARE,VEN,70-79,0,1,0,0,0,1,0,1,0,1,Veneto,ITH3
2021-01-07,PF/BT,845237,RSA DI CURA E REC. CASA NOGARE,VEN,90+,0,1,0,0,0,1,0,1,0,1,Veneto,ITH3
2021-01-08,PF/BT,0,Mancante,VEN,40-49,0,1,0,1,0,0,0,1,0,1,Veneto,ITH3
2021-01-08,PF/BT,132221,C.R. 'MUZAN' - MALO,VEN,20-29,2,7,0,5,4,0,0,9,0,9,Veneto,ITH3
2021-01-08,PF/BT,132221,C.R. 'MUZAN' - MALO,VEN,30-39,2,8,0,6,4,0,0,10,0,10,Veneto,ITH3
2021-01-08,PF/BT,132221,C.R. 'MUZAN' - MALO,VEN,40-49,4,16,0,12,7,1,0,20,0,20,Veneto,ITH3
2021-01-08,PF/BT,132221,C.R. 'MUZAN' - MALO,VEN,50-59,2,25,0,17,8,2,0,27,0,27,Veneto,ITH3
2021-01-08,PF/BT,132221,C.R. 'MUZAN' - MALO,VEN,60-69,4,5,0,3,2,4,0,9,0,9,Veneto,ITH3
2021-01-08,PF/BT,132221,C.R. 'MUZAN' - MALO,VEN,70-79,6,8,0,0,0,14,0,14,0,14,Veneto,ITH3
2021-01-08,PF/BT,132221,C.R. 'MUZAN' - MALO,VEN,80-89,4,10,0,0,0,14,0,14,0,14,Veneto,ITH3
2021-01-08,PF/BT,132221,C.R. 'MUZAN' - MALO,VEN,90+,0,11,0,0,0,11,0,11,0,11,Veneto,ITH3
2021-01-08,PF/BT,162439,CASA DI RIPOSO SCALABRIN ARZIGNANO,VEN,20-29,5,17,0,15,6,1,0,22,0,22,Veneto,ITH3
2021-01-08,PF/BT,162439,CASA DI RIPOSO SCALABRIN ARZIGNANO,VEN,30-39,4,17,0,16,5,0,0,21,0,21,Veneto,ITH3
2021-01-08,PF/BT,162439,CASA DI RIPOSO SCALABRIN ARZIGNANO,VEN,40-49,8,29,0,26,10,1,0,37,0,37,Veneto,ITH3
2021-01-08,PF/BT,162439,CASA DI RIPOSO SCALABRIN ARZIGNANO,VEN,50-59,4,27,0,20,9,2,0,31,0,31,Veneto,ITH3
2021-01-08,PF/BT,162439,CASA DI RIPOSO SCALABRIN ARZIGNANO,VEN,60-69,10,13,0,4,9,10,0,23,0,23,Veneto,ITH3
2021-01-08,PF/BT,162439,CASA DI RIPOSO SCALABRIN ARZIGNANO,VEN,70-79,7,8,0,0,1,14,0,15,0,15,Veneto,ITH3
2021-01-08,PF/BT,162439,CASA DI RIPOSO SCALABRIN ARZIGNANO,VEN,80-89,11,27,0,0,0,38,0,38,0,38,Veneto,ITH3
2021-01-08,PF/BT,162439,CASA DI RIPOSO SCALABRIN ARZIGNANO,VEN,90+,5,27,0,0,0,32,0,32,0,32,Veneto,ITH3
2021-01-08,PF/BT,162502,RESIDENZA MONTALBIERI VALDAGNO,VEN,20-29,0,5,0,5,0,0,0,5,0,5,Veneto,ITH3
2021-01-08,PF/BT,162502,RESIDENZA MONTALBIERI VALDAGNO,VEN,30-39,3,6,0,7,2,0,0,9,0,9,Veneto,ITH3
2021-01-08,PF/BT,162502,RESIDENZA MONTALBIERI VALDAGNO,VEN,40-49,2,6,0,4,4,0,0,8,0,8,Veneto,ITH3
2021-01-08,PF/BT,162502,RESIDENZA MONTALBIERI VALDAGNO,VEN,50-59,2,5,0,3,2,2,0,7,0,7,Veneto,ITH3
2021-01-08,PF/BT,162502,RESIDENZA MONTALBIERI VALDAGNO,VEN,60-69,1,2,0,0,1,2,0,3,0,3,Veneto,ITH3
2021-01-08,PF/BT,162502,RESIDENZA MONTALBIERI VALDAGNO,VEN,70-79,10,6,0,0,0,16,0,16,0,16,Veneto,ITH3
2021-01-08,PF/BT,162502,RESIDENZA MONTALBIERI VALDAGNO,VEN,80-89,4,8,0,0,0,12,0,12,0,12,Veneto,ITH3
2021-01-08,PF/BT,162502,RESIDENZA MONTALBIERI VALDAGNO,VEN,90+,0,8,0,0,0,8,0,8,0,8,Veneto,ITH3
2021-01-08,PF/BT,208015,CASA DI RIPOSO SAN GIUSEPPE,VEN,20-29,0,11,0,7,4,0,0,11,0,11,Veneto,ITH3
2021-01-08,PF/BT,208015,CASA DI RIPOSO SAN GIUSEPPE,VEN,30-39,0,11,0,8,3,0,0,11,0,11,Veneto,ITH3
2021-01-08,PF/BT,208015,CASA DI RIPOSO SAN GIUSEPPE,VEN,40-49,0,10,0,5,5,0,0,10,0,10,Veneto,ITH3
2021-01-08,PF/BT,208015,CASA DI RIPOSO SAN GIUSEPPE,VEN,50-59,1,17,0,13,4,1,0,18,0,18,Veneto,ITH3
2021-01-08,PF/BT,208015,CASA DI RIPOSO SAN GIUSEPPE,VEN,60-69,4,11,0,3,7,5,0,15,0,15,Veneto,ITH3
2021-01-08,PF/BT,208015,CASA DI RIPOSO SAN GIUSEPPE,VEN,70-79,5,7,0,0,0,12,0,12,0,12,Veneto,ITH3
2021-01-08,PF/BT,208015,CASA DI RIPOSO SAN GIUSEPPE,VEN,80-89,8,26,0,0,0,34,0,34,0,34,Veneto,ITH3
2021-01-08,PF/BT,208015,CASA DI RIPOSO SAN GIUSEPPE,VEN,90+,3,31,0,0,0,34,0,34,0,34,Veneto,ITH3
2021-01-08,PF/BT,208017,CASA DI RIPOSO A. MICHELAZZO,VEN,20-29,2,5,0,6,1,0,0,7,0,7,Veneto,ITH3
2021-01-08,PF/BT,208017,CASA DI RIPOSO A. MICHELAZZO,VEN,30-39,1,5,0,3,3,0,0,6,0,6,Veneto,ITH3
2021-01-08,PF/BT,208017,CASA DI RIPOSO A. MICHELAZZO,VEN,40-49,2,9,0,7,4,0,0,11,0,11,Veneto,ITH3
2021-01-08,PF/BT,208017,CASA DI RIPOSO A. MICHELAZZO,VEN,50-59,4,16,0,12,8,0,0,20,0,20,Veneto,ITH3
2021-01-08,PF/BT,208017,CASA DI RIPOSO A. MICHELAZZO,VEN,60-69,4,11,0,5,1,9,0,15,0,15,Veneto,ITH3
2021-01-08,PF/BT,208017,CASA DI RIPOSO A. MICHELAZZO,VEN,70-79,3,11,0,0,0,14,0,14,0,14,Veneto,ITH3
2021-01-08,PF/BT,208017,CASA DI RIPOSO A. MICHELAZZO,VEN,80-89,10,23,0,0,0,33,0,33,0,33,Veneto,ITH3
2021-01-08,PF/BT,208017,CASA DI RIPOSO A. MICHELAZZO,VEN,90+,3,27,0,0,0,30,0,30,0,30,Veneto,ITH3
2021-01-08,PF/BT,244021,"CENTRO DI SERVIZI RESIDENZIALE ""CASA AMICA"" - FREGONA",VEN,20-29,0,3,0,3,0,0,0,3,0,3,Veneto,ITH3
2021-01-08,PF/BT,244021,"CENTRO DI SERVIZI RESIDENZIALE ""CASA AMICA"" - FREGONA",VEN,30-39,3,6,0,6,3,0,0,9,0,9,Veneto,ITH3
2021-01-08,PF/BT,244021,"CENTRO DI SERVIZI RESIDENZIALE ""CASA AMICA"" - FREGONA",VEN,40-49,3,10,0,5,8,0,0,13,0,13,Veneto,ITH3
2021-01-08,PF/BT,244021,"CENTRO DI SERVIZI RESIDENZIALE ""CASA AMICA"" - FREGONA",VEN,50-59,6,10,0,8,8,0,0,16,0,16,Veneto,ITH3
2021-01-08,PF/BT,244021,"CENTRO DI SERVIZI RESIDENZIALE ""CASA AMICA"" - FREGONA",VEN,60-69,6,8,0,1,6,7,0,14,0,14,Veneto,ITH3
2021-01-08,PF/BT,244021,"CENTRO DI SERVIZI RESIDENZIALE ""CASA AMICA"" - FREGONA",VEN,70-79,6,5,0,0,4,7,0,11,0,11,Veneto,ITH3
2021-01-08,PF/BT,244021,"CENTRO DI SERVIZI RESIDENZIALE ""CASA AMICA"" - FREGONA",VEN,80-89,9,25,0,0,4,30,0,34,0,34,Veneto,ITH3
2021-01-08,PF/BT,244021,"CENTRO DI SERVIZI RESIDENZIALE ""CASA AMICA"" - FREGONA",VEN,90+,2,37,0,0,0,39,0,39,0,39,Veneto,ITH3
2021-01-08,PF/BT,284037,"CENTRO DI SERVIZI RESIDENZIALE ""CIVITAS VITAE"" DI VEDELAGO",VEN,20-29,1,6,0,7,0,0,0,7,0,7,Veneto,ITH3
2021-01-08,PF/BT,284037,"CENTRO DI SERVIZI RESIDENZIALE ""CIVITAS VITAE"" DI VEDELAGO",VEN,30-39,4,22,0,23,3,0,0,26,0,26,Veneto,ITH3
2021-01-08,PF/BT,284037,"CENTRO DI SERVIZI RESIDENZIALE ""CIVITAS VITAE"" DI VEDELAGO",VEN,40-49,3,26,0,25,4,0,0,29,0,29,Veneto,ITH3
2021-01-08,PF/BT,284037,"CENTRO DI SERVIZI RESIDENZIALE ""CIVITAS VITAE"" DI VEDELAGO",VEN,50-59,5,22,0,15,11,1,0,27,0,27,Veneto,ITH3
2021-01-08,PF/BT,284037,"CENTRO DI SERVIZI RESIDENZIALE ""CIVITAS VITAE"" DI VEDELAGO",VEN,60-69,3,6,0,5,1,3,0,9,0,9,Veneto,ITH3
2021-01-08,PF/BT,284037,"CENTRO DI SERVIZI RESIDENZIALE ""CIVITAS VITAE"" DI VEDELAGO",VEN,70-79,3,11,0,0,0,14,0,14,0,14,Veneto,ITH3
2021-01-08,PF/BT,284037,"CENTRO DI SERVIZI RESIDENZIALE ""CIVITAS VITAE"" DI VEDELAGO",VEN,80-89,17,36,0,0,0,53,0,53,0,53,Veneto,ITH3
2021-01-08,PF/BT,284037,"CENTRO DI SERVIZI RESIDENZIALE ""CIVITAS VITAE"" DI VEDELAGO",VEN,90+,7,29,0,0,0,36,0,36,0,36,Veneto,ITH3
2021-01-08,PF/BT,323203,"CENTRO DI SERVIZI RESIDENZIALE ""VILLA DELLE MAGNOLIE"" - MONASTIER",VEN,20-29,3,11,0,10,4,0,0,14,0,14,Veneto,ITH3
2021-01-08,PF/BT,323203,"CENTRO DI SERVIZI RESIDENZIALE ""VILLA DELLE MAGNOLIE"" - MONASTIER",VEN,30-39,3,20,0,18,5,0,0,23,0,23,Veneto,ITH3
2021-01-08,PF/BT,323203,"CENTRO DI SERVIZI RESIDENZIALE ""VILLA DELLE MAGNOLIE"" - MONASTIER",VEN,40-49,3,43,0,29,17,0,0,46,0,46,Veneto,ITH3
2021-01-08,PF/BT,323203,"CENTRO DI SERVIZI RESIDENZIALE ""VILLA DELLE MAGNOLIE"" - MONASTIER",VEN,50-59,10,46,0,33,22,1,0,56,0,56,Veneto,ITH3
2021-01-08,PF/BT,323203,"CENTRO DI SERVIZI RESIDENZIALE ""VILLA DELLE MAGNOLIE"" - MONASTIER",VEN,60-69,6,14,0,11,6,3,0,20,0,20,Veneto,ITH3
2021-01-08,PF/BT,323203,"CENTRO DI SERVIZI RESIDENZIALE ""VILLA DELLE MAGNOLIE"" - MONASTIER",VEN,70-79,7,10,0,1,1,15,0,17,0,17,Veneto,ITH3
2021-01-08,PF/BT,323203,"CENTRO DI SERVIZI RESIDENZIALE ""VILLA DELLE MAGNOLIE"" - MONASTIER",VEN,80-89,11,46,0,0,0,57,0,57,0,57,Veneto,ITH3
2021-01-08,PF/BT,323203,"CENTRO DI SERVIZI RESIDENZIALE ""VILLA DELLE MAGNOLIE"" - MONASTIER",VEN,90+,5,43,0,0,0,48,0,48,0,48,Veneto,ITH3
2021-01-08,PF/BT,323218,"CENTRO DI SERVIZI RESIDENZIALE ""GIUSEPPE MENEGAZZI"" - TREVISO",VEN,90+,0,1,0,0,0,1,0,1,0,1,Veneto,ITH3
2021-01-08,PF/BT,323231,"CENTRO DI SERVIZI RESIDENZIALE ""CASA ALBERGO"" - TREVISO",VEN,80-89,0,3,0,0,0,2,1,3,0,3,Veneto,ITH3
2021-01-08,PF/BT,323236,CENTRO DI SERVIZI RESIDENZIALE 'ISTITUTO COSTANTE GRIS' - MOGLIANO VENETO,VEN,20-29,9,0,0,7,2,0,0,9,0,9,Veneto,ITH3
2021-01-08,PF/BT,323236,CENTRO DI SERVIZI RESIDENZIALE 'ISTITUTO COSTANTE GRIS' - MOGLIANO VENETO,VEN,30-39,5,9,0,9,5,0,0,14,0,14,Veneto,ITH3
2021-01-08,PF/BT,323236,CENTRO DI SERVIZI RESIDENZIALE 'ISTITUTO COSTANTE GRIS' - MOGLIANO VENETO,VEN,40-49,9,19,0,21,7,0,0,28,0,28,Veneto,ITH3
2021-01-08,PF/BT,323236,CENTRO DI SERVIZI RESIDENZIALE 'ISTITUTO COSTANTE GRIS' - MOGLIANO VENETO,VEN,50-59,11,25,0,17,17,2,0,36,0,36,Veneto,ITH3
2021-01-08,PF/BT,323236,CENTRO DI SERVIZI RESIDENZIALE 'ISTITUTO COSTANTE GRIS' - MOGLIANO VENETO,VEN,60-69,7,8,0,3,7,5,0,15,0,15,Veneto,ITH3
2021-01-08,PF/BT,323236,CENTRO DI SERVIZI RESIDENZIALE 'ISTITUTO COSTANTE GRIS' - MOGLIANO VENETO,VEN,70-79,17,13,0,0,1,29,0,30,0,30,Veneto,ITH3
2021-01-08,PF/BT,323236,CENTRO DI SERVIZI RESIDENZIALE 'ISTITUTO COSTANTE GRIS' - MOGLIANO VENETO,VEN,80-89,14,29,0,0,2,41,0,43,0,43,Veneto,ITH3
2021-01-08,PF/BT,323236,CENTRO DI SERVIZI RESIDENZIALE 'ISTITUTO COSTANTE GRIS' - MOGLIANO VENETO,VEN,90+,1,32,0,0,0,33,0,33,0,33,Veneto,ITH3
2021-01-08,PF/BT,363704,CASA DI RIPOSO 'FONDAZIONE F.LLI ZULIANELLO',VEN,20-29,0,4,0,4,0,0,0,4,0,4,Veneto,ITH3
2021-01-08,PF/BT,363704,CASA DI RIPOSO 'FONDAZIONE F.LLI ZULIANELLO',VEN,30-39,2,4,0,5,1,0,0,6,0,6,Veneto,ITH3
2021-01-08,PF/BT,363704,CASA DI RIPOSO 'FONDAZIONE F.LLI ZULIANELLO',VEN,40-49,3,7,0,10,0,0,0,10,0,10,Veneto,ITH3
2021-01-08,PF/BT,363704,CASA DI RIPOSO 'FONDAZIONE F.LLI ZULIANELLO',VEN,50-59,0,14,0,11,3,0,0,14,0,14,Veneto,ITH3
2021-01-08,PF/BT,363704,CASA DI RIPOSO 'FONDAZIONE F.LLI ZULIANELLO',VEN,60-69,5,5,0,5,0,5,0,10,0,10,Veneto,ITH3
2021-01-08,PF/BT,363704,CASA DI RIPOSO 'FONDAZIONE F.LLI ZULIANELLO',VEN,70-79,3,10,0,1,0,12,0,13,0,13,Veneto,ITH3
2021-01-08,PF/BT,363704,CASA DI RIPOSO 'FONDAZIONE F.LLI ZULIANELLO',VEN,80-89,4,22,0,0,0,26,0,26,0,26,Veneto,ITH3
2021-01-08,PF/BT,363704,CASA DI RIPOSO 'FONDAZIONE F.LLI ZULIANELLO',VEN,90+,3,15,0,0,0,18,0,18,0,18,Veneto,ITH3
2021-01-08,PF/BT,363723,CENTRO SERVIZI PER ANZIANI 'I TIGLI',VEN,30-39,0,1,0,1,0,0,0,1,0,1,Veneto,ITH3
2021-01-08,PF/BT,42818,C.S.A. 'SAN ANTONIO',VEN,20-29,0,2,0,2,0,0,0,2,0,2,Veneto,ITH3
2021-01-08,PF/BT,42818,C.S.A. 'SAN ANTONIO',VEN,30-39,1,5,0,4,2,0,0,6,0,6,Veneto,ITH3
2021-01-08,PF/BT,42818,C.S.A. 'SAN ANTONIO',VEN,40-49,1,15,0,11,4,1,0,16,0,16,Veneto,ITH3
2021-01-08,PF/BT,42818,C.S.A. 'SAN ANTONIO',VEN,50-59,4,21,0,11,10,4,0,25,0,25,Veneto,ITH3
2021-01-08,PF/BT,42818,C.S.A. 'SAN ANTONIO',VEN,60-69,5,2,0,1,3,3,0,7,0,7,Veneto,ITH3
2021-01-08,PF/BT,42818,C.S.A. 'SAN ANTONIO',VEN,70-79,3,7,0,0,0,10,0,10,0,10,Veneto,ITH3
2021-01-08,PF/BT,42818,C.S.A. 'SAN ANTONIO',VEN,80-89,4,14,0,0,0,18,0,18,0,18,Veneto,ITH3
2021-01-08,PF/BT,42818,C.S.A. 'SAN ANTONIO',VEN,90+,4,17,0,0,0,21,0,21,0,21,Veneto,ITH3
2021-01-08,PF/BT,42819,C.S.A. ISTITUTO CANOSSIANO 'G. BAKHITA',VEN,30-39,0,2,0,0,0,0,2,2,0,2,Veneto,ITH3
2021-01-08,PF/BT,42819,C.S.A. ISTITUTO CANOSSIANO 'G. BAKHITA',VEN,40-49,0,2,0,0,2,0,0,2,0,2,Veneto,ITH3
2021-01-08,PF/BT,42819,C.S.A. ISTITUTO CANOSSIANO 'G. BAKHITA',VEN,50-59,0,8,0,4,4,0,0,8,0,8,Veneto,ITH3
2021-01-08,PF/BT,42819,C.S.A. ISTITUTO CANOSSIANO 'G. BAKHITA',VEN,60-69,0,3,0,2,0,1,0,3,0,3,Veneto,ITH3
2021-01-08,PF/BT,42819,C.S.A. ISTITUTO CANOSSIANO 'G. BAKHITA',VEN,70-79,0,5,0,1,0,4,0,5,0,5,Veneto,ITH3
2021-01-08,PF/BT,42819,C.S.A. ISTITUTO CANOSSIANO 'G. BAKHITA',VEN,80-89,0,9,0,0,0,9,0,9,0,9,Veneto,ITH3
2021-01-08,PF/BT,42819,C.S.A. ISTITUTO CANOSSIANO 'G. BAKHITA',VEN,90+,0,7,0,0,0,7,0,7,0,7,Veneto,ITH3
2021-01-08,PF/BT,440101,POLIAMB. OSPEDALE VILLA SALUS,VEN,20-29,0,1,0,1,0,0,0,1,0,1,Veneto,ITH3
2021-01-08,PF/BT,440101,POLIAMB. OSPEDALE VILLA SALUS,VEN,30-39,1,1,0,2,0,0,0,2,0,2,Veneto,ITH3
2021-01-08,PF/BT,440101,POLIAMB. OSPEDALE VILLA SALUS,VEN,40-49,2,5,0,4,3,0,0,7,0,7,Veneto,ITH3
2021-01-08,PF/BT,440101,POLIAMB. OSPEDALE VILLA SALUS,VEN,50-59,6,25,0,12,19,0,0,31,0,31,Veneto,ITH3
2021-01-08,PF/BT,440101,POLIAMB. OSPEDALE VILLA SALUS,VEN,60-69,1,3,0,3,1,0,0,4,0,4,Veneto,ITH3
2021-01-08,PF/BT,440101,POLIAMB. OSPEDALE VILLA SALUS,VEN,70-79,1,0,0,1,0,0,0,1,0,1,Veneto,ITH3
2021-01-08,PF/BT,440101,POLIAMB. OSPEDALE VILLA SALUS,VEN,80-89,1,0,0,1,0,0,0,1,0,1,Veneto,ITH3
2021-01-08,PF/BT,441801,POLIAMB. OSPEDALE SAN MARCO,VEN,20-29,2,1,0,3,0,0,0,3,0,3,Veneto,ITH3
2021-01-08,PF/BT,441801,POLIAMB. OSPEDALE SAN MARCO,VEN,30-39,2,0,0,2,0,0,0,2,0,2,Veneto,ITH3
2021-01-08,PF/BT,441801,POLIAMB. OSPEDALE SAN MARCO,VEN,40-49,4,3,0,7,0,0,0,7,0,7,Veneto,ITH3
2021-01-08,PF/BT,441801,POLIAMB. OSPEDALE SAN MARCO,VEN,50-59,2,5,0,7,0,0,0,7,0,7,Veneto,ITH3
2021-01-08,PF/BT,441801,POLIAMB. OSPEDALE SAN MARCO,VEN,60-69,2,3,0,5,0,0,0,5,0,5,Veneto,ITH3
2021-01-08,PF/BT,441801,POLIAMB. OSPEDALE SAN MARCO,VEN,70-79,4,1,0,5,0,0,0,5,0,5,Veneto,ITH3
2021-01-08,PF/BT,445325,C. SERV.RES.ANZ.-S.LORENZO,VEN,70-79,4,4,0,0,0,8,0,8,0,8,Veneto,ITH3
2021-01-08,PF/BT,445325,C. SERV.RES.ANZ.-S.LORENZO,VEN,80-89,6,10,0,0,0,16,0,16,0,16,Veneto,ITH3
2021-01-08,PF/BT,445325,C. SERV.RES.ANZ.-S.LORENZO,VEN,90+,4,8,0,0,0,12,0,12,0,12,Veneto,ITH3
2021-01-08,PF/BT,445326,C. SERV.RES.ANZ.-CARLO STEEB,VEN,20-29,0,1,0,1,0,0,0,1,0,1,Veneto,ITH3
2021-01-08,PF/BT,445326,C. SERV.RES.ANZ.-CARLO STEEB,VEN,30-39,1,3,0,4,0,0,0,4,0,4,Veneto,ITH3
2021-01-08,PF/BT,445326,C. SERV.RES.ANZ.-CARLO STEEB,VEN,40-49,4,10,0,13,0,0,1,14,0,14,Veneto,ITH3
2021-01-08,PF/BT,445326,C. SERV.RES.ANZ.-CARLO STEEB,VEN,50-59,3,14,0,16,0,1,0,17,0,17,Veneto,ITH3
2021-01-08,PF/BT,445326,C. SERV.RES.ANZ.-CARLO STEEB,VEN,60-69,1,5,0,5,0,1,0,6,0,6,Veneto,ITH3
2021-01-08,PF/BT,445326,C. SERV.RES.ANZ.-CARLO STEEB,VEN,70-79,2,1,0,0,0,3,0,3,0,3,Veneto,ITH3
2021-01-08,PF/BT,445326,C. SERV.RES.ANZ.-CARLO STEEB,VEN,80-89,1,2,0,0,0,3,0,3,0,3,Veneto,ITH3
2021-01-08,PF/BT,445326,C. SERV.RES.ANZ.-CARLO STEEB,VEN,90+,0,5,0,0,0,5,0,5,0,5,Veneto,ITH3
2021-01-08,PF/BT,445385,C. SERV.RES.ANZ.-CONTARINI IRE,VEN,30-39,1,1,0,2,0,0,0,2,0,2,Veneto,ITH3
2021-01-08,PF/BT,445385,C. SERV.RES.ANZ.-CONTARINI IRE,VEN,40-49,1,3,0,3,0,1,0,4,0,4,Veneto,ITH3
2021-01-08,PF/BT,445385,C. SERV.RES.ANZ.-CONTARINI IRE,VEN,50-59,0,2,0,2,0,0,0,2,0,2,Veneto,ITH3
2021-01-08,PF/BT,445385,C. SERV.RES.ANZ.-CONTARINI IRE,VEN,60-69,2,0,0,1,0,1,0,2,0,2,Veneto,ITH3
2021-01-08,PF/BT,445385,C. SERV.RES.ANZ.-CONTARINI IRE,VEN,70-79,0,6,0,0,0,6,0,6,0,6,Veneto,ITH3
2021-01-08,PF/BT,445385,C. SERV.RES.ANZ.-CONTARINI IRE,VEN,80-89,5,11,0,0,0,16,0,16,0,16,Veneto,ITH3
2021-01-08,PF/BT,445385,C. SERV.RES.ANZ.-CONTARINI IRE,VEN,90+,0,19,0,0,0,19,0,19,0,19,Veneto,ITH3
2021-01-08,PF/BT,445388,C. SERV.RES.ANZ.-ZITELLE,VEN,20-29,1,1,0,0,0,0,2,2,0,2,Veneto,ITH3
2021-01-08,PF/BT,445388,C. SERV.RES.ANZ.-ZITELLE,VEN,30-39,0,1,0,1,0,0,0,1,0,1,Veneto,ITH3
2021-01-08,PF/BT,445388,C. SERV.RES.ANZ.-ZITELLE,VEN,40-49,0,3,0,1,0,0,2,3,0,3,Veneto,ITH3
2021-01-08,PF/BT,445388,C. SERV.RES.ANZ.-ZITELLE,VEN,50-59,4,3,0,1,0,0,6,7,0,7,Veneto,ITH3
2021-01-08,PF/BT,445388,C. SERV.RES.ANZ.-ZITELLE,VEN,60-69,0,5,0,1,0,0,4,5,0,5,Veneto,ITH3
2021-01-08,PF/BT,445438,S.V.P. CENTRO SERV. ANTICA SCUOLA DEI BATTUTI,VEN,20-29,1,2,0,2,1,0,0,3,0,3,Veneto,ITH3
2021-01-08,PF/BT,445438,S.V.P. CENTRO SERV. ANTICA SCUOLA DEI BATTUTI,VEN,30-39,4,2,0,4,2,0,0,6,0,6,Veneto,ITH3
2021-01-08,PF/BT,445438,S.V.P. CENTRO SERV. ANTICA SCUOLA DEI BATTUTI,VEN,40-49,5,13,0,13,5,0,0,18,0,18,Veneto,ITH3
2021-01-08,PF/BT,445438,S.V.P. CENTRO SERV. ANTICA SCUOLA DEI BATTUTI,VEN,50-59,4,21,0,16,9,0,0,25,0,25,Veneto,ITH3
2021-01-08,PF/BT,445438,S.V.P. CENTRO SERV. ANTICA SCUOLA DEI BATTUTI,VEN,60-69,0,5,0,5,0,0,0,5,0,5,Veneto,ITH3
2021-01-08,PF/BT,445440,C. SERV.RES.ANZ.- IRE SAN GIOBBE,VEN,20-29,3,3,0,3,3,0,0,6,0,6,Veneto,ITH3
2021-01-08,PF/BT,445440,C. SERV.RES.ANZ.- IRE SAN GIOBBE,VEN,30-39,2,1,0,3,0,0,0,3,0,3,Veneto,ITH3
2021-01-08,PF/BT,445440,C. SERV.RES.ANZ.- IRE SAN GIOBBE,VEN,40-49,0,2,0,1,1,0,0,2,0,2,Veneto,ITH3
2021-01-08,PF/BT,445440,C. SERV.RES.ANZ.- IRE SAN GIOBBE,VEN,50-59,4,11,0,9,6,0,0,15,0,15,Veneto,ITH3
2021-01-08,PF/BT,445440,C. SERV.RES.ANZ.- IRE SAN GIOBBE,VEN,60-69,1,3,0,3,1,0,0,4,0,4,Veneto,ITH3
2021-01-08,PF/BT,445444,C. SERV.RES.ANZ.- RESIDENZA VENEZIA,VEN,20-29,5,7,0,10,2,0,0,12,0,12,Veneto,ITH3
2021-01-08,PF/BT,445444,C. SERV.RES.ANZ.- RESIDENZA VENEZIA,VEN,30-39,7,8,0,13,2,0,0,15,0,15,Veneto,ITH3
2021-01-08,PF/BT,445444,C. SERV.RES.ANZ.- RESIDENZA VENEZIA,VEN,40-49,2,11,0,10,3,0,0,13,0,13,Veneto,ITH3
2021-01-08,PF/BT,445444,C. SERV.RES.ANZ.- RESIDENZA VENEZIA,VEN,50-59,5,14,0,14,4,1,0,19,0,19,Veneto,ITH3
2021-01-08,PF/BT,445444,C. SERV.RES.ANZ.- RESIDENZA VENEZIA,VEN,60-69,1,0,0,1,0,0,0,1,0,1,Veneto,ITH3
2021-01-08,PF/BT,486000,RES. RIVIERA DEL BRENTA - DOLO,VEN,30-39,0,3,0,2,1,0,0,3,0,3,Veneto,ITH3
2021-01-08,PF/BT,486000,RES. RIVIERA DEL BRENTA - DOLO,VEN,40-49,0,9,0,8,1,0,0,9,0,9,Veneto,ITH3
2021-01-08,PF/BT,486000,RES. RIVIERA DEL BRENTA - DOLO,VEN,50-59,1,7,0,8,0,0,0,8,0,8,Veneto,ITH3
2021-01-08,PF/BT,486000,RES. RIVIERA DEL BRENTA - DOLO,VEN,60-69,1,2,0,2,0,1,0,3,0,3,Veneto,ITH3
2021-01-08,PF/BT,486000,RES. RIVIERA DEL BRENTA - DOLO,VEN,70-79,0,2,0,0,0,2,0,2,0,2,Veneto,ITH3
2021-01-08,PF/BT,486000,RES. RIVIERA DEL BRENTA - DOLO,VEN,80-89,2,5,0,0,0,7,0,7,0,7,Veneto,ITH3
2021-01-08,PF/BT,486000,RES. RIVIERA DEL BRENTA - DOLO,VEN,90+,2,2,0,0,0,4,0,4,0,4,Veneto,ITH3
2021-01-08,PF/BT,486001,C.A.S.A. MARIUTTO - MIRANO,VEN,20-29,2,11,0,9,2,0,2,13,0,13,Veneto,ITH3
2021-01-08,PF/BT,486001,C.A.S.A. MARIUTTO - MIRANO,VEN,30-39,4,8,0,9,1,0,2,12,0,12,Veneto,ITH3
2021-01-08,PF/BT,486001,C.A.S.A. MARIUTTO - MIRANO,VEN,40-49,9,24,0,20,7,0,6,33,0,33,Veneto,ITH3
2021-01-08,PF/BT,486001,C.A.S.A. MARIUTTO - MIRANO,VEN,50-59,7,52,0,40,7,0,12,59,0,59,Veneto,ITH3
2021-01-08,PF/BT,486001,C.A.S.A. MARIUTTO - MIRANO,VEN,60-69,5,7,0,5,3,0,4,12,0,12,Veneto,ITH3
2021-01-08,PF/BT,486001,C.A.S.A. MARIUTTO - MIRANO,VEN,70-79,2,0,0,0,1,1,0,2,0,2,Veneto,ITH3
2021-01-08,PF/BT,486015,RESIDENZA ANZIANI 'ADELE ZARA',VEN,20-29,8,13,0,12,9,0,0,21,0,21,Veneto,ITH3
2021-01-08,PF/BT,486015,RESIDENZA ANZIANI 'ADELE ZARA',VEN,30-39,0,18,0,4,14,0,0,18,0,18,Veneto,ITH3
2021-01-08,PF/BT,486015,RESIDENZA ANZIANI 'ADELE ZARA',VEN,40-49,5,22,0,12,15,0,0,27,0,27,Veneto,ITH3
2021-01-08,PF/BT,486015,RESIDENZA ANZIANI 'ADELE ZARA',VEN,50-59,5,17,0,12,10,0,0,22,0,22,Veneto,ITH3
2021-01-08,PF/BT,486015,RESIDENZA ANZIANI 'ADELE ZARA',VEN,60-69,1,0,0,0,1,0,0,1,0,1,Veneto,ITH3
2021-01-08,PF/BT,486015,RESIDENZA ANZIANI 'ADELE ZARA',VEN,80-89,1,1,0,0,0,2,0,2,0,2,Veneto,ITH3
2021-01-08,PF/BT,486015,RESIDENZA ANZIANI 'ADELE ZARA',VEN,90+,0,3,0,0,0,3,0,3,0,3,Veneto,ITH3
2021-01-08,PF/BT,5001700,OSPEDALE SACRO CUORE DI NEGRAR,VEN,20-29,10,19,0,21,8,0,0,29,0,29,Veneto,ITH3
2021-01-08,PF/BT,5001700,OSPEDALE SACRO CUORE DI NEGRAR,VEN,30-39,17,36,0,27,26,0,0,53,0,53,Veneto,ITH3
2021-01-08,PF/BT,5001700,OSPEDALE SACRO CUORE DI NEGRAR,VEN,40-49,18,43,0,31,30,0,0,61,0,61,Veneto,ITH3
2021-01-08,PF/BT,5001700,OSPEDALE SACRO CUORE DI NEGRAR,VEN,50-59,17,41,0,31,27,0,0,58,0,58,Veneto,ITH3
2021-01-08,PF/BT,5001700,OSPEDALE SACRO CUORE DI NEGRAR,VEN,60-69,11,8,0,16,3,0,0,19,0,19,Veneto,ITH3
2021-01-08,PF/BT,5002200,OSPEDALE P. PEDERZOLI,VEN,20-29,4,16,0,20,0,0,0,20,0,20,Veneto,ITH3
2021-01-08,PF/BT,5002200,OSPEDALE P. PEDERZOLI,VEN,30-39,7,18,0,25,0,0,0,25,0,25,Veneto,ITH3
2021-01-08,PF/BT,5002200,OSPEDALE P. PEDERZOLI,VEN,40-49,8,16,0,24,0,0,0,24,0,24,Veneto,ITH3
2021-01-08,PF/BT,5002200,OSPEDALE P. PEDERZOLI,VEN,50-59,5,11,0,16,0,0,0,16,0,16,Veneto,ITH3
2021-01-08,PF/BT,5002200,OSPEDALE P. PEDERZOLI,VEN,60-69,4,2,0,6,0,0,0,6,0,6,Veneto,ITH3
2021-01-08,PF/BT,5002200,OSPEDALE P. PEDERZOLI,VEN,70-79,2,1,0,2,0,0,1,3,0,3,Veneto,ITH3
2021-01-08,PF/BT,5012000,CASA DI CURA DIAZ - PADOVA,VEN,40-49,0,2,0,2,0,0,0,2,0,2,Veneto,ITH3
2021-01-08,PF/BT,5012000,CASA DI CURA DIAZ - PADOVA,VEN,50-59,0,4,0,4,0,0,0,4,0,4,Veneto,ITH3
2021-01-08,PF/BT,5012000,CASA DI CURA DIAZ - PADOVA,VEN,60-69,2,0,0,2,0,0,0,2,0,2,Veneto,ITH3
2021-01-08,PF/BT,5012000,CASA DI CURA DIAZ - PADOVA,VEN,70-79,2,1,0,3,0,0,0,3,0,3,Veneto,ITH3
2021-01-08,PF/BT,50501,AGORDO - SERVIZIO IGIENE,VEN,20-29,5,11,0,13,3,0,0,16,0,16,Veneto,ITH3
2021-01-08,PF/BT,50501,AGORDO - SERVIZIO IGIENE,VEN,30-39,6,8,0,11,3,0,0,14,0,14,Veneto,ITH3
2021-01-08,PF/BT,50501,AGORDO - SERVIZIO IGIENE,VEN,40-49,10,20,0,18,12,0,0,30,0,30,Veneto,ITH3
2021-01-08,PF/BT,50501,AGORDO - SERVIZIO IGIENE,VEN,50-59,4,8,0,7,5,0,0,12,0,12,Veneto,ITH3
2021-01-08,PF/BT,50501,AGORDO - SERVIZIO IGIENE,VEN,60-69,1,1,0,1,1,0,0,2,0,2,Veneto,ITH3
2021-01-08,PF/BT,50501,"BELLUNO ""DRIVE-IN""",VEN,20-29,3,9,0,12,0,0,0,12,0,12,Veneto,ITH3
2021-01-08,PF/BT,50501,"BELLUNO ""DRIVE-IN""",VEN,30-39,7,16,0,23,0,0,0,23,0,23,Veneto,ITH3
2021-01-08,PF/BT,50501,"BELLUNO ""DRIVE-IN""",VEN,40-49,9,33,0,42,0,0,0,42,0,42,Veneto,ITH3
2021-01-08,PF/BT,50501,"BELLUNO ""DRIVE-IN""",VEN,50-59,9,48,0,54,3,0,0,57,0,57,Veneto,ITH3
2021-01-08,PF/BT,50501,"BELLUNO ""DRIVE-IN""",VEN,60-69,8,10,0,17,1,0,0,18,0,18,Veneto,ITH3
2021-01-08,PF/BT,50501,"BELLUNO ""DRIVE-IN""",VEN,80-89,1,0,0,0,0,0,1,1,0,1,Veneto,ITH3
2021-01-08,PF/BT,50501,FELTRE,VEN,20-29,2,8,0,8,2,0,0,10,0,10,Veneto,ITH3
2021-01-08,PF/BT,50501,FELTRE,VEN,30-39,6,16,0,18,4,0,0,22,0,22,Veneto,ITH3
2021-01-08,PF/BT,50501,FELTRE,VEN,40-49,5,27,0,27,5,0,0,32,0,32,Veneto,ITH3
2021-01-08,PF/BT,50501,FELTRE,VEN,50-59,10,49,0,50,9,0,0,59,0,59,Veneto,ITH3
2021-01-08,PF/BT,50501,FELTRE,VEN,60-69,5,5,0,6,4,0,0,10,0,10,Veneto,ITH3
2021-01-08,PF/BT,50501,FELTRE,VEN,80-89,0,1,0,0,0,1,0,1,0,1,Veneto,ITH3
2021-01-08,PF/BT,50502,CASTELFRANCO VENETO,VEN,40-49,0,1,0,1,0,0,0,1,0,1,Veneto,ITH3
2021-01-08,PF/BT,50502,CASTELFRANCO VENETO,VEN,60-69,2,0,0,2,0,0,0,2,0,2,Veneto,ITH3
2021-01-08,PF/BT,50502,PREGANZIOL,VEN,40-49,0,1,0,1,0,0,0,1,0,1,Veneto,ITH3
2021-01-08,PF/BT,50502,PREGANZIOL,VEN,60-69,0,1,0,1,0,0,0,1,0,1,Veneto,ITH3
2021-01-08,PF/BT,50502,TREVISO,VEN,30-39,0,1,0,1,0,0,0,1,0,1,Veneto,ITH3
2021-01-08,PF/BT,50503,CAMPONOGARA ADULTI,VEN,20-29,1,2,0,3,0,0,0,3,0,3,Veneto,ITH3
2021-01-08,PF/BT,50503,CAMPONOGARA ADULTI,VEN,30-39,1,1,0,2,0,0,0,2,0,2,Veneto,ITH3
2021-01-08,PF/BT,50503,CAMPONOGARA ADULTI,VEN,40-49,2,9,0,11,0,0,0,11,0,11,Veneto,ITH3
2021-01-08,PF/BT,50503,CAMPONOGARA ADULTI,VEN,50-59,1,7,0,8,0,0,0,8,0,8,Veneto,ITH3
2021-01-08,PF/BT,50503,CAMPONOGARA ADULTI,VEN,60-69,3,2,0,5,0,0,0,5,0,5,Veneto,ITH3
2021-01-08,PF/BT,50503,CAMPONOGARA ADULTI,VEN,70-79,1,0,0,1,0,0,0,1,0,1,Veneto,ITH3
2021-01-08,PF/BT,50503,MED.PREV - CHIOGGIA,VEN,20-29,5,4,0,9,0,0,0,9,0,9,Veneto,ITH3
2021-01-08,PF/BT,50503,MED.PREV - CHIOGGIA,VEN,30-39,2,1,0,3,0,0,0,3,0,3,Veneto,ITH3
2021-01-08,PF/BT,50503,MED.PREV - CHIOGGIA,VEN,40-49,6,3,0,9,0,0,0,9,0,9,Veneto,ITH3
2021-01-08,PF/BT,50503,MED.PREV - CHIOGGIA,VEN,50-59,8,10,0,18,0,0,0,18,0,18,Veneto,ITH3
2021-01-08,PF/BT,50503,MED.PREV - CHIOGGIA,VEN,60-69,6,3,0,9,0,0,0,9,0,9,Veneto,ITH3
2021-01-08,PF/BT,50503,MEDICINA PREVENTIVA MESTRE,VEN,16-19,0,1,0,1,0,0,0,1,0,1,Veneto,ITH3
2021-01-08,PF/BT,50503,MEDICINA PREVENTIVA MESTRE,VEN,20-29,18,19,0,35,2,0,0,37,0,37,Veneto,ITH3
2021-01-08,PF/BT,50503,MEDICINA PREVENTIVA MESTRE,VEN,30-39,22,39,0,59,2,0,0,61,0,61,Veneto,ITH3
2021-01-08,PF/BT,50503,MEDICINA PREVENTIVA MESTRE,VEN,40-49,25,54,0,77,2,0,0,79,0,79,Veneto,ITH3
2021-01-08,PF/BT,50503,MEDICINA PREVENTIVA MESTRE,VEN,50-59,28,80,0,100,7,0,1,108,0,108,Veneto,ITH3
2021-01-08,PF/BT,50503,MEDICINA PREVENTIVA MESTRE,VEN,60-69,21,25,0,44,2,0,0,46,0,46,Veneto,ITH3
2021-01-08,PF/BT,50503,MEDICINA PREVENTIVA MESTRE,VEN,70-79,3,1,0,3,1,0,0,4,0,4,Veneto,ITH3
2021-01-08,PF/BT,50503,MEDICINA PREVENTIVA VENEZIA,VEN,20-29,2,5,0,6,1,0,0,7,0,7,Veneto,ITH3
2021-01-08,PF/BT,50503,MEDICINA PREVENTIVA VENEZIA,VEN,30-39,13,13,0,18,8,0,0,26,0,26,Veneto,ITH3
2021-01-08,PF/BT,50503,MEDICINA PREVENTIVA VENEZIA,VEN,40-49,20,35,0,35,20,0,0,55,0,55,Veneto,ITH3
2021-01-08,PF/BT,50503,MEDICINA PREVENTIVA VENEZIA,VEN,50-59,30,43,0,43,30,0,0,73,0,73,Veneto,ITH3
2021-01-08,PF/BT,50503,MEDICINA PREVENTIVA VENEZIA,VEN,60-69,9,14,0,17,6,0,0,23,0,23,Veneto,ITH3
2021-01-08,PF/BT,50503,MEDICINA PREVENTIVA VENEZIA,VEN,70-79,2,0,0,0,2,0,0,2,0,2,Veneto,ITH3
2021-01-08,PF/BT,50503,S.I.S.P. MESTRE,VEN,20-29,14,10,0,21,3,0,0,24,0,24,Veneto,ITH3
2021-01-08,PF/BT,50503,S.I.S.P. MESTRE,VEN,30-39,5,13,0,15,3,0,0,18,0,18,Veneto,ITH3
2021-01-08,PF/BT,50503,S.I.S.P. MESTRE,VEN,40-49,3,22,0,20,5,0,0,25,0,25,Veneto,ITH3
2021-01-08,PF/BT,50503,S.I.S.P. MESTRE,VEN,50-59,7,18,0,16,9,0,0,25,0,25,Veneto,ITH3
2021-01-08,PF/BT,50503,S.I.S.P. MESTRE,VEN,60-69,3,4,0,7,0,0,0,7,0,7,Veneto,ITH3
2021-01-08,PF/BT,50503,S.I.S.P. MESTRE,VEN,70-79,2,0,0,2,0,0,0,2,0,2,Veneto,ITH3
2021-01-08,PF/BT,50503,S.I.S.P. MESTRE,VEN,90+,1,0,0,1,0,0,0,1,0,1,Veneto,ITH3
2021-01-08,PF/BT,50503,S.I.S.P. VENEZIA,VEN,20-29,2,2,0,4,0,0,0,4,0,4,Veneto,ITH3
2021-01-08,PF/BT,50503,S.I.S.P. VENEZIA,VEN,30-39,1,4,0,5,0,0,0,5,0,5,Veneto,ITH3
2021-01-08,PF/BT,50503,S.I.S.P. VENEZIA,VEN,40-49,0,1,0,0,1,0,0,1,0,1,Veneto,ITH3
2021-01-08,PF/BT,50503,S.I.S.P. VENEZIA,VEN,50-59,1,3,0,4,0,0,0,4,0,4,Veneto,ITH3
2021-01-08,PF/BT,50503,S.I.S.P. VENEZIA,VEN,60-69,15,3,0,18,0,0,0,18,0,18,Veneto,ITH3
2021-01-08,PF/BT,50503,S.I.S.P. VENEZIA,VEN,70-79,2,0,0,2,0,0,0,2,0,2,Veneto,ITH3
2021-01-08,PF/BT,50503,S.I.S.P. VENEZIA,VEN,80-89,1,1,0,0,0,0,2,2,0,2,Veneto,ITH3
2021-01-08,PF/BT,50503,SISP DOLO ADULTI,VEN,20-29,1,15,0,16,0,0,0,16,0,16,Veneto,ITH3
2021-01-08,PF/BT,50503,SISP DOLO ADULTI,VEN,30-39,8,15,0,23,0,0,0,23,0,23,Veneto,ITH3
2021-01-08,PF/BT,50503,SISP DOLO ADULTI,VEN,40-49,21,31,0,52,0,0,0,52,0,52,Veneto,ITH3
2021-01-08,PF/BT,50503,SISP DOLO ADULTI,VEN,50-59,13,46,0,59,0,0,0,59,0,59,Veneto,ITH3
2021-01-08,PF/BT,50503,SISP DOLO ADULTI,VEN,60-69,7,10,0,17,0,0,0,17,0,17,Veneto,ITH3
2021-01-08,PF/BT,50503,SISP DOLO ADULTI,VEN,70-79,1,0,0,1,0,0,0,1,0,1,Veneto,ITH3
2021-01-08,PF/BT,50505,ADRIA,VEN,20-29,4,11,0,10,5,0,0,15,0,15,Veneto,ITH3
2021-01-08,PF/BT,50505,ADRIA,VEN,30-39,7,15,0,16,6,0,0,22,0,22,Veneto,ITH3
2021-01-08,PF/BT,50505,ADRIA,VEN,40-49,7,15,0,16,6,0,0,22,0,22,Veneto,ITH3
2021-01-08,PF/BT,50505,ADRIA,VEN,50-59,18,25,0,39,4,0,0,43,0,43,Veneto,ITH3
2021-01-08,PF/BT,50505,ADRIA,VEN,60-69,8,10,0,13,5,0,0,18,0,18,Veneto,ITH3
2021-01-08,PF/BT,50505,TRECENTA,VEN,20-29,6,7,0,13,0,0,0,13,0,13,Veneto,ITH3
2021-01-08,PF/BT,50505,TRECENTA,VEN,30-39,2,7,0,9,0,0,0,9,0,9,Veneto,ITH3
2021-01-08,PF/BT,50505,TRECENTA,VEN,40-49,6,7,0,12,0,0,1,13,0,13,Veneto,ITH3
2021-01-08,PF/BT,50505,TRECENTA,VEN,50-59,13,19,0,31,0,0,1,32,0,32,Veneto,ITH3
2021-01-08,PF/BT,50505,TRECENTA,VEN,60-69,11,11,0,22,0,0,0,22,0,22,Veneto,ITH3
2021-01-08,PF/BT,50505,TRECENTA,VEN,70-79,2,0,0,2,0,0,0,2,0,2,Veneto,ITH3
2021-01-08,PF/BT,5050501,PRESIDIO OSPEDALIERO ROVIGO,VEN,20-29,5,8,0,10,1,0,2,13,0,13,Veneto,ITH3
2021-01-08,PF/BT,5050501,PRESIDIO OSPEDALIERO ROVIGO,VEN,30-39,11,16,0,23,1,0,3,27,0,27,Veneto,ITH3
2021-01-08,PF/BT,5050501,PRESIDIO OSPEDALIERO ROVIGO,VEN,40-49,10,45,0,41,1,0,13,55,0,55,Veneto,ITH3
2021-01-08,PF/BT,5050501,PRESIDIO OSPEDALIERO ROVIGO,VEN,50-59,19,72,0,68,3,0,20,91,0,91,Veneto,ITH3
2021-01-08,PF/BT,5050501,PRESIDIO OSPEDALIERO ROVIGO,VEN,60-69,11,26,0,25,1,0,11,37,0,37,Veneto,ITH3
2021-01-08,PF/BT,5050501,PRESIDIO OSPEDALIERO ROVIGO,VEN,70-79,4,0,0,4,0,0,0,4,0,4,Veneto,ITH3
2021-01-08,PF/BT,5050501,PRESIDIO OSPEDALIERO ROVIGO,VEN,80-89,1,0,0,1,0,0,0,1,0,1,Veneto,ITH3
2021-01-08,PF/BT,50506,AZ OSPEDALIERA DI PADOVA MAL. INFET.E TR,VEN,20-29,3,13,0,16,0,0,0,16,0,16,Veneto,ITH3
2021-01-08,PF/BT,50506,AZ OSPEDALIERA DI PADOVA MAL. INFET.E TR,VEN,30-39,15,26,0,41,0,0,0,41,0,41,Veneto,ITH3
2021-01-08,PF/BT,50506,AZ OSPEDALIERA DI PADOVA MAL. INFET.E TR,VEN,40-49,7,36,0,43,0,0,0,43,0,43,Veneto,ITH3
2021-01-08,PF/BT,50506,AZ OSPEDALIERA DI PADOVA MAL. INFET.E TR,VEN,50-59,13,32,0,45,0,0,0,45,0,45,Veneto,ITH3
2021-01-08,PF/BT,50506,AZ OSPEDALIERA DI PADOVA MAL. INFET.E TR,VEN,60-69,11,11,0,22,0,0,0,22,0,22,Veneto,ITH3
2021-01-08,PF/BT,50506,AZ OSPEDALIERA DI PADOVA MAL. INFET.E TR,VEN,70-79,0,1,0,1,0,0,0,1,0,1,Veneto,ITH3
2021-01-08,PF/BT,50506,CAMPOSAMPIERO,VEN,16-19,0,1,0,1,0,0,0,1,0,1,Veneto,ITH3
2021-01-08,PF/BT,50506,CAMPOSAMPIERO,VEN,20-29,4,10,0,14,0,0,0,14,0,14,Veneto,ITH3
2021-01-08,PF/BT,50506,CAMPOSAMPIERO,VEN,30-39,2,16,0,18,0,0,0,18,0,18,Veneto,ITH3
2021-01-08,PF/BT,50506,CAMPOSAMPIERO,VEN,40-49,1,34,0,35,0,0,0,35,0,35,Veneto,ITH3
2021-01-08,PF/BT,50506,CAMPOSAMPIERO,VEN,50-59,3,27,0,30,0,0,0,30,0,30,Veneto,ITH3
2021-01-08,PF/BT,50506,CAMPOSAMPIERO,VEN,60-69,20,8,0,28,0,0,0,28,0,28,Veneto,ITH3
2021-01-08,PF/BT,50506,CAMPOSAMPIERO (S.I.S.P.),VEN,16-19,0,1,0,0,0,0,1,1,0,1,Veneto,ITH3
2021-01-08,PF/BT,50506,CAMPOSAMPIERO (S.I.S.P.),VEN,20-29,6,9,0,12,1,0,2,15,0,15,Veneto,ITH3
2021-01-08,PF/BT,50506,CAMPOSAMPIERO (S.I.S.P.),VEN,30-39,6,4,0,9,0,0,1,10,0,10,Veneto,ITH3
2021-01-08,PF/BT,50506,CAMPOSAMPIERO (S.I.S.P.),VEN,40-49,2,7,0,6,0,0,3,9,0,9,Veneto,ITH3
2021-01-08,PF/BT,50506,CAMPOSAMPIERO (S.I.S.P.),VEN,50-59,14,19,0,24,0,0,9,33,0,33,Veneto,ITH3
2021-01-08,PF/BT,50506,CAMPOSAMPIERO (S.I.S.P.),VEN,60-69,20,10,0,27,0,0,3,30,0,30,Veneto,ITH3
2021-01-08,PF/BT,50506,CAMPOSAMPIERO MEDICO COMPETENT,VEN,20-29,2,8,0,10,0,0,0,10,0,10,Veneto,ITH3
2021-01-08,PF/BT,50506,CAMPOSAMPIERO MEDICO COMPETENT,VEN,30-39,2,12,0,14,0,0,0,14,0,14,Veneto,ITH3
2021-01-08,PF/BT,50506,CAMPOSAMPIERO MEDICO COMPETENT,VEN,40-49,4,19,0,23,0,0,0,23,0,23,Veneto,ITH3
2021-01-08,PF/BT,50506,CAMPOSAMPIERO MEDICO COMPETENT,VEN,50-59,6,15,0,20,1,0,0,21,0,21,Veneto,ITH3
2021-01-08,PF/BT,50506,CAMPOSAMPIERO MEDICO COMPETENT,VEN,60-69,3,1,0,4,0,0,0,4,0,4,Veneto,ITH3
2021-01-08,PF/BT,50506,CITTADELLA MEDICO COMPETENTE,VEN,20-29,0,4,0,4,0,0,0,4,0,4,Veneto,ITH3
2021-01-08,PF/BT,50506,CITTADELLA MEDICO COMPETENTE,VEN,30-39,5,16,0,19,2,0,0,21,0,21,Veneto,ITH3
2021-01-08,PF/BT,50506,CITTADELLA MEDICO COMPETENTE,VEN,40-49,8,23,0,22,6,0,3,31,0,31,Veneto,ITH3
2021-01-08,PF/BT,50506,CITTADELLA MEDICO COMPETENTE,VEN,50-59,10,35,0,33,11,0,1,45,0,45,Veneto,ITH3
2021-01-08,PF/BT,50506,CITTADELLA MEDICO COMPETENTE,VEN,60-69,5,8,0,5,8,0,0,13,0,13,Veneto,ITH3
2021-01-08,PF/BT,50506,COLLI VACC. ADULTI,VEN,20-29,2,4,0,6,0,0,0,6,0,6,Veneto,ITH3
2021-01-08,PF/BT,50506,COLLI VACC. ADULTI,VEN,30-39,5,5,0,10,0,0,0,10,0,10,Veneto,ITH3
2021-01-08,PF/BT,50506,COLLI VACC. ADULTI,VEN,40-49,1,3,0,4,0,0,0,4,0,4,Veneto,ITH3
2021-01-08,PF/BT,50506,COLLI VACC. ADULTI,VEN,50-59,2,17,0,19,0,0,0,19,0,19,Veneto,ITH3
2021-01-08,PF/BT,50506,COLLI VACC. ADULTI,VEN,60-69,4,6,0,10,0,0,0,10,0,10,Veneto,ITH3
2021-01-08,PF/BT,50506,DIRIGENZA MEDICA P.D.SACCO,VEN,20-29,1,5,0,6,0,0,0,6,0,6,Veneto,ITH3
2021-01-08,PF/BT,50506,DIRIGENZA MEDICA P.D.SACCO,VEN,30-39,3,8,0,10,1,0,0,11,0,11,Veneto,ITH3
2021-01-08,PF/BT,50506,DIRIGENZA MEDICA P.D.SACCO,VEN,40-49,6,19,0,23,2,0,0,25,0,25,Veneto,ITH3
2021-01-08,PF/BT,50506,DIRIGENZA MEDICA P.D.SACCO,VEN,50-59,9,30,0,35,4,0,0,39,0,39,Veneto,ITH3
2021-01-08,PF/BT,50506,DIRIGENZA MEDICA P.D.SACCO,VEN,60-69,4,4,0,4,4,0,0,8,0,8,Veneto,ITH3
2021-01-08,PF/BT,50506,DISTR. 3 ALBIGNASEGO AMB.IGIEN,VEN,20-29,3,3,0,6,0,0,0,6,0,6,Veneto,ITH3
2021-01-08,PF/BT,50506,DISTR. 3 ALBIGNASEGO AMB.IGIEN,VEN,30-39,3,4,0,7,0,0,0,7,0,7,Veneto,ITH3
2021-01-08,PF/BT,50506,DISTR. 3 ALBIGNASEGO AMB.IGIEN,VEN,40-49,5,8,0,11,2,0,0,13,0,13,Veneto,ITH3
2021-01-08,PF/BT,50506,DISTR. 3 ALBIGNASEGO AMB.IGIEN,VEN,50-59,4,10,0,13,1,0,0,14,0,14,Veneto,ITH3
2021-01-08,PF/BT,50506,DISTR. 3 ALBIGNASEGO AMB.IGIEN,VEN,60-69,12,20,0,27,5,0,0,32,0,32,Veneto,ITH3
2021-01-08,PF/BT,50506,IGIENE PUBBLICA RUBANO,VEN,20-29,6,5,0,4,6,0,1,11,0,11,Veneto,ITH3
2021-01-08,PF/BT,50506,IGIENE PUBBLICA RUBANO,VEN,30-39,2,5,0,5,2,0,0,7,0,7,Veneto,ITH3
2021-01-08,PF/BT,50506,IGIENE PUBBLICA RUBANO,VEN,40-49,1,26,0,21,5,0,1,27,0,27,Veneto,ITH3
2021-01-08,PF/BT,50506,IGIENE PUBBLICA RUBANO,VEN,50-59,6,21,0,20,7,0,0,27,0,27,Veneto,ITH3
2021-01-08,PF/BT,50506,IGIENE PUBBLICA RUBANO,VEN,60-69,16,14,0,21,9,0,0,30,0,30,Veneto,ITH3
2021-01-08,PF/BT,50506,MONSELICE,VEN,20-29,2,3,0,5,0,0,0,5,0,5,Veneto,ITH3
2021-01-08,PF/BT,50506,MONSELICE,VEN,30-39,2,7,0,8,1,0,0,9,0,9,Veneto,ITH3
2021-01-08,PF/BT,50506,MONSELICE,VEN,40-49,0,18,0,15,3,0,0,18,0,18,Veneto,ITH3
2021-01-08,PF/BT,50506,MONSELICE,VEN,50-59,5,18,0,12,11,0,0,23,0,23,Veneto,ITH3
2021-01-08,PF/BT,50506,MONSELICE,VEN,60-69,2,3,0,4,1,0,0,5,0,5,Veneto,ITH3
2021-01-08,PF/BT,50506,PIOVE DI SACCO - SERV. IGIENE E SANITA',VEN,20-29,1,9,0,9,1,0,0,10,0,10,Veneto,ITH3
2021-01-08,PF/BT,50506,PIOVE DI SACCO - SERV. IGIENE E SANITA',VEN,30-39,3,7,0,8,2,0,0,10,0,10,Veneto,ITH3
2021-01-08,PF/BT,50506,PIOVE DI SACCO - SERV. IGIENE E SANITA',VEN,40-49,3,15,0,18,0,0,0,18,0,18,Veneto,ITH3
2021-01-08,PF/BT,50506,PIOVE DI SACCO - SERV. IGIENE E SANITA',VEN,50-59,4,12,0,15,1,0,0,16,0,16,Veneto,ITH3
2021-01-08,PF/BT,50506,PIOVE DI SACCO - SERV. IGIENE E SANITA',VEN,60-69,10,7,0,16,1,0,0,17,0,17,Veneto,ITH3
2021-01-08,PF/BT,50506,SCHIAVONIA AMBULATORIO,VEN,20-29,1,5,0,6,0,0,0,6,0,6,Veneto,ITH3
2021-01-08,PF/BT,50506,SCHIAVONIA AMBULATORIO,VEN,30-39,3,11,0,14,0,0,0,14,0,14,Veneto,ITH3
2021-01-08,PF/BT,50506,SCHIAVONIA AMBULATORIO,VEN,40-49,5,19,0,24,0,0,0,24,0,24,Veneto,ITH3
2021-01-08,PF/BT,50506,SCHIAVONIA AMBULATORIO,VEN,50-59,11,23,0,34,0,0,0,34,0,34,Veneto,ITH3
2021-01-08,PF/BT,50506,SCHIAVONIA AMBULATORIO,VEN,60-69,4,3,0,7,0,0,0,7,0,7,Veneto,ITH3
2021-01-08,PF/BT,50506,SET.IGIENE PUBBLICA EPID.E PROF. MAL.INF,VEN,20-29,0,8,0,7,1,0,0,8,0,8,Veneto,ITH3
2021-01-08,PF/BT,50506,SET.IGIENE PUBBLICA EPID.E PROF. MAL.INF,VEN,30-39,4,5,0,7,2,0,0,9,0,9,Veneto,ITH3
2021-01-08,PF/BT,50506,SET.IGIENE PUBBLICA EPID.E PROF. MAL.INF,VEN,40-49,4,3,0,5,1,0,1,7,0,7,Veneto,ITH3
2021-01-08,PF/BT,50506,SET.IGIENE PUBBLICA EPID.E PROF. MAL.INF,VEN,50-59,9,11,0,16,4,0,0,20,0,20,Veneto,ITH3
2021-01-08,PF/BT,50506,SET.IGIENE PUBBLICA EPID.E PROF. MAL.INF,VEN,60-69,8,2,0,8,2,0,0,10,0,10,Veneto,ITH3
2021-01-08,PF/BT,50506,VIA SCROVEGNI ANTI INFLUENZALE,VEN,40-49,0,4,0,4,0,0,0,4,0,4,Veneto,ITH3
2021-01-08,PF/BT,50506,VIA SCROVEGNI ANTI INFLUENZALE,VEN,50-59,0,3,0,2,1,0,0,3,0,3,Veneto,ITH3
2021-01-08,PF/BT,50506,VIA SCROVEGNI ANTI INFLUENZALE,VEN,60-69,3,2,0,5,0,0,0,5,0,5,Veneto,ITH3
2021-01-08,PF/BT,50507,DIPARTIMENTO DI PREVENZIONE,VEN,20-29,2,11,0,11,2,0,0,13,0,13,Veneto,ITH3
2021-01-08,PF/BT,50507,DIPARTIMENTO DI PREVENZIONE,VEN,30-39,1,12,0,13,0,0,0,13,0,13,Veneto,ITH3
2021-01-08,PF/BT,50507,DIPARTIMENTO DI PREVENZIONE,VEN,40-49,3,16,0,19,0,0,0,19,0,19,Veneto,ITH3
2021-01-08,PF/BT,50507,DIPARTIMENTO DI PREVENZIONE,VEN,50-59,8,19,0,21,6,0,0,27,0,27,Veneto,ITH3
2021-01-08,PF/BT,50507,DIPARTIMENTO DI PREVENZIONE,VEN,60-69,13,5,0,17,1,0,0,18,0,18,Veneto,ITH3
2021-01-08,PF/BT,50507,DIPARTIMENTO DI PREVENZIONE,VEN,90+,0,1,0,0,0,1,0,1,0,1,Veneto,ITH3
2021-01-08,PF/BT,50507,EX OSPEDALE - BOLDRINI,VEN,16-19,0,1,0,1,0,0,0,1,0,1,Veneto,ITH3
2021-01-08,PF/BT,50507,EX OSPEDALE - BOLDRINI,VEN,20-29,2,12,0,14,0,0,0,14,0,14,Veneto,ITH3
2021-01-08,PF/BT,50507,EX OSPEDALE - BOLDRINI,VEN,30-39,11,10,0,21,0,0,0,21,0,21,Veneto,ITH3
2021-01-08,PF/BT,50507,EX OSPEDALE - BOLDRINI,VEN,40-49,13,22,0,35,0,0,0,35,0,35,Veneto,ITH3
2021-01-08,PF/BT,50507,EX OSPEDALE - BOLDRINI,VEN,50-59,14,50,0,64,0,0,0,64,0,64,Veneto,ITH3
2021-01-08,PF/BT,50507,EX OSPEDALE - BOLDRINI,VEN,60-69,20,12,0,32,0,0,0,32,0,32,Veneto,ITH3
2021-01-08,PF/BT,50507,EX OSPEDALE - BOLDRINI,VEN,70-79,13,3,0,16,0,0,0,16,0,16,Veneto,ITH3
2021-01-08,PF/BT,50507,H BASSANO,VEN,16-19,1,0,0,0,1,0,0,1,0,1,Veneto,ITH3
2021-01-08,PF/BT,50507,H BASSANO,VEN,20-29,3,9,0,7,5,0,0,12,0,12,Veneto,ITH3
2021-01-08,PF/BT,50507,H BASSANO,VEN,30-39,14,15,0,11,18,0,0,29,0,29,Veneto,ITH3
2021-01-08,PF/BT,50507,H BASSANO,VEN,40-49,9,18,0,7,20,0,0,27,0,27,Veneto,ITH3
2021-01-08,PF/BT,50507,H BASSANO,VEN,50-59,12,13,0,10,15,0,0,25,0,25,Veneto,ITH3
2021-01-08,PF/BT,50507,H BASSANO,VEN,60-69,5,8,0,6,7,0,0,13,0,13,Veneto,ITH3
2021-01-08,PF/BT,50507,H BASSANO,VEN,80-89,0,1,0,0,0,1,0,1,0,1,Veneto,ITH3
2021-01-08,PF/BT,50507,THIENE,VEN,20-29,0,6,0,6,0,0,0,6,0,6,Veneto,ITH3
2021-01-08,PF/BT,50507,THIENE,VEN,30-39,7,13,0,20,0,0,0,20,0,20,Veneto,ITH3
2021-01-08,PF/BT,50507,THIENE,VEN,40-49,6,14,0,20,0,0,0,20,0,20,Veneto,ITH3
2021-01-08,PF/BT,50507,THIENE,VEN,50-59,6,38,0,44,0,0,0,44,0,44,Veneto,ITH3
2021-01-08,PF/BT,50507,THIENE,VEN,60-69,3,8,0,11,0,0,0,11,0,11,Veneto,ITH3
2021-01-08,PF/BT,5050801,MED.COMP. - OSP. SAN BORTOLO,VEN,20-29,13,27,0,35,2,0,3,40,0,40,Veneto,ITH3
2021-01-08,PF/BT,5050801,MED.COMP. - OSP. SAN BORTOLO,VEN,30-39,18,41,0,55,1,0,3,59,0,59,Veneto,ITH3
2021-01-08,PF/BT,5050801,MED.COMP. - OSP. SAN BORTOLO,VEN,40-49,22,79,0,86,4,0,11,101,0,101,Veneto,ITH3
2021-01-08,PF/BT,5050801,MED.COMP. - OSP. SAN BORTOLO,VEN,50-59,29,85,0,98,5,0,11,114,0,114,Veneto,ITH3
2021-01-08,PF/BT,5050801,MED.COMP. - OSP. SAN BORTOLO,VEN,60-69,19,17,0,30,0,0,6,36,0,36,Veneto,ITH3
2021-01-08,PF/BT,5050801,MED.COMP. - OSP. SAN BORTOLO,VEN,70-79,6,0,0,6,0,0,0,6,0,6,Veneto,ITH3
2021-01-08,PF/BT,5050802,MED.COMP. - OSP. PIETRO MILAN,VEN,20-29,4,12,0,14,1,0,1,16,0,16,Veneto,ITH3
2021-01-08,PF/BT,5050802,MED.COMP. - OSP. PIETRO MILAN,VEN,30-39,7,11,0,18,0,0,0,18,0,18,Veneto,ITH3
2021-01-08,PF/BT,5050802,MED.COMP. - OSP. PIETRO MILAN,VEN,40-49,10,41,0,48,0,0,3,51,0,51,Veneto,ITH3
2021-01-08,PF/BT,5050802,MED.COMP. - OSP. PIETRO MILAN,VEN,50-59,17,44,0,58,2,0,1,61,0,61,Veneto,ITH3
2021-01-08,PF/BT,5050802,MED.COMP. - OSP. PIETRO MILAN,VEN,60-69,23,7,0,28,1,0,1,30,0,30,Veneto,ITH3
2021-01-08,PF/BT,5050802,MED.COMP. - OSP. PIETRO MILAN,VEN,70-79,1,0,0,1,0,0,0,1,0,1,Veneto,ITH3
2021-01-08,PF/BT,5050802,MED.COMP. - OSP. PIETRO MILAN,VEN,80-89,1,0,0,1,0,0,0,1,0,1,Veneto,ITH3
2021-01-08,PF/BT,50509,LEGNAGO,VEN,20-29,4,4,0,5,1,0,2,8,0,8,Veneto,ITH3
2021-01-08,PF/BT,50509,LEGNAGO,VEN,30-39,5,11,0,15,1,0,0,16,0,16,Veneto,ITH3
2021-01-08,PF/BT,50509,LEGNAGO,VEN,40-49,5,14,0,14,4,0,1,19,0,19,Veneto,ITH3
2021-01-08,PF/BT,50509,LEGNAGO,VEN,50-59,17,18,0,15,16,0,4,35,0,35,Veneto,ITH3
2021-01-08,PF/BT,50509,LEGNAGO,VEN,60-69,16,6,0,13,9,0,0,22,0,22,Veneto,ITH3
2021-01-08,PF/BT,50509,LEGNAGO,VEN,70-79,2,0,0,1,1,0,0,2,0,2,Veneto,ITH3
2021-01-08,PF/BT,50509,SAN BONIFACIO,VEN,20-29,3,8,0,10,1,0,0,11,0,11,Veneto,ITH3
2021-01-08,PF/BT,50509,SAN BONIFACIO,VEN,30-39,6,11,0,15,2,0,0,17,0,17,Veneto,ITH3
2021-01-08,PF/BT,50509,SAN BONIFACIO,VEN,40-49,11,31,0,33,9,0,0,42,0,42,Veneto,ITH3
2021-01-08,PF/BT,50509,SAN BONIFACIO,VEN,50-59,17,60,0,56,20,0,1,77,0,77,Veneto,ITH3
2021-01-08,PF/BT,50509,SAN BONIFACIO,VEN,60-69,15,17,0,26,6,0,0,32,0,32,Veneto,ITH3
2021-01-08,PF/BT,50509,SAN BONIFACIO,VEN,70-79,2,0,0,1,1,0,0,2,0,2,Veneto,ITH3
2021-01-08,PF/BT,5091201,AOUIVR,VEN,20-29,46,88,0,133,1,0,0,134,0,134,Veneto,ITH3
2021-01-08,PF/BT,5091201,AOUIVR,VEN,30-39,59,109,0,160,8,0,0,168,0,168,Veneto,ITH3
2021-01-08,PF/BT,5091201,AOUIVR,VEN,40-49,43,103,0,138,8,0,0,146,0,146,Veneto,ITH3
2021-01-08,PF/BT,5091201,AOUIVR,VEN,50-59,56,185,0,218,23,0,0,241,0,241,Veneto,ITH3
2021-01-08,PF/BT,5091201,AOUIVR,VEN,60-69,30,40,0,64,6,0,0,70,0,70,Veneto,ITH3
2021-01-08,PF/BT,5095201,IOV,VEN,20-29,4,24,0,28,0,0,0,28,0,28,Veneto,ITH3
2021-01-08,PF/BT,5095201,IOV,VEN,30-39,10,27,0,37,0,0,0,37,0,37,Veneto,ITH3
2021-01-08,PF/BT,5095201,IOV,VEN,40-49,12,26,0,38,0,0,0,38,0,38,Veneto,ITH3
2021-01-08,PF/BT,5095201,IOV,VEN,50-59,8,26,0,34,0,0,0,34,0,34,Veneto,ITH3
2021-01-08,PF/BT,5095201,IOV,VEN,60-69,4,2,0,6,0,0,0,6,0,6,Veneto,ITH3
2021-01-08,PF/BT,5095201,IOV,VEN,70-79,1,0,0,1,0,0,0,1,0,1,Veneto,ITH3
2021-01-08,PF/BT,521630,R.S.A. 'IL GIRASOLE',VEN,60-69,0,2,0,0,0,2,0,2,0,2,Veneto,ITH3
2021-01-08,PF/BT,521630,R.S.A. 'IL GIRASOLE',VEN,70-79,1,0,0,0,0,1,0,1,0,1,Veneto,ITH3
2021-01-08,PF/BT,605602,CENTRO MED. FONIATRIA,VEN,20-29,1,0,0,1,0,0,0,1,0,1,Veneto,ITH3
2021-01-08,PF/BT,605602,CENTRO MED. FONIATRIA,VEN,40-49,0,3,0,3,0,0,0,3,0,3,Veneto,ITH3
2021-01-08,PF/BT,605602,CENTRO MED. FONIATRIA,VEN,50-59,1,4,0,5,0,0,0,5,0,5,Veneto,ITH3
2021-01-08,PF/BT,609901,CASA DI CURA DI ABANO TERME - POLISPECIALISTICA E TERMALE SPA,VEN,50-59,1,0,0,1,0,0,0,1,0,1,Veneto,ITH3
2021-01-08,PF/BT,610903,CASA DI CURA ABANO TERME SPA,VEN,20-29,3,5,0,8,0,0,0,8,0,8,Veneto,ITH3
2021-01-08,PF/BT,610903,CASA DI CURA ABANO TERME SPA,VEN,30-39,1,2,0,3,0,0,0,3,0,3,Veneto,ITH3
2021-01-08,PF/BT,610903,CASA DI CURA ABANO TERME SPA,VEN,40-49,0,2,0,2,0,0,0,2,0,2,Veneto,ITH3
2021-01-08,PF/BT,610903,CASA DI CURA ABANO TERME SPA,VEN,50-59,0,1,0,1,0,0,0,1,0,1,Veneto,ITH3
2021-01-08,PF/BT,610903,CASA DI CURA ABANO TERME SPA,VEN,60-69,1,1,0,2,0,0,0,2,0,2,Veneto,ITH3
2021-01-08,PF/BT,610903,CASA DI CURA ABANO TERME SPA,VEN,70-79,2,1,0,3,0,0,0,3,0,3,Veneto,ITH3
2021-01-08,PF/BT,610946,ALTAVITA IRA - CENTRO SERVIZI BEATO PELLEGRINO,VEN,20-29,1,3,0,3,1,0,0,4,0,4,Veneto,ITH3
2021-01-08,PF/BT,610946,ALTAVITA IRA - CENTRO SERVIZI BEATO PELLEGRINO,VEN,30-39,1,1,0,2,0,0,0,2,0,2,Veneto,ITH3
2021-01-08,PF/BT,610946,ALTAVITA IRA - CENTRO SERVIZI BEATO PELLEGRINO,VEN,40-49,3,16,0,14,5,0,0,19,0,19,Veneto,ITH3
2021-01-08,PF/BT,610946,ALTAVITA IRA - CENTRO SERVIZI BEATO PELLEGRINO,VEN,50-59,8,21,0,22,7,0,0,29,0,29,Veneto,ITH3
2021-01-08,PF/BT,610946,ALTAVITA IRA - CENTRO SERVIZI BEATO PELLEGRINO,VEN,60-69,7,5,0,5,4,3,0,12,0,12,Veneto,ITH3
2021-01-08,PF/BT,610946,ALTAVITA IRA - CENTRO SERVIZI BEATO PELLEGRINO,VEN,70-79,2,7,0,2,0,7,0,9,0,9,Veneto,ITH3
2021-01-08,PF/BT,610946,ALTAVITA IRA - CENTRO SERVIZI BEATO PELLEGRINO,VEN,80-89,4,11,0,0,0,15,0,15,0,15,Veneto,ITH3
2021-01-08,PF/BT,610946,ALTAVITA IRA - CENTRO SERVIZI BEATO PELLEGRINO,VEN,90+,3,15,0,0,0,18,0,18,0,18,Veneto,ITH3
2021-01-08,PF/BT,610952,O.I.C. CENTRO NAZARETH,VEN,20-29,3,12,0,12,3,0,0,15,0,15,Veneto,ITH3
2021-01-08,PF/BT,610952,O.I.C. CENTRO NAZARETH,VEN,30-39,1,4,0,4,1,0,0,5,0,5,Veneto,ITH3
2021-01-08,PF/BT,610952,O.I.C. CENTRO NAZARETH,VEN,40-49,1,17,0,16,2,0,0,18,0,18,Veneto,ITH3
2021-01-08,PF/BT,610952,O.I.C. CENTRO NAZARETH,VEN,50-59,9,11,0,13,7,0,0,20,0,20,Veneto,ITH3
2021-01-08,PF/BT,610952,O.I.C. CENTRO NAZARETH,VEN,60-69,1,6,0,3,2,2,0,7,0,7,Veneto,ITH3
2021-01-08,PF/BT,610952,O.I.C. CENTRO NAZARETH,VEN,70-79,2,12,0,0,0,14,0,14,0,14,Veneto,ITH3
2021-01-08,PF/BT,610952,O.I.C. CENTRO NAZARETH,VEN,80-89,19,32,0,0,2,49,0,51,0,51,Veneto,ITH3
2021-01-08,PF/BT,610952,O.I.C. CENTRO NAZARETH,VEN,90+,5,22,0,0,0,27,0,27,0,27,Veneto,ITH3
2021-01-08,PF/BT,610955,OPSA - OPERA PROVVIDENZA S.ANTONIO DISABILI,VEN,30-39,0,4,0,2,0,2,0,4,0,4,Veneto,ITH3
2021-01-08,PF/BT,610955,OPSA - OPERA PROVVIDENZA S.ANTONIO DISABILI,VEN,40-49,1,14,0,10,0,5,0,15,0,15,Veneto,ITH3
2021-01-08,PF/BT,610955,OPSA - OPERA PROVVIDENZA S.ANTONIO DISABILI,VEN,50-59,4,25,0,9,2,17,1,29,0,29,Veneto,ITH3
2021-01-08,PF/BT,610955,OPSA - OPERA PROVVIDENZA S.ANTONIO DISABILI,VEN,60-69,0,13,0,0,1,11,1,13,0,13,Veneto,ITH3
2021-01-08,PF/BT,610955,OPSA - OPERA PROVVIDENZA S.ANTONIO DISABILI,VEN,70-79,2,9,0,0,0,11,0,11,0,11,Veneto,ITH3
2021-01-08,PF/BT,610955,OPSA - OPERA PROVVIDENZA S.ANTONIO DISABILI,VEN,80-89,1,0,0,0,0,0,1,1,0,1,Veneto,ITH3
2021-01-08,PF/BT,611054,OPSA - CASA SOCCIORNO MONS.BORTIGNON - RELIGIOSI,VEN,80-89,2,2,0,0,0,4,0,4,0,4,Veneto,ITH3
2021-01-08,PF/BT,611075,NUCLEO PAZIENTI STATO VEGETATIVO,VEN,80-89,0,1,0,0,0,1,0,1,0,1,Veneto,ITH3
2021-01-08,PF/BT,611145,OIC - CENTRO RESIDENZIALE CIVITAS VITAE,VEN,20-29,6,17,0,20,2,1,0,23,0,23,Veneto,ITH3
2021-01-08,PF/BT,611145,OIC - CENTRO RESIDENZIALE CIVITAS VITAE,VEN,30-39,7,13,0,15,3,2,0,20,0,20,Veneto,ITH3
2021-01-08,PF/BT,611145,OIC - CENTRO RESIDENZIALE CIVITAS VITAE,VEN,40-49,11,24,0,21,9,5,0,35,0,35,Veneto,ITH3
2021-01-08,PF/BT,611145,OIC - CENTRO RESIDENZIALE CIVITAS VITAE,VEN,50-59,20,32,0,36,15,1,0,52,0,52,Veneto,ITH3
2021-01-08,PF/BT,611145,OIC - CENTRO RESIDENZIALE CIVITAS VITAE,VEN,60-69,11,17,0,13,6,9,0,28,0,28,Veneto,ITH3
2021-01-08,PF/BT,611145,OIC - CENTRO RESIDENZIALE CIVITAS VITAE,VEN,70-79,14,9,0,1,0,22,0,23,0,23,Veneto,ITH3
2021-01-08,PF/BT,611145,OIC - CENTRO RESIDENZIALE CIVITAS VITAE,VEN,80-89,16,18,0,1,0,33,0,34,0,34,Veneto,ITH3
2021-01-08,PF/BT,611145,OIC - CENTRO RESIDENZIALE CIVITAS VITAE,VEN,90+,4,14,0,0,0,18,0,18,0,18,Veneto,ITH3
2021-01-08,PF/BT,611165,CRAUP - RSA VIA BOTTA,VEN,20-29,0,4,0,4,0,0,0,4,0,4,Veneto,ITH3
2021-01-08,PF/BT,611165,CRAUP - RSA VIA BOTTA,VEN,30-39,0,1,0,1,0,0,0,1,0,1,Veneto,ITH3
2021-01-08,PF/BT,611165,CRAUP - RSA VIA BOTTA,VEN,40-49,1,6,0,6,1,0,0,7,0,7,Veneto,ITH3
2021-01-08,PF/BT,611165,CRAUP - RSA VIA BOTTA,VEN,50-59,2,13,0,9,6,0,0,15,0,15,Veneto,ITH3
2021-01-08,PF/BT,611165,CRAUP - RSA VIA BOTTA,VEN,60-69,2,3,0,3,0,2,0,5,0,5,Veneto,ITH3
2021-01-08,PF/BT,611165,CRAUP - RSA VIA BOTTA,VEN,70-79,2,5,0,0,0,7,0,7,0,7,Veneto,ITH3
2021-01-08,PF/BT,611165,CRAUP - RSA VIA BOTTA,VEN,80-89,1,18,0,0,0,19,0,19,0,19,Veneto,ITH3
2021-01-08,PF/BT,611165,CRAUP - RSA VIA BOTTA,VEN,90+,1,7,0,0,0,8,0,8,0,8,Veneto,ITH3
2021-01-08,PF/BT,611181,ISTITUTO CONFIGLIACHI - 'RESIDENZA BREDA',VEN,20-29,0,2,0,0,2,0,0,2,0,2,Veneto,ITH3
2021-01-08,PF/BT,611181,ISTITUTO CONFIGLIACHI - 'RESIDENZA BREDA',VEN,40-49,1,1,0,0,2,0,0,2,0,2,Veneto,ITH3
2021-01-08,PF/BT,611181,ISTITUTO CONFIGLIACHI - 'RESIDENZA BREDA',VEN,50-59,0,4,0,0,3,1,0,4,0,4,Veneto,ITH3
2021-01-08,PF/BT,611181,ISTITUTO CONFIGLIACHI - 'RESIDENZA BREDA',VEN,60-69,1,3,0,0,2,2,0,4,0,4,Veneto,ITH3
2021-01-08,PF/BT,611181,ISTITUTO CONFIGLIACHI - 'RESIDENZA BREDA',VEN,80-89,3,5,0,0,0,8,0,8,0,8,Veneto,ITH3
2021-01-08,PF/BT,611181,ISTITUTO CONFIGLIACHI - 'RESIDENZA BREDA',VEN,90+,2,6,0,0,0,8,0,8,0,8,Veneto,ITH3
2021-01-08,PF/BT,611198,OPSA - CASA MASSIMILIANO KOLBE,VEN,30-39,0,5,0,4,1,0,0,5,0,5,Veneto,ITH3
2021-01-08,PF/BT,611198,OPSA - CASA MASSIMILIANO KOLBE,VEN,40-49,2,7,0,7,2,0,0,9,0,9,Veneto,ITH3
2021-01-08,PF/BT,611198,OPSA - CASA MASSIMILIANO KOLBE,VEN,50-59,3,10,0,9,4,0,0,13,0,13,Veneto,ITH3
2021-01-08,PF/BT,611198,OPSA - CASA MASSIMILIANO KOLBE,VEN,60-69,2,0,0,0,2,0,0,2,0,2,Veneto,ITH3
2021-01-08,PF/BT,611234,CASA DEI FONDATORI,VEN,50-59,1,0,0,1,0,0,0,1,0,1,Veneto,ITH3
2021-01-08,PF/BT,611234,CASA DEI FONDATORI,VEN,90+,1,0,0,0,0,1,0,1,0,1,Veneto,ITH3
2021-01-08,PF/BT,611243,CENTRO DI RIFERIMENTO PER LE GRAVI DISABILITA' E DISTIURBI DEL COMPORTAMENTO,VEN,20-29,2,0,0,0,0,2,0,2,0,2,Veneto,ITH3
2021-01-08,PF/BT,611243,CENTRO DI RIFERIMENTO PER LE GRAVI DISABILITA' E DISTIURBI DEL COMPORTAMENTO,VEN,30-39,1,0,0,0,0,1,0,1,0,1,Veneto,ITH3
2021-01-08,PF/BT,611243,CENTRO DI RIFERIMENTO PER LE GRAVI DISABILITA' E DISTIURBI DEL COMPORTAMENTO,VEN,40-49,0,3,0,0,0,3,0,3,0,3,Veneto,ITH3
2021-01-08,PF/BT,611243,CENTRO DI RIFERIMENTO PER LE GRAVI DISABILITA' E DISTIURBI DEL COMPORTAMENTO,VEN,50-59,0,13,0,0,0,13,0,13,0,13,Veneto,ITH3
2021-01-08,PF/BT,611243,CENTRO DI RIFERIMENTO PER LE GRAVI DISABILITA' E DISTIURBI DEL COMPORTAMENTO,VEN,60-69,0,8,0,0,0,8,0,8,0,8,Veneto,ITH3
2021-01-08,PF/BT,611243,CENTRO DI RIFERIMENTO PER LE GRAVI DISABILITA' E DISTIURBI DEL COMPORTAMENTO,VEN,70-79,0,3,0,0,0,3,0,3,0,3,Veneto,ITH3
2021-01-08,PF/BT,611243,CENTRO DI RIFERIMENTO PER LE GRAVI DISABILITA' E DISTIURBI DEL COMPORTAMENTO,VEN,80-89,0,2,0,0,0,2,0,2,0,2,Veneto,ITH3
2021-01-08,PF/BT,611243,CENTRO DI RIFERIMENTO PER LE GRAVI DISABILITA' E DISTIURBI DEL COMPORTAMENTO,VEN,90+,0,1,0,0,0,1,0,1,0,1,Veneto,ITH3
2021-01-08,PF/BT,642094,CASA DI RIPOSO MERLARA,VEN,20-29,0,1,0,0,0,0,1,1,0,1,Veneto,ITH3
2021-01-08,PF/BT,642094,CASA DI RIPOSO MERLARA,VEN,30-39,2,7,0,0,0,0,9,9,0,9,Veneto,ITH3
2021-01-08,PF/BT,642094,CASA DI RIPOSO MERLARA,VEN,40-49,2,8,0,0,0,0,10,10,0,10,Veneto,ITH3
2021-01-08,PF/BT,642094,CASA DI RIPOSO MERLARA,VEN,50-59,2,16,0,1,0,0,17,18,0,18,Veneto,ITH3
2021-01-08,PF/BT,642094,CASA DI RIPOSO MERLARA,VEN,60-69,3,0,0,1,0,2,0,3,0,3,Veneto,ITH3
2021-01-08,PF/BT,642094,CASA DI RIPOSO MERLARA,VEN,70-79,2,8,0,0,0,10,0,10,0,10,Veneto,ITH3
2021-01-08,PF/BT,642094,CASA DI RIPOSO MERLARA,VEN,80-89,6,16,0,0,0,22,0,22,0,22,Veneto,ITH3
2021-01-08,PF/BT,642094,CASA DI RIPOSO MERLARA,VEN,90+,5,14,0,0,0,19,0,19,0,19,Veneto,ITH3
2021-01-08,PF/BT,642147,"C.S.A. NON AUTOSUFFICIENTI ""RESIDENZA AL PARCO"" GALZIGNANO TERME",VEN,20-29,4,6,0,9,1,0,0,10,0,10,Veneto,ITH3
2021-01-08,PF/BT,642147,"C.S.A. NON AUTOSUFFICIENTI ""RESIDENZA AL PARCO"" GALZIGNANO TERME",VEN,30-39,2,5,0,6,1,0,0,7,0,7,Veneto,ITH3
2021-01-08,PF/BT,642147,"C.S.A. NON AUTOSUFFICIENTI ""RESIDENZA AL PARCO"" GALZIGNANO TERME",VEN,40-49,2,6,0,7,1,0,0,8,0,8,Veneto,ITH3
2021-01-08,PF/BT,642147,"C.S.A. NON AUTOSUFFICIENTI ""RESIDENZA AL PARCO"" GALZIGNANO TERME",VEN,50-59,2,8,0,8,2,0,0,10,0,10,Veneto,ITH3
2021-01-08,PF/BT,642147,"C.S.A. NON AUTOSUFFICIENTI ""RESIDENZA AL PARCO"" GALZIGNANO TERME",VEN,60-69,1,1,0,2,0,0,0,2,0,2,Veneto,ITH3
2021-01-08,PF/BT,642147,"C.S.A. NON AUTOSUFFICIENTI ""RESIDENZA AL PARCO"" GALZIGNANO TERME",VEN,80-89,1,2,0,0,0,3,0,3,0,3,Veneto,ITH3
2021-01-08,PF/BT,642147,"C.S.A. NON AUTOSUFFICIENTI ""RESIDENZA AL PARCO"" GALZIGNANO TERME",VEN,90+,0,2,0,0,0,2,0,2,0,2,Veneto,ITH3
2021-01-08,PF/BT,682301,RSA ISTITUTI POLESANI DI FICAROLO,VEN,16-19,1,1,0,0,0,2,0,2,0,2,Veneto,ITH3
2021-01-08,PF/BT,682301,RSA ISTITUTI POLESANI DI FICAROLO,VEN,20-29,22,11,0,15,0,18,0,33,0,33,Veneto,ITH3
2021-01-08,PF/BT,682301,RSA ISTITUTI POLESANI DI FICAROLO,VEN,30-39,13,14,0,17,0,10,0,27,0,27,Veneto,ITH3
2021-01-08,PF/BT,682301,RSA ISTITUTI POLESANI DI FICAROLO,VEN,40-49,32,25,0,37,1,19,0,57,0,57,Veneto,ITH3
2021-01-08,PF/BT,682301,RSA ISTITUTI POLESANI DI FICAROLO,VEN,50-59,47,52,0,43,0,56,0,99,0,99,Veneto,ITH3
2021-01-08,PF/BT,682301,RSA ISTITUTI POLESANI DI FICAROLO,VEN,60-69,58,51,0,17,0,92,0,109,0,109,Veneto,ITH3
2021-01-08,PF/BT,682301,RSA ISTITUTI POLESANI DI FICAROLO,VEN,70-79,14,10,0,0,0,24,0,24,0,24,Veneto,ITH3
2021-01-08,PF/BT,682301,RSA ISTITUTI POLESANI DI FICAROLO,VEN,80-89,2,2,0,2,0,2,0,4,0,4,Veneto,ITH3
2021-01-08,PF/BT,683009,CASA DI RIPOSO DI BADIA POL.,VEN,20-29,1,0,0,1,0,0,0,1,0,1,Veneto,ITH3
2021-01-08,PF/BT,683009,CASA DI RIPOSO DI BADIA POL.,VEN,30-39,0,1,0,1,0,0,0,1,0,1,Veneto,ITH3
2021-01-08,PF/BT,683009,CASA DI RIPOSO DI BADIA POL.,VEN,40-49,1,1,0,1,1,0,0,2,0,2,Veneto,ITH3
2021-01-08,PF/BT,683009,CASA DI RIPOSO DI BADIA POL.,VEN,50-59,1,3,0,1,3,0,0,4,0,4,Veneto,ITH3
2021-01-08,PF/BT,683013,IRAS IST. RODIGINO DI ASS. SOC,VEN,40-49,0,5,0,4,0,0,1,5,0,5,Veneto,ITH3
2021-01-08,PF/BT,683013,IRAS IST. RODIGINO DI ASS. SOC,VEN,50-59,0,6,0,5,0,0,1,6,0,6,Veneto,ITH3
2021-01-08,PF/BT,721011,CENTRO SERVIZI VILLA TAMERICI - Porto Viro,VEN,30-39,0,1,0,1,0,0,0,1,0,1,Veneto,ITH3
2021-01-08,PF/BT,721011,CENTRO SERVIZI VILLA TAMERICI - Porto Viro,VEN,40-49,0,3,0,3,0,0,0,3,0,3,Veneto,ITH3
2021-01-08,PF/BT,721011,CENTRO SERVIZI VILLA TAMERICI - Porto Viro,VEN,50-59,0,1,0,1,0,0,0,1,0,1,Veneto,ITH3
2021-01-08,PF/BT,721015,CASA DI RIPOSO VILLA AGOPIAN - CORBOLA,VEN,20-29,0,3,0,3,0,0,0,3,0,3,Veneto,ITH3
2021-01-08,PF/BT,721015,CASA DI RIPOSO VILLA AGOPIAN - CORBOLA,VEN,30-39,3,3,0,4,2,0,0,6,0,6,Veneto,ITH3
2021-01-08,PF/BT,721015,CASA DI RIPOSO VILLA AGOPIAN - CORBOLA,VEN,40-49,2,10,0,7,5,0,0,12,0,12,Veneto,ITH3
2021-01-08,PF/BT,721015,CASA DI RIPOSO VILLA AGOPIAN - CORBOLA,VEN,50-59,4,23,0,18,9,0,0,27,0,27,Veneto,ITH3
2021-01-08,PF/BT,721015,CASA DI RIPOSO VILLA AGOPIAN - CORBOLA,VEN,60-69,5,4,0,3,5,0,1,9,0,9,Veneto,ITH3
2021-01-08,PF/BT,721015,CASA DI RIPOSO VILLA AGOPIAN - CORBOLA,VEN,70-79,1,1,0,0,0,1,1,2,0,2,Veneto,ITH3
2021-01-08,PF/BT,721015,CASA DI RIPOSO VILLA AGOPIAN - CORBOLA,VEN,80-89,0,4,0,0,0,4,0,4,0,4,Veneto,ITH3
2021-01-08,PF/BT,721015,CASA DI RIPOSO VILLA AGOPIAN - CORBOLA,VEN,90+,0,3,0,0,0,3,0,3,0,3,Veneto,ITH3
2021-01-08,PF/BT,765057,FOND. MONS. A. MARANGONI,VEN,20-29,2,3,0,4,1,0,0,5,0,5,Veneto,ITH3
2021-01-08,PF/BT,765057,FOND. MONS. A. MARANGONI,VEN,30-39,2,1,0,3,0,0,0,3,0,3,Veneto,ITH3
2021-01-08,PF/BT,765057,FOND. MONS. A. MARANGONI,VEN,40-49,5,10,0,10,5,0,0,15,0,15,Veneto,ITH3
2021-01-08,PF/BT,765057,FOND. MONS. A. MARANGONI,VEN,50-59,1,6,0,5,2,0,0,7,0,7,Veneto,ITH3
2021-01-08,PF/BT,765057,FOND. MONS. A. MARANGONI,VEN,60-69,0,1,0,1,0,0,0,1,0,1,Veneto,ITH3
2021-01-08,PF/BT,765057,FOND. MONS. A. MARANGONI,VEN,70-79,3,1,0,0,0,4,0,4,0,4,Veneto,ITH3
2021-01-08,PF/BT,765057,FOND. MONS. A. MARANGONI,VEN,80-89,2,0,0,0,0,2,0,2,0,2,Veneto,ITH3
2021-01-08,PF/BT,765057,FOND. MONS. A. MARANGONI,VEN,90+,0,2,0,0,0,2,0,2,0,2,Veneto,ITH3
2021-01-08,PF/BT,84006,CASA DI RIPOSO G. STERNI,VEN,20-29,4,6,0,7,3,0,0,10,0,10,Veneto,ITH3
2021-01-08,PF/BT,84006,CASA DI RIPOSO G. STERNI,VEN,30-39,2,4,0,6,0,0,0,6,0,6,Veneto,ITH3
2021-01-08,PF/BT,84006,CASA DI RIPOSO G. STERNI,VEN,40-49,1,10,0,6,5,0,0,11,0,11,Veneto,ITH3
2021-01-08,PF/BT,84006,CASA DI RIPOSO G. STERNI,VEN,50-59,0,13,0,5,8,0,0,13,0,13,Veneto,ITH3
2021-01-08,PF/BT,84006,CASA DI RIPOSO G. STERNI,VEN,60-69,2,6,0,3,4,1,0,8,0,8,Veneto,ITH3
2021-01-08,PF/BT,84006,CASA DI RIPOSO G. STERNI,VEN,70-79,0,2,0,0,0,2,0,2,0,2,Veneto,ITH3
2021-01-08,PF/BT,84006,CASA DI RIPOSO G. STERNI,VEN,80-89,6,18,0,0,0,24,0,24,0,24,Veneto,ITH3
2021-01-08,PF/BT,84006,CASA DI RIPOSO G. STERNI,VEN,90+,0,32,0,0,0,32,0,32,0,32,Veneto,ITH3
2021-01-08,PF/BT,845232,CASA DEL CLERO,VEN,60-69,1,0,0,0,0,1,0,1,0,1,Veneto,ITH3
2021-01-08,PF/BT,845232,CASA DEL CLERO,VEN,70-79,3,0,0,0,0,3,0,3,0,3,Veneto,ITH3
2021-01-08,PF/BT,845232,CASA DEL CLERO,VEN,80-89,7,0,0,0,0,7,0,7,0,7,Veneto,ITH3
2021-01-08,PF/BT,845232,CASA DEL CLERO,VEN,90+,2,1,0,0,0,3,0,3,0,3,Veneto,ITH3
2021-01-08,PF/BT,845233,CASA PEREZ,VEN,60-69,5,0,0,0,0,5,0,5,0,5,Veneto,ITH3
2021-01-08,PF/BT,845233,CASA PEREZ,VEN,70-79,3,0,0,0,0,3,0,3,0,3,Veneto,ITH3
2021-01-08,PF/BT,845234,CASA NOGARE',VEN,40-49,1,0,0,0,0,1,0,1,0,1,Veneto,ITH3
2021-01-08,PF/BT,845234,CASA NOGARE',VEN,50-59,1,0,0,0,0,1,0,1,0,1,Veneto,ITH3
2021-01-08,PF/BT,845234,CASA NOGARE',VEN,70-79,1,1,0,0,0,2,0,2,0,2,Veneto,ITH3
2021-01-08,PF/BT,845234,CASA NOGARE',VEN,90+,0,5,0,0,0,5,0,5,0,5,Veneto,ITH3
2021-01-08,PF/BT,845237,RSA DI CURA E REC. CASA NOGARE,VEN,70-79,1,1,0,0,0,2,0,2,0,2,Veneto,ITH3
2021-01-08,PF/BT,845237,RSA DI CURA E REC. CASA NOGARE,VEN,80-89,1,0,0,0,0,1,0,1,0,1,Veneto,ITH3
2021-01-08,PF/BT,845237,RSA DI CURA E REC. CASA NOGARE,VEN,90+,0,2,0,0,0,2,0,2,0,2,Veneto,ITH3
2021-01-09,PF/BT,0,Mancante,VEN,20-29,0,1,0,1,0,0,0,1,0,1,Veneto,ITH3
2021-01-09,PF/BT,132223,C.R. 'LA PIEVE' - BREGANZE,VEN,20-29,1,5,0,5,1,0,0,6,0,6,Veneto,ITH3
2021-01-09,PF/BT,132223,C.R. 'LA PIEVE' - BREGANZE,VEN,30-39,1,3,0,2,2,0,0,4,0,4,Veneto,ITH3
2021-01-09,PF/BT,132223,C.R. 'LA PIEVE' - BREGANZE,VEN,40-49,5,21,0,18,8,0,0,26,0,26,Veneto,ITH3
2021-01-09,PF/BT,132223,C.R. 'LA PIEVE' - BREGANZE,VEN,50-59,6,18,0,11,12,1,0,24,0,24,Veneto,ITH3
2021-01-09,PF/BT,132223,C.R. 'LA PIEVE' - BREGANZE,VEN,60-69,2,4,0,1,4,1,0,6,0,6,Veneto,ITH3
2021-01-09,PF/BT,132223,C.R. 'LA PIEVE' - BREGANZE,VEN,70-79,4,6,0,0,1,9,0,10,0,10,Veneto,ITH3
2021-01-09,PF/BT,132223,C.R. 'LA PIEVE' - BREGANZE,VEN,80-89,4,5,0,0,0,9,0,9,0,9,Veneto,ITH3
2021-01-09,PF/BT,132223,C.R. 'LA PIEVE' - BREGANZE,VEN,90+,1,2,0,0,0,3,0,3,0,3,Veneto,ITH3
2021-01-09,PF/BT,132224,C.R. 'VILLA S.ANGELA'-BREGANZE,VEN,20-29,0,4,0,2,2,0,0,4,0,4,Veneto,ITH3
2021-01-09,PF/BT,132224,C.R. 'VILLA S.ANGELA'-BREGANZE,VEN,30-39,0,2,0,0,2,0,0,2,0,2,Veneto,ITH3
2021-01-09,PF/BT,132224,C.R. 'VILLA S.ANGELA'-BREGANZE,VEN,40-49,0,4,0,1,3,0,0,4,0,4,Veneto,ITH3
2021-01-09,PF/BT,132224,C.R. 'VILLA S.ANGELA'-BREGANZE,VEN,50-59,2,6,0,5,3,0,0,8,0,8,Veneto,ITH3
2021-01-09,PF/BT,132224,C.R. 'VILLA S.ANGELA'-BREGANZE,VEN,60-69,0,5,0,1,3,1,0,5,0,5,Veneto,ITH3
2021-01-09,PF/BT,132224,C.R. 'VILLA S.ANGELA'-BREGANZE,VEN,70-79,0,11,0,0,7,4,0,11,0,11,Veneto,ITH3
2021-01-09,PF/BT,132224,C.R. 'VILLA S.ANGELA'-BREGANZE,VEN,80-89,0,14,0,0,5,9,0,14,0,14,Veneto,ITH3
2021-01-09,PF/BT,132224,C.R. 'VILLA S.ANGELA'-BREGANZE,VEN,90+,0,6,0,0,0,6,0,6,0,6,Veneto,ITH3
2021-01-09,PF/BT,162445,CASA DI RIPOSO LA PIEVE MONTECCHIO,VEN,16-19,1,0,0,0,1,0,0,1,0,1,Veneto,ITH3
2021-01-09,PF/BT,162445,CASA DI RIPOSO LA PIEVE MONTECCHIO,VEN,20-29,6,15,0,19,2,0,0,21,0,21,Veneto,ITH3
2021-01-09,PF/BT,162445,CASA DI RIPOSO LA PIEVE MONTECCHIO,VEN,30-39,4,12,0,12,3,1,0,16,0,16,Veneto,ITH3
2021-01-09,PF/BT,162445,CASA DI RIPOSO LA PIEVE MONTECCHIO,VEN,40-49,5,23,0,19,6,3,0,28,0,28,Veneto,ITH3
2021-01-09,PF/BT,162445,CASA DI RIPOSO LA PIEVE MONTECCHIO,VEN,50-59,8,18,0,15,5,6,0,26,0,26,Veneto,ITH3
2021-01-09,PF/BT,162445,CASA DI RIPOSO LA PIEVE MONTECCHIO,VEN,60-69,7,15,0,6,2,14,0,22,0,22,Veneto,ITH3
2021-01-09,PF/BT,162445,CASA DI RIPOSO LA PIEVE MONTECCHIO,VEN,70-79,9,9,0,0,0,18,0,18,0,18,Veneto,ITH3
2021-01-09,PF/BT,162445,CASA DI RIPOSO LA PIEVE MONTECCHIO,VEN,80-89,7,18,0,0,0,25,0,25,0,25,Veneto,ITH3
2021-01-09,PF/BT,162445,CASA DI RIPOSO LA PIEVE MONTECCHIO,VEN,90+,2,12,0,0,0,14,0,14,0,14,Veneto,ITH3
2021-01-09,PF/BT,162517,CASA ALBERGO PARCO FORTUNA RECOARO TERME,VEN,20-29,2,6,0,4,4,0,0,8,0,8,Veneto,ITH3
2021-01-09,PF/BT,162517,CASA ALBERGO PARCO FORTUNA RECOARO TERME,VEN,30-39,3,4,0,5,2,0,0,7,0,7,Veneto,ITH3
2021-01-09,PF/BT,162517,CASA ALBERGO PARCO FORTUNA RECOARO TERME,VEN,40-49,1,7,0,3,5,0,0,8,0,8,Veneto,ITH3
2021-01-09,PF/BT,162517,CASA ALBERGO PARCO FORTUNA RECOARO TERME,VEN,50-59,2,9,0,5,6,0,0,11,0,11,Veneto,ITH3
2021-01-09,PF/BT,162517,CASA ALBERGO PARCO FORTUNA RECOARO TERME,VEN,60-69,4,4,0,3,2,3,0,8,0,8,Veneto,ITH3
2021-01-09,PF/BT,162517,CASA ALBERGO PARCO FORTUNA RECOARO TERME,VEN,70-79,4,7,0,0,2,9,0,11,0,11,Veneto,ITH3
2021-01-09,PF/BT,162517,CASA ALBERGO PARCO FORTUNA RECOARO TERME,VEN,80-89,8,24,0,0,0,32,0,32,0,32,Veneto,ITH3
2021-01-09,PF/BT,162517,CASA ALBERGO PARCO FORTUNA RECOARO TERME,VEN,90+,1,19,0,0,0,20,0,20,0,20,Veneto,ITH3
2021-01-09,PF/BT,200057,IPAB - IPARK - RESIDENZA PARCO CITTA',VEN,20-29,4,7,0,11,0,0,0,11,0,11,Veneto,ITH3
2021-01-09,PF/BT,200057,IPAB - IPARK - RESIDENZA PARCO CITTA',VEN,30-39,5,9,0,9,5,0,0,14,0,14,Veneto,ITH3
2021-01-09,PF/BT,200057,IPAB - IPARK - RESIDENZA PARCO CITTA',VEN,40-49,4,14,0,16,2,0,0,18,0,18,Veneto,ITH3
2021-01-09,PF/BT,200057,IPAB - IPARK - RESIDENZA PARCO CITTA',VEN,50-59,4,16,0,14,6,0,0,20,0,20,Veneto,ITH3
2021-01-09,PF/BT,200057,IPAB - IPARK - RESIDENZA PARCO CITTA',VEN,60-69,5,2,0,2,1,4,0,7,0,7,Veneto,ITH3
2021-01-09,PF/BT,200057,IPAB - IPARK - RESIDENZA PARCO CITTA',VEN,70-79,7,7,0,0,0,14,0,14,0,14,Veneto,ITH3
2021-01-09,PF/BT,200057,IPAB - IPARK - RESIDENZA PARCO CITTA',VEN,80-89,6,24,0,0,0,30,0,30,0,30,Veneto,ITH3
2021-01-09,PF/BT,200057,IPAB - IPARK - RESIDENZA PARCO CITTA',VEN,90+,5,26,0,0,0,31,0,31,0,31,Veneto,ITH3
2021-01-09,PF/BT,208016,IPAB - SUOR DIODATA BERTOLO,VEN,20-29,4,9,0,13,0,0,0,13,0,13,Veneto,ITH3
2021-01-09,PF/BT,208016,IPAB - SUOR DIODATA BERTOLO,VEN,30-39,2,8,0,10,0,0,0,10,0,10,Veneto,ITH3
2021-01-09,PF/BT,208016,IPAB - SUOR DIODATA BERTOLO,VEN,40-49,4,34,0,31,7,0,0,38,0,38,Veneto,ITH3
2021-01-09,PF/BT,208016,IPAB - SUOR DIODATA BERTOLO,VEN,50-59,4,32,0,29,6,1,0,36,0,36,Veneto,ITH3
2021-01-09,PF/BT,208016,IPAB - SUOR DIODATA BERTOLO,VEN,60-69,5,10,0,9,0,6,0,15,0,15,Veneto,ITH3
2021-01-09,PF/BT,208016,IPAB - SUOR DIODATA BERTOLO,VEN,70-79,8,13,0,0,0,21,0,21,0,21,Veneto,ITH3
2021-01-09,PF/BT,208016,IPAB - SUOR DIODATA BERTOLO,VEN,80-89,11,32,0,0,0,43,0,43,0,43,Veneto,ITH3
2021-01-09,PF/BT,208016,IPAB - SUOR DIODATA BERTOLO,VEN,90+,3,30,0,0,0,33,0,33,0,33,Veneto,ITH3
2021-01-09,PF/BT,244067,"CENTRO DI SERIVIZI RESIDENZALE ""FONDAZIONE DE LOZZO DA DALTO"" - S. PIETRO DI FELETTO",VEN,20-29,0,3,0,3,0,0,0,3,0,3,Veneto,ITH3
2021-01-09,PF/BT,244067,"CENTRO DI SERIVIZI RESIDENZALE ""FONDAZIONE DE LOZZO DA DALTO"" - S. PIETRO DI FELETTO",VEN,30-39,4,7,0,10,1,0,0,11,0,11,Veneto,ITH3
2021-01-09,PF/BT,244067,"CENTRO DI SERIVIZI RESIDENZALE ""FONDAZIONE DE LOZZO DA DALTO"" - S. PIETRO DI FELETTO",VEN,40-49,1,10,0,9,2,0,0,11,0,11,Veneto,ITH3
2021-01-09,PF/BT,244067,"CENTRO DI SERIVIZI RESIDENZALE ""FONDAZIONE DE LOZZO DA DALTO"" - S. PIETRO DI FELETTO",VEN,50-59,2,15,0,16,1,0,0,17,0,17,Veneto,ITH3
2021-01-09,PF/BT,244067,"CENTRO DI SERIVIZI RESIDENZALE ""FONDAZIONE DE LOZZO DA DALTO"" - S. PIETRO DI FELETTO",VEN,60-69,3,11,0,8,3,3,0,14,0,14,Veneto,ITH3
2021-01-09,PF/BT,244067,"CENTRO DI SERIVIZI RESIDENZALE ""FONDAZIONE DE LOZZO DA DALTO"" - S. PIETRO DI FELETTO",VEN,70-79,3,2,0,0,0,5,0,5,0,5,Veneto,ITH3
2021-01-09,PF/BT,244067,"CENTRO DI SERIVIZI RESIDENZALE ""FONDAZIONE DE LOZZO DA DALTO"" - S. PIETRO DI FELETTO",VEN,80-89,12,22,0,0,0,34,0,34,0,34,Veneto,ITH3
2021-01-09,PF/BT,244067,"CENTRO DI SERIVIZI RESIDENZALE ""FONDAZIONE DE LOZZO DA DALTO"" - S. PIETRO DI FELETTO",VEN,90+,1,24,0,0,0,25,0,25,0,25,Veneto,ITH3
2021-01-09,PF/BT,323213,"CENTRO DI SERVIZI RESIDENZIALE ""VILLA DR. TOMASI"" - SPRESIANO",VEN,16-19,0,1,0,0,1,0,0,1,0,1,Veneto,ITH3
2021-01-09,PF/BT,323213,"CENTRO DI SERVIZI RESIDENZIALE ""VILLA DR. TOMASI"" - SPRESIANO",VEN,20-29,0,7,0,6,1,0,0,7,0,7,Veneto,ITH3
2021-01-09,PF/BT,323213,"CENTRO DI SERVIZI RESIDENZIALE ""VILLA DR. TOMASI"" - SPRESIANO",VEN,30-39,2,8,0,4,6,0,0,10,0,10,Veneto,ITH3
2021-01-09,PF/BT,323213,"CENTRO DI SERVIZI RESIDENZIALE ""VILLA DR. TOMASI"" - SPRESIANO",VEN,40-49,2,5,0,4,3,0,0,7,0,7,Veneto,ITH3
2021-01-09,PF/BT,323213,"CENTRO DI SERVIZI RESIDENZIALE ""VILLA DR. TOMASI"" - SPRESIANO",VEN,50-59,2,20,0,16,5,1,0,22,0,22,Veneto,ITH3
2021-01-09,PF/BT,323213,"CENTRO DI SERVIZI RESIDENZIALE ""VILLA DR. TOMASI"" - SPRESIANO",VEN,60-69,4,9,0,10,0,3,0,13,0,13,Veneto,ITH3
2021-01-09,PF/BT,323213,"CENTRO DI SERVIZI RESIDENZIALE ""VILLA DR. TOMASI"" - SPRESIANO",VEN,70-79,10,2,0,0,1,11,0,12,0,12,Veneto,ITH3
2021-01-09,PF/BT,323213,"CENTRO DI SERVIZI RESIDENZIALE ""VILLA DR. TOMASI"" - SPRESIANO",VEN,80-89,8,24,0,0,0,32,0,32,0,32,Veneto,ITH3
2021-01-09,PF/BT,323213,"CENTRO DI SERVIZI RESIDENZIALE ""VILLA DR. TOMASI"" - SPRESIANO",VEN,90+,5,23,0,0,0,28,0,28,0,28,Veneto,ITH3
2021-01-09,PF/BT,323703,"CENTRO DI SERVIZI RESIDENZIALE ""CASA LUIGI E AUGUSTA"" - ORMELLE",VEN,20-29,1,19,0,19,1,0,0,20,0,20,Veneto,ITH3
2021-01-09,PF/BT,323703,"CENTRO DI SERVIZI RESIDENZIALE ""CASA LUIGI E AUGUSTA"" - ORMELLE",VEN,30-39,4,25,0,23,6,0,0,29,0,29,Veneto,ITH3
2021-01-09,PF/BT,323703,"CENTRO DI SERVIZI RESIDENZIALE ""CASA LUIGI E AUGUSTA"" - ORMELLE",VEN,40-49,4,26,0,22,7,0,1,30,0,30,Veneto,ITH3
2021-01-09,PF/BT,323703,"CENTRO DI SERVIZI RESIDENZIALE ""CASA LUIGI E AUGUSTA"" - ORMELLE",VEN,50-59,10,33,0,32,9,2,0,43,0,43,Veneto,ITH3
2021-01-09,PF/BT,323703,"CENTRO DI SERVIZI RESIDENZIALE ""CASA LUIGI E AUGUSTA"" - ORMELLE",VEN,60-69,5,7,0,2,4,6,0,12,0,12,Veneto,ITH3
2021-01-09,PF/BT,323703,"CENTRO DI SERVIZI RESIDENZIALE ""CASA LUIGI E AUGUSTA"" - ORMELLE",VEN,70-79,9,16,0,0,4,21,0,25,0,25,Veneto,ITH3
2021-01-09,PF/BT,323703,"CENTRO DI SERVIZI RESIDENZIALE ""CASA LUIGI E AUGUSTA"" - ORMELLE",VEN,80-89,19,34,0,0,0,53,0,53,0,53,Veneto,ITH3
2021-01-09,PF/BT,323703,"CENTRO DI SERVIZI RESIDENZIALE ""CASA LUIGI E AUGUSTA"" - ORMELLE",VEN,90+,9,32,0,1,0,40,0,41,0,41,Veneto,ITH3
2021-01-09,PF/BT,363709,CENTRO SERVIZI RESIDENZIALI 'IDA ZUZZI',VEN,20-29,0,3,0,3,0,0,0,3,0,3,Veneto,ITH3
2021-01-09,PF/BT,363709,CENTRO SERVIZI RESIDENZIALI 'IDA ZUZZI',VEN,30-39,1,6,0,7,0,0,0,7,0,7,Veneto,ITH3
2021-01-09,PF/BT,363709,CENTRO SERVIZI RESIDENZIALI 'IDA ZUZZI',VEN,40-49,0,13,0,13,0,0,0,13,0,13,Veneto,ITH3
2021-01-09,PF/BT,363709,CENTRO SERVIZI RESIDENZIALI 'IDA ZUZZI',VEN,50-59,2,15,0,16,0,1,0,17,0,17,Veneto,ITH3
2021-01-09,PF/BT,363709,CENTRO SERVIZI RESIDENZIALI 'IDA ZUZZI',VEN,60-69,3,4,0,3,0,4,0,7,0,7,Veneto,ITH3
2021-01-09,PF/BT,363709,CENTRO SERVIZI RESIDENZIALI 'IDA ZUZZI',VEN,70-79,3,5,0,0,0,8,0,8,0,8,Veneto,ITH3
2021-01-09,PF/BT,363709,CENTRO SERVIZI RESIDENZIALI 'IDA ZUZZI',VEN,80-89,6,23,0,0,0,29,0,29,0,29,Veneto,ITH3
2021-01-09,PF/BT,363709,CENTRO SERVIZI RESIDENZIALI 'IDA ZUZZI',VEN,90+,1,29,0,0,0,30,0,30,0,30,Veneto,ITH3
2021-01-09,PF/BT,42823,C.S.A. 'CASA PADRE KOLBE',VEN,20-29,2,4,0,4,2,0,0,6,0,6,Veneto,ITH3
2021-01-09,PF/BT,42823,C.S.A. 'CASA PADRE KOLBE',VEN,30-39,3,4,0,3,4,0,0,7,0,7,Veneto,ITH3
2021-01-09,PF/BT,42823,C.S.A. 'CASA PADRE KOLBE',VEN,40-49,3,10,0,9,4,0,0,13,0,13,Veneto,ITH3
2021-01-09,PF/BT,42823,C.S.A. 'CASA PADRE KOLBE',VEN,50-59,0,16,0,7,9,0,0,16,0,16,Veneto,ITH3
2021-01-09,PF/BT,42823,C.S.A. 'CASA PADRE KOLBE',VEN,60-69,3,6,0,2,4,3,0,9,0,9,Veneto,ITH3
2021-01-09,PF/BT,42823,C.S.A. 'CASA PADRE KOLBE',VEN,70-79,7,2,0,0,2,7,0,9,0,9,Veneto,ITH3
2021-01-09,PF/BT,42823,C.S.A. 'CASA PADRE KOLBE',VEN,80-89,13,20,0,0,0,33,0,33,0,33,Veneto,ITH3
2021-01-09,PF/BT,42823,C.S.A. 'CASA PADRE KOLBE',VEN,90+,9,21,0,0,0,30,0,30,0,30,Veneto,ITH3
2021-01-09,PF/BT,445328,C. SERV.RES.ANZ.-COTTOLENGO,VEN,30-39,0,1,0,0,1,0,0,1,0,1,Veneto,ITH3
2021-01-09,PF/BT,445328,C. SERV.RES.ANZ.-COTTOLENGO,VEN,40-49,0,5,0,2,2,0,1,5,0,5,Veneto,ITH3
2021-01-09,PF/BT,445328,C. SERV.RES.ANZ.-COTTOLENGO,VEN,50-59,0,5,0,1,4,0,0,5,0,5,Veneto,ITH3
2021-01-09,PF/BT,445328,C. SERV.RES.ANZ.-COTTOLENGO,VEN,60-69,0,4,0,2,1,0,1,4,0,4,Veneto,ITH3
2021-01-09,PF/BT,445328,C. SERV.RES.ANZ.-COTTOLENGO,VEN,70-79,3,7,0,0,0,3,7,10,0,10,Veneto,ITH3
2021-01-09,PF/BT,445328,C. SERV.RES.ANZ.-COTTOLENGO,VEN,80-89,0,19,0,0,2,9,8,19,0,19,Veneto,ITH3
2021-01-09,PF/BT,445328,C. SERV.RES.ANZ.-COTTOLENGO,VEN,90+,0,14,0,0,1,7,6,14,0,14,Veneto,ITH3
2021-01-09,PF/BT,486000,RES. RIVIERA DEL BRENTA - DOLO,VEN,30-39,1,0,0,1,0,0,0,1,0,1,Veneto,ITH3
2021-01-09,PF/BT,486000,RES. RIVIERA DEL BRENTA - DOLO,VEN,40-49,0,3,0,3,0,0,0,3,0,3,Veneto,ITH3
2021-01-09,PF/BT,486000,RES. RIVIERA DEL BRENTA - DOLO,VEN,50-59,0,4,0,3,1,0,0,4,0,4,Veneto,ITH3
2021-01-09,PF/BT,486000,RES. RIVIERA DEL BRENTA - DOLO,VEN,60-69,0,4,0,1,3,0,0,4,0,4,Veneto,ITH3
2021-01-09,PF/BT,5001700,OSPEDALE SACRO CUORE DI NEGRAR,VEN,20-29,3,11,0,9,5,0,0,14,0,14,Veneto,ITH3
2021-01-09,PF/BT,5001700,OSPEDALE SACRO CUORE DI NEGRAR,VEN,30-39,3,22,0,19,6,0,0,25,0,25,Veneto,ITH3
2021-01-09,PF/BT,5001700,OSPEDALE SACRO CUORE DI NEGRAR,VEN,40-49,12,18,0,17,13,0,0,30,0,30,Veneto,ITH3
2021-01-09,PF/BT,5001700,OSPEDALE SACRO CUORE DI NEGRAR,VEN,50-59,9,17,0,19,7,0,0,26,0,26,Veneto,ITH3
2021-01-09,PF/BT,5001700,OSPEDALE SACRO CUORE DI NEGRAR,VEN,60-69,3,3,0,4,2,0,0,6,0,6,Veneto,ITH3
2021-01-09,PF/BT,5001700,OSPEDALE SACRO CUORE DI NEGRAR,VEN,70-79,0,1,0,1,0,0,0,1,0,1,Veneto,ITH3
2021-01-09,PF/BT,5002200,OSPEDALE P. PEDERZOLI,VEN,20-29,0,3,0,3,0,0,0,3,0,3,Veneto,ITH3
2021-01-09,PF/BT,5002200,OSPEDALE P. PEDERZOLI,VEN,30-39,3,3,0,6,0,0,0,6,0,6,Veneto,ITH3
2021-01-09,PF/BT,5002200,OSPEDALE P. PEDERZOLI,VEN,40-49,8,7,0,15,0,0,0,15,0,15,Veneto,ITH3
2021-01-09,PF/BT,5002200,OSPEDALE P. PEDERZOLI,VEN,50-59,4,5,0,9,0,0,0,9,0,9,Veneto,ITH3
2021-01-09,PF/BT,5002200,OSPEDALE P. PEDERZOLI,VEN,60-69,0,3,0,3,0,0,0,3,0,3,Veneto,ITH3
2021-01-09,PF/BT,5017,CASA DI RIPOSO VILLA 'DON G.CECCON',VEN,20-29,0,3,0,3,0,0,0,3,0,3,Veneto,ITH3
2021-01-09,PF/BT,5017,CASA DI RIPOSO VILLA 'DON G.CECCON',VEN,30-39,0,5,0,2,3,0,0,5,0,5,Veneto,ITH3
2021-01-09,PF/BT,5017,CASA DI RIPOSO VILLA 'DON G.CECCON',VEN,40-49,2,12,0,7,7,0,0,14,0,14,Veneto,ITH3
2021-01-09,PF/BT,5017,CASA DI RIPOSO VILLA 'DON G.CECCON',VEN,50-59,3,12,0,9,5,1,0,15,0,15,Veneto,ITH3
2021-01-09,PF/BT,5017,CASA DI RIPOSO VILLA 'DON G.CECCON',VEN,60-69,3,5,0,3,4,1,0,8,0,8,Veneto,ITH3
2021-01-09,PF/BT,5017,CASA DI RIPOSO VILLA 'DON G.CECCON',VEN,70-79,4,6,0,0,1,9,0,10,0,10,Veneto,ITH3
2021-01-09,PF/BT,5017,CASA DI RIPOSO VILLA 'DON G.CECCON',VEN,80-89,3,19,0,0,0,22,0,22,0,22,Veneto,ITH3
2021-01-09,PF/BT,5017,CASA DI RIPOSO VILLA 'DON G.CECCON',VEN,90+,3,13,0,0,0,16,0,16,0,16,Veneto,ITH3
2021-01-09,PF/BT,50501,"BELLUNO ""DRIVE-IN""",VEN,16-19,0,1,0,0,1,0,0,1,0,1,Veneto,ITH3
2021-01-09,PF/BT,50501,"BELLUNO ""DRIVE-IN""",VEN,20-29,0,2,0,1,1,0,0,2,0,2,Veneto,ITH3
2021-01-09,PF/BT,50501,"BELLUNO ""DRIVE-IN""",VEN,30-39,5,5,0,0,10,0,0,10,0,10,Veneto,ITH3
2021-01-09,PF/BT,50501,"BELLUNO ""DRIVE-IN""",VEN,40-49,3,19,0,0,22,0,0,22,0,22,Veneto,ITH3
2021-01-09,PF/BT,50501,"BELLUNO ""DRIVE-IN""",VEN,50-59,15,24,0,9,30,0,0,39,0,39,Veneto,ITH3
2021-01-09,PF/BT,50501,"BELLUNO ""DRIVE-IN""",VEN,60-69,3,11,0,5,9,0,0,14,0,14,Veneto,ITH3
2021-01-09,PF/BT,50501,BELLUNO AMBULATORIO N.15,VEN,20-29,0,4,0,4,0,0,0,4,0,4,Veneto,ITH3
2021-01-09,PF/BT,50501,BELLUNO AMBULATORIO N.15,VEN,30-39,1,5,0,3,3,0,0,6,0,6,Veneto,ITH3
2021-01-09,PF/BT,50501,BELLUNO AMBULATORIO N.15,VEN,40-49,2,5,0,4,3,0,0,7,0,7,Veneto,ITH3
2021-01-09,PF/BT,50501,BELLUNO AMBULATORIO N.15,VEN,50-59,2,5,0,6,1,0,0,7,0,7,Veneto,ITH3
2021-01-09,PF/BT,50501,BELLUNO AMBULATORIO N.15,VEN,60-69,0,1,0,1,0,0,0,1,0,1,Veneto,ITH3
2021-01-09,PF/BT,50501,BELLUNO AMBULATORIO N.15,VEN,70-79,1,1,0,1,1,0,0,2,0,2,Veneto,ITH3
2021-01-09,PF/BT,50501,CORTINA,VEN,20-29,2,3,0,5,0,0,0,5,0,5,Veneto,ITH3
2021-01-09,PF/BT,50501,CORTINA,VEN,30-39,1,3,0,3,1,0,0,4,0,4,Veneto,ITH3
2021-01-09,PF/BT,50501,CORTINA,VEN,40-49,3,7,0,4,1,0,5,10,0,10,Veneto,ITH3
2021-01-09,PF/BT,50501,CORTINA,VEN,50-59,2,5,0,3,1,0,3,7,0,7,Veneto,ITH3
2021-01-09,PF/BT,50501,CORTINA,VEN,60-69,2,2,0,2,0,0,2,4,0,4,Veneto,ITH3
2021-01-09,PF/BT,50501,FELTRE,VEN,30-39,0,2,0,2,0,0,0,2,0,2,Veneto,ITH3
2021-01-09,PF/BT,5050201,OSPEDALE CA' FONCELLO,VEN,20-29,29,58,0,83,4,0,0,87,0,87,Veneto,ITH3
2021-01-09,PF/BT,5050201,OSPEDALE CA' FONCELLO,VEN,30-39,35,49,0,75,9,0,0,84,0,84,Veneto,ITH3
2021-01-09,PF/BT,5050201,OSPEDALE CA' FONCELLO,VEN,40-49,20,52,0,60,12,0,0,72,0,72,Veneto,ITH3
2021-01-09,PF/BT,5050201,OSPEDALE CA' FONCELLO,VEN,50-59,57,92,0,139,10,0,0,149,0,149,Veneto,ITH3
2021-01-09,PF/BT,5050201,OSPEDALE CA' FONCELLO,VEN,60-69,146,68,0,208,5,0,1,214,0,214,Veneto,ITH3
2021-01-09,PF/BT,5050201,OSPEDALE CA' FONCELLO,VEN,70-79,1,1,0,2,0,0,0,2,0,2,Veneto,ITH3
2021-01-09,PF/BT,50503,CAMPONOGARA ADULTI,VEN,20-29,2,5,0,7,0,0,0,7,0,7,Veneto,ITH3
2021-01-09,PF/BT,50503,CAMPONOGARA ADULTI,VEN,30-39,2,9,0,11,0,0,0,11,0,11,Veneto,ITH3
2021-01-09,PF/BT,50503,CAMPONOGARA ADULTI,VEN,40-49,5,15,0,20,0,0,0,20,0,20,Veneto,ITH3
2021-01-09,PF/BT,50503,CAMPONOGARA ADULTI,VEN,50-59,5,12,0,17,0,0,0,17,0,17,Veneto,ITH3
2021-01-09,PF/BT,50503,CAMPONOGARA ADULTI,VEN,60-69,7,6,0,13,0,0,0,13,0,13,Veneto,ITH3
2021-01-09,PF/BT,50503,CAMPONOGARA ADULTI,VEN,70-79,3,0,0,3,0,0,0,3,0,3,Veneto,ITH3
2021-01-09,PF/BT,50503,CAMPONOGARA ADULTI,VEN,80-89,1,0,0,1,0,0,0,1,0,1,Veneto,ITH3
2021-01-09,PF/BT,50503,MEDICINA PREVENTIVA MESTRE,VEN,16-19,0,1,0,1,0,0,0,1,0,1,Veneto,ITH3
2021-01-09,PF/BT,50503,MEDICINA PREVENTIVA MESTRE,VEN,20-29,14,11,0,18,7,0,0,25,0,25,Veneto,ITH3
2021-01-09,PF/BT,50503,MEDICINA PREVENTIVA MESTRE,VEN,30-39,13,14,0,18,9,0,0,27,0,27,Veneto,ITH3
2021-01-09,PF/BT,50503,MEDICINA PREVENTIVA MESTRE,VEN,40-49,10,23,0,18,15,0,0,33,0,33,Veneto,ITH3
2021-01-09,PF/BT,50503,MEDICINA PREVENTIVA MESTRE,VEN,50-59,28,13,0,26,15,0,0,41,0,41,Veneto,ITH3
2021-01-09,PF/BT,50503,MEDICINA PREVENTIVA MESTRE,VEN,60-69,8,7,0,12,3,0,0,15,0,15,Veneto,ITH3
2021-01-09,PF/BT,50503,MEDICINA PREVENTIVA MESTRE,VEN,70-79,2,0,0,2,0,0,0,2,0,2,Veneto,ITH3
2021-01-09,PF/BT,50503,MEDICINA PREVENTIVA VENEZIA,VEN,20-29,10,6,0,10,6,0,0,16,0,16,Veneto,ITH3
2021-01-09,PF/BT,50503,MEDICINA PREVENTIVA VENEZIA,VEN,30-39,11,3,0,8,6,0,0,14,0,14,Veneto,ITH3
2021-01-09,PF/BT,50503,MEDICINA PREVENTIVA VENEZIA,VEN,40-49,10,8,0,14,4,0,0,18,0,18,Veneto,ITH3
2021-01-09,PF/BT,50503,MEDICINA PREVENTIVA VENEZIA,VEN,50-59,9,14,0,19,4,0,0,23,0,23,Veneto,ITH3
2021-01-09,PF/BT,50503,MEDICINA PREVENTIVA VENEZIA,VEN,60-69,1,2,0,3,0,0,0,3,0,3,Veneto,ITH3
2021-01-09,PF/BT,50503,MEDICINA PREVENTIVA VENEZIA,VEN,70-79,4,0,0,2,2,0,0,4,0,4,Veneto,ITH3
2021-01-09,PF/BT,50503,S.I.S.P. MESTRE,VEN,20-29,3,6,0,7,2,0,0,9,0,9,Veneto,ITH3
2021-01-09,PF/BT,50503,S.I.S.P. MESTRE,VEN,30-39,1,5,0,5,1,0,0,6,0,6,Veneto,ITH3
2021-01-09,PF/BT,50503,S.I.S.P. MESTRE,VEN,40-49,3,7,0,8,2,0,0,10,0,10,Veneto,ITH3
2021-01-09,PF/BT,50503,S.I.S.P. MESTRE,VEN,50-59,10,18,0,19,9,0,0,28,0,28,Veneto,ITH3
2021-01-09,PF/BT,50503,S.I.S.P. MESTRE,VEN,60-69,22,15,0,35,2,0,0,37,0,37,Veneto,ITH3
2021-01-09,PF/BT,50503,SISP DOLO ADULTI,VEN,20-29,15,21,0,32,1,0,3,36,0,36,Veneto,ITH3
2021-01-09,PF/BT,50503,SISP DOLO ADULTI,VEN,30-39,7,27,0,24,8,0,2,34,0,34,Veneto,ITH3
2021-01-09,PF/BT,50503,SISP DOLO ADULTI,VEN,40-49,11,57,0,44,20,0,4,68,0,68,Veneto,ITH3
2021-01-09,PF/BT,50503,SISP DOLO ADULTI,VEN,50-59,28,67,0,75,11,0,9,95,0,95,Veneto,ITH3
2021-01-09,PF/BT,50503,SISP DOLO ADULTI,VEN,60-69,44,30,0,68,5,0,1,74,0,74,Veneto,ITH3
2021-01-09,PF/BT,50503,SISP DOLO ADULTI,VEN,70-79,1,1,0,2,0,0,0,2,0,2,Veneto,ITH3
2021-01-09,PF/BT,50504,PORTOGRUARO,VEN,30-39,0,2,0,2,0,0,0,2,0,2,Veneto,ITH3
2021-01-09,PF/BT,50504,PORTOGRUARO,VEN,40-49,0,1,0,1,0,0,0,1,0,1,Veneto,ITH3
2021-01-09,PF/BT,50504,PORTOGRUARO,VEN,50-59,0,1,0,1,0,0,0,1,0,1,Veneto,ITH3
2021-01-09,PF/BT,50504,PORTOGRUARO,VEN,60-69,1,0,0,1,0,0,0,1,0,1,Veneto,ITH3
2021-01-09,PF/BT,50504,SAN DONA DI PIAVE SISP,VEN,20-29,7,7,0,14,0,0,0,14,0,14,Veneto,ITH3
2021-01-09,PF/BT,50504,SAN DONA DI PIAVE SISP,VEN,30-39,6,12,0,17,1,0,0,18,0,18,Veneto,ITH3
2021-01-09,PF/BT,50504,SAN DONA DI PIAVE SISP,VEN,40-49,6,26,0,32,0,0,0,32,0,32,Veneto,ITH3
2021-01-09,PF/BT,50504,SAN DONA DI PIAVE SISP,VEN,50-59,11,30,0,38,3,0,0,41,0,41,Veneto,ITH3
2021-01-09,PF/BT,50504,SAN DONA DI PIAVE SISP,VEN,60-69,18,17,0,35,0,0,0,35,0,35,Veneto,ITH3
2021-01-09,PF/BT,50504,SAN DONA DI PIAVE SISP,VEN,70-79,1,0,0,1,0,0,0,1,0,1,Veneto,ITH3
2021-01-09,PF/BT,50505,ADRIA,VEN,20-29,5,6,0,10,0,0,1,11,0,11,Veneto,ITH3
2021-01-09,PF/BT,50505,ADRIA,VEN,30-39,10,10,0,12,1,0,7,20,0,20,Veneto,ITH3
2021-01-09,PF/BT,50505,ADRIA,VEN,40-49,8,19,0,19,2,0,6,27,0,27,Veneto,ITH3
2021-01-09,PF/BT,50505,ADRIA,VEN,50-59,11,23,0,24,6,0,4,34,0,34,Veneto,ITH3
2021-01-09,PF/BT,50505,ADRIA,VEN,60-69,7,7,0,10,2,0,2,14,0,14,Veneto,ITH3
2021-01-09,PF/BT,50505,ADRIA,VEN,70-79,2,0,0,2,0,0,0,2,0,2,Veneto,ITH3
2021-01-09,PF/BT,50505,MAGAZZINO MED. COMPETENTE 05,VEN,20-29,0,1,0,1,0,0,0,1,0,1,Veneto,ITH3
2021-01-09,PF/BT,50505,TRECENTA,VEN,20-29,5,3,0,8,0,0,0,8,0,8,Veneto,ITH3
2021-01-09,PF/BT,50505,TRECENTA,VEN,30-39,3,6,0,7,0,0,2,9,0,9,Veneto,ITH3
2021-01-09,PF/BT,50505,TRECENTA,VEN,40-49,3,8,0,6,0,0,5,11,0,11,Veneto,ITH3
2021-01-09,PF/BT,50505,TRECENTA,VEN,50-59,7,9,0,14,0,0,2,16,0,16,Veneto,ITH3
2021-01-09,PF/BT,50505,TRECENTA,VEN,60-69,5,1,0,4,0,0,2,6,0,6,Veneto,ITH3
2021-01-09,PF/BT,50505,TRECENTA,VEN,70-79,3,0,0,3,0,0,0,3,0,3,Veneto,ITH3
2021-01-09,PF/BT,50505,TRECENTA,VEN,90+,1,0,0,1,0,0,0,1,0,1,Veneto,ITH3
2021-01-09,PF/BT,5050501,PRESIDIO OSPEDALIERO ROVIGO,VEN,20-29,6,14,0,12,1,0,7,20,0,20,Veneto,ITH3
2021-01-09,PF/BT,5050501,PRESIDIO OSPEDALIERO ROVIGO,VEN,30-39,8,28,0,18,2,2,14,36,0,36,Veneto,ITH3
2021-01-09,PF/BT,5050501,PRESIDIO OSPEDALIERO ROVIGO,VEN,40-49,25,36,0,25,3,7,26,61,0,61,Veneto,ITH3
2021-01-09,PF/BT,5050501,PRESIDIO OSPEDALIERO ROVIGO,VEN,50-59,24,63,0,51,3,1,32,87,0,87,Veneto,ITH3
2021-01-09,PF/BT,5050501,PRESIDIO OSPEDALIERO ROVIGO,VEN,60-69,8,15,0,10,0,0,13,23,0,23,Veneto,ITH3
2021-01-09,PF/BT,5050501,PRESIDIO OSPEDALIERO ROVIGO,VEN,70-79,1,0,0,1,0,0,0,1,0,1,Veneto,ITH3
2021-01-09,PF/BT,50506,AZ OSPEDALIERA DI PADOVA MAL. INFET.E TR,VEN,20-29,23,52,0,75,0,0,0,75,0,75,Veneto,ITH3
2021-01-09,PF/BT,50506,AZ OSPEDALIERA DI PADOVA MAL. INFET.E TR,VEN,30-39,49,69,0,118,0,0,0,118,0,118,Veneto,ITH3
2021-01-09,PF/BT,50506,AZ OSPEDALIERA DI PADOVA MAL. INFET.E TR,VEN,40-49,43,84,0,127,0,0,0,127,0,127,Veneto,ITH3
2021-01-09,PF/BT,50506,AZ OSPEDALIERA DI PADOVA MAL. INFET.E TR,VEN,50-59,34,94,0,128,0,0,0,128,0,128,Veneto,ITH3
2021-01-09,PF/BT,50506,AZ OSPEDALIERA DI PADOVA MAL. INFET.E TR,VEN,60-69,20,20,0,40,0,0,0,40,0,40,Veneto,ITH3
2021-01-09,PF/BT,50506,CITTADELLA MEDICO COMPETENTE,VEN,16-19,1,0,0,0,0,0,1,1,0,1,Veneto,ITH3
2021-01-09,PF/BT,50506,CITTADELLA MEDICO COMPETENTE,VEN,20-29,7,10,0,9,4,0,4,17,0,17,Veneto,ITH3
2021-01-09,PF/BT,50506,CITTADELLA MEDICO COMPETENTE,VEN,30-39,9,12,0,10,3,0,8,21,0,21,Veneto,ITH3
2021-01-09,PF/BT,50506,CITTADELLA MEDICO COMPETENTE,VEN,40-49,15,31,0,22,13,0,11,46,0,46,Veneto,ITH3
2021-01-09,PF/BT,50506,CITTADELLA MEDICO COMPETENTE,VEN,50-59,13,51,0,30,19,0,15,64,0,64,Veneto,ITH3
2021-01-09,PF/BT,50506,CITTADELLA MEDICO COMPETENTE,VEN,60-69,14,13,0,6,13,0,8,27,0,27,Veneto,ITH3
2021-01-09,PF/BT,50506,CITTADELLA MEDICO COMPETENTE,VEN,70-79,12,1,0,0,7,0,6,13,0,13,Veneto,ITH3
2021-01-09,PF/BT,50506,CITTADELLA MEDICO COMPETENTE,VEN,80-89,2,1,0,0,1,0,2,3,0,3,Veneto,ITH3
2021-01-09,PF/BT,50506,COLLI VACC. ADULTI,VEN,20-29,1,0,0,0,0,0,1,1,0,1,Veneto,ITH3
2021-01-09,PF/BT,50506,COLLI VACC. ADULTI,VEN,30-39,2,2,0,4,0,0,0,4,0,4,Veneto,ITH3
2021-01-09,PF/BT,50506,COLLI VACC. ADULTI,VEN,40-49,2,5,0,7,0,0,0,7,0,7,Veneto,ITH3
2021-01-09,PF/BT,50506,COLLI VACC. ADULTI,VEN,50-59,3,10,0,10,3,0,0,13,0,13,Veneto,ITH3
2021-01-09,PF/BT,50506,COLLI VACC. ADULTI,VEN,60-69,2,3,0,5,0,0,0,5,0,5,Veneto,ITH3
2021-01-09,PF/BT,50506,DIRIGENZA MEDICA P.D.SACCO,VEN,20-29,2,3,0,5,0,0,0,5,0,5,Veneto,ITH3
2021-01-09,PF/BT,50506,DIRIGENZA MEDICA P.D.SACCO,VEN,30-39,0,3,0,3,0,0,0,3,0,3,Veneto,ITH3
2021-01-09,PF/BT,50506,DIRIGENZA MEDICA P.D.SACCO,VEN,40-49,3,7,0,10,0,0,0,10,0,10,Veneto,ITH3
2021-01-09,PF/BT,50506,DIRIGENZA MEDICA P.D.SACCO,VEN,50-59,1,15,0,16,0,0,0,16,0,16,Veneto,ITH3
2021-01-09,PF/BT,50506,DIRIGENZA MEDICA P.D.SACCO,VEN,60-69,1,1,0,1,1,0,0,2,0,2,Veneto,ITH3
2021-01-09,PF/BT,50506,DISTR. 3 ALBIGNASEGO AMB.IGIEN,VEN,20-29,2,3,0,1,3,1,0,5,0,5,Veneto,ITH3
2021-01-09,PF/BT,50506,DISTR. 3 ALBIGNASEGO AMB.IGIEN,VEN,30-39,2,5,0,3,2,2,0,7,0,7,Veneto,ITH3
2021-01-09,PF/BT,50506,DISTR. 3 ALBIGNASEGO AMB.IGIEN,VEN,40-49,3,5,0,5,1,2,0,8,0,8,Veneto,ITH3
2021-01-09,PF/BT,50506,DISTR. 3 ALBIGNASEGO AMB.IGIEN,VEN,50-59,3,5,0,4,0,4,0,8,0,8,Veneto,ITH3
2021-01-09,PF/BT,50506,DISTR. 3 ALBIGNASEGO AMB.IGIEN,VEN,60-69,0,2,0,1,1,0,0,2,0,2,Veneto,ITH3
2021-01-09,PF/BT,50506,SCHIAVONIA AMBULATORIO,VEN,20-29,3,5,0,8,0,0,0,8,0,8,Veneto,ITH3
2021-01-09,PF/BT,50506,SCHIAVONIA AMBULATORIO,VEN,30-39,2,7,0,9,0,0,0,9,0,9,Veneto,ITH3
2021-01-09,PF/BT,50506,SCHIAVONIA AMBULATORIO,VEN,40-49,5,19,0,24,0,0,0,24,0,24,Veneto,ITH3
2021-01-09,PF/BT,50506,SCHIAVONIA AMBULATORIO,VEN,50-59,6,27,0,32,0,0,1,33,0,33,Veneto,ITH3
2021-01-09,PF/BT,50506,SCHIAVONIA AMBULATORIO,VEN,60-69,2,2,0,4,0,0,0,4,0,4,Veneto,ITH3
2021-01-09,PF/BT,50506,SET.IGIENE PUBBLICA EPID.E PROF. MAL.INF,VEN,16-19,2,1,0,0,3,0,0,3,0,3,Veneto,ITH3
2021-01-09,PF/BT,50506,SET.IGIENE PUBBLICA EPID.E PROF. MAL.INF,VEN,20-29,22,22,0,13,31,0,0,44,0,44,Veneto,ITH3
2021-01-09,PF/BT,50506,SET.IGIENE PUBBLICA EPID.E PROF. MAL.INF,VEN,30-39,19,17,0,7,29,0,0,36,0,36,Veneto,ITH3
2021-01-09,PF/BT,50506,SET.IGIENE PUBBLICA EPID.E PROF. MAL.INF,VEN,40-49,22,16,0,10,28,0,0,38,0,38,Veneto,ITH3
2021-01-09,PF/BT,50506,SET.IGIENE PUBBLICA EPID.E PROF. MAL.INF,VEN,50-59,22,17,0,5,34,0,0,39,0,39,Veneto,ITH3
2021-01-09,PF/BT,50506,SET.IGIENE PUBBLICA EPID.E PROF. MAL.INF,VEN,60-69,17,9,0,4,22,0,0,26,0,26,Veneto,ITH3
2021-01-09,PF/BT,50506,SET.IGIENE PUBBLICA EPID.E PROF. MAL.INF,VEN,70-79,5,0,0,0,5,0,0,5,0,5,Veneto,ITH3
2021-01-09,PF/BT,50506,SET.IGIENE PUBBLICA EPID.E PROF. MAL.INF,VEN,80-89,1,0,0,0,1,0,0,1,0,1,Veneto,ITH3
2021-01-09,PF/BT,50506,VIA SCROVEGNI ANTI INFLUENZALE,VEN,30-39,2,1,0,3,0,0,0,3,0,3,Veneto,ITH3
2021-01-09,PF/BT,50506,VIA SCROVEGNI ANTI INFLUENZALE,VEN,40-49,1,0,0,1,0,0,0,1,0,1,Veneto,ITH3
2021-01-09,PF/BT,50506,VIA SCROVEGNI ANTI INFLUENZALE,VEN,50-59,0,1,0,1,0,0,0,1,0,1,Veneto,ITH3
2021-01-09,PF/BT,50506,VIA SCROVEGNI ANTI INFLUENZALE,VEN,60-69,13,7,0,20,0,0,0,20,0,20,Veneto,ITH3
2021-01-09,PF/BT,50507,DIPARTIMENTO DI PREVENZIONE,VEN,20-29,1,0,0,1,0,0,0,1,0,1,Veneto,ITH3
2021-01-09,PF/BT,50507,H BASSANO,VEN,16-19,1,2,0,0,3,0,0,3,0,3,Veneto,ITH3
2021-01-09,PF/BT,50507,H BASSANO,VEN,20-29,10,9,0,9,10,0,0,19,0,19,Veneto,ITH3
2021-01-09,PF/BT,50507,H BASSANO,VEN,30-39,8,6,0,1,12,0,1,14,0,14,Veneto,ITH3
2021-01-09,PF/BT,50507,H BASSANO,VEN,40-49,10,10,0,2,18,0,0,20,0,20,Veneto,ITH3
2021-01-09,PF/BT,50507,H BASSANO,VEN,50-59,4,11,0,2,12,0,1,15,0,15,Veneto,ITH3
2021-01-09,PF/BT,50507,H BASSANO,VEN,60-69,11,9,0,1,19,0,0,20,0,20,Veneto,ITH3
2021-01-09,PF/BT,50507,H BASSANO,VEN,70-79,4,1,0,0,5,0,0,5,0,5,Veneto,ITH3
2021-01-09,PF/BT,50507,H MAROSTICA,VEN,20-29,0,6,0,6,0,0,0,6,0,6,Veneto,ITH3
2021-01-09,PF/BT,50507,H MAROSTICA,VEN,30-39,4,13,0,16,1,0,0,17,0,17,Veneto,ITH3
2021-01-09,PF/BT,50507,H MAROSTICA,VEN,40-49,2,33,0,33,2,0,0,35,0,35,Veneto,ITH3
2021-01-09,PF/BT,50507,H MAROSTICA,VEN,50-59,3,33,0,29,6,0,1,36,0,36,Veneto,ITH3
2021-01-09,PF/BT,50507,H MAROSTICA,VEN,60-69,4,11,0,12,2,1,0,15,0,15,Veneto,ITH3
2021-01-09,PF/BT,50507,THIENE,VEN,20-29,3,6,0,9,0,0,0,9,0,9,Veneto,ITH3
2021-01-09,PF/BT,50507,THIENE,VEN,30-39,1,4,0,5,0,0,0,5,0,5,Veneto,ITH3
2021-01-09,PF/BT,50507,THIENE,VEN,40-49,2,18,0,20,0,0,0,20,0,20,Veneto,ITH3
2021-01-09,PF/BT,50507,THIENE,VEN,50-59,4,30,0,34,0,0,0,34,0,34,Veneto,ITH3
2021-01-09,PF/BT,50507,THIENE,VEN,60-69,1,4,0,5,0,0,0,5,0,5,Veneto,ITH3
2021-01-09,PF/BT,5050801,MED.COMP. - OSP. SAN BORTOLO,VEN,20-29,5,24,0,25,2,0,2,29,0,29,Veneto,ITH3
2021-01-09,PF/BT,5050801,MED.COMP. - OSP. SAN BORTOLO,VEN,30-39,14,31,0,43,1,0,1,45,0,45,Veneto,ITH3
2021-01-09,PF/BT,5050801,MED.COMP. - OSP. SAN BORTOLO,VEN,40-49,20,58,0,68,2,0,8,78,0,78,Veneto,ITH3
2021-01-09,PF/BT,5050801,MED.COMP. - OSP. SAN BORTOLO,VEN,50-59,17,64,0,69,4,0,8,81,0,81,Veneto,ITH3
2021-01-09,PF/BT,5050801,MED.COMP. - OSP. SAN BORTOLO,VEN,60-69,24,24,0,46,1,0,1,48,0,48,Veneto,ITH3
2021-01-09,PF/BT,5050801,MED.COMP. - OSP. SAN BORTOLO,VEN,70-79,4,1,0,5,0,0,0,5,0,5,Veneto,ITH3
2021-01-09,PF/BT,50509,LEGNAGO,VEN,20-29,0,2,0,2,0,0,0,2,0,2,Veneto,ITH3
2021-01-09,PF/BT,50509,LEGNAGO,VEN,30-39,6,6,0,9,2,0,1,12,0,12,Veneto,ITH3
2021-01-09,PF/BT,50509,LEGNAGO,VEN,40-49,6,9,0,13,2,0,0,15,0,15,Veneto,ITH3
2021-01-09,PF/BT,50509,LEGNAGO,VEN,50-59,9,31,0,33,7,0,0,40,0,40,Veneto,ITH3
2021-01-09,PF/BT,50509,LEGNAGO,VEN,60-69,20,5,0,22,1,0,2,25,0,25,Veneto,ITH3
2021-01-09,PF/BT,50509,LEGNAGO,VEN,70-79,5,1,0,4,0,0,2,6,0,6,Veneto,ITH3
2021-01-09,PF/BT,50509,LEGNAGO,VEN,80-89,1,0,0,1,0,0,0,1,0,1,Veneto,ITH3
2021-01-09,PF/BT,50509,SAN BONIFACIO,VEN,20-29,2,5,0,6,1,0,0,7,0,7,Veneto,ITH3
2021-01-09,PF/BT,50509,SAN BONIFACIO,VEN,30-39,5,8,0,11,2,0,0,13,0,13,Veneto,ITH3
2021-01-09,PF/BT,50509,SAN BONIFACIO,VEN,40-49,10,22,0,19,9,0,4,32,0,32,Veneto,ITH3
2021-01-09,PF/BT,50509,SAN BONIFACIO,VEN,50-59,19,72,0,65,13,0,13,91,0,91,Veneto,ITH3
2021-01-09,PF/BT,50509,SAN BONIFACIO,VEN,60-69,23,13,0,33,2,0,1,36,0,36,Veneto,ITH3
2021-01-09,PF/BT,50509,VILLAFRANCA,VEN,20-29,4,3,0,7,0,0,0,7,0,7,Veneto,ITH3
2021-01-09,PF/BT,50509,VILLAFRANCA,VEN,30-39,4,14,0,18,0,0,0,18,0,18,Veneto,ITH3
2021-01-09,PF/BT,50509,VILLAFRANCA,VEN,40-49,10,62,0,71,0,0,1,72,0,72,Veneto,ITH3
2021-01-09,PF/BT,50509,VILLAFRANCA,VEN,50-59,33,104,0,136,0,0,1,137,0,137,Veneto,ITH3
2021-01-09,PF/BT,50509,VILLAFRANCA,VEN,60-69,37,37,0,73,1,0,0,74,0,74,Veneto,ITH3
2021-01-09,PF/BT,50509,VILLAFRANCA,VEN,70-79,1,1,0,2,0,0,0,2,0,2,Veneto,ITH3
2021-01-09,PF/BT,5091201,AOUIVR,VEN,20-29,24,49,0,73,0,0,0,73,0,73,Veneto,ITH3
2021-01-09,PF/BT,5091201,AOUIVR,VEN,30-39,43,68,0,111,0,0,0,111,0,111,Veneto,ITH3
2021-01-09,PF/BT,5091201,AOUIVR,VEN,40-49,20,91,0,111,0,0,0,111,0,111,Veneto,ITH3
2021-01-09,PF/BT,5091201,AOUIVR,VEN,50-59,27,122,0,149,0,0,0,149,0,149,Veneto,ITH3
2021-01-09,PF/BT,5091201,AOUIVR,VEN,60-69,22,30,0,52,0,0,0,52,0,52,Veneto,ITH3
2021-01-09,PF/BT,5091201,AOUIVR,VEN,90+,0,1,0,1,0,0,0,1,0,1,Veneto,ITH3
2021-01-09,PF/BT,5095201,IOV,VEN,20-29,4,5,0,9,0,0,0,9,0,9,Veneto,ITH3
2021-01-09,PF/BT,5095201,IOV,VEN,30-39,13,6,0,19,0,0,0,19,0,19,Veneto,ITH3
2021-01-09,PF/BT,5095201,IOV,VEN,40-49,4,12,0,16,0,0,0,16,0,16,Veneto,ITH3
2021-01-09,PF/BT,5095201,IOV,VEN,50-59,5,17,0,22,0,0,0,22,0,22,Veneto,ITH3
2021-01-09,PF/BT,5095201,IOV,VEN,60-69,1,5,0,6,0,0,0,6,0,6,Veneto,ITH3
2021-01-09,PF/BT,563038,C DIURNO C.D.R. CITTADELLA,VEN,20-29,1,3,0,4,0,0,0,4,0,4,Veneto,ITH3
2021-01-09,PF/BT,563038,C DIURNO C.D.R. CITTADELLA,VEN,30-39,1,2,0,2,1,0,0,3,0,3,Veneto,ITH3
2021-01-09,PF/BT,563038,C DIURNO C.D.R. CITTADELLA,VEN,40-49,0,6,0,4,2,0,0,6,0,6,Veneto,ITH3
2021-01-09,PF/BT,563038,C DIURNO C.D.R. CITTADELLA,VEN,50-59,1,3,0,2,2,0,0,4,0,4,Veneto,ITH3
2021-01-09,PF/BT,563038,C DIURNO C.D.R. CITTADELLA,VEN,60-69,0,4,0,3,1,0,0,4,0,4,Veneto,ITH3
2021-01-09,PF/BT,563038,C DIURNO C.D.R. CITTADELLA,VEN,70-79,1,0,0,0,0,1,0,1,0,1,Veneto,ITH3
2021-01-09,PF/BT,563038,C DIURNO C.D.R. CITTADELLA,VEN,80-89,0,1,0,0,0,1,0,1,0,1,Veneto,ITH3
2021-01-09,PF/BT,563047,R.S.A. PER DISABILI -C.S.PIERO,VEN,20-29,1,2,0,1,0,2,0,3,0,3,Veneto,ITH3
2021-01-09,PF/BT,563047,R.S.A. PER DISABILI -C.S.PIERO,VEN,30-39,3,4,0,4,0,3,0,7,0,7,Veneto,ITH3
2021-01-09,PF/BT,563047,R.S.A. PER DISABILI -C.S.PIERO,VEN,40-49,4,1,0,0,0,5,0,5,0,5,Veneto,ITH3
2021-01-09,PF/BT,563047,R.S.A. PER DISABILI -C.S.PIERO,VEN,50-59,6,10,0,3,0,13,0,16,0,16,Veneto,ITH3
2021-01-09,PF/BT,563047,R.S.A. PER DISABILI -C.S.PIERO,VEN,60-69,1,4,0,0,0,5,0,5,0,5,Veneto,ITH3
2021-01-09,PF/BT,609901,CASA DI CURA DI ABANO TERME - POLISPECIALISTICA E TERMALE SPA,VEN,20-29,4,8,0,12,0,0,0,12,0,12,Veneto,ITH3
2021-01-09,PF/BT,609901,CASA DI CURA DI ABANO TERME - POLISPECIALISTICA E TERMALE SPA,VEN,30-39,11,9,0,20,0,0,0,20,0,20,Veneto,ITH3
2021-01-09,PF/BT,609901,CASA DI CURA DI ABANO TERME - POLISPECIALISTICA E TERMALE SPA,VEN,40-49,5,8,0,13,0,0,0,13,0,13,Veneto,ITH3
2021-01-09,PF/BT,609901,CASA DI CURA DI ABANO TERME - POLISPECIALISTICA E TERMALE SPA,VEN,50-59,4,12,0,16,0,0,0,16,0,16,Veneto,ITH3
2021-01-09,PF/BT,609901,CASA DI CURA DI ABANO TERME - POLISPECIALISTICA E TERMALE SPA,VEN,60-69,8,1,0,9,0,0,0,9,0,9,Veneto,ITH3
2021-01-09,PF/BT,609901,CASA DI CURA DI ABANO TERME - POLISPECIALISTICA E TERMALE SPA,VEN,70-79,6,0,0,6,0,0,0,6,0,6,Veneto,ITH3
2021-01-09,PF/BT,609901,CASA DI CURA DI ABANO TERME - POLISPECIALISTICA E TERMALE SPA,VEN,80-89,1,0,0,1,0,0,0,1,0,1,Veneto,ITH3
2021-01-09,PF/BT,610903,CASA DI CURA ABANO TERME SPA,VEN,20-29,0,1,0,1,0,0,0,1,0,1,Veneto,ITH3
2021-01-09,PF/BT,610903,CASA DI CURA ABANO TERME SPA,VEN,30-39,0,2,0,2,0,0,0,2,0,2,Veneto,ITH3
2021-01-09,PF/BT,610903,CASA DI CURA ABANO TERME SPA,VEN,40-49,1,4,0,5,0,0,0,5,0,5,Veneto,ITH3
2021-01-09,PF/BT,610903,CASA DI CURA ABANO TERME SPA,VEN,50-59,0,2,0,2,0,0,0,2,0,2,Veneto,ITH3
2021-01-09,PF/BT,610903,CASA DI CURA ABANO TERME SPA,VEN,60-69,1,1,0,2,0,0,0,2,0,2,Veneto,ITH3
2021-01-09,PF/BT,610903,CASA DI CURA ABANO TERME SPA,VEN,70-79,1,0,0,1,0,0,0,1,0,1,Veneto,ITH3
2021-01-09,PF/BT,610903,CASA DI CURA ABANO TERME SPA,VEN,80-89,1,0,0,1,0,0,0,1,0,1,Veneto,ITH3
2021-01-09,PF/BT,610946,ALTAVITA IRA - CENTRO SERVIZI BEATO PELLEGRINO,VEN,60-69,1,0,0,0,0,1,0,1,0,1,Veneto,ITH3
2021-01-09,PF/BT,610946,ALTAVITA IRA - CENTRO SERVIZI BEATO PELLEGRINO,VEN,70-79,3,3,0,0,0,6,0,6,0,6,Veneto,ITH3
2021-01-09,PF/BT,610946,ALTAVITA IRA - CENTRO SERVIZI BEATO PELLEGRINO,VEN,80-89,0,12,0,0,0,12,0,12,0,12,Veneto,ITH3
2021-01-09,PF/BT,610946,ALTAVITA IRA - CENTRO SERVIZI BEATO PELLEGRINO,VEN,90+,1,9,0,0,0,10,0,10,0,10,Veneto,ITH3
2021-01-09,PF/BT,610952,O.I.C. CENTRO NAZARETH,VEN,70-79,0,1,0,0,0,1,0,1,0,1,Veneto,ITH3
2021-01-09,PF/BT,610952,O.I.C. CENTRO NAZARETH,VEN,80-89,0,1,0,0,0,1,0,1,0,1,Veneto,ITH3
2021-01-09,PF/BT,610955,OPSA - OPERA PROVVIDENZA S.ANTONIO DISABILI,VEN,40-49,4,0,0,0,0,4,0,4,0,4,Veneto,ITH3
2021-01-09,PF/BT,610955,OPSA - OPERA PROVVIDENZA S.ANTONIO DISABILI,VEN,50-59,14,0,0,0,0,14,0,14,0,14,Veneto,ITH3
2021-01-09,PF/BT,610955,OPSA - OPERA PROVVIDENZA S.ANTONIO DISABILI,VEN,60-69,22,0,0,0,0,22,0,22,0,22,Veneto,ITH3
2021-01-09,PF/BT,610955,OPSA - OPERA PROVVIDENZA S.ANTONIO DISABILI,VEN,70-79,7,0,0,0,0,7,0,7,0,7,Veneto,ITH3
2021-01-09,PF/BT,610955,OPSA - OPERA PROVVIDENZA S.ANTONIO DISABILI,VEN,80-89,3,0,0,0,0,3,0,3,0,3,Veneto,ITH3
2021-01-09,PF/BT,611054,OPSA - CASA SOCCIORNO MONS.BORTIGNON - RELIGIOSI,VEN,80-89,2,0,0,0,0,2,0,2,0,2,Veneto,ITH3
2021-01-09,PF/BT,611054,OPSA - CASA SOCCIORNO MONS.BORTIGNON - RELIGIOSI,VEN,90+,1,1,0,0,0,2,0,2,0,2,Veneto,ITH3
2021-01-09,PF/BT,611145,OIC - CENTRO RESIDENZIALE CIVITAS VITAE,VEN,70-79,2,1,0,0,0,3,0,3,0,3,Veneto,ITH3
2021-01-09,PF/BT,611145,OIC - CENTRO RESIDENZIALE CIVITAS VITAE,VEN,80-89,4,1,0,0,0,5,0,5,0,5,Veneto,ITH3
2021-01-09,PF/BT,611145,OIC - CENTRO RESIDENZIALE CIVITAS VITAE,VEN,90+,0,4,0,0,0,4,0,4,0,4,Veneto,ITH3
2021-01-09,PF/BT,611243,CENTRO DI RIFERIMENTO PER LE GRAVI DISABILITA' E DISTIURBI DEL COMPORTAMENTO,VEN,40-49,0,1,0,0,0,1,0,1,0,1,Veneto,ITH3
2021-01-09,PF/BT,611243,CENTRO DI RIFERIMENTO PER LE GRAVI DISABILITA' E DISTIURBI DEL COMPORTAMENTO,VEN,50-59,2,1,0,0,0,3,0,3,0,3,Veneto,ITH3
2021-01-09,PF/BT,611243,CENTRO DI RIFERIMENTO PER LE GRAVI DISABILITA' E DISTIURBI DEL COMPORTAMENTO,VEN,60-69,15,1,0,0,0,16,0,16,0,16,Veneto,ITH3
2021-01-09,PF/BT,611243,CENTRO DI RIFERIMENTO PER LE GRAVI DISABILITA' E DISTIURBI DEL COMPORTAMENTO,VEN,70-79,10,1,0,0,0,11,0,11,0,11,Veneto,ITH3
2021-01-09,PF/BT,611243,CENTRO DI RIFERIMENTO PER LE GRAVI DISABILITA' E DISTIURBI DEL COMPORTAMENTO,VEN,80-89,1,0,0,0,0,1,0,1,0,1,Veneto,ITH3
2021-01-09,PF/BT,642091,CASA DI RIPOSO CASALE,VEN,20-29,2,5,0,4,3,0,0,7,0,7,Veneto,ITH3
2021-01-09,PF/BT,642091,CASA DI RIPOSO CASALE,VEN,30-39,0,6,0,4,2,0,0,6,0,6,Veneto,ITH3
2021-01-09,PF/BT,642091,CASA DI RIPOSO CASALE,VEN,40-49,1,12,0,10,3,0,0,13,0,13,Veneto,ITH3
2021-01-09,PF/BT,642091,CASA DI RIPOSO CASALE,VEN,50-59,4,24,0,22,5,1,0,28,0,28,Veneto,ITH3
2021-01-09,PF/BT,642091,CASA DI RIPOSO CASALE,VEN,60-69,6,7,0,2,2,9,0,13,0,13,Veneto,ITH3
2021-01-09,PF/BT,642091,CASA DI RIPOSO CASALE,VEN,70-79,17,13,0,0,0,30,0,30,0,30,Veneto,ITH3
2021-01-09,PF/BT,642091,CASA DI RIPOSO CASALE,VEN,80-89,8,23,0,0,0,31,0,31,0,31,Veneto,ITH3
2021-01-09,PF/BT,642091,CASA DI RIPOSO CASALE,VEN,90+,2,14,0,0,0,16,0,16,0,16,Veneto,ITH3
2021-01-09,PF/BT,642093,"CASA DI RIPOSO ""SANTA TECLA"" ESTE",VEN,20-29,0,11,0,9,2,0,0,11,0,11,Veneto,ITH3
2021-01-09,PF/BT,642093,"CASA DI RIPOSO ""SANTA TECLA"" ESTE",VEN,30-39,0,5,0,3,2,0,0,5,0,5,Veneto,ITH3
2021-01-09,PF/BT,642093,"CASA DI RIPOSO ""SANTA TECLA"" ESTE",VEN,40-49,0,13,0,11,2,0,0,13,0,13,Veneto,ITH3
2021-01-09,PF/BT,642093,"CASA DI RIPOSO ""SANTA TECLA"" ESTE",VEN,50-59,1,13,0,11,3,0,0,14,0,14,Veneto,ITH3
2021-01-09,PF/BT,642093,"CASA DI RIPOSO ""SANTA TECLA"" ESTE",VEN,60-69,1,4,0,3,2,0,0,5,0,5,Veneto,ITH3
2021-01-09,PF/BT,642093,"CASA DI RIPOSO ""SANTA TECLA"" ESTE",VEN,70-79,1,1,0,0,0,2,0,2,0,2,Veneto,ITH3
2021-01-09,PF/BT,642093,"CASA DI RIPOSO ""SANTA TECLA"" ESTE",VEN,80-89,0,1,0,0,0,1,0,1,0,1,Veneto,ITH3
2021-01-09,PF/BT,642096,CASA DI RIPOSO MONTAGNANA,VEN,20-29,1,1,0,2,0,0,0,2,0,2,Veneto,ITH3
2021-01-09,PF/BT,642096,CASA DI RIPOSO MONTAGNANA,VEN,30-39,0,2,0,2,0,0,0,2,0,2,Veneto,ITH3
2021-01-09,PF/BT,642096,CASA DI RIPOSO MONTAGNANA,VEN,40-49,2,5,0,4,2,1,0,7,0,7,Veneto,ITH3
2021-01-09,PF/BT,642096,CASA DI RIPOSO MONTAGNANA,VEN,50-59,2,8,0,7,2,1,0,10,0,10,Veneto,ITH3
2021-01-09,PF/BT,642096,CASA DI RIPOSO MONTAGNANA,VEN,60-69,2,6,0,3,2,3,0,8,0,8,Veneto,ITH3
2021-01-09,PF/BT,642096,CASA DI RIPOSO MONTAGNANA,VEN,70-79,5,2,0,0,0,7,0,7,0,7,Veneto,ITH3
2021-01-09,PF/BT,642096,CASA DI RIPOSO MONTAGNANA,VEN,80-89,3,6,0,0,0,9,0,9,0,9,Veneto,ITH3
2021-01-09,PF/BT,642096,CASA DI RIPOSO MONTAGNANA,VEN,90+,1,2,0,0,0,3,0,3,0,3,Veneto,ITH3
2021-01-09,PF/BT,642110,SAPA FONDAZIONE IST. PER ANZIANI 'S. TECLA' ESTE,VEN,70-79,1,0,0,0,0,1,0,1,0,1,Veneto,ITH3
2021-01-09,PF/BT,642110,SAPA FONDAZIONE IST. PER ANZIANI 'S. TECLA' ESTE,VEN,80-89,1,1,0,0,0,2,0,2,0,2,Veneto,ITH3
2021-01-09,PF/BT,683009,CASA DI RIPOSO DI BADIA POL.,VEN,20-29,5,3,0,7,1,0,0,8,0,8,Veneto,ITH3
2021-01-09,PF/BT,683009,CASA DI RIPOSO DI BADIA POL.,VEN,30-39,3,9,0,8,4,0,0,12,0,12,Veneto,ITH3
2021-01-09,PF/BT,683009,CASA DI RIPOSO DI BADIA POL.,VEN,40-49,3,34,0,29,8,0,0,37,0,37,Veneto,ITH3
2021-01-09,PF/BT,683009,CASA DI RIPOSO DI BADIA POL.,VEN,50-59,7,38,0,33,10,2,0,45,0,45,Veneto,ITH3
2021-01-09,PF/BT,683009,CASA DI RIPOSO DI BADIA POL.,VEN,60-69,12,8,0,5,3,12,0,20,0,20,Veneto,ITH3
2021-01-09,PF/BT,683009,CASA DI RIPOSO DI BADIA POL.,VEN,70-79,2,10,0,0,0,12,0,12,0,12,Veneto,ITH3
2021-01-09,PF/BT,683009,CASA DI RIPOSO DI BADIA POL.,VEN,80-89,15,41,0,0,0,56,0,56,0,56,Veneto,ITH3
2021-01-09,PF/BT,683009,CASA DI RIPOSO DI BADIA POL.,VEN,90+,5,42,0,0,0,47,0,47,0,47,Veneto,ITH3
2021-01-09,PF/BT,721013,CENTRO SERVIZI ANZIANI ADRIA,VEN,20-29,0,7,0,3,2,0,2,7,0,7,Veneto,ITH3
2021-01-09,PF/BT,721013,CENTRO SERVIZI ANZIANI ADRIA,VEN,30-39,2,7,0,7,2,0,0,9,0,9,Veneto,ITH3
2021-01-09,PF/BT,721013,CENTRO SERVIZI ANZIANI ADRIA,VEN,40-49,2,27,0,17,12,0,0,29,0,29,Veneto,ITH3
2021-01-09,PF/BT,721013,CENTRO SERVIZI ANZIANI ADRIA,VEN,50-59,8,37,0,26,15,2,2,45,0,45,Veneto,ITH3
2021-01-09,PF/BT,721013,CENTRO SERVIZI ANZIANI ADRIA,VEN,60-69,8,12,0,6,4,7,3,20,0,20,Veneto,ITH3
2021-01-09,PF/BT,721013,CENTRO SERVIZI ANZIANI ADRIA,VEN,70-79,4,2,0,0,0,6,0,6,0,6,Veneto,ITH3
2021-01-09,PF/BT,721013,CENTRO SERVIZI ANZIANI ADRIA,VEN,80-89,5,23,0,0,0,28,0,28,0,28,Veneto,ITH3
2021-01-09,PF/BT,721013,CENTRO SERVIZI ANZIANI ADRIA,VEN,90+,3,14,0,0,0,17,0,17,0,17,Veneto,ITH3
2021-01-09,PF/BT,765057,FOND. MONS. A. MARANGONI,VEN,30-39,0,3,0,2,1,0,0,3,0,3,Veneto,ITH3
2021-01-09,PF/BT,765057,FOND. MONS. A. MARANGONI,VEN,40-49,0,4,0,1,3,0,0,4,0,4,Veneto,ITH3
2021-01-09,PF/BT,765057,FOND. MONS. A. MARANGONI,VEN,50-59,1,2,0,1,2,0,0,3,0,3,Veneto,ITH3
2021-01-09,PF/BT,765057,FOND. MONS. A. MARANGONI,VEN,70-79,1,3,0,0,0,4,0,4,0,4,Veneto,ITH3
2021-01-09,PF/BT,765057,FOND. MONS. A. MARANGONI,VEN,80-89,1,11,0,0,0,12,0,12,0,12,Veneto,ITH3
2021-01-09,PF/BT,765057,FOND. MONS. A. MARANGONI,VEN,90+,1,12,0,0,0,13,0,13,0,13,Veneto,ITH3
2021-01-09,PF/BT,802207,FONDAZIONE GOBETTI,VEN,30-39,0,4,0,4,0,0,0,4,0,4,Veneto,ITH3
2021-01-09,PF/BT,802207,FONDAZIONE GOBETTI,VEN,40-49,1,16,0,11,6,0,0,17,0,17,Veneto,ITH3
2021-01-09,PF/BT,802207,FONDAZIONE GOBETTI,VEN,50-59,0,10,0,9,1,0,0,10,0,10,Veneto,ITH3
2021-01-09,PF/BT,802207,FONDAZIONE GOBETTI,VEN,60-69,1,3,0,2,2,0,0,4,0,4,Veneto,ITH3
2021-01-09,PF/BT,802207,FONDAZIONE GOBETTI,VEN,70-79,2,3,0,1,0,4,0,5,0,5,Veneto,ITH3
2021-01-09,PF/BT,802207,FONDAZIONE GOBETTI,VEN,80-89,4,10,0,0,0,14,0,14,0,14,Veneto,ITH3
2021-01-09,PF/BT,802207,FONDAZIONE GOBETTI,VEN,90+,1,5,0,0,0,6,0,6,0,6,Veneto,ITH3
2021-01-09,PF/BT,83530,ISTITUTI PII PALAZZOLO,VEN,16-19,1,0,0,0,0,1,0,1,0,1,Veneto,ITH3
2021-01-09,PF/BT,83530,ISTITUTI PII PALAZZOLO,VEN,20-29,5,22,0,23,0,3,1,27,0,27,Veneto,ITH3
2021-01-09,PF/BT,83530,ISTITUTI PII PALAZZOLO,VEN,30-39,11,21,0,22,0,10,0,32,0,32,Veneto,ITH3
2021-01-09,PF/BT,83530,ISTITUTI PII PALAZZOLO,VEN,40-49,3,24,0,16,0,11,0,27,0,27,Veneto,ITH3
2021-01-09,PF/BT,83530,ISTITUTI PII PALAZZOLO,VEN,50-59,12,60,0,26,1,45,0,72,0,72,Veneto,ITH3
2021-01-09,PF/BT,83530,ISTITUTI PII PALAZZOLO,VEN,60-69,2,27,0,6,0,23,0,29,0,29,Veneto,ITH3
2021-01-09,PF/BT,83530,ISTITUTI PII PALAZZOLO,VEN,70-79,0,26,0,0,0,26,0,26,0,26,Veneto,ITH3
2021-01-09,PF/BT,83530,ISTITUTI PII PALAZZOLO,VEN,80-89,0,24,0,1,2,21,0,24,0,24,Veneto,ITH3
2021-01-09,PF/BT,83530,ISTITUTI PII PALAZZOLO,VEN,90+,1,11,0,0,0,12,0,12,0,12,Veneto,ITH3
2021-01-10,PF/BT,132229,C.R.'CASA PANCIERA'-SCHIO,VEN,30-39,0,2,0,2,0,0,0,2,0,2,Veneto,ITH3
2021-01-10,PF/BT,132229,C.R.'CASA PANCIERA'-SCHIO,VEN,40-49,0,1,0,1,0,0,0,1,0,1,Veneto,ITH3
2021-01-10,PF/BT,132229,C.R.'CASA PANCIERA'-SCHIO,VEN,50-59,1,3,0,2,2,0,0,4,0,4,Veneto,ITH3
2021-01-10,PF/BT,132229,C.R.'CASA PANCIERA'-SCHIO,VEN,60-69,0,1,0,0,1,0,0,1,0,1,Veneto,ITH3
2021-01-10,PF/BT,132229,C.R.'CASA PANCIERA'-SCHIO,VEN,70-79,0,1,0,0,0,0,1,1,0,1,Veneto,ITH3
2021-01-10,PF/BT,132229,C.R.'CASA PANCIERA'-SCHIO,VEN,80-89,0,2,0,0,0,0,2,2,0,2,Veneto,ITH3
2021-01-10,PF/BT,132232,C.R. 'A. ROSSI' - ARSIERO,VEN,20-29,1,0,0,1,0,0,0,1,0,1,Veneto,ITH3
2021-01-10,PF/BT,132232,C.R. 'A. ROSSI' - ARSIERO,VEN,30-39,2,5,0,6,1,0,0,7,0,7,Veneto,ITH3
2021-01-10,PF/BT,132232,C.R. 'A. ROSSI' - ARSIERO,VEN,40-49,1,8,0,1,8,0,0,9,0,9,Veneto,ITH3
2021-01-10,PF/BT,132232,C.R. 'A. ROSSI' - ARSIERO,VEN,50-59,5,17,0,10,12,0,0,22,0,22,Veneto,ITH3
2021-01-10,PF/BT,132232,C.R. 'A. ROSSI' - ARSIERO,VEN,60-69,1,3,0,1,2,1,0,4,0,4,Veneto,ITH3
2021-01-10,PF/BT,132232,C.R. 'A. ROSSI' - ARSIERO,VEN,70-79,3,0,0,0,0,2,1,3,0,3,Veneto,ITH3
2021-01-10,PF/BT,132232,C.R. 'A. ROSSI' - ARSIERO,VEN,80-89,1,1,0,0,0,2,0,2,0,2,Veneto,ITH3
2021-01-10,PF/BT,132232,C.R. 'A. ROSSI' - ARSIERO,VEN,90+,0,1,0,0,0,1,0,1,0,1,Veneto,ITH3
2021-01-10,PF/BT,323204,"CENTRO DI SERVIZI RESIDENZIALE ""N.D. M. TOMITANO E N. BOCCASSIN"" - MOTTA DI LIVENZA",VEN,16-19,0,1,0,1,0,0,0,1,0,1,Veneto,ITH3
2021-01-10,PF/BT,323204,"CENTRO DI SERVIZI RESIDENZIALE ""N.D. M. TOMITANO E N. BOCCASSIN"" - MOTTA DI LIVENZA",VEN,20-29,3,8,0,11,0,0,0,11,0,11,Veneto,ITH3
2021-01-10,PF/BT,323204,"CENTRO DI SERVIZI RESIDENZIALE ""N.D. M. TOMITANO E N. BOCCASSIN"" - MOTTA DI LIVENZA",VEN,30-39,1,5,0,5,1,0,0,6,0,6,Veneto,ITH3
2021-01-10,PF/BT,323204,"CENTRO DI SERVIZI RESIDENZIALE ""N.D. M. TOMITANO E N. BOCCASSIN"" - MOTTA DI LIVENZA",VEN,40-49,3,16,0,14,5,0,0,19,0,19,Veneto,ITH3
2021-01-10,PF/BT,323204,"CENTRO DI SERVIZI RESIDENZIALE ""N.D. M. TOMITANO E N. BOCCASSIN"" - MOTTA DI LIVENZA",VEN,50-59,8,25,0,22,11,0,0,33,0,33,Veneto,ITH3
2021-01-10,PF/BT,323204,"CENTRO DI SERVIZI RESIDENZIALE ""N.D. M. TOMITANO E N. BOCCASSIN"" - MOTTA DI LIVENZA",VEN,60-69,3,14,0,8,6,3,0,17,0,17,Veneto,ITH3
2021-01-10,PF/BT,323204,"CENTRO DI SERVIZI RESIDENZIALE ""N.D. M. TOMITANO E N. BOCCASSIN"" - MOTTA DI LIVENZA",VEN,70-79,7,11,0,0,0,18,0,18,0,18,Veneto,ITH3
2021-01-10,PF/BT,323204,"CENTRO DI SERVIZI RESIDENZIALE ""N.D. M. TOMITANO E N. BOCCASSIN"" - MOTTA DI LIVENZA",VEN,80-89,13,33,0,0,0,46,0,46,0,46,Veneto,ITH3
2021-01-10,PF/BT,323204,"CENTRO DI SERVIZI RESIDENZIALE ""N.D. M. TOMITANO E N. BOCCASSIN"" - MOTTA DI LIVENZA",VEN,90+,2,27,0,0,0,29,0,29,0,29,Veneto,ITH3
2021-01-10,PF/BT,363784,RESIDENZA PER ANZIANI 'SERENI ORIZZONTI',VEN,20-29,3,3,0,4,2,0,0,6,0,6,Veneto,ITH3
2021-01-10,PF/BT,363784,RESIDENZA PER ANZIANI 'SERENI ORIZZONTI',VEN,30-39,2,3,0,3,2,0,0,5,0,5,Veneto,ITH3
2021-01-10,PF/BT,363784,RESIDENZA PER ANZIANI 'SERENI ORIZZONTI',VEN,40-49,0,1,0,0,1,0,0,1,0,1,Veneto,ITH3
2021-01-10,PF/BT,363784,RESIDENZA PER ANZIANI 'SERENI ORIZZONTI',VEN,50-59,1,3,0,0,3,1,0,4,0,4,Veneto,ITH3
2021-01-10,PF/BT,363784,RESIDENZA PER ANZIANI 'SERENI ORIZZONTI',VEN,60-69,3,1,0,0,0,4,0,4,0,4,Veneto,ITH3
2021-01-10,PF/BT,363784,RESIDENZA PER ANZIANI 'SERENI ORIZZONTI',VEN,70-79,6,4,0,1,0,8,1,10,0,10,Veneto,ITH3
2021-01-10,PF/BT,363784,RESIDENZA PER ANZIANI 'SERENI ORIZZONTI',VEN,80-89,10,25,0,0,0,35,0,35,0,35,Veneto,ITH3
2021-01-10,PF/BT,363784,RESIDENZA PER ANZIANI 'SERENI ORIZZONTI',VEN,90+,3,14,0,0,0,17,0,17,0,17,Veneto,ITH3
2021-01-10,PF/BT,42817,C.S.A. 'A. BRANDALISE',VEN,20-29,1,3,0,4,0,0,0,4,0,4,Veneto,ITH3
2021-01-10,PF/BT,42817,C.S.A. 'A. BRANDALISE',VEN,30-39,2,5,0,5,2,0,0,7,0,7,Veneto,ITH3
2021-01-10,PF/BT,42817,C.S.A. 'A. BRANDALISE',VEN,40-49,1,15,0,9,7,0,0,16,0,16,Veneto,ITH3
2021-01-10,PF/BT,42817,C.S.A. 'A. BRANDALISE',VEN,50-59,5,14,0,15,4,0,0,19,0,19,Veneto,ITH3
2021-01-10,PF/BT,42817,C.S.A. 'A. BRANDALISE',VEN,60-69,0,5,0,5,0,0,0,5,0,5,Veneto,ITH3
2021-01-10,PF/BT,42820,C.S.A. 'CASA CHARITAS',VEN,40-49,1,1,0,2,0,0,0,2,0,2,Veneto,ITH3
2021-01-10,PF/BT,42820,C.S.A. 'CASA CHARITAS',VEN,50-59,0,1,0,1,0,0,0,1,0,1,Veneto,ITH3
2021-01-10,PF/BT,42823,C.S.A. 'CASA PADRE KOLBE',VEN,16-19,1,0,0,0,1,0,0,1,0,1,Veneto,ITH3
2021-01-10,PF/BT,42823,C.S.A. 'CASA PADRE KOLBE',VEN,20-29,1,1,0,2,0,0,0,2,0,2,Veneto,ITH3
2021-01-10,PF/BT,42823,C.S.A. 'CASA PADRE KOLBE',VEN,30-39,0,2,0,1,1,0,0,2,0,2,Veneto,ITH3
2021-01-10,PF/BT,42823,C.S.A. 'CASA PADRE KOLBE',VEN,40-49,0,5,0,4,1,0,0,5,0,5,Veneto,ITH3
2021-01-10,PF/BT,42823,C.S.A. 'CASA PADRE KOLBE',VEN,50-59,3,8,0,9,1,1,0,11,0,11,Veneto,ITH3
2021-01-10,PF/BT,42823,C.S.A. 'CASA PADRE KOLBE',VEN,60-69,2,5,0,5,1,1,0,7,0,7,Veneto,ITH3
2021-01-10,PF/BT,42823,C.S.A. 'CASA PADRE KOLBE',VEN,70-79,0,1,0,0,0,1,0,1,0,1,Veneto,ITH3
2021-01-10,PF/BT,42823,C.S.A. 'CASA PADRE KOLBE',VEN,80-89,3,6,0,0,0,9,0,9,0,9,Veneto,ITH3
2021-01-10,PF/BT,42823,C.S.A. 'CASA PADRE KOLBE',VEN,90+,0,13,0,0,0,13,0,13,0,13,Veneto,ITH3
2021-01-10,PF/BT,5001700,OSPEDALE SACRO CUORE DI NEGRAR,VEN,20-29,2,11,0,11,2,0,0,13,0,13,Veneto,ITH3
2021-01-10,PF/BT,5001700,OSPEDALE SACRO CUORE DI NEGRAR,VEN,30-39,7,12,0,8,11,0,0,19,0,19,Veneto,ITH3
2021-01-10,PF/BT,5001700,OSPEDALE SACRO CUORE DI NEGRAR,VEN,40-49,18,14,0,21,11,0,0,32,0,32,Veneto,ITH3
2021-01-10,PF/BT,5001700,OSPEDALE SACRO CUORE DI NEGRAR,VEN,50-59,16,13,0,18,11,0,0,29,0,29,Veneto,ITH3
2021-01-10,PF/BT,5001700,OSPEDALE SACRO CUORE DI NEGRAR,VEN,60-69,5,3,0,6,2,0,0,8,0,8,Veneto,ITH3
2021-01-10,PF/BT,5001700,OSPEDALE SACRO CUORE DI NEGRAR,VEN,70-79,1,0,0,1,0,0,0,1,0,1,Veneto,ITH3
2021-01-10,PF/BT,5018,CASA DI RIPOSO 'A. SANTIN',VEN,20-29,0,1,0,0,1,0,0,1,0,1,Veneto,ITH3
2021-01-10,PF/BT,5018,CASA DI RIPOSO 'A. SANTIN',VEN,30-39,1,5,0,2,3,0,1,6,0,6,Veneto,ITH3
2021-01-10,PF/BT,5018,CASA DI RIPOSO 'A. SANTIN',VEN,40-49,1,6,0,3,4,0,0,7,0,7,Veneto,ITH3
2021-01-10,PF/BT,5018,CASA DI RIPOSO 'A. SANTIN',VEN,50-59,1,10,0,1,9,0,1,11,0,11,Veneto,ITH3
2021-01-10,PF/BT,5018,CASA DI RIPOSO 'A. SANTIN',VEN,60-69,2,7,0,0,5,3,1,9,0,9,Veneto,ITH3
2021-01-10,PF/BT,5018,CASA DI RIPOSO 'A. SANTIN',VEN,70-79,1,0,0,1,0,0,0,1,0,1,Veneto,ITH3
2021-01-10,PF/BT,5018,CASA DI RIPOSO 'A. SANTIN',VEN,80-89,2,2,0,0,0,3,1,4,0,4,Veneto,ITH3
2021-01-10,PF/BT,5018,CASA DI RIPOSO 'A. SANTIN',VEN,90+,1,4,0,0,0,5,0,5,0,5,Veneto,ITH3
2021-01-10,PF/BT,50501,"BELLUNO ""DRIVE-IN""",VEN,16-19,1,0,0,0,1,0,0,1,0,1,Veneto,ITH3
2021-01-10,PF/BT,50501,"BELLUNO ""DRIVE-IN""",VEN,20-29,22,16,0,5,33,0,0,38,0,38,Veneto,ITH3
2021-01-10,PF/BT,50501,"BELLUNO ""DRIVE-IN""",VEN,30-39,18,17,0,2,33,0,0,35,0,35,Veneto,ITH3
2021-01-10,PF/BT,50501,"BELLUNO ""DRIVE-IN""",VEN,40-49,36,31,0,2,65,0,0,67,0,67,Veneto,ITH3
2021-01-10,PF/BT,50501,"BELLUNO ""DRIVE-IN""",VEN,50-59,78,43,0,7,113,0,1,121,0,121,Veneto,ITH3
2021-01-10,PF/BT,50501,"BELLUNO ""DRIVE-IN""",VEN,60-69,50,24,0,8,66,0,0,74,0,74,Veneto,ITH3
2021-01-10,PF/BT,50501,"BELLUNO ""DRIVE-IN""",VEN,70-79,17,4,0,1,20,0,0,21,0,21,Veneto,ITH3
2021-01-10,PF/BT,50501,BELLUNO AMBULATORIO N.15,VEN,40-49,0,1,0,1,0,0,0,1,0,1,Veneto,ITH3
2021-01-10,PF/BT,50501,CORTINA,VEN,20-29,0,2,0,2,0,0,0,2,0,2,Veneto,ITH3
2021-01-10,PF/BT,50501,CORTINA,VEN,30-39,1,2,0,3,0,0,0,3,0,3,Veneto,ITH3
2021-01-10,PF/BT,50501,CORTINA,VEN,40-49,0,8,0,7,1,0,0,8,0,8,Veneto,ITH3
2021-01-10,PF/BT,50501,CORTINA,VEN,50-59,1,5,0,4,2,0,0,6,0,6,Veneto,ITH3
2021-01-10,PF/BT,50501,CORTINA,VEN,60-69,2,1,0,1,2,0,0,3,0,3,Veneto,ITH3
2021-01-10,PF/BT,50501,CORTINA,VEN,70-79,1,3,0,0,0,4,0,4,0,4,Veneto,ITH3
2021-01-10,PF/BT,50501,CORTINA,VEN,80-89,1,7,0,0,0,8,0,8,0,8,Veneto,ITH3
2021-01-10,PF/BT,50501,CORTINA,VEN,90+,1,5,0,0,0,6,0,6,0,6,Veneto,ITH3
2021-01-10,PF/BT,50501,FELTRE,VEN,20-29,1,0,0,1,0,0,0,1,0,1,Veneto,ITH3
2021-01-10,PF/BT,50501,FELTRE,VEN,50-59,1,0,0,1,0,0,0,1,0,1,Veneto,ITH3
2021-01-10,PF/BT,5050201,OSPEDALE CA' FONCELLO,VEN,16-19,0,2,0,2,0,0,0,2,0,2,Veneto,ITH3
2021-01-10,PF/BT,5050201,OSPEDALE CA' FONCELLO,VEN,20-29,27,83,0,103,7,0,0,110,0,110,Veneto,ITH3
2021-01-10,PF/BT,5050201,OSPEDALE CA' FONCELLO,VEN,30-39,31,68,0,87,12,0,0,99,0,99,Veneto,ITH3
2021-01-10,PF/BT,5050201,OSPEDALE CA' FONCELLO,VEN,40-49,18,71,0,71,18,0,0,89,0,89,Veneto,ITH3
2021-01-10,PF/BT,5050201,OSPEDALE CA' FONCELLO,VEN,50-59,51,154,0,152,47,0,6,205,0,205,Veneto,ITH3
2021-01-10,PF/BT,5050201,OSPEDALE CA' FONCELLO,VEN,60-69,24,54,0,62,16,0,0,78,0,78,Veneto,ITH3
2021-01-10,PF/BT,5050201,OSPEDALE CA' FONCELLO,VEN,70-79,4,1,0,4,1,0,0,5,0,5,Veneto,ITH3
2021-01-10,PF/BT,50503,CAMPONOGARA ADULTI,VEN,20-29,2,1,0,3,0,0,0,3,0,3,Veneto,ITH3
2021-01-10,PF/BT,50503,CAMPONOGARA ADULTI,VEN,30-39,2,6,0,8,0,0,0,8,0,8,Veneto,ITH3
2021-01-10,PF/BT,50503,CAMPONOGARA ADULTI,VEN,40-49,0,8,0,8,0,0,0,8,0,8,Veneto,ITH3
2021-01-10,PF/BT,50503,CAMPONOGARA ADULTI,VEN,50-59,2,7,0,9,0,0,0,9,0,9,Veneto,ITH3
2021-01-10,PF/BT,50503,CAMPONOGARA ADULTI,VEN,60-69,5,2,0,7,0,0,0,7,0,7,Veneto,ITH3
2021-01-10,PF/BT,50503,CAMPONOGARA ADULTI,VEN,70-79,1,0,0,1,0,0,0,1,0,1,Veneto,ITH3
2021-01-10,PF/BT,50503,MEDICINA PREVENTIVA MESTRE,VEN,16-19,1,2,0,3,0,0,0,3,0,3,Veneto,ITH3
2021-01-10,PF/BT,50503,MEDICINA PREVENTIVA MESTRE,VEN,20-29,5,7,0,8,4,0,0,12,0,12,Veneto,ITH3
2021-01-10,PF/BT,50503,MEDICINA PREVENTIVA MESTRE,VEN,30-39,10,6,0,13,3,0,0,16,0,16,Veneto,ITH3
2021-01-10,PF/BT,50503,MEDICINA PREVENTIVA MESTRE,VEN,40-49,7,15,0,15,7,0,0,22,0,22,Veneto,ITH3
2021-01-10,PF/BT,50503,MEDICINA PREVENTIVA MESTRE,VEN,50-59,7,20,0,13,14,0,0,27,0,27,Veneto,ITH3
2021-01-10,PF/BT,50503,MEDICINA PREVENTIVA MESTRE,VEN,60-69,8,7,0,9,6,0,0,15,0,15,Veneto,ITH3
2021-01-10,PF/BT,50503,MEDICINA PREVENTIVA MESTRE,VEN,70-79,1,0,0,0,1,0,0,1,0,1,Veneto,ITH3
2021-01-10,PF/BT,50503,MEDICINA PREVENTIVA VENEZIA,VEN,20-29,6,7,0,12,1,0,0,13,0,13,Veneto,ITH3
2021-01-10,PF/BT,50503,MEDICINA PREVENTIVA VENEZIA,VEN,30-39,3,4,0,6,1,0,0,7,0,7,Veneto,ITH3
2021-01-10,PF/BT,50503,MEDICINA PREVENTIVA VENEZIA,VEN,40-49,3,7,0,9,1,0,0,10,0,10,Veneto,ITH3
2021-01-10,PF/BT,50503,MEDICINA PREVENTIVA VENEZIA,VEN,50-59,3,4,0,6,1,0,0,7,0,7,Veneto,ITH3
2021-01-10,PF/BT,50503,MEDICINA PREVENTIVA VENEZIA,VEN,60-69,6,3,0,8,1,0,0,9,0,9,Veneto,ITH3
2021-01-10,PF/BT,50503,MEDICINA PREVENTIVA VENEZIA,VEN,70-79,1,0,0,1,0,0,0,1,0,1,Veneto,ITH3
2021-01-10,PF/BT,50503,S.I.S.P. MESTRE,VEN,20-29,2,2,0,2,2,0,0,4,0,4,Veneto,ITH3
2021-01-10,PF/BT,50503,S.I.S.P. MESTRE,VEN,30-39,1,10,0,7,3,0,1,11,0,11,Veneto,ITH3
2021-01-10,PF/BT,50503,S.I.S.P. MESTRE,VEN,40-49,0,9,0,3,6,0,0,9,0,9,Veneto,ITH3
2021-01-10,PF/BT,50503,S.I.S.P. MESTRE,VEN,50-59,5,18,0,8,14,0,1,23,0,23,Veneto,ITH3
2021-01-10,PF/BT,50503,S.I.S.P. MESTRE,VEN,60-69,19,11,0,27,3,0,0,30,0,30,Veneto,ITH3
2021-01-10,PF/BT,50503,S.I.S.P. MESTRE,VEN,70-79,1,0,0,1,0,0,0,1,0,1,Veneto,ITH3
2021-01-10,PF/BT,50503,SISP DOLO ADULTI,VEN,20-29,7,15,0,20,1,0,1,22,0,22,Veneto,ITH3
2021-01-10,PF/BT,50503,SISP DOLO ADULTI,VEN,30-39,9,20,0,29,0,0,0,29,0,29,Veneto,ITH3
2021-01-10,PF/BT,50503,SISP DOLO ADULTI,VEN,40-49,10,45,0,52,3,0,0,55,0,55,Veneto,ITH3
2021-01-10,PF/BT,50503,SISP DOLO ADULTI,VEN,50-59,12,41,0,48,4,0,1,53,0,53,Veneto,ITH3
2021-01-10,PF/BT,50503,SISP DOLO ADULTI,VEN,60-69,13,23,0,35,0,0,1,36,0,36,Veneto,ITH3
2021-01-10,PF/BT,50503,SISP DOLO ADULTI,VEN,70-79,1,1,0,2,0,0,0,2,0,2,Veneto,ITH3
2021-01-10,PF/BT,50504,PORTOGRUARO,VEN,20-29,3,8,0,11,0,0,0,11,0,11,Veneto,ITH3
2021-01-10,PF/BT,50504,PORTOGRUARO,VEN,30-39,5,15,0,20,0,0,0,20,0,20,Veneto,ITH3
2021-01-10,PF/BT,50504,PORTOGRUARO,VEN,40-49,5,25,0,30,0,0,0,30,0,30,Veneto,ITH3
2021-01-10,PF/BT,50504,PORTOGRUARO,VEN,50-59,16,32,0,46,2,0,0,48,0,48,Veneto,ITH3
2021-01-10,PF/BT,50504,PORTOGRUARO,VEN,60-69,20,14,0,33,1,0,0,34,0,34,Veneto,ITH3
2021-01-10,PF/BT,50504,PORTOGRUARO,VEN,70-79,1,0,0,0,1,0,0,1,0,1,Veneto,ITH3
2021-01-10,PF/BT,50504,S.I.S.P. CA' SAVIO,VEN,16-19,1,2,0,0,0,3,0,3,0,3,Veneto,ITH3
2021-01-10,PF/BT,50504,S.I.S.P. CA' SAVIO,VEN,20-29,3,17,0,20,0,0,0,20,0,20,Veneto,ITH3
2021-01-10,PF/BT,50504,S.I.S.P. CA' SAVIO,VEN,30-39,4,11,0,15,0,0,0,15,0,15,Veneto,ITH3
2021-01-10,PF/BT,50504,S.I.S.P. CA' SAVIO,VEN,40-49,5,22,0,27,0,0,0,27,0,27,Veneto,ITH3
2021-01-10,PF/BT,50504,S.I.S.P. CA' SAVIO,VEN,50-59,12,31,0,39,3,1,0,43,0,43,Veneto,ITH3
2021-01-10,PF/BT,50504,S.I.S.P. CA' SAVIO,VEN,60-69,15,9,0,22,2,0,0,24,0,24,Veneto,ITH3
2021-01-10,PF/BT,50505,ADRIA,VEN,16-19,0,1,0,0,1,0,0,1,0,1,Veneto,ITH3
2021-01-10,PF/BT,50505,ADRIA,VEN,20-29,5,6,0,6,4,1,0,11,0,11,Veneto,ITH3
2021-01-10,PF/BT,50505,ADRIA,VEN,30-39,8,9,0,7,3,1,6,17,0,17,Veneto,ITH3
2021-01-10,PF/BT,50505,ADRIA,VEN,40-49,9,19,0,14,9,0,5,28,0,28,Veneto,ITH3
2021-01-10,PF/BT,50505,ADRIA,VEN,50-59,9,15,0,14,4,0,6,24,0,24,Veneto,ITH3
2021-01-10,PF/BT,50505,ADRIA,VEN,60-69,5,4,0,6,2,0,1,9,0,9,Veneto,ITH3
2021-01-10,PF/BT,5050501,PRESIDIO OSPEDALIERO ROVIGO,VEN,20-29,9,4,0,4,0,6,3,13,0,13,Veneto,ITH3
2021-01-10,PF/BT,5050501,PRESIDIO OSPEDALIERO ROVIGO,VEN,30-39,12,17,0,8,0,12,9,29,0,29,Veneto,ITH3
2021-01-10,PF/BT,5050501,PRESIDIO OSPEDALIERO ROVIGO,VEN,40-49,14,19,0,12,0,15,6,33,0,33,Veneto,ITH3
2021-01-10,PF/BT,5050501,PRESIDIO OSPEDALIERO ROVIGO,VEN,50-59,15,34,0,24,1,9,15,49,0,49,Veneto,ITH3
2021-01-10,PF/BT,5050501,PRESIDIO OSPEDALIERO ROVIGO,VEN,60-69,10,8,0,11,0,4,3,18,0,18,Veneto,ITH3
2021-01-10,PF/BT,5050501,PRESIDIO OSPEDALIERO ROVIGO,VEN,70-79,1,0,0,0,0,0,1,1,0,1,Veneto,ITH3
2021-01-10,PF/BT,50506,AZ OSPEDALIERA DI PADOVA MAL. INFET.E TR,VEN,20-29,32,60,0,92,0,0,0,92,0,92,Veneto,ITH3
2021-01-10,PF/BT,50506,AZ OSPEDALIERA DI PADOVA MAL. INFET.E TR,VEN,30-39,37,66,0,103,0,0,0,103,0,103,Veneto,ITH3
2021-01-10,PF/BT,50506,AZ OSPEDALIERA DI PADOVA MAL. INFET.E TR,VEN,40-49,23,84,0,107,0,0,0,107,0,107,Veneto,ITH3
2021-01-10,PF/BT,50506,AZ OSPEDALIERA DI PADOVA MAL. INFET.E TR,VEN,50-59,31,108,0,139,0,0,0,139,0,139,Veneto,ITH3
2021-01-10,PF/BT,50506,AZ OSPEDALIERA DI PADOVA MAL. INFET.E TR,VEN,60-69,20,25,0,45,0,0,0,45,0,45,Veneto,ITH3
2021-01-10,PF/BT,50506,DIRIGENZA MEDICA P.D.SACCO,VEN,30-39,0,3,0,2,1,0,0,3,0,3,Veneto,ITH3
2021-01-10,PF/BT,50506,DIRIGENZA MEDICA P.D.SACCO,VEN,40-49,1,3,0,3,1,0,0,4,0,4,Veneto,ITH3
2021-01-10,PF/BT,50506,DIRIGENZA MEDICA P.D.SACCO,VEN,50-59,0,9,0,4,5,0,0,9,0,9,Veneto,ITH3
2021-01-10,PF/BT,50506,DIRIGENZA MEDICA P.D.SACCO,VEN,60-69,0,2,0,1,1,0,0,2,0,2,Veneto,ITH3
2021-01-10,PF/BT,50506,SCHIAVONIA AMBULATORIO,VEN,20-29,1,0,0,1,0,0,0,1,0,1,Veneto,ITH3
2021-01-10,PF/BT,50506,SCHIAVONIA AMBULATORIO,VEN,30-39,2,2,0,4,0,0,0,4,0,4,Veneto,ITH3
2021-01-10,PF/BT,50506,SCHIAVONIA AMBULATORIO,VEN,40-49,7,14,0,21,0,0,0,21,0,21,Veneto,ITH3
2021-01-10,PF/BT,50506,SCHIAVONIA AMBULATORIO,VEN,50-59,9,35,0,42,2,0,0,44,0,44,Veneto,ITH3
2021-01-10,PF/BT,50506,SCHIAVONIA AMBULATORIO,VEN,60-69,1,7,0,7,1,0,0,8,0,8,Veneto,ITH3
2021-01-10,PF/BT,50506,SET.IGIENE PUBBLICA EPID.E PROF. MAL.INF,VEN,16-19,2,1,0,0,3,0,0,3,0,3,Veneto,ITH3
2021-01-10,PF/BT,50506,SET.IGIENE PUBBLICA EPID.E PROF. MAL.INF,VEN,20-29,2,9,0,1,10,0,0,11,0,11,Veneto,ITH3
2021-01-10,PF/BT,50506,SET.IGIENE PUBBLICA EPID.E PROF. MAL.INF,VEN,30-39,11,10,0,1,20,0,0,21,0,21,Veneto,ITH3
2021-01-10,PF/BT,50506,SET.IGIENE PUBBLICA EPID.E PROF. MAL.INF,VEN,40-49,8,14,0,0,22,0,0,22,0,22,Veneto,ITH3
2021-01-10,PF/BT,50506,SET.IGIENE PUBBLICA EPID.E PROF. MAL.INF,VEN,50-59,29,14,0,1,42,0,0,43,0,43,Veneto,ITH3
2021-01-10,PF/BT,50506,SET.IGIENE PUBBLICA EPID.E PROF. MAL.INF,VEN,60-69,16,4,0,1,19,0,0,20,0,20,Veneto,ITH3
2021-01-10,PF/BT,50506,SET.IGIENE PUBBLICA EPID.E PROF. MAL.INF,VEN,70-79,4,0,0,0,4,0,0,4,0,4,Veneto,ITH3
2021-01-10,PF/BT,50507,DIPARTIMENTO DI PREVENZIONE,VEN,20-29,2,8,0,10,0,0,0,10,0,10,Veneto,ITH3
2021-01-10,PF/BT,50507,DIPARTIMENTO DI PREVENZIONE,VEN,30-39,0,8,0,8,0,0,0,8,0,8,Veneto,ITH3
2021-01-10,PF/BT,50507,DIPARTIMENTO DI PREVENZIONE,VEN,40-49,3,10,0,13,0,0,0,13,0,13,Veneto,ITH3
2021-01-10,PF/BT,50507,DIPARTIMENTO DI PREVENZIONE,VEN,50-59,3,24,0,27,0,0,0,27,0,27,Veneto,ITH3
2021-01-10,PF/BT,50507,DIPARTIMENTO DI PREVENZIONE,VEN,60-69,7,5,0,12,0,0,0,12,0,12,Veneto,ITH3
2021-01-10,PF/BT,50507,DIPARTIMENTO DI PREVENZIONE,VEN,70-79,4,9,0,12,0,0,1,13,0,13,Veneto,ITH3
2021-01-10,PF/BT,50507,DIPARTIMENTO DI PREVENZIONE,VEN,80-89,15,29,0,44,0,0,0,44,0,44,Veneto,ITH3
2021-01-10,PF/BT,50507,DIPARTIMENTO DI PREVENZIONE,VEN,90+,4,18,0,22,0,0,0,22,0,22,Veneto,ITH3
2021-01-10,PF/BT,50507,H BASSANO,VEN,16-19,3,2,0,0,5,0,0,5,0,5,Veneto,ITH3
2021-01-10,PF/BT,50507,H BASSANO,VEN,20-29,4,7,0,2,9,0,0,11,0,11,Veneto,ITH3
2021-01-10,PF/BT,50507,H BASSANO,VEN,30-39,8,4,0,1,11,0,0,12,0,12,Veneto,ITH3
2021-01-10,PF/BT,50507,H BASSANO,VEN,40-49,6,14,0,3,17,0,0,20,0,20,Veneto,ITH3
2021-01-10,PF/BT,50507,H BASSANO,VEN,50-59,13,22,0,3,32,0,0,35,0,35,Veneto,ITH3
2021-01-10,PF/BT,50507,H BASSANO,VEN,60-69,6,6,0,1,11,0,0,12,0,12,Veneto,ITH3
2021-01-10,PF/BT,50507,H BASSANO,VEN,70-79,6,1,0,0,7,0,0,7,0,7,Veneto,ITH3
2021-01-10,PF/BT,50507,THIENE,VEN,20-29,1,4,0,5,0,0,0,5,0,5,Veneto,ITH3
2021-01-10,PF/BT,50507,THIENE,VEN,30-39,1,7,0,8,0,0,0,8,0,8,Veneto,ITH3
2021-01-10,PF/BT,50507,THIENE,VEN,40-49,8,16,0,24,0,0,0,24,0,24,Veneto,ITH3
2021-01-10,PF/BT,50507,THIENE,VEN,50-59,3,16,0,19,0,0,0,19,0,19,Veneto,ITH3
2021-01-10,PF/BT,50507,THIENE,VEN,60-69,1,3,0,4,0,0,0,4,0,4,Veneto,ITH3
2021-01-10,PF/BT,5050801,MED.COMP. - OSP. SAN BORTOLO,VEN,20-29,20,35,0,49,6,0,0,55,0,55,Veneto,ITH3
2021-01-10,PF/BT,5050801,MED.COMP. - OSP. SAN BORTOLO,VEN,30-39,21,37,0,49,8,0,1,58,0,58,Veneto,ITH3
2021-01-10,PF/BT,5050801,MED.COMP. - OSP. SAN BORTOLO,VEN,40-49,15,57,0,57,10,0,5,72,0,72,Veneto,ITH3
2021-01-10,PF/BT,5050801,MED.COMP. - OSP. SAN BORTOLO,VEN,50-59,24,68,0,73,13,0,6,92,0,92,Veneto,ITH3
2021-01-10,PF/BT,5050801,MED.COMP. - OSP. SAN BORTOLO,VEN,60-69,15,12,0,18,8,0,1,27,0,27,Veneto,ITH3
2021-01-10,PF/BT,5050801,MED.COMP. - OSP. SAN BORTOLO,VEN,70-79,2,1,0,3,0,0,0,3,0,3,Veneto,ITH3
2021-01-10,PF/BT,5050801,MED.COMP. - OSP. SAN BORTOLO,VEN,80-89,1,0,0,1,0,0,0,1,0,1,Veneto,ITH3
2021-01-10,PF/BT,50509,SAN BONIFACIO,VEN,20-29,5,8,0,8,5,0,0,13,0,13,Veneto,ITH3
2021-01-10,PF/BT,50509,SAN BONIFACIO,VEN,30-39,8,30,0,17,20,0,1,38,0,38,Veneto,ITH3
2021-01-10,PF/BT,50509,SAN BONIFACIO,VEN,40-49,12,34,0,19,27,0,0,46,0,46,Veneto,ITH3
2021-01-10,PF/BT,50509,SAN BONIFACIO,VEN,50-59,24,61,0,58,26,0,1,85,0,85,Veneto,ITH3
2021-01-10,PF/BT,50509,SAN BONIFACIO,VEN,60-69,27,24,0,42,9,0,0,51,0,51,Veneto,ITH3
2021-01-10,PF/BT,50509,SAN BONIFACIO,VEN,70-79,1,0,0,1,0,0,0,1,0,1,Veneto,ITH3
2021-01-10,PF/BT,50509,VILLAFRANCA,VEN,20-29,4,8,0,12,0,0,0,12,0,12,Veneto,ITH3
2021-01-10,PF/BT,50509,VILLAFRANCA,VEN,30-39,8,12,0,20,0,0,0,20,0,20,Veneto,ITH3
2021-01-10,PF/BT,50509,VILLAFRANCA,VEN,40-49,6,40,0,46,0,0,0,46,0,46,Veneto,ITH3
2021-01-10,PF/BT,50509,VILLAFRANCA,VEN,50-59,34,92,0,126,0,0,0,126,0,126,Veneto,ITH3
2021-01-10,PF/BT,50509,VILLAFRANCA,VEN,60-69,40,40,0,80,0,0,0,80,0,80,Veneto,ITH3
2021-01-10,PF/BT,50509,VILLAFRANCA,VEN,70-79,2,0,0,2,0,0,0,2,0,2,Veneto,ITH3
2021-01-10,PF/BT,609901,CASA DI CURA DI ABANO TERME - POLISPECIALISTICA E TERMALE SPA,VEN,20-29,6,29,0,35,0,0,0,35,0,35,Veneto,ITH3
2021-01-10,PF/BT,609901,CASA DI CURA DI ABANO TERME - POLISPECIALISTICA E TERMALE SPA,VEN,30-39,12,14,0,26,0,0,0,26,0,26,Veneto,ITH3
2021-01-10,PF/BT,609901,CASA DI CURA DI ABANO TERME - POLISPECIALISTICA E TERMALE SPA,VEN,40-49,3,14,0,17,0,0,0,17,0,17,Veneto,ITH3
2021-01-10,PF/BT,609901,CASA DI CURA DI ABANO TERME - POLISPECIALISTICA E TERMALE SPA,VEN,50-59,1,12,0,13,0,0,0,13,0,13,Veneto,ITH3
2021-01-10,PF/BT,609901,CASA DI CURA DI ABANO TERME - POLISPECIALISTICA E TERMALE SPA,VEN,60-69,6,1,0,7,0,0,0,7,0,7,Veneto,ITH3
2021-01-10,PF/BT,609901,CASA DI CURA DI ABANO TERME - POLISPECIALISTICA E TERMALE SPA,VEN,70-79,2,0,0,2,0,0,0,2,0,2,Veneto,ITH3
2021-01-10,PF/BT,610001,C.D.C. 'VILLA MARIA' Spa,VEN,20-29,10,18,0,28,0,0,0,28,0,28,Veneto,ITH3
2021-01-10,PF/BT,610001,C.D.C. 'VILLA MARIA' Spa,VEN,30-39,13,9,0,22,0,0,0,22,0,22,Veneto,ITH3
2021-01-10,PF/BT,610001,C.D.C. 'VILLA MARIA' Spa,VEN,40-49,10,24,0,34,0,0,0,34,0,34,Veneto,ITH3
2021-01-10,PF/BT,610001,C.D.C. 'VILLA MARIA' Spa,VEN,50-59,9,10,0,19,0,0,0,19,0,19,Veneto,ITH3
2021-01-10,PF/BT,610001,C.D.C. 'VILLA MARIA' Spa,VEN,60-69,2,5,0,7,0,0,0,7,0,7,Veneto,ITH3
2021-01-10,PF/BT,610001,C.D.C. 'VILLA MARIA' Spa,VEN,70-79,5,1,0,6,0,0,0,6,0,6,Veneto,ITH3
2021-01-10,PF/BT,610903,CASA DI CURA ABANO TERME SPA,VEN,20-29,5,2,0,7,0,0,0,7,0,7,Veneto,ITH3
2021-01-10,PF/BT,610903,CASA DI CURA ABANO TERME SPA,VEN,30-39,5,9,0,14,0,0,0,14,0,14,Veneto,ITH3
2021-01-10,PF/BT,610903,CASA DI CURA ABANO TERME SPA,VEN,40-49,4,12,0,16,0,0,0,16,0,16,Veneto,ITH3
2021-01-10,PF/BT,610903,CASA DI CURA ABANO TERME SPA,VEN,50-59,6,11,0,17,0,0,0,17,0,17,Veneto,ITH3
2021-01-10,PF/BT,610903,CASA DI CURA ABANO TERME SPA,VEN,60-69,3,3,0,6,0,0,0,6,0,6,Veneto,ITH3
2021-01-10,PF/BT,610903,CASA DI CURA ABANO TERME SPA,VEN,70-79,5,0,0,5,0,0,0,5,0,5,Veneto,ITH3
2021-01-10,PF/BT,610946,ALTAVITA IRA - CENTRO SERVIZI BEATO PELLEGRINO,VEN,30-39,0,1,0,1,0,0,0,1,0,1,Veneto,ITH3
2021-01-10,PF/BT,610946,ALTAVITA IRA - CENTRO SERVIZI BEATO PELLEGRINO,VEN,40-49,1,1,0,2,0,0,0,2,0,2,Veneto,ITH3
2021-01-10,PF/BT,610946,ALTAVITA IRA - CENTRO SERVIZI BEATO PELLEGRINO,VEN,50-59,1,3,0,3,1,0,0,4,0,4,Veneto,ITH3
2021-01-10,PF/BT,610946,ALTAVITA IRA - CENTRO SERVIZI BEATO PELLEGRINO,VEN,60-69,1,2,0,1,0,2,0,3,0,3,Veneto,ITH3
2021-01-10,PF/BT,610946,ALTAVITA IRA - CENTRO SERVIZI BEATO PELLEGRINO,VEN,70-79,1,3,0,0,0,4,0,4,0,4,Veneto,ITH3
2021-01-10,PF/BT,610946,ALTAVITA IRA - CENTRO SERVIZI BEATO PELLEGRINO,VEN,80-89,2,5,0,0,0,7,0,7,0,7,Veneto,ITH3
2021-01-10,PF/BT,610946,ALTAVITA IRA - CENTRO SERVIZI BEATO PELLEGRINO,VEN,90+,0,2,0,0,0,2,0,2,0,2,Veneto,ITH3
2021-01-10,PF/BT,610947,CONGR. SUORE CARITA' SS. CAPITANIO E GEROSA CASA DI RIPOSO MARIA BAMBINA,VEN,50-59,0,1,0,1,0,0,0,1,0,1,Veneto,ITH3
2021-01-10,PF/BT,610947,CONGR. SUORE CARITA' SS. CAPITANIO E GEROSA CASA DI RIPOSO MARIA BAMBINA,VEN,80-89,0,1,0,0,0,1,0,1,0,1,Veneto,ITH3
2021-01-10,PF/BT,610952,O.I.C. CENTRO NAZARETH,VEN,80-89,0,1,0,0,0,1,0,1,0,1,Veneto,ITH3
2021-01-10,PF/BT,610952,O.I.C. CENTRO NAZARETH,VEN,90+,0,3,0,0,0,3,0,3,0,3,Veneto,ITH3
2021-01-10,PF/BT,610959,S. MARCO SRL VILLA ALTICHIERO CASA DI RIPOSO,VEN,16-19,0,1,0,1,0,0,0,1,0,1,Veneto,ITH3
2021-01-10,PF/BT,610959,S. MARCO SRL VILLA ALTICHIERO CASA DI RIPOSO,VEN,20-29,6,3,0,8,1,0,0,9,0,9,Veneto,ITH3
2021-01-10,PF/BT,610959,S. MARCO SRL VILLA ALTICHIERO CASA DI RIPOSO,VEN,30-39,1,3,0,3,1,0,0,4,0,4,Veneto,ITH3
2021-01-10,PF/BT,610959,S. MARCO SRL VILLA ALTICHIERO CASA DI RIPOSO,VEN,40-49,6,6,0,7,4,1,0,12,0,12,Veneto,ITH3
2021-01-10,PF/BT,610959,S. MARCO SRL VILLA ALTICHIERO CASA DI RIPOSO,VEN,50-59,2,1,0,2,0,1,0,3,0,3,Veneto,ITH3
2021-01-10,PF/BT,610959,S. MARCO SRL VILLA ALTICHIERO CASA DI RIPOSO,VEN,60-69,4,5,0,0,0,9,0,9,0,9,Veneto,ITH3
2021-01-10,PF/BT,610959,S. MARCO SRL VILLA ALTICHIERO CASA DI RIPOSO,VEN,70-79,3,2,0,0,0,5,0,5,0,5,Veneto,ITH3
2021-01-10,PF/BT,610959,S. MARCO SRL VILLA ALTICHIERO CASA DI RIPOSO,VEN,80-89,3,3,0,0,0,6,0,6,0,6,Veneto,ITH3
2021-01-10,PF/BT,610959,S. MARCO SRL VILLA ALTICHIERO CASA DI RIPOSO,VEN,90+,0,3,0,0,0,3,0,3,0,3,Veneto,ITH3
2021-01-10,PF/BT,683013,IRAS IST. RODIGINO DI ASS. SOC,VEN,30-39,0,1,0,1,0,0,0,1,0,1,Veneto,ITH3
2021-01-10,PF/BT,683014,CASA SACRA FAMIGLIA FRATTA PO,VEN,20-29,4,9,0,8,1,0,4,13,0,13,Veneto,ITH3
2021-01-10,PF/BT,683014,CASA SACRA FAMIGLIA FRATTA PO,VEN,30-39,1,16,0,12,4,0,1,17,0,17,Veneto,ITH3
2021-01-10,PF/BT,683014,CASA SACRA FAMIGLIA FRATTA PO,VEN,40-49,9,31,0,24,6,0,10,40,0,40,Veneto,ITH3
2021-01-10,PF/BT,683014,CASA SACRA FAMIGLIA FRATTA PO,VEN,50-59,11,75,0,41,15,0,30,86,0,86,Veneto,ITH3
2021-01-10,PF/BT,683014,CASA SACRA FAMIGLIA FRATTA PO,VEN,60-69,0,36,0,5,2,4,25,36,0,36,Veneto,ITH3
2021-01-10,PF/BT,683014,CASA SACRA FAMIGLIA FRATTA PO,VEN,70-79,0,17,0,0,1,15,1,17,0,17,Veneto,ITH3
2021-01-10,PF/BT,683014,CASA SACRA FAMIGLIA FRATTA PO,VEN,80-89,0,13,0,0,1,12,0,13,0,13,Veneto,ITH3
2021-01-10,PF/BT,683014,CASA SACRA FAMIGLIA FRATTA PO,VEN,90+,0,10,0,0,0,10,0,10,0,10,Veneto,ITH3
2021-01-10,PF/BT,ANNSCHIO,CASA ANNUNZIATA - SCHIO,VEN,20-29,0,4,0,4,0,0,0,4,0,4,Veneto,ITH3
2021-01-10,PF/BT,ANNSCHIO,CASA ANNUNZIATA - SCHIO,VEN,30-39,0,4,0,2,2,0,0,4,0,4,Veneto,ITH3
2021-01-10,PF/BT,ANNSCHIO,CASA ANNUNZIATA - SCHIO,VEN,40-49,1,7,0,7,1,0,0,8,0,8,Veneto,ITH3
2021-01-10,PF/BT,ANNSCHIO,CASA ANNUNZIATA - SCHIO,VEN,50-59,2,3,0,4,1,0,0,5,0,5,Veneto,ITH3
2021-01-10,PF/BT,ANNSCHIO,CASA ANNUNZIATA - SCHIO,VEN,60-69,2,2,0,0,3,1,0,4,0,4,Veneto,ITH3
2021-01-10,PF/BT,ANNSCHIO,CASA ANNUNZIATA - SCHIO,VEN,70-79,0,1,0,0,0,1,0,1,0,1,Veneto,ITH3
2021-01-10,PF/BT,ANNSCHIO,CASA ANNUNZIATA - SCHIO,VEN,80-89,1,6,0,0,0,7,0,7,0,7,Veneto,ITH3
2021-01-10,PF/BT,ANNSCHIO,CASA ANNUNZIATA - SCHIO,VEN,90+,0,9,0,0,0,9,0,9,0,9,Veneto,ITH3
2021-01-11,PF/BT,0,Mancante,VEN,30-39,1,0,0,1,0,0,0,1,0,1,Veneto,ITH3
2021-01-11,PF/BT,0,Mancante,VEN,50-59,1,0,0,1,0,0,0,1,0,1,Veneto,ITH3
2021-01-11,PF/BT,132232,C.R. 'A. ROSSI' - ARSIERO,VEN,40-49,0,1,0,0,1,0,0,1,0,1,Veneto,ITH3
2021-01-11,PF/BT,132232,C.R. 'A. ROSSI' - ARSIERO,VEN,60-69,1,1,0,0,2,0,0,2,0,2,Veneto,ITH3
2021-01-11,PF/BT,162439,CASA DI RIPOSO SCALABRIN ARZIGNANO,VEN,20-29,1,0,0,1,0,0,0,1,0,1,Veneto,ITH3
2021-01-11,PF/BT,162441,CENTRO SERVIZI ASSISTENZIALI S. ANTONIO - CHIAMPO E ALTA VALLE,VEN,20-29,0,12,0,10,2,0,0,12,0,12,Veneto,ITH3
2021-01-11,PF/BT,162441,CENTRO SERVIZI ASSISTENZIALI S. ANTONIO - CHIAMPO E ALTA VALLE,VEN,30-39,1,19,0,18,2,0,0,20,0,20,Veneto,ITH3
2021-01-11,PF/BT,162441,CENTRO SERVIZI ASSISTENZIALI S. ANTONIO - CHIAMPO E ALTA VALLE,VEN,40-49,5,33,0,25,13,0,0,38,0,38,Veneto,ITH3
2021-01-11,PF/BT,162441,CENTRO SERVIZI ASSISTENZIALI S. ANTONIO - CHIAMPO E ALTA VALLE,VEN,50-59,3,34,0,23,12,2,0,37,0,37,Veneto,ITH3
2021-01-11,PF/BT,162441,CENTRO SERVIZI ASSISTENZIALI S. ANTONIO - CHIAMPO E ALTA VALLE,VEN,60-69,16,8,0,2,12,10,0,24,0,24,Veneto,ITH3
2021-01-11,PF/BT,162441,CENTRO SERVIZI ASSISTENZIALI S. ANTONIO - CHIAMPO E ALTA VALLE,VEN,70-79,11,9,0,0,1,19,0,20,0,20,Veneto,ITH3
2021-01-11,PF/BT,162441,CENTRO SERVIZI ASSISTENZIALI S. ANTONIO - CHIAMPO E ALTA VALLE,VEN,80-89,13,35,0,0,1,47,0,48,0,48,Veneto,ITH3
2021-01-11,PF/BT,162441,CENTRO SERVIZI ASSISTENZIALI S. ANTONIO - CHIAMPO E ALTA VALLE,VEN,90+,5,27,0,0,0,32,0,32,0,32,Veneto,ITH3
2021-01-11,PF/BT,162449,CASA DI RIPOSO F. MARZOTTO VALDAGNO,VEN,20-29,3,18,0,21,0,0,0,21,0,21,Veneto,ITH3
2021-01-11,PF/BT,162449,CASA DI RIPOSO F. MARZOTTO VALDAGNO,VEN,30-39,1,11,0,11,1,0,0,12,0,12,Veneto,ITH3
2021-01-11,PF/BT,162449,CASA DI RIPOSO F. MARZOTTO VALDAGNO,VEN,40-49,0,22,0,19,3,0,0,22,0,22,Veneto,ITH3
2021-01-11,PF/BT,162449,CASA DI RIPOSO F. MARZOTTO VALDAGNO,VEN,50-59,3,31,0,22,11,1,0,34,0,34,Veneto,ITH3
2021-01-11,PF/BT,162449,CASA DI RIPOSO F. MARZOTTO VALDAGNO,VEN,60-69,0,6,0,0,3,3,0,6,0,6,Veneto,ITH3
2021-01-11,PF/BT,162449,CASA DI RIPOSO F. MARZOTTO VALDAGNO,VEN,70-79,5,8,0,0,0,13,0,13,0,13,Veneto,ITH3
2021-01-11,PF/BT,162449,CASA DI RIPOSO F. MARZOTTO VALDAGNO,VEN,80-89,9,28,0,0,0,37,0,37,0,37,Veneto,ITH3
2021-01-11,PF/BT,162449,CASA DI RIPOSO F. MARZOTTO VALDAGNO,VEN,90+,2,38,0,0,0,40,0,40,0,40,Veneto,ITH3
2021-01-11,PF/BT,208012,CASA DI RIPOSO ORAZIO LAMPERTICO,VEN,20-29,2,2,0,3,1,0,0,4,0,4,Veneto,ITH3
2021-01-11,PF/BT,208012,CASA DI RIPOSO ORAZIO LAMPERTICO,VEN,30-39,0,3,0,3,0,0,0,3,0,3,Veneto,ITH3
2021-01-11,PF/BT,208012,CASA DI RIPOSO ORAZIO LAMPERTICO,VEN,40-49,0,8,0,5,3,0,0,8,0,8,Veneto,ITH3
2021-01-11,PF/BT,208012,CASA DI RIPOSO ORAZIO LAMPERTICO,VEN,50-59,3,14,0,9,8,0,0,17,0,17,Veneto,ITH3
2021-01-11,PF/BT,208012,CASA DI RIPOSO ORAZIO LAMPERTICO,VEN,60-69,1,6,0,2,3,2,0,7,0,7,Veneto,ITH3
2021-01-11,PF/BT,208012,CASA DI RIPOSO ORAZIO LAMPERTICO,VEN,70-79,5,4,0,0,1,8,0,9,0,9,Veneto,ITH3
2021-01-11,PF/BT,208012,CASA DI RIPOSO ORAZIO LAMPERTICO,VEN,80-89,1,11,0,0,0,12,0,12,0,12,Veneto,ITH3
2021-01-11,PF/BT,208012,CASA DI RIPOSO ORAZIO LAMPERTICO,VEN,90+,0,5,0,0,0,5,0,5,0,5,Veneto,ITH3
2021-01-11,PF/BT,208019,IPAB - RESIDENZA TRENTO,VEN,20-29,6,1,0,6,0,1,0,7,0,7,Veneto,ITH3
2021-01-11,PF/BT,208019,IPAB - RESIDENZA TRENTO,VEN,30-39,1,6,0,4,2,1,0,7,0,7,Veneto,ITH3
2021-01-11,PF/BT,208019,IPAB - RESIDENZA TRENTO,VEN,40-49,7,30,0,27,8,2,0,37,0,37,Veneto,ITH3
2021-01-11,PF/BT,208019,IPAB - RESIDENZA TRENTO,VEN,50-59,16,46,0,33,24,5,0,62,0,62,Veneto,ITH3
2021-01-11,PF/BT,208019,IPAB - RESIDENZA TRENTO,VEN,60-69,8,9,0,8,3,6,0,17,0,17,Veneto,ITH3
2021-01-11,PF/BT,208019,IPAB - RESIDENZA TRENTO,VEN,70-79,5,4,0,0,1,8,0,9,0,9,Veneto,ITH3
2021-01-11,PF/BT,208019,IPAB - RESIDENZA TRENTO,VEN,80-89,2,23,0,0,3,22,0,25,0,25,Veneto,ITH3
2021-01-11,PF/BT,208019,IPAB - RESIDENZA TRENTO,VEN,90+,1,23,0,0,0,24,0,24,0,24,Veneto,ITH3
2021-01-11,PF/BT,244077,CENTRO DI SERVIZI RESIDENZIALI 'ISTITUTO PADRE PIO' - TARZO,VEN,20-29,3,5,0,8,0,0,0,8,0,8,Veneto,ITH3
2021-01-11,PF/BT,244077,CENTRO DI SERVIZI RESIDENZIALI 'ISTITUTO PADRE PIO' - TARZO,VEN,30-39,2,9,0,7,4,0,0,11,0,11,Veneto,ITH3
2021-01-11,PF/BT,244077,CENTRO DI SERVIZI RESIDENZIALI 'ISTITUTO PADRE PIO' - TARZO,VEN,40-49,1,17,0,9,9,0,0,18,0,18,Veneto,ITH3
2021-01-11,PF/BT,244077,CENTRO DI SERVIZI RESIDENZIALI 'ISTITUTO PADRE PIO' - TARZO,VEN,50-59,2,25,0,23,2,2,0,27,0,27,Veneto,ITH3
2021-01-11,PF/BT,244077,CENTRO DI SERVIZI RESIDENZIALI 'ISTITUTO PADRE PIO' - TARZO,VEN,60-69,4,4,0,3,0,5,0,8,0,8,Veneto,ITH3
2021-01-11,PF/BT,244077,CENTRO DI SERVIZI RESIDENZIALI 'ISTITUTO PADRE PIO' - TARZO,VEN,70-79,8,5,0,0,0,13,0,13,0,13,Veneto,ITH3
2021-01-11,PF/BT,244077,CENTRO DI SERVIZI RESIDENZIALI 'ISTITUTO PADRE PIO' - TARZO,VEN,80-89,8,22,0,0,0,30,0,30,0,30,Veneto,ITH3
2021-01-11,PF/BT,244077,CENTRO DI SERVIZI RESIDENZIALI 'ISTITUTO PADRE PIO' - TARZO,VEN,90+,3,14,0,0,0,17,0,17,0,17,Veneto,ITH3
2021-01-11,PF/BT,284003,"CENTRO DI SERVIZI RESIDENZIALE ""VILLA FIORITA"" CORNUDA",VEN,20-29,0,2,0,0,2,0,0,2,0,2,Veneto,ITH3
2021-01-11,PF/BT,284003,"CENTRO DI SERVIZI RESIDENZIALE ""VILLA FIORITA"" CORNUDA",VEN,30-39,1,4,0,3,2,0,0,5,0,5,Veneto,ITH3
2021-01-11,PF/BT,284003,"CENTRO DI SERVIZI RESIDENZIALE ""VILLA FIORITA"" CORNUDA",VEN,40-49,1,7,0,5,3,0,0,8,0,8,Veneto,ITH3
2021-01-11,PF/BT,284003,"CENTRO DI SERVIZI RESIDENZIALE ""VILLA FIORITA"" CORNUDA",VEN,50-59,1,10,0,8,3,0,0,11,0,11,Veneto,ITH3
2021-01-11,PF/BT,284003,"CENTRO DI SERVIZI RESIDENZIALE ""VILLA FIORITA"" CORNUDA",VEN,60-69,1,2,0,2,1,0,0,3,0,3,Veneto,ITH3
2021-01-11,PF/BT,284007,"CENTRO DI SERVIZI RESIDENZIALE ""OPERE PIE D'ONIGO"" PEDEROBBA",VEN,20-29,0,1,0,0,1,0,0,1,0,1,Veneto,ITH3
2021-01-11,PF/BT,284007,"CENTRO DI SERVIZI RESIDENZIALE ""OPERE PIE D'ONIGO"" PEDEROBBA",VEN,30-39,1,4,0,5,0,0,0,5,0,5,Veneto,ITH3
2021-01-11,PF/BT,284007,"CENTRO DI SERVIZI RESIDENZIALE ""OPERE PIE D'ONIGO"" PEDEROBBA",VEN,40-49,1,6,0,7,0,0,0,7,0,7,Veneto,ITH3
2021-01-11,PF/BT,284007,"CENTRO DI SERVIZI RESIDENZIALE ""OPERE PIE D'ONIGO"" PEDEROBBA",VEN,50-59,2,10,0,10,2,0,0,12,0,12,Veneto,ITH3
2021-01-11,PF/BT,284007,"CENTRO DI SERVIZI RESIDENZIALE ""OPERE PIE D'ONIGO"" PEDEROBBA",VEN,60-69,0,1,0,1,0,0,0,1,0,1,Veneto,ITH3
2021-01-11,PF/BT,323129,"CENTRO DI SERVIZI RESIDENZIALE ""GINO E PIERINA MARANI"" - VILLORBA",VEN,20-29,1,1,0,2,0,0,0,2,0,2,Veneto,ITH3
2021-01-11,PF/BT,323129,"CENTRO DI SERVIZI RESIDENZIALE ""GINO E PIERINA MARANI"" - VILLORBA",VEN,30-39,0,2,0,2,0,0,0,2,0,2,Veneto,ITH3
2021-01-11,PF/BT,323129,"CENTRO DI SERVIZI RESIDENZIALE ""GINO E PIERINA MARANI"" - VILLORBA",VEN,40-49,1,3,0,4,0,0,0,4,0,4,Veneto,ITH3
2021-01-11,PF/BT,323129,"CENTRO DI SERVIZI RESIDENZIALE ""GINO E PIERINA MARANI"" - VILLORBA",VEN,50-59,0,6,0,3,3,0,0,6,0,6,Veneto,ITH3
2021-01-11,PF/BT,323129,"CENTRO DI SERVIZI RESIDENZIALE ""GINO E PIERINA MARANI"" - VILLORBA",VEN,60-69,3,8,0,1,0,9,1,11,0,11,Veneto,ITH3
2021-01-11,PF/BT,323129,"CENTRO DI SERVIZI RESIDENZIALE ""GINO E PIERINA MARANI"" - VILLORBA",VEN,70-79,10,16,0,0,0,26,0,26,0,26,Veneto,ITH3
2021-01-11,PF/BT,323129,"CENTRO DI SERVIZI RESIDENZIALE ""GINO E PIERINA MARANI"" - VILLORBA",VEN,80-89,12,61,0,0,0,73,0,73,0,73,Veneto,ITH3
2021-01-11,PF/BT,323129,"CENTRO DI SERVIZI RESIDENZIALE ""GINO E PIERINA MARANI"" - VILLORBA",VEN,90+,6,59,0,0,0,65,0,65,0,65,Veneto,ITH3
2021-01-11,PF/BT,323234,"CENTRO DI SERVIZI RESIDENZIALE ""RESIDENZA GIANNI MARIN"" - PONTE DI PIAVE",VEN,20-29,2,1,0,2,1,0,0,3,0,3,Veneto,ITH3
2021-01-11,PF/BT,323234,"CENTRO DI SERVIZI RESIDENZIALE ""RESIDENZA GIANNI MARIN"" - PONTE DI PIAVE",VEN,30-39,0,6,0,4,2,0,0,6,0,6,Veneto,ITH3
2021-01-11,PF/BT,323234,"CENTRO DI SERVIZI RESIDENZIALE ""RESIDENZA GIANNI MARIN"" - PONTE DI PIAVE",VEN,40-49,2,15,0,16,1,0,0,17,0,17,Veneto,ITH3
2021-01-11,PF/BT,323234,"CENTRO DI SERVIZI RESIDENZIALE ""RESIDENZA GIANNI MARIN"" - PONTE DI PIAVE",VEN,50-59,4,18,0,16,5,1,0,22,0,22,Veneto,ITH3
2021-01-11,PF/BT,323234,"CENTRO DI SERVIZI RESIDENZIALE ""RESIDENZA GIANNI MARIN"" - PONTE DI PIAVE",VEN,60-69,10,9,0,2,5,12,0,19,0,19,Veneto,ITH3
2021-01-11,PF/BT,323234,"CENTRO DI SERVIZI RESIDENZIALE ""RESIDENZA GIANNI MARIN"" - PONTE DI PIAVE",VEN,70-79,9,6,0,0,0,15,0,15,0,15,Veneto,ITH3
2021-01-11,PF/BT,323234,"CENTRO DI SERVIZI RESIDENZIALE ""RESIDENZA GIANNI MARIN"" - PONTE DI PIAVE",VEN,80-89,6,19,0,0,0,25,0,25,0,25,Veneto,ITH3
2021-01-11,PF/BT,323234,"CENTRO DI SERVIZI RESIDENZIALE ""RESIDENZA GIANNI MARIN"" - PONTE DI PIAVE",VEN,90+,0,17,0,0,0,17,0,17,0,17,Veneto,ITH3
2021-01-11,PF/BT,323611,"CENTRO DI SERVIZI RESIDENZIALE ""RESIDENZE PER ANZIANI CITTÂ¿ DI TREVISO"" - TREVISO",VEN,20-29,5,8,0,11,2,0,0,13,0,13,Veneto,ITH3
2021-01-11,PF/BT,323611,"CENTRO DI SERVIZI RESIDENZIALE ""RESIDENZE PER ANZIANI CITTÂ¿ DI TREVISO"" - TREVISO",VEN,30-39,6,22,0,22,6,0,0,28,0,28,Veneto,ITH3
2021-01-11,PF/BT,323611,"CENTRO DI SERVIZI RESIDENZIALE ""RESIDENZE PER ANZIANI CITTÂ¿ DI TREVISO"" - TREVISO",VEN,40-49,9,41,0,39,11,0,0,50,0,50,Veneto,ITH3
2021-01-11,PF/BT,323611,"CENTRO DI SERVIZI RESIDENZIALE ""RESIDENZE PER ANZIANI CITTÂ¿ DI TREVISO"" - TREVISO",VEN,50-59,13,57,0,47,23,0,0,70,0,70,Veneto,ITH3
2021-01-11,PF/BT,323611,"CENTRO DI SERVIZI RESIDENZIALE ""RESIDENZE PER ANZIANI CITTÂ¿ DI TREVISO"" - TREVISO",VEN,60-69,3,15,0,11,7,0,0,18,0,18,Veneto,ITH3
2021-01-11,PF/BT,323611,"CENTRO DI SERVIZI RESIDENZIALE ""RESIDENZE PER ANZIANI CITTÂ¿ DI TREVISO"" - TREVISO",VEN,80-89,1,0,0,1,0,0,0,1,0,1,Veneto,ITH3
2021-01-11,PF/BT,323703,"CENTRO DI SERVIZI RESIDENZIALE ""CASA LUIGI E AUGUSTA"" - ORMELLE",VEN,20-29,0,1,0,1,0,0,0,1,0,1,Veneto,ITH3
2021-01-11,PF/BT,363705,CASA DI RIPOSO 'DON MOSCHETTA',VEN,20-29,0,6,0,6,0,0,0,6,0,6,Veneto,ITH3
2021-01-11,PF/BT,363705,CASA DI RIPOSO 'DON MOSCHETTA',VEN,30-39,5,4,0,4,5,0,0,9,0,9,Veneto,ITH3
2021-01-11,PF/BT,363705,CASA DI RIPOSO 'DON MOSCHETTA',VEN,40-49,3,24,0,17,10,0,0,27,0,27,Veneto,ITH3
2021-01-11,PF/BT,363705,CASA DI RIPOSO 'DON MOSCHETTA',VEN,50-59,2,8,0,6,4,0,0,10,0,10,Veneto,ITH3
2021-01-11,PF/BT,363705,CASA DI RIPOSO 'DON MOSCHETTA',VEN,60-69,3,6,0,6,3,0,0,9,0,9,Veneto,ITH3
2021-01-11,PF/BT,363705,CASA DI RIPOSO 'DON MOSCHETTA',VEN,70-79,2,3,0,0,1,4,0,5,0,5,Veneto,ITH3
2021-01-11,PF/BT,363705,CASA DI RIPOSO 'DON MOSCHETTA',VEN,80-89,5,11,0,0,1,15,0,16,0,16,Veneto,ITH3
2021-01-11,PF/BT,363705,CASA DI RIPOSO 'DON MOSCHETTA',VEN,90+,0,7,0,0,0,7,0,7,0,7,Veneto,ITH3
2021-01-11,PF/BT,42821,CASA DI RIPOSO DI LENTIAI - C.S.A. 'ROSA ED ETTORE MIONE',VEN,60-69,0,1,0,0,0,1,0,1,0,1,Veneto,ITH3
2021-01-11,PF/BT,42821,CASA DI RIPOSO DI LENTIAI - C.S.A. 'ROSA ED ETTORE MIONE',VEN,70-79,0,1,0,0,0,1,0,1,0,1,Veneto,ITH3
2021-01-11,PF/BT,42821,CASA DI RIPOSO DI LENTIAI - C.S.A. 'ROSA ED ETTORE MIONE',VEN,80-89,0,4,0,0,0,4,0,4,0,4,Veneto,ITH3
2021-01-11,PF/BT,42828,C.S.A. 'MADONNA DELLA SALUTE',VEN,20-29,2,5,0,7,0,0,0,7,0,7,Veneto,ITH3
2021-01-11,PF/BT,42828,C.S.A. 'MADONNA DELLA SALUTE',VEN,30-39,1,2,0,1,2,0,0,3,0,3,Veneto,ITH3
2021-01-11,PF/BT,42828,C.S.A. 'MADONNA DELLA SALUTE',VEN,40-49,3,5,0,5,3,0,0,8,0,8,Veneto,ITH3
2021-01-11,PF/BT,42828,C.S.A. 'MADONNA DELLA SALUTE',VEN,50-59,1,11,0,8,2,2,0,12,0,12,Veneto,ITH3
2021-01-11,PF/BT,42828,C.S.A. 'MADONNA DELLA SALUTE',VEN,60-69,0,1,0,1,0,0,0,1,0,1,Veneto,ITH3
2021-01-11,PF/BT,42828,C.S.A. 'MADONNA DELLA SALUTE',VEN,70-79,3,4,0,0,0,7,0,7,0,7,Veneto,ITH3
2021-01-11,PF/BT,42828,C.S.A. 'MADONNA DELLA SALUTE',VEN,80-89,8,25,0,0,0,33,0,33,0,33,Veneto,ITH3
2021-01-11,PF/BT,42828,C.S.A. 'MADONNA DELLA SALUTE',VEN,90+,2,17,0,0,0,19,0,19,0,19,Veneto,ITH3
2021-01-11,PF/BT,440101,POLIAMB. OSPEDALE VILLA SALUS,VEN,20-29,0,8,0,7,1,0,0,8,0,8,Veneto,ITH3
2021-01-11,PF/BT,440101,POLIAMB. OSPEDALE VILLA SALUS,VEN,30-39,2,7,0,3,6,0,0,9,0,9,Veneto,ITH3
2021-01-11,PF/BT,440101,POLIAMB. OSPEDALE VILLA SALUS,VEN,40-49,3,10,0,7,6,0,0,13,0,13,Veneto,ITH3
2021-01-11,PF/BT,440101,POLIAMB. OSPEDALE VILLA SALUS,VEN,50-59,3,15,0,4,14,0,0,18,0,18,Veneto,ITH3
2021-01-11,PF/BT,440101,POLIAMB. OSPEDALE VILLA SALUS,VEN,60-69,6,3,0,3,6,0,0,9,0,9,Veneto,ITH3
2021-01-11,PF/BT,440101,POLIAMB. OSPEDALE VILLA SALUS,VEN,70-79,0,2,0,2,0,0,0,2,0,2,Veneto,ITH3
2021-01-11,PF/BT,440101,POLIAMB. OSPEDALE VILLA SALUS,VEN,80-89,0,2,0,1,1,0,0,2,0,2,Veneto,ITH3
2021-01-11,PF/BT,441801,POLIAMB. OSPEDALE SAN MARCO,VEN,20-29,1,0,0,1,0,0,0,1,0,1,Veneto,ITH3
2021-01-11,PF/BT,441801,POLIAMB. OSPEDALE SAN MARCO,VEN,40-49,1,1,0,2,0,0,0,2,0,2,Veneto,ITH3
2021-01-11,PF/BT,441801,POLIAMB. OSPEDALE SAN MARCO,VEN,50-59,1,0,0,1,0,0,0,1,0,1,Veneto,ITH3
2021-01-11,PF/BT,441801,POLIAMB. OSPEDALE SAN MARCO,VEN,70-79,2,0,0,2,0,0,0,2,0,2,Veneto,ITH3
2021-01-11,PF/BT,445325,C. SERV.RES.ANZ.-S.LORENZO,VEN,40-49,0,3,0,3,0,0,0,3,0,3,Veneto,ITH3
2021-01-11,PF/BT,445325,C. SERV.RES.ANZ.-S.LORENZO,VEN,50-59,1,8,0,3,5,1,0,9,0,9,Veneto,ITH3
2021-01-11,PF/BT,445325,C. SERV.RES.ANZ.-S.LORENZO,VEN,60-69,2,2,0,3,0,1,0,4,0,4,Veneto,ITH3
2021-01-11,PF/BT,445325,C. SERV.RES.ANZ.-S.LORENZO,VEN,70-79,0,5,0,0,0,5,0,5,0,5,Veneto,ITH3
2021-01-11,PF/BT,445325,C. SERV.RES.ANZ.-S.LORENZO,VEN,80-89,1,10,0,0,0,11,0,11,0,11,Veneto,ITH3
2021-01-11,PF/BT,445325,C. SERV.RES.ANZ.-S.LORENZO,VEN,90+,2,7,0,0,0,9,0,9,0,9,Veneto,ITH3
2021-01-11,PF/BT,445328,C. SERV.RES.ANZ.-COTTOLENGO,VEN,40-49,0,2,0,2,0,0,0,2,0,2,Veneto,ITH3
2021-01-11,PF/BT,445328,C. SERV.RES.ANZ.-COTTOLENGO,VEN,50-59,0,2,0,2,0,0,0,2,0,2,Veneto,ITH3
2021-01-11,PF/BT,445328,C. SERV.RES.ANZ.-COTTOLENGO,VEN,60-69,0,2,0,2,0,0,0,2,0,2,Veneto,ITH3
2021-01-11,PF/BT,445371,C. SERV.RES.ANZ.-ANNI AZZ.FAVARO,VEN,20-29,0,1,0,1,0,0,0,1,0,1,Veneto,ITH3
2021-01-11,PF/BT,445371,C. SERV.RES.ANZ.-ANNI AZZ.FAVARO,VEN,30-39,0,4,0,2,2,0,0,4,0,4,Veneto,ITH3
2021-01-11,PF/BT,445371,C. SERV.RES.ANZ.-ANNI AZZ.FAVARO,VEN,40-49,0,2,0,1,1,0,0,2,0,2,Veneto,ITH3
2021-01-11,PF/BT,445371,C. SERV.RES.ANZ.-ANNI AZZ.FAVARO,VEN,50-59,0,2,0,0,1,1,0,2,0,2,Veneto,ITH3
2021-01-11,PF/BT,445371,C. SERV.RES.ANZ.-ANNI AZZ.FAVARO,VEN,60-69,0,2,0,0,0,2,0,2,0,2,Veneto,ITH3
2021-01-11,PF/BT,445371,C. SERV.RES.ANZ.-ANNI AZZ.FAVARO,VEN,70-79,3,1,0,0,0,4,0,4,0,4,Veneto,ITH3
2021-01-11,PF/BT,445371,C. SERV.RES.ANZ.-ANNI AZZ.FAVARO,VEN,80-89,4,17,0,0,0,21,0,21,0,21,Veneto,ITH3
2021-01-11,PF/BT,445371,C. SERV.RES.ANZ.-ANNI AZZ.FAVARO,VEN,90+,1,10,0,0,0,11,0,11,0,11,Veneto,ITH3
2021-01-11,PF/BT,445385,C. SERV.RES.ANZ.-CONTARINI IRE,VEN,60-69,1,0,0,0,0,1,0,1,0,1,Veneto,ITH3
2021-01-11,PF/BT,445385,C. SERV.RES.ANZ.-CONTARINI IRE,VEN,80-89,2,0,0,0,0,2,0,2,0,2,Veneto,ITH3
2021-01-11,PF/BT,445385,C. SERV.RES.ANZ.-CONTARINI IRE,VEN,90+,0,3,0,0,0,3,0,3,0,3,Veneto,ITH3
2021-01-11,PF/BT,445388,C. SERV.RES.ANZ.-ZITELLE,VEN,20-29,2,1,0,1,0,0,2,3,0,3,Veneto,ITH3
2021-01-11,PF/BT,445388,C. SERV.RES.ANZ.-ZITELLE,VEN,30-39,0,2,0,1,0,0,1,2,0,2,Veneto,ITH3
2021-01-11,PF/BT,445388,C. SERV.RES.ANZ.-ZITELLE,VEN,40-49,1,4,0,2,0,0,3,5,0,5,Veneto,ITH3
2021-01-11,PF/BT,445388,C. SERV.RES.ANZ.-ZITELLE,VEN,50-59,4,6,0,4,0,0,6,10,0,10,Veneto,ITH3
2021-01-11,PF/BT,445388,C. SERV.RES.ANZ.-ZITELLE,VEN,60-69,0,4,0,1,0,0,3,4,0,4,Veneto,ITH3
2021-01-11,PF/BT,445438,S.V.P. CENTRO SERV. ANTICA SCUOLA DEI BATTUTI,VEN,20-29,1,0,0,1,0,0,0,1,0,1,Veneto,ITH3
2021-01-11,PF/BT,445438,S.V.P. CENTRO SERV. ANTICA SCUOLA DEI BATTUTI,VEN,30-39,2,3,0,5,0,0,0,5,0,5,Veneto,ITH3
2021-01-11,PF/BT,445438,S.V.P. CENTRO SERV. ANTICA SCUOLA DEI BATTUTI,VEN,40-49,1,5,0,5,1,0,0,6,0,6,Veneto,ITH3
2021-01-11,PF/BT,445438,S.V.P. CENTRO SERV. ANTICA SCUOLA DEI BATTUTI,VEN,50-59,4,10,0,10,4,0,0,14,0,14,Veneto,ITH3
2021-01-11,PF/BT,445438,S.V.P. CENTRO SERV. ANTICA SCUOLA DEI BATTUTI,VEN,60-69,2,6,0,6,2,0,0,8,0,8,Veneto,ITH3
2021-01-11,PF/BT,445438,S.V.P. CENTRO SERV. ANTICA SCUOLA DEI BATTUTI,VEN,80-89,0,1,0,0,0,1,0,1,0,1,Veneto,ITH3
2021-01-11,PF/BT,445440,C. SERV.RES.ANZ.- IRE SAN GIOBBE,VEN,20-29,0,1,0,1,0,0,0,1,0,1,Veneto,ITH3
2021-01-11,PF/BT,445440,C. SERV.RES.ANZ.- IRE SAN GIOBBE,VEN,30-39,0,3,0,2,1,0,0,3,0,3,Veneto,ITH3
2021-01-11,PF/BT,445440,C. SERV.RES.ANZ.- IRE SAN GIOBBE,VEN,40-49,1,5,0,2,4,0,0,6,0,6,Veneto,ITH3
2021-01-11,PF/BT,445440,C. SERV.RES.ANZ.- IRE SAN GIOBBE,VEN,50-59,2,5,0,4,2,1,0,7,0,7,Veneto,ITH3
2021-01-11,PF/BT,445440,C. SERV.RES.ANZ.- IRE SAN GIOBBE,VEN,60-69,0,1,0,1,0,0,0,1,0,1,Veneto,ITH3
2021-01-11,PF/BT,445440,C. SERV.RES.ANZ.- IRE SAN GIOBBE,VEN,80-89,0,4,0,0,0,4,0,4,0,4,Veneto,ITH3
2021-01-11,PF/BT,445440,C. SERV.RES.ANZ.- IRE SAN GIOBBE,VEN,90+,0,8,0,0,0,8,0,8,0,8,Veneto,ITH3
2021-01-11,PF/BT,486006,CASA DI RIPOSO - STRA,VEN,50-59,0,1,0,0,0,1,0,1,0,1,Veneto,ITH3
2021-01-11,PF/BT,486006,CASA DI RIPOSO - STRA,VEN,60-69,3,2,0,0,0,5,0,5,0,5,Veneto,ITH3
2021-01-11,PF/BT,486006,CASA DI RIPOSO - STRA,VEN,70-79,8,3,0,0,0,11,0,11,0,11,Veneto,ITH3
2021-01-11,PF/BT,486006,CASA DI RIPOSO - STRA,VEN,80-89,7,30,0,0,0,37,0,37,0,37,Veneto,ITH3
2021-01-11,PF/BT,486006,CASA DI RIPOSO - STRA,VEN,90+,2,16,0,0,0,18,0,18,0,18,Veneto,ITH3
2021-01-11,PF/BT,486010,CASA DI RIPOSO 'ANNI SERENI' - SCORZE',VEN,20-29,1,3,0,3,1,0,0,4,0,4,Veneto,ITH3
2021-01-11,PF/BT,486010,CASA DI RIPOSO 'ANNI SERENI' - SCORZE',VEN,30-39,0,5,0,3,2,0,0,5,0,5,Veneto,ITH3
2021-01-11,PF/BT,486010,CASA DI RIPOSO 'ANNI SERENI' - SCORZE',VEN,40-49,1,7,0,4,4,0,0,8,0,8,Veneto,ITH3
2021-01-11,PF/BT,486010,CASA DI RIPOSO 'ANNI SERENI' - SCORZE',VEN,50-59,2,12,0,7,7,0,0,14,0,14,Veneto,ITH3
2021-01-11,PF/BT,486010,CASA DI RIPOSO 'ANNI SERENI' - SCORZE',VEN,60-69,1,4,0,0,5,0,0,5,0,5,Veneto,ITH3
2021-01-11,PF/BT,5001700,OSPEDALE SACRO CUORE DI NEGRAR,VEN,40-49,0,1,0,0,1,0,0,1,0,1,Veneto,ITH3
2021-01-11,PF/BT,5001700,OSPEDALE SACRO CUORE DI NEGRAR,VEN,50-59,3,0,0,0,3,0,0,3,0,3,Veneto,ITH3
2021-01-11,PF/BT,5002200,OSPEDALE P. PEDERZOLI,VEN,20-29,2,10,0,12,0,0,0,12,0,12,Veneto,ITH3
2021-01-11,PF/BT,5002200,OSPEDALE P. PEDERZOLI,VEN,30-39,7,13,0,20,0,0,0,20,0,20,Veneto,ITH3
2021-01-11,PF/BT,5002200,OSPEDALE P. PEDERZOLI,VEN,40-49,3,17,0,20,0,0,0,20,0,20,Veneto,ITH3
2021-01-11,PF/BT,5002200,OSPEDALE P. PEDERZOLI,VEN,50-59,5,17,0,22,0,0,0,22,0,22,Veneto,ITH3
2021-01-11,PF/BT,5002200,OSPEDALE P. PEDERZOLI,VEN,60-69,6,2,0,8,0,0,0,8,0,8,Veneto,ITH3
2021-01-11,PF/BT,5017,CASA DI RIPOSO VILLA 'DON G.CECCON',VEN,20-29,1,1,0,2,0,0,0,2,0,2,Veneto,ITH3
2021-01-11,PF/BT,5017,CASA DI RIPOSO VILLA 'DON G.CECCON',VEN,40-49,0,1,0,1,0,0,0,1,0,1,Veneto,ITH3
2021-01-11,PF/BT,50501,AGORDO - SERVIZIO IGIENE,VEN,20-29,3,3,0,4,2,0,0,6,0,6,Veneto,ITH3
2021-01-11,PF/BT,50501,AGORDO - SERVIZIO IGIENE,VEN,30-39,3,1,0,3,1,0,0,4,0,4,Veneto,ITH3
2021-01-11,PF/BT,50501,AGORDO - SERVIZIO IGIENE,VEN,40-49,3,12,0,9,5,1,0,15,0,15,Veneto,ITH3
2021-01-11,PF/BT,50501,AGORDO - SERVIZIO IGIENE,VEN,50-59,2,13,0,8,7,0,0,15,0,15,Veneto,ITH3
2021-01-11,PF/BT,50501,AGORDO - SERVIZIO IGIENE,VEN,60-69,1,3,0,0,0,4,0,4,0,4,Veneto,ITH3
2021-01-11,PF/BT,50501,AGORDO - SERVIZIO IGIENE,VEN,70-79,6,3,0,1,1,7,0,9,0,9,Veneto,ITH3
2021-01-11,PF/BT,50501,AGORDO - SERVIZIO IGIENE,VEN,80-89,7,14,0,0,0,21,0,21,0,21,Veneto,ITH3
2021-01-11,PF/BT,50501,AGORDO - SERVIZIO IGIENE,VEN,90+,0,11,0,0,0,11,0,11,0,11,Veneto,ITH3
2021-01-11,PF/BT,50501,"BELLUNO ""DRIVE-IN""",VEN,20-29,0,4,0,3,1,0,0,4,0,4,Veneto,ITH3
2021-01-11,PF/BT,50501,"BELLUNO ""DRIVE-IN""",VEN,30-39,6,14,0,14,6,0,0,20,0,20,Veneto,ITH3
2021-01-11,PF/BT,50501,"BELLUNO ""DRIVE-IN""",VEN,40-49,5,20,0,17,8,0,0,25,0,25,Veneto,ITH3
2021-01-11,PF/BT,50501,"BELLUNO ""DRIVE-IN""",VEN,50-59,6,31,0,22,15,0,0,37,0,37,Veneto,ITH3
2021-01-11,PF/BT,50501,"BELLUNO ""DRIVE-IN""",VEN,60-69,5,13,0,12,6,0,0,18,0,18,Veneto,ITH3
2021-01-11,PF/BT,50501,BELLUNO AMBULATORIO N.15,VEN,70-79,0,1,0,0,0,0,1,1,0,1,Veneto,ITH3
2021-01-11,PF/BT,50501,BELLUNO AMBULATORIO N.15,VEN,80-89,100,114,0,1,0,0,213,214,0,214,Veneto,ITH3
2021-01-11,PF/BT,50501,BELLUNO AMBULATORIO N.15,VEN,90+,15,17,0,0,0,0,32,32,0,32,Veneto,ITH3
2021-01-11,PF/BT,50501,FELTRE,VEN,20-29,1,7,0,6,2,0,0,8,0,8,Veneto,ITH3
2021-01-11,PF/BT,50501,FELTRE,VEN,30-39,0,4,0,2,2,0,0,4,0,4,Veneto,ITH3
2021-01-11,PF/BT,50501,FELTRE,VEN,40-49,5,6,0,10,1,0,0,11,0,11,Veneto,ITH3
2021-01-11,PF/BT,50501,FELTRE,VEN,50-59,4,13,0,12,5,0,0,17,0,17,Veneto,ITH3
2021-01-11,PF/BT,50501,FELTRE,VEN,60-69,49,8,0,1,0,0,56,57,0,57,Veneto,ITH3
2021-01-11,PF/BT,50502,CASTELFRANCO VENETO,VEN,20-29,0,1,0,1,0,0,0,1,0,1,Veneto,ITH3
2021-01-11,PF/BT,50502,CASTELFRANCO VENETO,VEN,30-39,0,1,0,1,0,0,0,1,0,1,Veneto,ITH3
2021-01-11,PF/BT,50502,CASTELFRANCO VENETO,VEN,50-59,0,1,0,1,0,0,0,1,0,1,Veneto,ITH3
2021-01-11,PF/BT,50502,ODERZO,VEN,50-59,0,1,0,0,1,0,0,1,0,1,Veneto,ITH3
2021-01-11,PF/BT,50502,SAN BIAGIO,VEN,20-29,0,1,0,1,0,0,0,1,0,1,Veneto,ITH3
2021-01-11,PF/BT,50502,SISP - AMBULATORIO VIAGGIATORI,VEN,30-39,0,1,0,1,0,0,0,1,0,1,Veneto,ITH3
2021-01-11,PF/BT,50502,SISP - AMBULATORIO VIAGGIATORI,VEN,40-49,1,2,0,3,0,0,0,3,0,3,Veneto,ITH3
2021-01-11,PF/BT,50502,SISP - AMBULATORIO VIAGGIATORI,VEN,50-59,0,4,0,4,0,0,0,4,0,4,Veneto,ITH3
2021-01-11,PF/BT,50502,SISP - AMBULATORIO VIAGGIATORI,VEN,60-69,1,1,0,2,0,0,0,2,0,2,Veneto,ITH3
2021-01-11,PF/BT,50503,MED.PREV - CHIOGGIA,VEN,20-29,1,0,0,1,0,0,0,1,0,1,Veneto,ITH3
2021-01-11,PF/BT,50503,MED.PREV - CHIOGGIA,VEN,30-39,2,4,0,6,0,0,0,6,0,6,Veneto,ITH3
2021-01-11,PF/BT,50503,MED.PREV - CHIOGGIA,VEN,40-49,1,8,0,9,0,0,0,9,0,9,Veneto,ITH3
2021-01-11,PF/BT,50503,MED.PREV - CHIOGGIA,VEN,50-59,6,4,0,10,0,0,0,10,0,10,Veneto,ITH3
2021-01-11,PF/BT,50503,MED.PREV - CHIOGGIA,VEN,60-69,1,0,0,1,0,0,0,1,0,1,Veneto,ITH3
2021-01-11,PF/BT,50503,MED.PREV - CHIOGGIA,VEN,70-79,3,0,0,3,0,0,0,3,0,3,Veneto,ITH3
2021-01-11,PF/BT,50503,MEDICINA PREVENTIVA MESTRE,VEN,16-19,1,1,0,2,0,0,0,2,0,2,Veneto,ITH3
2021-01-11,PF/BT,50503,MEDICINA PREVENTIVA MESTRE,VEN,20-29,7,12,0,17,2,0,0,19,0,19,Veneto,ITH3
2021-01-11,PF/BT,50503,MEDICINA PREVENTIVA MESTRE,VEN,30-39,14,17,0,24,7,0,0,31,0,31,Veneto,ITH3
2021-01-11,PF/BT,50503,MEDICINA PREVENTIVA MESTRE,VEN,40-49,20,28,0,37,11,0,0,48,0,48,Veneto,ITH3
2021-01-11,PF/BT,50503,MEDICINA PREVENTIVA MESTRE,VEN,50-59,33,29,0,44,18,0,0,62,0,62,Veneto,ITH3
2021-01-11,PF/BT,50503,MEDICINA PREVENTIVA MESTRE,VEN,60-69,12,9,0,16,5,0,0,21,0,21,Veneto,ITH3
2021-01-11,PF/BT,50503,MEDICINA PREVENTIVA MESTRE,VEN,70-79,3,0,0,2,1,0,0,3,0,3,Veneto,ITH3
2021-01-11,PF/BT,50503,MEDICINA PREVENTIVA VENEZIA,VEN,20-29,7,3,0,2,8,0,0,10,0,10,Veneto,ITH3
2021-01-11,PF/BT,50503,MEDICINA PREVENTIVA VENEZIA,VEN,30-39,11,10,0,12,9,0,0,21,0,21,Veneto,ITH3
2021-01-11,PF/BT,50503,MEDICINA PREVENTIVA VENEZIA,VEN,40-49,10,17,0,15,12,0,0,27,0,27,Veneto,ITH3
2021-01-11,PF/BT,50503,MEDICINA PREVENTIVA VENEZIA,VEN,50-59,11,25,0,26,10,0,0,36,0,36,Veneto,ITH3
2021-01-11,PF/BT,50503,MEDICINA PREVENTIVA VENEZIA,VEN,60-69,17,17,0,16,18,0,0,34,0,34,Veneto,ITH3
2021-01-11,PF/BT,50503,MEDICINA PREVENTIVA VENEZIA,VEN,70-79,6,3,0,3,6,0,0,9,0,9,Veneto,ITH3
2021-01-11,PF/BT,50503,MEDICINA PREVENTIVA VENEZIA,VEN,80-89,0,1,0,0,1,0,0,1,0,1,Veneto,ITH3
2021-01-11,PF/BT,50503,S.I.S.P. MESTRE,VEN,20-29,3,8,0,9,2,0,0,11,0,11,Veneto,ITH3
2021-01-11,PF/BT,50503,S.I.S.P. MESTRE,VEN,30-39,7,6,0,10,3,0,0,13,0,13,Veneto,ITH3
2021-01-11,PF/BT,50503,S.I.S.P. MESTRE,VEN,40-49,6,14,0,16,4,0,0,20,0,20,Veneto,ITH3
2021-01-11,PF/BT,50503,S.I.S.P. MESTRE,VEN,50-59,9,13,0,15,7,0,0,22,0,22,Veneto,ITH3
2021-01-11,PF/BT,50503,S.I.S.P. MESTRE,VEN,60-69,5,4,0,7,2,0,0,9,0,9,Veneto,ITH3
2021-01-11,PF/BT,50503,S.I.S.P. MESTRE,VEN,70-79,9,0,0,9,0,0,0,9,0,9,Veneto,ITH3
2021-01-11,PF/BT,50503,S.I.S.P. VENEZIA,VEN,16-19,0,1,0,0,1,0,0,1,0,1,Veneto,ITH3
2021-01-11,PF/BT,50503,S.I.S.P. VENEZIA,VEN,20-29,0,3,0,0,3,0,0,3,0,3,Veneto,ITH3
2021-01-11,PF/BT,50503,S.I.S.P. VENEZIA,VEN,30-39,1,6,0,5,2,0,0,7,0,7,Veneto,ITH3
2021-01-11,PF/BT,50503,S.I.S.P. VENEZIA,VEN,40-49,0,5,0,4,1,0,0,5,0,5,Veneto,ITH3
2021-01-11,PF/BT,50503,S.I.S.P. VENEZIA,VEN,50-59,1,6,0,6,1,0,0,7,0,7,Veneto,ITH3
2021-01-11,PF/BT,50503,S.I.S.P. VENEZIA,VEN,60-69,4,2,0,6,0,0,0,6,0,6,Veneto,ITH3
2021-01-11,PF/BT,50503,S.I.S.P. VENEZIA,VEN,70-79,1,0,0,1,0,0,0,1,0,1,Veneto,ITH3
2021-01-11,PF/BT,50503,SISP DOLO ADULTI,VEN,20-29,3,14,0,17,0,0,0,17,0,17,Veneto,ITH3
2021-01-11,PF/BT,50503,SISP DOLO ADULTI,VEN,30-39,5,10,0,15,0,0,0,15,0,15,Veneto,ITH3
2021-01-11,PF/BT,50503,SISP DOLO ADULTI,VEN,40-49,9,49,0,56,2,0,0,58,0,58,Veneto,ITH3
2021-01-11,PF/BT,50503,SISP DOLO ADULTI,VEN,50-59,20,60,0,77,2,0,1,80,0,80,Veneto,ITH3
2021-01-11,PF/BT,50503,SISP DOLO ADULTI,VEN,60-69,10,6,0,15,1,0,0,16,0,16,Veneto,ITH3
2021-01-11,PF/BT,50504,SANTO STINO DI LIVENZA,VEN,20-29,0,4,0,4,0,0,0,4,0,4,Veneto,ITH3
2021-01-11,PF/BT,50504,SANTO STINO DI LIVENZA,VEN,30-39,4,9,0,11,2,0,0,13,0,13,Veneto,ITH3
2021-01-11,PF/BT,50504,SANTO STINO DI LIVENZA,VEN,40-49,7,17,0,21,3,0,0,24,0,24,Veneto,ITH3
2021-01-11,PF/BT,50504,SANTO STINO DI LIVENZA,VEN,50-59,5,28,0,27,6,0,0,33,0,33,Veneto,ITH3
2021-01-11,PF/BT,50504,SANTO STINO DI LIVENZA,VEN,60-69,4,6,0,6,4,0,0,10,0,10,Veneto,ITH3
2021-01-11,PF/BT,50505,ADRIA,VEN,20-29,6,5,0,2,1,6,2,11,0,11,Veneto,ITH3
2021-01-11,PF/BT,50505,ADRIA,VEN,30-39,15,8,0,2,2,16,3,23,0,23,Veneto,ITH3
2021-01-11,PF/BT,50505,ADRIA,VEN,40-49,10,14,0,10,0,10,4,24,0,24,Veneto,ITH3
2021-01-11,PF/BT,50505,ADRIA,VEN,50-59,11,9,0,9,3,8,0,20,0,20,Veneto,ITH3
2021-01-11,PF/BT,50505,ADRIA,VEN,60-69,5,5,0,1,3,4,2,10,0,10,Veneto,ITH3
2021-01-11,PF/BT,50505,ADRIA,VEN,70-79,2,0,0,0,2,0,0,2,0,2,Veneto,ITH3
2021-01-11,PF/BT,50505,TRECENTA,VEN,16-19,0,1,0,0,0,1,0,1,0,1,Veneto,ITH3
2021-01-11,PF/BT,50505,TRECENTA,VEN,20-29,6,2,0,1,0,7,0,8,0,8,Veneto,ITH3
2021-01-11,PF/BT,50505,TRECENTA,VEN,30-39,6,3,0,1,0,8,0,9,0,9,Veneto,ITH3
2021-01-11,PF/BT,50505,TRECENTA,VEN,40-49,4,12,0,4,0,12,0,16,0,16,Veneto,ITH3
2021-01-11,PF/BT,50505,TRECENTA,VEN,50-59,6,5,0,3,0,8,0,11,0,11,Veneto,ITH3
2021-01-11,PF/BT,50505,TRECENTA,VEN,60-69,0,3,0,2,0,1,0,3,0,3,Veneto,ITH3
2021-01-11,PF/BT,50505,TRECENTA,VEN,70-79,1,0,0,1,0,0,0,1,0,1,Veneto,ITH3
2021-01-11,PF/BT,5050501,Mancante,VEN,70-79,1,0,0,1,0,0,0,1,0,1,Veneto,ITH3
2021-01-11,PF/BT,5050501,PRESIDIO OSPEDALIERO ROVIGO,VEN,20-29,1,6,0,5,0,0,2,7,0,7,Veneto,ITH3
2021-01-11,PF/BT,5050501,PRESIDIO OSPEDALIERO ROVIGO,VEN,30-39,1,4,0,3,0,0,2,5,0,5,Veneto,ITH3
2021-01-11,PF/BT,5050501,PRESIDIO OSPEDALIERO ROVIGO,VEN,40-49,3,10,0,3,0,0,10,13,0,13,Veneto,ITH3
2021-01-11,PF/BT,5050501,PRESIDIO OSPEDALIERO ROVIGO,VEN,50-59,10,18,0,2,0,0,26,28,0,28,Veneto,ITH3
2021-01-11,PF/BT,5050501,PRESIDIO OSPEDALIERO ROVIGO,VEN,60-69,11,8,0,4,0,0,15,19,0,19,Veneto,ITH3
2021-01-11,PF/BT,5050501,PRESIDIO OSPEDALIERO ROVIGO,VEN,70-79,4,0,0,3,0,0,1,4,0,4,Veneto,ITH3
2021-01-11,PF/BT,50506,AZ OSPEDALIERA DI PADOVA MAL. INFET.E TR,VEN,20-29,4,10,0,14,0,0,0,14,0,14,Veneto,ITH3
2021-01-11,PF/BT,50506,AZ OSPEDALIERA DI PADOVA MAL. INFET.E TR,VEN,30-39,8,21,0,29,0,0,0,29,0,29,Veneto,ITH3
2021-01-11,PF/BT,50506,AZ OSPEDALIERA DI PADOVA MAL. INFET.E TR,VEN,40-49,8,32,0,40,0,0,0,40,0,40,Veneto,ITH3
2021-01-11,PF/BT,50506,AZ OSPEDALIERA DI PADOVA MAL. INFET.E TR,VEN,50-59,5,24,0,29,0,0,0,29,0,29,Veneto,ITH3
2021-01-11,PF/BT,50506,AZ OSPEDALIERA DI PADOVA MAL. INFET.E TR,VEN,60-69,5,5,0,10,0,0,0,10,0,10,Veneto,ITH3
2021-01-11,PF/BT,50506,CAMPOSAMPIERO MEDICO COMPETENT,VEN,20-29,3,6,0,9,0,0,0,9,0,9,Veneto,ITH3
2021-01-11,PF/BT,50506,CAMPOSAMPIERO MEDICO COMPETENT,VEN,30-39,5,20,0,24,1,0,0,25,0,25,Veneto,ITH3
2021-01-11,PF/BT,50506,CAMPOSAMPIERO MEDICO COMPETENT,VEN,40-49,6,33,0,39,0,0,0,39,0,39,Veneto,ITH3
2021-01-11,PF/BT,50506,CAMPOSAMPIERO MEDICO COMPETENT,VEN,50-59,9,41,0,46,4,0,0,50,0,50,Veneto,ITH3
2021-01-11,PF/BT,50506,CAMPOSAMPIERO MEDICO COMPETENT,VEN,60-69,4,5,0,9,0,0,0,9,0,9,Veneto,ITH3
2021-01-11,PF/BT,50506,CITTADELLA MEDICO COMPETENTE,VEN,20-29,3,6,0,4,3,0,2,9,0,9,Veneto,ITH3
2021-01-11,PF/BT,50506,CITTADELLA MEDICO COMPETENTE,VEN,30-39,4,10,0,7,5,0,2,14,0,14,Veneto,ITH3
2021-01-11,PF/BT,50506,CITTADELLA MEDICO COMPETENTE,VEN,40-49,2,10,0,4,5,0,3,12,0,12,Veneto,ITH3
2021-01-11,PF/BT,50506,CITTADELLA MEDICO COMPETENTE,VEN,50-59,9,18,0,11,11,0,5,27,0,27,Veneto,ITH3
2021-01-11,PF/BT,50506,CITTADELLA MEDICO COMPETENTE,VEN,60-69,4,6,0,2,7,0,1,10,0,10,Veneto,ITH3
2021-01-11,PF/BT,50506,COLLI VACC. ADULTI,VEN,20-29,1,2,0,1,0,0,2,3,0,3,Veneto,ITH3
2021-01-11,PF/BT,50506,COLLI VACC. ADULTI,VEN,30-39,1,4,0,5,0,0,0,5,0,5,Veneto,ITH3
2021-01-11,PF/BT,50506,COLLI VACC. ADULTI,VEN,40-49,4,13,0,11,5,0,1,17,0,17,Veneto,ITH3
2021-01-11,PF/BT,50506,COLLI VACC. ADULTI,VEN,50-59,6,26,0,20,9,0,3,32,0,32,Veneto,ITH3
2021-01-11,PF/BT,50506,COLLI VACC. ADULTI,VEN,60-69,3,6,0,6,2,0,1,9,0,9,Veneto,ITH3
2021-01-11,PF/BT,50506,DIRIGENZA MEDICA P.D.SACCO,VEN,20-29,0,1,0,0,1,0,0,1,0,1,Veneto,ITH3
2021-01-11,PF/BT,50506,DIRIGENZA MEDICA P.D.SACCO,VEN,30-39,2,2,0,1,3,0,0,4,0,4,Veneto,ITH3
2021-01-11,PF/BT,50506,DIRIGENZA MEDICA P.D.SACCO,VEN,40-49,4,10,0,5,9,0,0,14,0,14,Veneto,ITH3
2021-01-11,PF/BT,50506,DIRIGENZA MEDICA P.D.SACCO,VEN,50-59,9,14,0,8,15,0,0,23,0,23,Veneto,ITH3
2021-01-11,PF/BT,50506,DIRIGENZA MEDICA P.D.SACCO,VEN,60-69,3,9,0,4,8,0,0,12,0,12,Veneto,ITH3
2021-01-11,PF/BT,50506,MONSELICE,VEN,20-29,11,12,0,5,8,10,0,23,0,23,Veneto,ITH3
2021-01-11,PF/BT,50506,MONSELICE,VEN,30-39,12,23,0,17,10,8,0,35,0,35,Veneto,ITH3
2021-01-11,PF/BT,50506,MONSELICE,VEN,40-49,13,28,0,27,9,5,0,41,0,41,Veneto,ITH3
2021-01-11,PF/BT,50506,MONSELICE,VEN,50-59,18,38,0,29,13,13,1,56,0,56,Veneto,ITH3
2021-01-11,PF/BT,50506,MONSELICE,VEN,60-69,18,9,0,19,8,0,0,27,0,27,Veneto,ITH3
2021-01-11,PF/BT,50506,MONSELICE,VEN,70-79,8,2,0,0,6,0,4,10,0,10,Veneto,ITH3
2021-01-11,PF/BT,50506,MONSELICE,VEN,80-89,0,2,0,0,0,0,2,2,0,2,Veneto,ITH3
2021-01-11,PF/BT,50506,PIAZZOLA SUL BRENTA,VEN,20-29,0,2,0,2,0,0,0,2,0,2,Veneto,ITH3
2021-01-11,PF/BT,50506,PIAZZOLA SUL BRENTA,VEN,30-39,1,11,0,11,1,0,0,12,0,12,Veneto,ITH3
2021-01-11,PF/BT,50506,PIAZZOLA SUL BRENTA,VEN,40-49,1,4,0,3,2,0,0,5,0,5,Veneto,ITH3
2021-01-11,PF/BT,50506,PIAZZOLA SUL BRENTA,VEN,50-59,3,16,0,10,9,0,0,19,0,19,Veneto,ITH3
2021-01-11,PF/BT,50506,PIAZZOLA SUL BRENTA,VEN,60-69,0,3,0,3,0,0,0,3,0,3,Veneto,ITH3
2021-01-11,PF/BT,50506,PIAZZOLA SUL BRENTA,VEN,70-79,1,0,0,1,0,0,0,1,0,1,Veneto,ITH3
2021-01-11,PF/BT,50506,PIOVE DI SACCO - SERV. IGIENE E SANITA',VEN,20-29,0,1,0,1,0,0,0,1,0,1,Veneto,ITH3
2021-01-11,PF/BT,50506,PIOVE DI SACCO - SERV. IGIENE E SANITA',VEN,30-39,1,3,0,1,2,1,0,4,0,4,Veneto,ITH3
2021-01-11,PF/BT,50506,PIOVE DI SACCO - SERV. IGIENE E SANITA',VEN,40-49,4,5,0,5,0,4,0,9,0,9,Veneto,ITH3
2021-01-11,PF/BT,50506,PIOVE DI SACCO - SERV. IGIENE E SANITA',VEN,50-59,6,1,0,1,0,6,0,7,0,7,Veneto,ITH3
2021-01-11,PF/BT,50506,PIOVE DI SACCO - SERV. IGIENE E SANITA',VEN,60-69,2,1,0,1,0,2,0,3,0,3,Veneto,ITH3
2021-01-11,PF/BT,50506,SCHIAVONIA AMBULATORIO,VEN,20-29,0,4,0,4,0,0,0,4,0,4,Veneto,ITH3
2021-01-11,PF/BT,50506,SCHIAVONIA AMBULATORIO,VEN,30-39,1,7,0,8,0,0,0,8,0,8,Veneto,ITH3
2021-01-11,PF/BT,50506,SCHIAVONIA AMBULATORIO,VEN,40-49,0,18,0,17,1,0,0,18,0,18,Veneto,ITH3
2021-01-11,PF/BT,50506,SCHIAVONIA AMBULATORIO,VEN,50-59,10,33,0,42,1,0,0,43,0,43,Veneto,ITH3
2021-01-11,PF/BT,50506,SCHIAVONIA AMBULATORIO,VEN,60-69,5,6,0,11,0,0,0,11,0,11,Veneto,ITH3
2021-01-11,PF/BT,50506,VIA SCROVEGNI ANTI INFLUENZALE,VEN,20-29,1,3,0,0,2,2,0,4,0,4,Veneto,ITH3
2021-01-11,PF/BT,50506,VIA SCROVEGNI ANTI INFLUENZALE,VEN,30-39,0,2,0,0,0,2,0,2,0,2,Veneto,ITH3
2021-01-11,PF/BT,50506,VIA SCROVEGNI ANTI INFLUENZALE,VEN,40-49,0,5,0,3,2,0,0,5,0,5,Veneto,ITH3
2021-01-11,PF/BT,50506,VIA SCROVEGNI ANTI INFLUENZALE,VEN,50-59,3,7,0,3,6,0,1,10,0,10,Veneto,ITH3
2021-01-11,PF/BT,50506,VIA SCROVEGNI ANTI INFLUENZALE,VEN,60-69,0,3,0,0,3,0,0,3,0,3,Veneto,ITH3
2021-01-11,PF/BT,50506,VIA TEMANZA ANTI INFLUENZALE,VEN,20-29,2,3,0,5,0,0,0,5,0,5,Veneto,ITH3
2021-01-11,PF/BT,50506,VIA TEMANZA ANTI INFLUENZALE,VEN,30-39,4,3,0,6,1,0,0,7,0,7,Veneto,ITH3
2021-01-11,PF/BT,50506,VIA TEMANZA ANTI INFLUENZALE,VEN,40-49,1,8,0,9,0,0,0,9,0,9,Veneto,ITH3
2021-01-11,PF/BT,50506,VIA TEMANZA ANTI INFLUENZALE,VEN,50-59,3,6,0,9,0,0,0,9,0,9,Veneto,ITH3
2021-01-11,PF/BT,50506,VIA TEMANZA ANTI INFLUENZALE,VEN,60-69,2,4,0,6,0,0,0,6,0,6,Veneto,ITH3
2021-01-11,PF/BT,50507,DIPARTIMENTO DI PREVENZIONE,VEN,20-29,1,2,0,3,0,0,0,3,0,3,Veneto,ITH3
2021-01-11,PF/BT,50507,DIPARTIMENTO DI PREVENZIONE,VEN,30-39,0,2,0,2,0,0,0,2,0,2,Veneto,ITH3
2021-01-11,PF/BT,50507,DIPARTIMENTO DI PREVENZIONE,VEN,40-49,0,6,0,4,2,0,0,6,0,6,Veneto,ITH3
2021-01-11,PF/BT,50507,DIPARTIMENTO DI PREVENZIONE,VEN,50-59,1,15,0,12,4,0,0,16,0,16,Veneto,ITH3
2021-01-11,PF/BT,50507,DIPARTIMENTO DI PREVENZIONE,VEN,60-69,0,3,0,3,0,0,0,3,0,3,Veneto,ITH3
2021-01-11,PF/BT,50507,DIPARTIMENTO DI PREVENZIONE,VEN,70-79,0,3,0,0,1,2,0,3,0,3,Veneto,ITH3
2021-01-11,PF/BT,50507,DIPARTIMENTO DI PREVENZIONE,VEN,80-89,0,12,0,0,0,12,0,12,0,12,Veneto,ITH3
2021-01-11,PF/BT,50507,DIPARTIMENTO DI PREVENZIONE,VEN,90+,0,4,0,0,0,4,0,4,0,4,Veneto,ITH3
2021-01-11,PF/BT,50507,EX OSPEDALE - BOLDRINI,VEN,16-19,0,4,0,4,0,0,0,4,0,4,Veneto,ITH3
2021-01-11,PF/BT,50507,EX OSPEDALE - BOLDRINI,VEN,20-29,11,16,0,27,0,0,0,27,0,27,Veneto,ITH3
2021-01-11,PF/BT,50507,EX OSPEDALE - BOLDRINI,VEN,30-39,13,13,0,26,0,0,0,26,0,26,Veneto,ITH3
2021-01-11,PF/BT,50507,EX OSPEDALE - BOLDRINI,VEN,40-49,18,21,0,39,0,0,0,39,0,39,Veneto,ITH3
2021-01-11,PF/BT,50507,EX OSPEDALE - BOLDRINI,VEN,50-59,19,31,0,50,0,0,0,50,0,50,Veneto,ITH3
2021-01-11,PF/BT,50507,EX OSPEDALE - BOLDRINI,VEN,60-69,21,20,0,41,0,0,0,41,0,41,Veneto,ITH3
2021-01-11,PF/BT,50507,EX OSPEDALE - BOLDRINI,VEN,70-79,5,7,0,12,0,0,0,12,0,12,Veneto,ITH3
2021-01-11,PF/BT,50507,EX OSPEDALE - BOLDRINI,VEN,80-89,1,0,0,1,0,0,0,1,0,1,Veneto,ITH3
2021-01-11,PF/BT,50507,H BASSANO,VEN,16-19,1,3,0,2,2,0,0,4,0,4,Veneto,ITH3
2021-01-11,PF/BT,50507,H BASSANO,VEN,20-29,4,15,0,14,5,0,0,19,0,19,Veneto,ITH3
2021-01-11,PF/BT,50507,H BASSANO,VEN,30-39,8,19,0,16,8,0,3,27,0,27,Veneto,ITH3
2021-01-11,PF/BT,50507,H BASSANO,VEN,40-49,3,31,0,24,10,0,0,34,0,34,Veneto,ITH3
2021-01-11,PF/BT,50507,H BASSANO,VEN,50-59,11,19,0,11,17,0,2,30,0,30,Veneto,ITH3
2021-01-11,PF/BT,50507,H BASSANO,VEN,60-69,7,5,0,4,7,0,1,12,0,12,Veneto,ITH3
2021-01-11,PF/BT,50507,H BASSANO,VEN,70-79,2,0,0,0,0,0,2,2,0,2,Veneto,ITH3
2021-01-11,PF/BT,50507,H BASSANO,VEN,80-89,3,1,0,0,2,0,2,4,0,4,Veneto,ITH3
2021-01-11,PF/BT,50507,H BASSANO,VEN,90+,1,0,0,0,0,0,1,1,0,1,Veneto,ITH3
2021-01-11,PF/BT,50507,THIENE,VEN,16-19,0,2,0,2,0,0,0,2,0,2,Veneto,ITH3
2021-01-11,PF/BT,50507,THIENE,VEN,20-29,9,9,0,18,0,0,0,18,0,18,Veneto,ITH3
2021-01-11,PF/BT,50507,THIENE,VEN,30-39,7,13,0,20,0,0,0,20,0,20,Veneto,ITH3
2021-01-11,PF/BT,50507,THIENE,VEN,40-49,7,19,0,26,0,0,0,26,0,26,Veneto,ITH3
2021-01-11,PF/BT,50507,THIENE,VEN,50-59,11,29,0,40,0,0,0,40,0,40,Veneto,ITH3
2021-01-11,PF/BT,50507,THIENE,VEN,60-69,4,1,0,5,0,0,0,5,0,5,Veneto,ITH3
2021-01-11,PF/BT,5050801,MED.COMP. - OSP. SAN BORTOLO,VEN,16-19,1,0,0,0,1,0,0,1,0,1,Veneto,ITH3
2021-01-11,PF/BT,5050801,MED.COMP. - OSP. SAN BORTOLO,VEN,20-29,13,35,0,35,8,0,5,48,0,48,Veneto,ITH3
2021-01-11,PF/BT,5050801,MED.COMP. - OSP. SAN BORTOLO,VEN,30-39,21,29,0,34,10,0,6,50,0,50,Veneto,ITH3
2021-01-11,PF/BT,5050801,MED.COMP. - OSP. SAN BORTOLO,VEN,40-49,19,59,0,50,15,0,13,78,0,78,Veneto,ITH3
2021-01-11,PF/BT,5050801,MED.COMP. - OSP. SAN BORTOLO,VEN,50-59,23,73,0,71,12,0,13,96,0,96,Veneto,ITH3
2021-01-11,PF/BT,5050801,MED.COMP. - OSP. SAN BORTOLO,VEN,60-69,13,23,0,22,8,0,6,36,0,36,Veneto,ITH3
2021-01-11,PF/BT,5050801,MED.COMP. - OSP. SAN BORTOLO,VEN,70-79,0,1,0,1,0,0,0,1,0,1,Veneto,ITH3
2021-01-11,PF/BT,5050803,MED.COMP. - OSP. CAZZAVILLAN,VEN,20-29,5,12,0,16,1,0,0,17,0,17,Veneto,ITH3
2021-01-11,PF/BT,5050803,MED.COMP. - OSP. CAZZAVILLAN,VEN,30-39,5,15,0,19,0,0,1,20,0,20,Veneto,ITH3
2021-01-11,PF/BT,5050803,MED.COMP. - OSP. CAZZAVILLAN,VEN,40-49,7,40,0,40,3,0,4,47,0,47,Veneto,ITH3
2021-01-11,PF/BT,5050803,MED.COMP. - OSP. CAZZAVILLAN,VEN,50-59,9,44,0,40,7,0,6,53,0,53,Veneto,ITH3
2021-01-11,PF/BT,5050803,MED.COMP. - OSP. CAZZAVILLAN,VEN,60-69,6,10,0,12,3,0,1,16,0,16,Veneto,ITH3
2021-01-11,PF/BT,5050803,MED.COMP. - OSP. CAZZAVILLAN,VEN,70-79,2,0,0,2,0,0,0,2,0,2,Veneto,ITH3
2021-01-11,PF/BT,50509,LEGNAGO,VEN,16-19,0,1,0,0,1,0,0,1,0,1,Veneto,ITH3
2021-01-11,PF/BT,50509,LEGNAGO,VEN,20-29,2,6,0,3,2,0,3,8,0,8,Veneto,ITH3
2021-01-11,PF/BT,50509,LEGNAGO,VEN,30-39,1,11,0,7,4,0,1,12,0,12,Veneto,ITH3
2021-01-11,PF/BT,50509,LEGNAGO,VEN,40-49,6,9,0,8,3,0,4,15,0,15,Veneto,ITH3
2021-01-11,PF/BT,50509,LEGNAGO,VEN,50-59,6,7,0,9,3,0,1,13,0,13,Veneto,ITH3
2021-01-11,PF/BT,50509,LEGNAGO,VEN,60-69,3,7,0,7,3,0,0,10,0,10,Veneto,ITH3
2021-01-11,PF/BT,50509,LEGNAGO,VEN,70-79,4,0,0,2,0,0,2,4,0,4,Veneto,ITH3
2021-01-11,PF/BT,50509,LEGNAGO,VEN,80-89,1,0,0,1,0,0,0,1,0,1,Veneto,ITH3
2021-01-11,PF/BT,521609,IPAB 'ANDREA DANIELATO',VEN,30-39,0,1,0,0,1,0,0,1,0,1,Veneto,ITH3
2021-01-11,PF/BT,521609,IPAB 'ANDREA DANIELATO',VEN,40-49,0,1,0,0,1,0,0,1,0,1,Veneto,ITH3
2021-01-11,PF/BT,521609,IPAB 'ANDREA DANIELATO',VEN,50-59,0,2,0,1,0,1,0,2,0,2,Veneto,ITH3
2021-01-11,PF/BT,521609,IPAB 'ANDREA DANIELATO',VEN,60-69,3,1,0,2,0,2,0,4,0,4,Veneto,ITH3
2021-01-11,PF/BT,521609,IPAB 'ANDREA DANIELATO',VEN,70-79,2,4,0,0,0,6,0,6,0,6,Veneto,ITH3
2021-01-11,PF/BT,521609,IPAB 'ANDREA DANIELATO',VEN,80-89,7,10,0,0,1,16,0,17,0,17,Veneto,ITH3
2021-01-11,PF/BT,521609,IPAB 'ANDREA DANIELATO',VEN,90+,1,16,0,0,0,17,0,17,0,17,Veneto,ITH3
2021-01-11,PF/BT,563021,C.D.R. - O.I.C. G. BOTTON,VEN,20-29,2,7,0,6,3,0,0,9,0,9,Veneto,ITH3
2021-01-11,PF/BT,563021,C.D.R. - O.I.C. G. BOTTON,VEN,30-39,0,6,0,6,0,0,0,6,0,6,Veneto,ITH3
2021-01-11,PF/BT,563021,C.D.R. - O.I.C. G. BOTTON,VEN,40-49,4,13,0,10,6,1,0,17,0,17,Veneto,ITH3
2021-01-11,PF/BT,563021,C.D.R. - O.I.C. G. BOTTON,VEN,50-59,1,15,0,10,6,0,0,16,0,16,Veneto,ITH3
2021-01-11,PF/BT,563021,C.D.R. - O.I.C. G. BOTTON,VEN,60-69,0,3,0,1,0,2,0,3,0,3,Veneto,ITH3
2021-01-11,PF/BT,563021,C.D.R. - O.I.C. G. BOTTON,VEN,70-79,4,3,0,0,0,7,0,7,0,7,Veneto,ITH3
2021-01-11,PF/BT,563021,C.D.R. - O.I.C. G. BOTTON,VEN,80-89,1,25,0,0,0,26,0,26,0,26,Veneto,ITH3
2021-01-11,PF/BT,563021,C.D.R. - O.I.C. G. BOTTON,VEN,90+,1,20,0,0,0,21,0,21,0,21,Veneto,ITH3
2021-01-11,PF/BT,563024,C.D.R. VILLA A.M. BRESSANIN,VEN,20-29,0,1,0,1,0,0,0,1,0,1,Veneto,ITH3
2021-01-11,PF/BT,563024,C.D.R. VILLA A.M. BRESSANIN,VEN,40-49,0,1,0,1,0,0,0,1,0,1,Veneto,ITH3
2021-01-11,PF/BT,563024,C.D.R. VILLA A.M. BRESSANIN,VEN,50-59,0,2,0,1,1,0,0,2,0,2,Veneto,ITH3
2021-01-11,PF/BT,563024,C.D.R. VILLA A.M. BRESSANIN,VEN,80-89,0,1,0,0,0,1,0,1,0,1,Veneto,ITH3
2021-01-11,PF/BT,563034,C.D.R. A.M. BONORA,VEN,16-19,0,1,0,1,0,0,0,1,0,1,Veneto,ITH3
2021-01-11,PF/BT,563034,C.D.R. A.M. BONORA,VEN,20-29,3,11,0,13,1,0,0,14,0,14,Veneto,ITH3
2021-01-11,PF/BT,563034,C.D.R. A.M. BONORA,VEN,30-39,5,12,0,17,0,0,0,17,0,17,Veneto,ITH3
2021-01-11,PF/BT,563034,C.D.R. A.M. BONORA,VEN,40-49,3,26,0,25,4,0,0,29,0,29,Veneto,ITH3
2021-01-11,PF/BT,563034,C.D.R. A.M. BONORA,VEN,50-59,5,43,0,43,4,1,0,48,0,48,Veneto,ITH3
2021-01-11,PF/BT,563034,C.D.R. A.M. BONORA,VEN,60-69,0,8,0,6,2,0,0,8,0,8,Veneto,ITH3
2021-01-11,PF/BT,563034,C.D.R. A.M. BONORA,VEN,70-79,0,1,0,0,0,1,0,1,0,1,Veneto,ITH3
2021-01-11,PF/BT,563034,C.D.R. A.M. BONORA,VEN,80-89,0,2,0,0,0,2,0,2,0,2,Veneto,ITH3
2021-01-11,PF/BT,563042,C.D.R. CITTADELLA,VEN,16-19,0,1,0,1,0,0,0,1,0,1,Veneto,ITH3
2021-01-11,PF/BT,563042,C.D.R. CITTADELLA,VEN,20-29,0,7,0,7,0,0,0,7,0,7,Veneto,ITH3
2021-01-11,PF/BT,563042,C.D.R. CITTADELLA,VEN,30-39,2,5,0,5,1,1,0,7,0,7,Veneto,ITH3
2021-01-11,PF/BT,563042,C.D.R. CITTADELLA,VEN,40-49,1,12,0,9,3,1,0,13,0,13,Veneto,ITH3
2021-01-11,PF/BT,563042,C.D.R. CITTADELLA,VEN,50-59,3,5,0,5,2,1,0,8,0,8,Veneto,ITH3
2021-01-11,PF/BT,563042,C.D.R. CITTADELLA,VEN,60-69,3,5,0,2,2,4,0,8,0,8,Veneto,ITH3
2021-01-11,PF/BT,563042,C.D.R. CITTADELLA,VEN,70-79,4,2,0,1,0,5,0,6,0,6,Veneto,ITH3
2021-01-11,PF/BT,563042,C.D.R. CITTADELLA,VEN,80-89,3,8,0,0,0,11,0,11,0,11,Veneto,ITH3
2021-01-11,PF/BT,563042,C.D.R. CITTADELLA,VEN,90+,0,1,0,0,0,1,0,1,0,1,Veneto,ITH3
2021-01-11,PF/BT,610001,C.D.C. 'VILLA MARIA' Spa,VEN,20-29,1,3,0,4,0,0,0,4,0,4,Veneto,ITH3
2021-01-11,PF/BT,610001,C.D.C. 'VILLA MARIA' Spa,VEN,30-39,1,2,0,3,0,0,0,3,0,3,Veneto,ITH3
2021-01-11,PF/BT,610001,C.D.C. 'VILLA MARIA' Spa,VEN,40-49,5,1,0,6,0,0,0,6,0,6,Veneto,ITH3
2021-01-11,PF/BT,610001,C.D.C. 'VILLA MARIA' Spa,VEN,50-59,0,2,0,2,0,0,0,2,0,2,Veneto,ITH3
2021-01-11,PF/BT,610001,C.D.C. 'VILLA MARIA' Spa,VEN,60-69,3,4,0,7,0,0,0,7,0,7,Veneto,ITH3
2021-01-11,PF/BT,610001,C.D.C. 'VILLA MARIA' Spa,VEN,70-79,2,0,0,2,0,0,0,2,0,2,Veneto,ITH3
2021-01-11,PF/BT,610903,CASA DI CURA ABANO TERME SPA,VEN,20-29,6,7,0,13,0,0,0,13,0,13,Veneto,ITH3
2021-01-11,PF/BT,610903,CASA DI CURA ABANO TERME SPA,VEN,30-39,10,8,0,18,0,0,0,18,0,18,Veneto,ITH3
2021-01-11,PF/BT,610903,CASA DI CURA ABANO TERME SPA,VEN,40-49,4,14,0,18,0,0,0,18,0,18,Veneto,ITH3
2021-01-11,PF/BT,610903,CASA DI CURA ABANO TERME SPA,VEN,50-59,7,8,0,15,0,0,0,15,0,15,Veneto,ITH3
2021-01-11,PF/BT,610903,CASA DI CURA ABANO TERME SPA,VEN,60-69,6,3,0,9,0,0,0,9,0,9,Veneto,ITH3
2021-01-11,PF/BT,610903,CASA DI CURA ABANO TERME SPA,VEN,70-79,4,0,0,4,0,0,0,4,0,4,Veneto,ITH3
2021-01-11,PF/BT,610946,ALTAVITA IRA - CENTRO SERVIZI BEATO PELLEGRINO,VEN,20-29,1,0,0,1,0,0,0,1,0,1,Veneto,ITH3
2021-01-11,PF/BT,610946,ALTAVITA IRA - CENTRO SERVIZI BEATO PELLEGRINO,VEN,30-39,3,4,0,6,0,0,1,7,0,7,Veneto,ITH3
2021-01-11,PF/BT,610946,ALTAVITA IRA - CENTRO SERVIZI BEATO PELLEGRINO,VEN,40-49,0,4,0,4,0,0,0,4,0,4,Veneto,ITH3
2021-01-11,PF/BT,610946,ALTAVITA IRA - CENTRO SERVIZI BEATO PELLEGRINO,VEN,50-59,6,14,0,19,1,0,0,20,0,20,Veneto,ITH3
2021-01-11,PF/BT,610946,ALTAVITA IRA - CENTRO SERVIZI BEATO PELLEGRINO,VEN,70-79,3,0,0,0,0,3,0,3,0,3,Veneto,ITH3
2021-01-11,PF/BT,610946,ALTAVITA IRA - CENTRO SERVIZI BEATO PELLEGRINO,VEN,80-89,4,12,0,0,0,16,0,16,0,16,Veneto,ITH3
2021-01-11,PF/BT,610946,ALTAVITA IRA - CENTRO SERVIZI BEATO PELLEGRINO,VEN,90+,1,8,0,0,0,9,0,9,0,9,Veneto,ITH3
2021-01-11,PF/BT,610955,OPSA - OPERA PROVVIDENZA S.ANTONIO DISABILI,VEN,20-29,2,1,0,3,0,0,0,3,0,3,Veneto,ITH3
2021-01-11,PF/BT,610955,OPSA - OPERA PROVVIDENZA S.ANTONIO DISABILI,VEN,30-39,0,5,0,4,1,0,0,5,0,5,Veneto,ITH3
2021-01-11,PF/BT,610955,OPSA - OPERA PROVVIDENZA S.ANTONIO DISABILI,VEN,40-49,4,17,0,19,1,0,1,21,0,21,Veneto,ITH3
2021-01-11,PF/BT,610955,OPSA - OPERA PROVVIDENZA S.ANTONIO DISABILI,VEN,50-59,11,20,0,26,3,0,2,31,0,31,Veneto,ITH3
2021-01-11,PF/BT,610955,OPSA - OPERA PROVVIDENZA S.ANTONIO DISABILI,VEN,60-69,1,4,0,3,1,0,1,5,0,5,Veneto,ITH3
2021-01-11,PF/BT,610955,OPSA - OPERA PROVVIDENZA S.ANTONIO DISABILI,VEN,70-79,1,0,0,1,0,0,0,1,0,1,Veneto,ITH3
2021-01-11,PF/BT,611121,OPSA - CENTRO RESIDENZIALE MADRE TERESA DI CALCUTTA,VEN,50-59,0,1,0,0,0,1,0,1,0,1,Veneto,ITH3
2021-01-11,PF/BT,611121,OPSA - CENTRO RESIDENZIALE MADRE TERESA DI CALCUTTA,VEN,60-69,2,3,0,0,0,5,0,5,0,5,Veneto,ITH3
2021-01-11,PF/BT,611121,OPSA - CENTRO RESIDENZIALE MADRE TERESA DI CALCUTTA,VEN,70-79,2,1,0,0,0,3,0,3,0,3,Veneto,ITH3
2021-01-11,PF/BT,611121,OPSA - CENTRO RESIDENZIALE MADRE TERESA DI CALCUTTA,VEN,80-89,2,6,0,0,0,8,0,8,0,8,Veneto,ITH3
2021-01-11,PF/BT,611121,OPSA - CENTRO RESIDENZIALE MADRE TERESA DI CALCUTTA,VEN,90+,0,1,0,0,0,1,0,1,0,1,Veneto,ITH3
2021-01-11,PF/BT,611257,PROVINCIA DI S. ANTONIO ORDINE FRATI MINORI - CASA SACRO CUORE,VEN,20-29,1,0,0,1,0,0,0,1,0,1,Veneto,ITH3
2021-01-11,PF/BT,611257,PROVINCIA DI S. ANTONIO ORDINE FRATI MINORI - CASA SACRO CUORE,VEN,40-49,1,1,0,0,2,0,0,2,0,2,Veneto,ITH3
2021-01-11,PF/BT,611257,PROVINCIA DI S. ANTONIO ORDINE FRATI MINORI - CASA SACRO CUORE,VEN,50-59,2,0,0,0,1,1,0,2,0,2,Veneto,ITH3
2021-01-11,PF/BT,611257,PROVINCIA DI S. ANTONIO ORDINE FRATI MINORI - CASA SACRO CUORE,VEN,60-69,4,1,0,2,3,0,0,5,0,5,Veneto,ITH3
2021-01-11,PF/BT,611257,PROVINCIA DI S. ANTONIO ORDINE FRATI MINORI - CASA SACRO CUORE,VEN,70-79,3,0,0,0,2,1,0,3,0,3,Veneto,ITH3
2021-01-11,PF/BT,611257,PROVINCIA DI S. ANTONIO ORDINE FRATI MINORI - CASA SACRO CUORE,VEN,80-89,2,0,0,0,0,2,0,2,0,2,Veneto,ITH3
2021-01-11,PF/BT,611257,PROVINCIA DI S. ANTONIO ORDINE FRATI MINORI - CASA SACRO CUORE,VEN,90+,2,0,0,0,0,2,0,2,0,2,Veneto,ITH3
2021-01-11,PF/BT,642091,CASA DI RIPOSO CASALE,VEN,90+,1,0,0,0,0,1,0,1,0,1,Veneto,ITH3
2021-01-11,PF/BT,642094,CASA DI RIPOSO MERLARA,VEN,50-59,1,0,0,0,0,0,1,1,0,1,Veneto,ITH3
2021-01-11,PF/BT,642094,CASA DI RIPOSO MERLARA,VEN,60-69,0,1,0,0,0,0,1,1,0,1,Veneto,ITH3
2021-01-11,PF/BT,642094,CASA DI RIPOSO MERLARA,VEN,70-79,1,0,0,0,0,0,1,1,0,1,Veneto,ITH3
2021-01-11,PF/BT,642094,CASA DI RIPOSO MERLARA,VEN,80-89,2,0,0,0,0,2,0,2,0,2,Veneto,ITH3
2021-01-11,PF/BT,642140,CENTRO SERVIZI 'VILLAGGIO ANZIANI TRA NOI' SOLESINO,VEN,20-29,0,2,0,2,0,0,0,2,0,2,Veneto,ITH3
2021-01-11,PF/BT,642140,CENTRO SERVIZI 'VILLAGGIO ANZIANI TRA NOI' SOLESINO,VEN,30-39,0,1,0,0,1,0,0,1,0,1,Veneto,ITH3
2021-01-11,PF/BT,642140,CENTRO SERVIZI 'VILLAGGIO ANZIANI TRA NOI' SOLESINO,VEN,50-59,0,2,0,2,0,0,0,2,0,2,Veneto,ITH3
2021-01-11,PF/BT,642140,CENTRO SERVIZI 'VILLAGGIO ANZIANI TRA NOI' SOLESINO,VEN,60-69,0,1,0,0,0,1,0,1,0,1,Veneto,ITH3
2021-01-11,PF/BT,642140,CENTRO SERVIZI 'VILLAGGIO ANZIANI TRA NOI' SOLESINO,VEN,70-79,1,3,0,0,0,4,0,4,0,4,Veneto,ITH3
2021-01-11,PF/BT,642140,CENTRO SERVIZI 'VILLAGGIO ANZIANI TRA NOI' SOLESINO,VEN,80-89,4,13,0,0,0,17,0,17,0,17,Veneto,ITH3
2021-01-11,PF/BT,642140,CENTRO SERVIZI 'VILLAGGIO ANZIANI TRA NOI' SOLESINO,VEN,90+,3,17,0,0,0,20,0,20,0,20,Veneto,ITH3
2021-01-11,PF/BT,683011,CASA ALBERGO PER ANZIANI LENDI,VEN,20-29,1,0,0,1,0,0,0,1,0,1,Veneto,ITH3
2021-01-11,PF/BT,683011,CASA ALBERGO PER ANZIANI LENDI,VEN,30-39,2,0,0,2,0,0,0,2,0,2,Veneto,ITH3
2021-01-11,PF/BT,683011,CASA ALBERGO PER ANZIANI LENDI,VEN,50-59,0,1,0,0,1,0,0,1,0,1,Veneto,ITH3
2021-01-11,PF/BT,767059,C.D.R. 'DON MOZZATTI D'APRILI',VEN,20-29,1,5,0,4,2,0,0,6,0,6,Veneto,ITH3
2021-01-11,PF/BT,767059,C.D.R. 'DON MOZZATTI D'APRILI',VEN,30-39,2,10,0,8,1,3,0,12,0,12,Veneto,ITH3
2021-01-11,PF/BT,767059,C.D.R. 'DON MOZZATTI D'APRILI',VEN,40-49,2,11,0,7,0,6,0,13,0,13,Veneto,ITH3
2021-01-11,PF/BT,767059,C.D.R. 'DON MOZZATTI D'APRILI',VEN,50-59,14,20,0,12,8,14,0,34,0,34,Veneto,ITH3
2021-01-11,PF/BT,767059,C.D.R. 'DON MOZZATTI D'APRILI',VEN,60-69,10,3,0,0,2,11,0,13,0,13,Veneto,ITH3
2021-01-11,PF/BT,767059,C.D.R. 'DON MOZZATTI D'APRILI',VEN,70-79,11,4,0,0,0,15,0,15,0,15,Veneto,ITH3
2021-01-11,PF/BT,767059,C.D.R. 'DON MOZZATTI D'APRILI',VEN,80-89,9,17,0,0,0,26,0,26,0,26,Veneto,ITH3
2021-01-11,PF/BT,767059,C.D.R. 'DON MOZZATTI D'APRILI',VEN,90+,5,19,0,0,0,24,0,24,0,24,Veneto,ITH3
2021-01-11,PF/BT,768178,CENTRO SERVIZI PER ANZIANI CA' DEI NONNI,VEN,20-29,0,5,0,3,2,0,0,5,0,5,Veneto,ITH3
2021-01-11,PF/BT,768178,CENTRO SERVIZI PER ANZIANI CA' DEI NONNI,VEN,30-39,5,9,0,8,6,0,0,14,0,14,Veneto,ITH3
2021-01-11,PF/BT,768178,CENTRO SERVIZI PER ANZIANI CA' DEI NONNI,VEN,40-49,2,15,0,12,5,0,0,17,0,17,Veneto,ITH3
2021-01-11,PF/BT,768178,CENTRO SERVIZI PER ANZIANI CA' DEI NONNI,VEN,50-59,6,17,0,12,8,3,0,23,0,23,Veneto,ITH3
2021-01-11,PF/BT,768178,CENTRO SERVIZI PER ANZIANI CA' DEI NONNI,VEN,60-69,3,9,0,7,0,5,0,12,0,12,Veneto,ITH3
2021-01-11,PF/BT,768178,CENTRO SERVIZI PER ANZIANI CA' DEI NONNI,VEN,70-79,4,5,0,0,0,9,0,9,0,9,Veneto,ITH3
2021-01-11,PF/BT,768178,CENTRO SERVIZI PER ANZIANI CA' DEI NONNI,VEN,80-89,7,25,0,0,0,32,0,32,0,32,Veneto,ITH3
2021-01-11,PF/BT,768178,CENTRO SERVIZI PER ANZIANI CA' DEI NONNI,VEN,90+,5,13,0,0,0,18,0,18,0,18,Veneto,ITH3
2021-01-11,PF/BT,802099,CASA DI RIPOSO SAN MICHELE,VEN,20-29,1,2,0,3,0,0,0,3,0,3,Veneto,ITH3
2021-01-11,PF/BT,802099,CASA DI RIPOSO SAN MICHELE,VEN,30-39,0,5,0,2,3,0,0,5,0,5,Veneto,ITH3
2021-01-11,PF/BT,802099,CASA DI RIPOSO SAN MICHELE,VEN,40-49,3,10,0,9,4,0,0,13,0,13,Veneto,ITH3
2021-01-11,PF/BT,802099,CASA DI RIPOSO SAN MICHELE,VEN,50-59,2,17,0,14,5,0,0,19,0,19,Veneto,ITH3
2021-01-11,PF/BT,802099,CASA DI RIPOSO SAN MICHELE,VEN,60-69,2,4,0,3,3,0,0,6,0,6,Veneto,ITH3
2021-01-11,PF/BT,802099,CASA DI RIPOSO SAN MICHELE,VEN,70-79,3,3,0,0,0,6,0,6,0,6,Veneto,ITH3
2021-01-11,PF/BT,802099,CASA DI RIPOSO SAN MICHELE,VEN,80-89,5,18,0,0,0,23,0,23,0,23,Veneto,ITH3
2021-01-11,PF/BT,802099,CASA DI RIPOSO SAN MICHELE,VEN,90+,2,15,0,0,0,17,0,17,0,17,Veneto,ITH3
2021-01-11,PF/BT,802210,CASA DI RIPOSO 'M.GASPARINI',VEN,40-49,0,1,0,1,0,0,0,1,0,1,Veneto,ITH3
2021-01-11,PF/BT,802210,CASA DI RIPOSO 'M.GASPARINI',VEN,80-89,1,3,0,0,0,4,0,4,0,4,Veneto,ITH3
2021-01-11,PF/BT,84007,I.S.A.C.C.- PENSIONATO STURM,VEN,20-29,0,1,0,1,0,0,0,1,0,1,Veneto,ITH3
2021-01-11,PF/BT,84007,I.S.A.C.C.- PENSIONATO STURM,VEN,30-39,9,5,0,11,2,1,0,14,0,14,Veneto,ITH3
2021-01-11,PF/BT,84007,I.S.A.C.C.- PENSIONATO STURM,VEN,40-49,5,26,0,21,9,1,0,31,0,31,Veneto,ITH3
2021-01-11,PF/BT,84007,I.S.A.C.C.- PENSIONATO STURM,VEN,50-59,7,27,0,17,15,2,0,34,0,34,Veneto,ITH3
2021-01-11,PF/BT,84007,I.S.A.C.C.- PENSIONATO STURM,VEN,60-69,3,19,0,11,7,4,0,22,0,22,Veneto,ITH3
2021-01-11,PF/BT,84007,I.S.A.C.C.- PENSIONATO STURM,VEN,70-79,5,4,0,0,0,9,0,9,0,9,Veneto,ITH3
2021-01-11,PF/BT,84007,I.S.A.C.C.- PENSIONATO STURM,VEN,80-89,1,4,0,0,0,5,0,5,0,5,Veneto,ITH3
2021-01-11,PF/BT,84007,I.S.A.C.C.- PENSIONATO STURM,VEN,90+,2,4,0,0,0,6,0,6,0,6,Veneto,ITH3
2021-01-11,PF/BT,84009,CASA PER ANZIANI COMM. RUBBI,VEN,20-29,1,3,0,4,0,0,0,4,0,4,Veneto,ITH3
2021-01-11,PF/BT,84009,CASA PER ANZIANI COMM. RUBBI,VEN,30-39,3,10,0,11,2,0,0,13,0,13,Veneto,ITH3
2021-01-11,PF/BT,84009,CASA PER ANZIANI COMM. RUBBI,VEN,40-49,3,12,0,9,3,0,3,15,0,15,Veneto,ITH3
2021-01-11,PF/BT,84009,CASA PER ANZIANI COMM. RUBBI,VEN,50-59,1,3,0,4,0,0,0,4,0,4,Veneto,ITH3
2021-01-11,PF/BT,84009,CASA PER ANZIANI COMM. RUBBI,VEN,60-69,2,4,0,3,1,1,1,6,0,6,Veneto,ITH3
2021-01-11,PF/BT,84009,CASA PER ANZIANI COMM. RUBBI,VEN,70-79,5,6,0,0,2,9,0,11,0,11,Veneto,ITH3
2021-01-11,PF/BT,84009,CASA PER ANZIANI COMM. RUBBI,VEN,80-89,6,17,0,0,0,23,0,23,0,23,Veneto,ITH3
2021-01-11,PF/BT,84009,CASA PER ANZIANI COMM. RUBBI,VEN,90+,1,21,0,0,0,22,0,22,0,22,Veneto,ITH3
2021-01-11,PF/BT,84016,I.S.A.C.C. - VILLA SERENA,VEN,20-29,2,0,0,2,0,0,0,2,0,2,Veneto,ITH3
2021-01-11,PF/BT,84016,I.S.A.C.C. - VILLA SERENA,VEN,30-39,0,6,0,5,1,0,0,6,0,6,Veneto,ITH3
2021-01-11,PF/BT,84016,I.S.A.C.C. - VILLA SERENA,VEN,40-49,5,5,0,9,1,0,0,10,0,10,Veneto,ITH3
2021-01-11,PF/BT,84016,I.S.A.C.C. - VILLA SERENA,VEN,50-59,4,12,0,9,6,1,0,16,0,16,Veneto,ITH3
2021-01-11,PF/BT,84016,I.S.A.C.C. - VILLA SERENA,VEN,70-79,3,7,0,0,0,10,0,10,0,10,Veneto,ITH3
2021-01-11,PF/BT,84016,I.S.A.C.C. - VILLA SERENA,VEN,80-89,11,18,0,0,0,29,0,29,0,29,Veneto,ITH3
2021-01-11,PF/BT,84016,I.S.A.C.C. - VILLA SERENA,VEN,90+,2,23,0,0,0,25,0,25,0,25,Veneto,ITH3
2021-01-12,PF/BT,0,Mancante,VEN,20-29,1,2,0,2,1,0,0,3,0,3,Veneto,ITH3
2021-01-12,PF/BT,0,Mancante,VEN,30-39,0,5,0,4,1,0,0,5,0,5,Veneto,ITH3
2021-01-12,PF/BT,0,Mancante,VEN,40-49,1,3,0,2,2,0,0,4,0,4,Veneto,ITH3
2021-01-12,PF/BT,0,Mancante,VEN,50-59,4,5,0,1,8,0,0,9,0,9,Veneto,ITH3
2021-01-12,PF/BT,0,Mancante,VEN,60-69,4,4,0,1,4,3,0,8,0,8,Veneto,ITH3
2021-01-12,PF/BT,0,Mancante,VEN,70-79,10,4,0,0,2,12,0,14,0,14,Veneto,ITH3
2021-01-12,PF/BT,0,Mancante,VEN,80-89,2,17,0,0,0,19,0,19,0,19,Veneto,ITH3
2021-01-12,PF/BT,0,Mancante,VEN,90+,1,10,0,0,0,11,0,11,0,11,Veneto,ITH3
2021-01-12,PF/BT,162442,CASA DI RIPOSO A. TASSONI CORNEDO,VEN,20-29,1,12,0,12,1,0,0,13,0,13,Veneto,ITH3
2021-01-12,PF/BT,162442,CASA DI RIPOSO A. TASSONI CORNEDO,VEN,30-39,1,11,0,9,3,0,0,12,0,12,Veneto,ITH3
2021-01-12,PF/BT,162442,CASA DI RIPOSO A. TASSONI CORNEDO,VEN,40-49,1,13,0,8,6,0,0,14,0,14,Veneto,ITH3
2021-01-12,PF/BT,162442,CASA DI RIPOSO A. TASSONI CORNEDO,VEN,50-59,2,13,0,9,6,0,0,15,0,15,Veneto,ITH3
2021-01-12,PF/BT,162442,CASA DI RIPOSO A. TASSONI CORNEDO,VEN,60-69,0,7,0,4,2,1,0,7,0,7,Veneto,ITH3
2021-01-12,PF/BT,162442,CASA DI RIPOSO A. TASSONI CORNEDO,VEN,70-79,2,4,0,0,0,6,0,6,0,6,Veneto,ITH3
2021-01-12,PF/BT,162442,CASA DI RIPOSO A. TASSONI CORNEDO,VEN,80-89,2,16,0,0,0,18,0,18,0,18,Veneto,ITH3
2021-01-12,PF/BT,162442,CASA DI RIPOSO A. TASSONI CORNEDO,VEN,90+,0,8,0,0,0,8,0,8,0,8,Veneto,ITH3
2021-01-12,PF/BT,162446,IPAB BISOGNIN SERVIZI SOCIO-ASSISTENZIALI,VEN,20-29,4,12,0,15,1,0,0,16,0,16,Veneto,ITH3
2021-01-12,PF/BT,162446,IPAB BISOGNIN SERVIZI SOCIO-ASSISTENZIALI,VEN,30-39,2,7,0,4,5,0,0,9,0,9,Veneto,ITH3
2021-01-12,PF/BT,162446,IPAB BISOGNIN SERVIZI SOCIO-ASSISTENZIALI,VEN,40-49,2,16,0,11,6,1,0,18,0,18,Veneto,ITH3
2021-01-12,PF/BT,162446,IPAB BISOGNIN SERVIZI SOCIO-ASSISTENZIALI,VEN,50-59,4,28,0,19,13,0,0,32,0,32,Veneto,ITH3
2021-01-12,PF/BT,162446,IPAB BISOGNIN SERVIZI SOCIO-ASSISTENZIALI,VEN,60-69,4,2,0,1,1,4,0,6,0,6,Veneto,ITH3
2021-01-12,PF/BT,162446,IPAB BISOGNIN SERVIZI SOCIO-ASSISTENZIALI,VEN,70-79,7,16,0,0,1,22,0,23,0,23,Veneto,ITH3
2021-01-12,PF/BT,162446,IPAB BISOGNIN SERVIZI SOCIO-ASSISTENZIALI,VEN,80-89,7,22,0,0,0,29,0,29,0,29,Veneto,ITH3
2021-01-12,PF/BT,162446,IPAB BISOGNIN SERVIZI SOCIO-ASSISTENZIALI,VEN,90+,4,18,0,0,0,22,0,22,0,22,Veneto,ITH3
2021-01-12,PF/BT,208014,CASA DI RIPOSO CA' ARNALDI,VEN,20-29,0,6,0,6,0,0,0,6,0,6,Veneto,ITH3
2021-01-12,PF/BT,208014,CASA DI RIPOSO CA' ARNALDI,VEN,30-39,0,3,0,3,0,0,0,3,0,3,Veneto,ITH3
2021-01-12,PF/BT,208014,CASA DI RIPOSO CA' ARNALDI,VEN,40-49,6,31,0,32,5,0,0,37,0,37,Veneto,ITH3
2021-01-12,PF/BT,208014,CASA DI RIPOSO CA' ARNALDI,VEN,50-59,6,17,0,19,4,0,0,23,0,23,Veneto,ITH3
2021-01-12,PF/BT,208014,CASA DI RIPOSO CA' ARNALDI,VEN,60-69,4,7,0,5,3,3,0,11,0,11,Veneto,ITH3
2021-01-12,PF/BT,208014,CASA DI RIPOSO CA' ARNALDI,VEN,70-79,7,11,0,0,2,16,0,18,0,18,Veneto,ITH3
2021-01-12,PF/BT,208014,CASA DI RIPOSO CA' ARNALDI,VEN,80-89,10,33,0,0,1,42,0,43,0,43,Veneto,ITH3
2021-01-12,PF/BT,208014,CASA DI RIPOSO CA' ARNALDI,VEN,90+,2,18,0,0,0,20,0,20,0,20,Veneto,ITH3
2021-01-12,PF/BT,323214,"CENTRO DI SERVIZI RESIDENZIALE ""CASA DEL CLERO"" - TREVISO",VEN,20-29,3,3,0,3,3,0,0,6,0,6,Veneto,ITH3
2021-01-12,PF/BT,323214,"CENTRO DI SERVIZI RESIDENZIALE ""CASA DEL CLERO"" - TREVISO",VEN,30-39,3,3,0,4,2,0,0,6,0,6,Veneto,ITH3
2021-01-12,PF/BT,323214,"CENTRO DI SERVIZI RESIDENZIALE ""CASA DEL CLERO"" - TREVISO",VEN,40-49,8,6,0,4,8,2,0,14,0,14,Veneto,ITH3
2021-01-12,PF/BT,323214,"CENTRO DI SERVIZI RESIDENZIALE ""CASA DEL CLERO"" - TREVISO",VEN,50-59,0,12,0,4,8,0,0,12,0,12,Veneto,ITH3
2021-01-12,PF/BT,323214,"CENTRO DI SERVIZI RESIDENZIALE ""CASA DEL CLERO"" - TREVISO",VEN,60-69,3,6,0,0,8,1,0,9,0,9,Veneto,ITH3
2021-01-12,PF/BT,323214,"CENTRO DI SERVIZI RESIDENZIALE ""CASA DEL CLERO"" - TREVISO",VEN,70-79,1,0,0,0,0,1,0,1,0,1,Veneto,ITH3
2021-01-12,PF/BT,323214,"CENTRO DI SERVIZI RESIDENZIALE ""CASA DEL CLERO"" - TREVISO",VEN,80-89,30,1,0,0,0,31,0,31,0,31,Veneto,ITH3
2021-01-12,PF/BT,323214,"CENTRO DI SERVIZI RESIDENZIALE ""CASA DEL CLERO"" - TREVISO",VEN,90+,8,3,0,0,0,11,0,11,0,11,Veneto,ITH3
2021-01-12,PF/BT,323217,"CENTRO DI SERVIZI RESIDENZIALE ""CASA DI RIPOSO SUORE FRANCESCANE"" - TREVISO",VEN,20-29,2,2,0,4,0,0,0,4,0,4,Veneto,ITH3
2021-01-12,PF/BT,323217,"CENTRO DI SERVIZI RESIDENZIALE ""CASA DI RIPOSO SUORE FRANCESCANE"" - TREVISO",VEN,30-39,3,15,0,18,0,0,0,18,0,18,Veneto,ITH3
2021-01-12,PF/BT,323217,"CENTRO DI SERVIZI RESIDENZIALE ""CASA DI RIPOSO SUORE FRANCESCANE"" - TREVISO",VEN,40-49,1,12,0,13,0,0,0,13,0,13,Veneto,ITH3
2021-01-12,PF/BT,323217,"CENTRO DI SERVIZI RESIDENZIALE ""CASA DI RIPOSO SUORE FRANCESCANE"" - TREVISO",VEN,50-59,8,6,0,14,0,0,0,14,0,14,Veneto,ITH3
2021-01-12,PF/BT,323217,"CENTRO DI SERVIZI RESIDENZIALE ""CASA DI RIPOSO SUORE FRANCESCANE"" - TREVISO",VEN,60-69,3,3,0,6,0,0,0,6,0,6,Veneto,ITH3
2021-01-12,PF/BT,323217,"CENTRO DI SERVIZI RESIDENZIALE ""CASA DI RIPOSO SUORE FRANCESCANE"" - TREVISO",VEN,70-79,3,5,0,7,0,1,0,8,0,8,Veneto,ITH3
2021-01-12,PF/BT,323217,"CENTRO DI SERVIZI RESIDENZIALE ""CASA DI RIPOSO SUORE FRANCESCANE"" - TREVISO",VEN,80-89,0,21,0,5,0,16,0,21,0,21,Veneto,ITH3
2021-01-12,PF/BT,323217,"CENTRO DI SERVIZI RESIDENZIALE ""CASA DI RIPOSO SUORE FRANCESCANE"" - TREVISO",VEN,90+,1,22,0,1,0,21,1,23,0,23,Veneto,ITH3
2021-01-12,PF/BT,363706,CASA DI RIPOSO 'MONUMENTO AI CADUTI IN GUERRA',VEN,16-19,1,1,0,0,2,0,0,2,0,2,Veneto,ITH3
2021-01-12,PF/BT,363706,CASA DI RIPOSO 'MONUMENTO AI CADUTI IN GUERRA',VEN,20-29,8,8,0,13,3,0,0,16,0,16,Veneto,ITH3
2021-01-12,PF/BT,363706,CASA DI RIPOSO 'MONUMENTO AI CADUTI IN GUERRA',VEN,30-39,2,10,0,10,2,0,0,12,0,12,Veneto,ITH3
2021-01-12,PF/BT,363706,CASA DI RIPOSO 'MONUMENTO AI CADUTI IN GUERRA',VEN,40-49,2,12,0,10,4,0,0,14,0,14,Veneto,ITH3
2021-01-12,PF/BT,363706,CASA DI RIPOSO 'MONUMENTO AI CADUTI IN GUERRA',VEN,50-59,4,17,0,11,8,2,0,21,0,21,Veneto,ITH3
2021-01-12,PF/BT,363706,CASA DI RIPOSO 'MONUMENTO AI CADUTI IN GUERRA',VEN,60-69,5,15,0,11,4,5,0,20,0,20,Veneto,ITH3
2021-01-12,PF/BT,363706,CASA DI RIPOSO 'MONUMENTO AI CADUTI IN GUERRA',VEN,70-79,8,5,0,1,0,12,0,13,0,13,Veneto,ITH3
2021-01-12,PF/BT,363706,CASA DI RIPOSO 'MONUMENTO AI CADUTI IN GUERRA',VEN,80-89,9,20,0,0,0,29,0,29,0,29,Veneto,ITH3
2021-01-12,PF/BT,363706,CASA DI RIPOSO 'MONUMENTO AI CADUTI IN GUERRA',VEN,90+,6,29,0,0,0,35,0,35,0,35,Veneto,ITH3
2021-01-12,PF/BT,400001,POLIAMB. OSPEDALE FATEBENEFR.,VEN,20-29,3,2,0,5,0,0,0,5,0,5,Veneto,ITH3
2021-01-12,PF/BT,400001,POLIAMB. OSPEDALE FATEBENEFR.,VEN,30-39,1,6,0,7,0,0,0,7,0,7,Veneto,ITH3
2021-01-12,PF/BT,400001,POLIAMB. OSPEDALE FATEBENEFR.,VEN,40-49,1,5,0,6,0,0,0,6,0,6,Veneto,ITH3
2021-01-12,PF/BT,400001,POLIAMB. OSPEDALE FATEBENEFR.,VEN,50-59,3,7,0,8,0,2,0,10,0,10,Veneto,ITH3
2021-01-12,PF/BT,400001,POLIAMB. OSPEDALE FATEBENEFR.,VEN,60-69,1,2,0,1,0,2,0,3,0,3,Veneto,ITH3
2021-01-12,PF/BT,400001,POLIAMB. OSPEDALE FATEBENEFR.,VEN,70-79,1,1,0,0,0,2,0,2,0,2,Veneto,ITH3
2021-01-12,PF/BT,400001,POLIAMB. OSPEDALE FATEBENEFR.,VEN,80-89,0,9,0,0,0,9,0,9,0,9,Veneto,ITH3
2021-01-12,PF/BT,400001,POLIAMB. OSPEDALE FATEBENEFR.,VEN,90+,0,6,0,0,0,6,0,6,0,6,Veneto,ITH3
2021-01-12,PF/BT,440101,POLIAMB. OSPEDALE VILLA SALUS,VEN,20-29,7,15,0,22,0,0,0,22,0,22,Veneto,ITH3
2021-01-12,PF/BT,440101,POLIAMB. OSPEDALE VILLA SALUS,VEN,30-39,7,15,0,16,6,0,0,22,0,22,Veneto,ITH3
2021-01-12,PF/BT,440101,POLIAMB. OSPEDALE VILLA SALUS,VEN,40-49,5,17,0,15,7,0,0,22,0,22,Veneto,ITH3
2021-01-12,PF/BT,440101,POLIAMB. OSPEDALE VILLA SALUS,VEN,50-59,11,13,0,16,8,0,0,24,0,24,Veneto,ITH3
2021-01-12,PF/BT,440101,POLIAMB. OSPEDALE VILLA SALUS,VEN,60-69,6,7,0,12,1,0,0,13,0,13,Veneto,ITH3
2021-01-12,PF/BT,440101,POLIAMB. OSPEDALE VILLA SALUS,VEN,70-79,2,1,0,2,1,0,0,3,0,3,Veneto,ITH3
2021-01-12,PF/BT,440101,POLIAMB. OSPEDALE VILLA SALUS,VEN,80-89,0,1,0,1,0,0,0,1,0,1,Veneto,ITH3
2021-01-12,PF/BT,445325,C. SERV.RES.ANZ.-S.LORENZO,VEN,20-29,0,1,0,1,0,0,0,1,0,1,Veneto,ITH3
2021-01-12,PF/BT,445325,C. SERV.RES.ANZ.-S.LORENZO,VEN,30-39,1,1,0,1,1,0,0,2,0,2,Veneto,ITH3
2021-01-12,PF/BT,445325,C. SERV.RES.ANZ.-S.LORENZO,VEN,40-49,0,7,0,7,0,0,0,7,0,7,Veneto,ITH3
2021-01-12,PF/BT,445325,C. SERV.RES.ANZ.-S.LORENZO,VEN,50-59,4,9,0,10,3,0,0,13,0,13,Veneto,ITH3
2021-01-12,PF/BT,445325,C. SERV.RES.ANZ.-S.LORENZO,VEN,60-69,3,2,0,4,1,0,0,5,0,5,Veneto,ITH3
2021-01-12,PF/BT,445325,C. SERV.RES.ANZ.-S.LORENZO,VEN,70-79,2,0,0,0,0,2,0,2,0,2,Veneto,ITH3
2021-01-12,PF/BT,445325,C. SERV.RES.ANZ.-S.LORENZO,VEN,80-89,2,6,0,0,0,8,0,8,0,8,Veneto,ITH3
2021-01-12,PF/BT,445325,C. SERV.RES.ANZ.-S.LORENZO,VEN,90+,1,8,0,0,0,9,0,9,0,9,Veneto,ITH3
2021-01-12,PF/BT,445326,C. SERV.RES.ANZ.-CARLO STEEB,VEN,80-89,0,1,0,0,0,1,0,1,0,1,Veneto,ITH3
2021-01-12,PF/BT,445331,C. SERV.RES.ANZ.-ANNI AZZ.QUARTO,VEN,20-29,0,4,0,4,0,0,0,4,0,4,Veneto,ITH3
2021-01-12,PF/BT,445331,C. SERV.RES.ANZ.-ANNI AZZ.QUARTO,VEN,30-39,2,9,0,7,4,0,0,11,0,11,Veneto,ITH3
2021-01-12,PF/BT,445331,C. SERV.RES.ANZ.-ANNI AZZ.QUARTO,VEN,40-49,4,11,0,8,7,0,0,15,0,15,Veneto,ITH3
2021-01-12,PF/BT,445331,C. SERV.RES.ANZ.-ANNI AZZ.QUARTO,VEN,50-59,8,20,0,13,15,0,0,28,0,28,Veneto,ITH3
2021-01-12,PF/BT,445331,C. SERV.RES.ANZ.-ANNI AZZ.QUARTO,VEN,60-69,1,6,0,5,1,1,0,7,0,7,Veneto,ITH3
2021-01-12,PF/BT,445331,C. SERV.RES.ANZ.-ANNI AZZ.QUARTO,VEN,70-79,1,7,0,0,0,8,0,8,0,8,Veneto,ITH3
2021-01-12,PF/BT,445331,C. SERV.RES.ANZ.-ANNI AZZ.QUARTO,VEN,80-89,3,24,0,0,0,27,0,27,0,27,Veneto,ITH3
2021-01-12,PF/BT,445331,C. SERV.RES.ANZ.-ANNI AZZ.QUARTO,VEN,90+,1,19,0,0,0,20,0,20,0,20,Veneto,ITH3
2021-01-12,PF/BT,445366,C. SERV.RES.ANZ.-NAZARET,VEN,20-29,0,1,0,1,0,0,0,1,0,1,Veneto,ITH3
2021-01-12,PF/BT,445366,C. SERV.RES.ANZ.-NAZARET,VEN,40-49,0,1,0,1,0,0,0,1,0,1,Veneto,ITH3
2021-01-12,PF/BT,445366,C. SERV.RES.ANZ.-NAZARET,VEN,50-59,0,1,0,0,0,1,0,1,0,1,Veneto,ITH3
2021-01-12,PF/BT,445366,C. SERV.RES.ANZ.-NAZARET,VEN,60-69,0,1,0,0,0,1,0,1,0,1,Veneto,ITH3
2021-01-12,PF/BT,445366,C. SERV.RES.ANZ.-NAZARET,VEN,70-79,2,9,0,0,0,11,0,11,0,11,Veneto,ITH3
2021-01-12,PF/BT,445366,C. SERV.RES.ANZ.-NAZARET,VEN,80-89,2,8,0,0,0,10,0,10,0,10,Veneto,ITH3
2021-01-12,PF/BT,445366,C. SERV.RES.ANZ.-NAZARET,VEN,90+,1,10,0,0,0,11,0,11,0,11,Veneto,ITH3
2021-01-12,PF/BT,445371,C. SERV.RES.ANZ.-ANNI AZZ.FAVARO,VEN,20-29,4,7,0,8,3,0,0,11,0,11,Veneto,ITH3
2021-01-12,PF/BT,445371,C. SERV.RES.ANZ.-ANNI AZZ.FAVARO,VEN,30-39,6,5,0,7,4,0,0,11,0,11,Veneto,ITH3
2021-01-12,PF/BT,445371,C. SERV.RES.ANZ.-ANNI AZZ.FAVARO,VEN,40-49,7,4,0,4,4,3,0,11,0,11,Veneto,ITH3
2021-01-12,PF/BT,445371,C. SERV.RES.ANZ.-ANNI AZZ.FAVARO,VEN,50-59,1,13,0,6,4,4,0,14,0,14,Veneto,ITH3
2021-01-12,PF/BT,445371,C. SERV.RES.ANZ.-ANNI AZZ.FAVARO,VEN,60-69,0,4,0,2,1,1,0,4,0,4,Veneto,ITH3
2021-01-12,PF/BT,445385,C. SERV.RES.ANZ.-CONTARINI IRE,VEN,40-49,2,0,0,2,0,0,0,2,0,2,Veneto,ITH3
2021-01-12,PF/BT,445385,C. SERV.RES.ANZ.-CONTARINI IRE,VEN,50-59,1,1,0,2,0,0,0,2,0,2,Veneto,ITH3
2021-01-12,PF/BT,445385,C. SERV.RES.ANZ.-CONTARINI IRE,VEN,80-89,0,2,0,0,0,2,0,2,0,2,Veneto,ITH3
2021-01-12,PF/BT,445388,C. SERV.RES.ANZ.-ZITELLE,VEN,30-39,0,1,0,1,0,0,0,1,0,1,Veneto,ITH3
2021-01-12,PF/BT,445388,C. SERV.RES.ANZ.-ZITELLE,VEN,40-49,1,1,0,1,0,0,1,2,0,2,Veneto,ITH3
2021-01-12,PF/BT,445388,C. SERV.RES.ANZ.-ZITELLE,VEN,50-59,1,2,0,1,0,0,2,3,0,3,Veneto,ITH3
2021-01-12,PF/BT,445388,C. SERV.RES.ANZ.-ZITELLE,VEN,60-69,0,1,0,0,0,0,1,1,0,1,Veneto,ITH3
2021-01-12,PF/BT,445388,C. SERV.RES.ANZ.-ZITELLE,VEN,80-89,3,1,0,0,0,4,0,4,0,4,Veneto,ITH3
2021-01-12,PF/BT,445388,C. SERV.RES.ANZ.-ZITELLE,VEN,90+,2,5,0,0,0,7,0,7,0,7,Veneto,ITH3
2021-01-12,PF/BT,445438,S.V.P. CENTRO SERV. ANTICA SCUOLA DEI BATTUTI,VEN,50-59,0,7,0,1,4,2,0,7,0,7,Veneto,ITH3
2021-01-12,PF/BT,445438,S.V.P. CENTRO SERV. ANTICA SCUOLA DEI BATTUTI,VEN,60-69,1,0,0,0,0,1,0,1,0,1,Veneto,ITH3
2021-01-12,PF/BT,445438,S.V.P. CENTRO SERV. ANTICA SCUOLA DEI BATTUTI,VEN,70-79,5,5,0,0,0,10,0,10,0,10,Veneto,ITH3
2021-01-12,PF/BT,445438,S.V.P. CENTRO SERV. ANTICA SCUOLA DEI BATTUTI,VEN,80-89,8,14,0,0,1,21,0,22,0,22,Veneto,ITH3
2021-01-12,PF/BT,445438,S.V.P. CENTRO SERV. ANTICA SCUOLA DEI BATTUTI,VEN,90+,0,20,0,0,0,20,0,20,0,20,Veneto,ITH3
2021-01-12,PF/BT,445440,C. SERV.RES.ANZ.- IRE SAN GIOBBE,VEN,30-39,0,1,0,1,0,0,0,1,0,1,Veneto,ITH3
2021-01-12,PF/BT,445440,C. SERV.RES.ANZ.- IRE SAN GIOBBE,VEN,40-49,1,1,0,0,2,0,0,2,0,2,Veneto,ITH3
2021-01-12,PF/BT,445440,C. SERV.RES.ANZ.- IRE SAN GIOBBE,VEN,50-59,1,4,0,2,3,0,0,5,0,5,Veneto,ITH3
2021-01-12,PF/BT,445440,C. SERV.RES.ANZ.- IRE SAN GIOBBE,VEN,60-69,0,2,0,1,1,0,0,2,0,2,Veneto,ITH3
2021-01-12,PF/BT,445440,C. SERV.RES.ANZ.- IRE SAN GIOBBE,VEN,70-79,0,1,0,0,0,1,0,1,0,1,Veneto,ITH3
2021-01-12,PF/BT,445440,C. SERV.RES.ANZ.- IRE SAN GIOBBE,VEN,80-89,0,1,0,0,0,1,0,1,0,1,Veneto,ITH3
2021-01-12,PF/BT,486001,C.A.S.A. MARIUTTO - MIRANO,VEN,30-39,0,1,0,1,0,0,0,1,0,1,Veneto,ITH3
2021-01-12,PF/BT,486001,C.A.S.A. MARIUTTO - MIRANO,VEN,40-49,0,3,0,2,1,0,0,3,0,3,Veneto,ITH3
2021-01-12,PF/BT,486001,C.A.S.A. MARIUTTO - MIRANO,VEN,50-59,2,2,0,2,1,1,0,4,0,4,Veneto,ITH3
2021-01-12,PF/BT,486001,C.A.S.A. MARIUTTO - MIRANO,VEN,60-69,4,2,0,0,0,6,0,6,0,6,Veneto,ITH3
2021-01-12,PF/BT,486001,C.A.S.A. MARIUTTO - MIRANO,VEN,70-79,12,6,0,0,0,18,0,18,0,18,Veneto,ITH3
2021-01-12,PF/BT,486001,C.A.S.A. MARIUTTO - MIRANO,VEN,80-89,11,22,0,0,0,33,0,33,0,33,Veneto,ITH3
2021-01-12,PF/BT,486001,C.A.S.A. MARIUTTO - MIRANO,VEN,90+,4,19,0,0,0,23,0,23,0,23,Veneto,ITH3
2021-01-12,PF/BT,486006,CASA DI RIPOSO - STRA,VEN,20-29,0,2,0,2,0,0,0,2,0,2,Veneto,ITH3
2021-01-12,PF/BT,486006,CASA DI RIPOSO - STRA,VEN,30-39,1,5,0,5,1,0,0,6,0,6,Veneto,ITH3
2021-01-12,PF/BT,486006,CASA DI RIPOSO - STRA,VEN,40-49,1,6,0,6,1,0,0,7,0,7,Veneto,ITH3
2021-01-12,PF/BT,486006,CASA DI RIPOSO - STRA,VEN,50-59,1,16,0,12,5,0,0,17,0,17,Veneto,ITH3
2021-01-12,PF/BT,486006,CASA DI RIPOSO - STRA,VEN,60-69,4,5,0,6,2,1,0,9,0,9,Veneto,ITH3
2021-01-12,PF/BT,486006,CASA DI RIPOSO - STRA,VEN,70-79,5,2,0,1,0,6,0,7,0,7,Veneto,ITH3
2021-01-12,PF/BT,486006,CASA DI RIPOSO - STRA,VEN,80-89,0,4,0,0,0,4,0,4,0,4,Veneto,ITH3
2021-01-12,PF/BT,486006,CASA DI RIPOSO - STRA,VEN,90+,1,1,0,0,0,2,0,2,0,2,Veneto,ITH3
2021-01-12,PF/BT,486011,RESIDENZA DELLA SALUTE - FIESSO D'ARTICO,VEN,20-29,1,4,0,3,2,0,0,5,0,5,Veneto,ITH3
2021-01-12,PF/BT,486011,RESIDENZA DELLA SALUTE - FIESSO D'ARTICO,VEN,30-39,4,10,0,11,3,0,0,14,0,14,Veneto,ITH3
2021-01-12,PF/BT,486011,RESIDENZA DELLA SALUTE - FIESSO D'ARTICO,VEN,40-49,3,7,0,9,1,0,0,10,0,10,Veneto,ITH3
2021-01-12,PF/BT,486011,RESIDENZA DELLA SALUTE - FIESSO D'ARTICO,VEN,50-59,1,6,0,6,0,1,0,7,0,7,Veneto,ITH3
2021-01-12,PF/BT,486011,RESIDENZA DELLA SALUTE - FIESSO D'ARTICO,VEN,60-69,0,6,0,1,1,4,0,6,0,6,Veneto,ITH3
2021-01-12,PF/BT,486011,RESIDENZA DELLA SALUTE - FIESSO D'ARTICO,VEN,70-79,7,9,0,0,0,16,0,16,0,16,Veneto,ITH3
2021-01-12,PF/BT,486011,RESIDENZA DELLA SALUTE - FIESSO D'ARTICO,VEN,80-89,6,30,0,0,0,36,0,36,0,36,Veneto,ITH3
2021-01-12,PF/BT,486011,RESIDENZA DELLA SALUTE - FIESSO D'ARTICO,VEN,90+,6,24,0,0,0,30,0,30,0,30,Veneto,ITH3
2021-01-12,PF/BT,5002200,OSPEDALE P. PEDERZOLI,VEN,20-29,6,12,0,18,0,0,0,18,0,18,Veneto,ITH3
2021-01-12,PF/BT,5002200,OSPEDALE P. PEDERZOLI,VEN,30-39,7,10,0,17,0,0,0,17,0,17,Veneto,ITH3
2021-01-12,PF/BT,5002200,OSPEDALE P. PEDERZOLI,VEN,40-49,6,17,0,23,0,0,0,23,0,23,Veneto,ITH3
2021-01-12,PF/BT,5002200,OSPEDALE P. PEDERZOLI,VEN,50-59,8,12,0,20,0,0,0,20,0,20,Veneto,ITH3
2021-01-12,PF/BT,5002200,OSPEDALE P. PEDERZOLI,VEN,60-69,4,3,0,7,0,0,0,7,0,7,Veneto,ITH3
2021-01-12,PF/BT,5002200,OSPEDALE P. PEDERZOLI,VEN,70-79,4,0,0,4,0,0,0,4,0,4,Veneto,ITH3
2021-01-12,PF/BT,50501,AGORDO - SERVIZIO IGIENE,VEN,20-29,1,0,0,0,1,0,0,1,0,1,Veneto,ITH3
2021-01-12,PF/BT,50501,AGORDO - SERVIZIO IGIENE,VEN,30-39,0,1,0,1,0,0,0,1,0,1,Veneto,ITH3
2021-01-12,PF/BT,50501,AGORDO - SERVIZIO IGIENE,VEN,40-49,2,4,0,4,2,0,0,6,0,6,Veneto,ITH3
2021-01-12,PF/BT,50501,AGORDO - SERVIZIO IGIENE,VEN,50-59,2,12,0,7,7,0,0,14,0,14,Veneto,ITH3
2021-01-12,PF/BT,50501,AGORDO - SERVIZIO IGIENE,VEN,60-69,20,6,0,2,0,0,24,26,0,26,Veneto,ITH3
2021-01-12,PF/BT,50501,BELLUNO AMBULATORIO N.15,VEN,70-79,1,2,0,0,0,0,3,3,0,3,Veneto,ITH3
2021-01-12,PF/BT,50501,BELLUNO AMBULATORIO N.15,VEN,80-89,63,73,0,0,0,0,136,136,0,136,Veneto,ITH3
2021-01-12,PF/BT,50501,BELLUNO AMBULATORIO N.15,VEN,90+,8,9,0,0,0,0,17,17,0,17,Veneto,ITH3
2021-01-12,PF/BT,50502,ODERZO,VEN,50-59,1,2,0,2,1,0,0,3,0,3,Veneto,ITH3
2021-01-12,PF/BT,50502,ODERZO,VEN,60-69,3,0,0,3,0,0,0,3,0,3,Veneto,ITH3
2021-01-12,PF/BT,50502,SISP - AMBULATORIO VIAGGIATORI,VEN,30-39,0,1,0,1,0,0,0,1,0,1,Veneto,ITH3
2021-01-12,PF/BT,50502,SISP - AMBULATORIO VIAGGIATORI,VEN,40-49,0,2,0,1,1,0,0,2,0,2,Veneto,ITH3
2021-01-12,PF/BT,50502,SISP - AMBULATORIO VIAGGIATORI,VEN,50-59,0,1,0,1,0,0,0,1,0,1,Veneto,ITH3
2021-01-12,PF/BT,50502,SISP - AMBULATORIO VIAGGIATORI,VEN,60-69,1,0,0,1,0,0,0,1,0,1,Veneto,ITH3
2021-01-12,PF/BT,50503,CHIOGGIA,VEN,20-29,0,4,0,1,0,0,3,4,0,4,Veneto,ITH3
2021-01-12,PF/BT,50503,CHIOGGIA,VEN,30-39,3,4,0,3,0,0,4,7,0,7,Veneto,ITH3
2021-01-12,PF/BT,50503,CHIOGGIA,VEN,40-49,2,5,0,4,0,0,3,7,0,7,Veneto,ITH3
2021-01-12,PF/BT,50503,CHIOGGIA,VEN,50-59,5,10,0,9,0,0,6,15,0,15,Veneto,ITH3
2021-01-12,PF/BT,50503,CHIOGGIA,VEN,60-69,8,7,0,15,0,0,0,15,0,15,Veneto,ITH3
2021-01-12,PF/BT,50503,MEDICINA PREVENTIVA MESTRE,VEN,16-19,1,0,0,0,1,0,0,1,0,1,Veneto,ITH3
2021-01-12,PF/BT,50503,MEDICINA PREVENTIVA MESTRE,VEN,20-29,11,8,0,13,6,0,0,19,0,19,Veneto,ITH3
2021-01-12,PF/BT,50503,MEDICINA PREVENTIVA MESTRE,VEN,30-39,17,14,0,16,15,0,0,31,0,31,Veneto,ITH3
2021-01-12,PF/BT,50503,MEDICINA PREVENTIVA MESTRE,VEN,40-49,12,26,0,16,22,0,0,38,0,38,Veneto,ITH3
2021-01-12,PF/BT,50503,MEDICINA PREVENTIVA MESTRE,VEN,50-59,22,31,0,28,25,0,0,53,0,53,Veneto,ITH3
2021-01-12,PF/BT,50503,MEDICINA PREVENTIVA MESTRE,VEN,60-69,11,7,0,9,9,0,0,18,0,18,Veneto,ITH3
2021-01-12,PF/BT,50503,MEDICINA PREVENTIVA MESTRE,VEN,70-79,1,1,0,0,2,0,0,2,0,2,Veneto,ITH3
2021-01-12,PF/BT,50503,MEDICINA PREVENTIVA VENEZIA,VEN,20-29,2,2,0,3,1,0,0,4,0,4,Veneto,ITH3
2021-01-12,PF/BT,50503,MEDICINA PREVENTIVA VENEZIA,VEN,30-39,4,5,0,6,3,0,0,9,0,9,Veneto,ITH3
2021-01-12,PF/BT,50503,MEDICINA PREVENTIVA VENEZIA,VEN,40-49,2,6,0,4,4,0,0,8,0,8,Veneto,ITH3
2021-01-12,PF/BT,50503,MEDICINA PREVENTIVA VENEZIA,VEN,50-59,4,13,0,11,6,0,0,17,0,17,Veneto,ITH3
2021-01-12,PF/BT,50503,MEDICINA PREVENTIVA VENEZIA,VEN,60-69,4,10,0,7,7,0,0,14,0,14,Veneto,ITH3
2021-01-12,PF/BT,50503,MEDICINA PREVENTIVA VENEZIA,VEN,70-79,7,1,0,1,7,0,0,8,0,8,Veneto,ITH3
2021-01-12,PF/BT,50503,S.I.S.P. VENEZIA,VEN,40-49,0,2,0,2,0,0,0,2,0,2,Veneto,ITH3
2021-01-12,PF/BT,50503,S.I.S.P. VENEZIA,VEN,50-59,0,3,0,3,0,0,0,3,0,3,Veneto,ITH3
2021-01-12,PF/BT,50503,S.I.S.P. VENEZIA,VEN,60-69,1,0,0,1,0,0,0,1,0,1,Veneto,ITH3
2021-01-12,PF/BT,50503,SISP DOLO ADULTI,VEN,20-29,6,13,0,17,2,0,0,19,0,19,Veneto,ITH3
2021-01-12,PF/BT,50503,SISP DOLO ADULTI,VEN,30-39,10,15,0,24,0,0,1,25,0,25,Veneto,ITH3
2021-01-12,PF/BT,50503,SISP DOLO ADULTI,VEN,40-49,11,34,0,38,0,0,7,45,0,45,Veneto,ITH3
2021-01-12,PF/BT,50503,SISP DOLO ADULTI,VEN,50-59,11,36,0,42,0,0,5,47,0,47,Veneto,ITH3
2021-01-12,PF/BT,50503,SISP DOLO ADULTI,VEN,60-69,10,15,0,23,0,0,2,25,0,25,Veneto,ITH3
2021-01-12,PF/BT,50503,SISP DOLO ADULTI,VEN,70-79,1,0,0,0,1,0,0,1,0,1,Veneto,ITH3
2021-01-12,PF/BT,50504,SAN DONA DI PIAVE SISP,VEN,30-39,1,3,0,0,2,2,0,4,0,4,Veneto,ITH3
2021-01-12,PF/BT,50504,SAN DONA DI PIAVE SISP,VEN,40-49,1,2,0,1,1,1,0,3,0,3,Veneto,ITH3
2021-01-12,PF/BT,50504,SAN DONA DI PIAVE SISP,VEN,50-59,3,8,0,1,6,4,0,11,0,11,Veneto,ITH3
2021-01-12,PF/BT,50504,SAN DONA DI PIAVE SISP,VEN,60-69,2,2,0,2,1,1,0,4,0,4,Veneto,ITH3
2021-01-12,PF/BT,50504,SANTO STINO DI LIVENZA,VEN,50-59,1,0,0,0,1,0,0,1,0,1,Veneto,ITH3
2021-01-12,PF/BT,50506,CAMPOSAMPIERO MEDICO COMPETENT,VEN,20-29,0,5,0,5,0,0,0,5,0,5,Veneto,ITH3
2021-01-12,PF/BT,50506,CAMPOSAMPIERO MEDICO COMPETENT,VEN,30-39,4,8,0,10,2,0,0,12,0,12,Veneto,ITH3
2021-01-12,PF/BT,50506,CAMPOSAMPIERO MEDICO COMPETENT,VEN,40-49,5,29,0,31,3,0,0,34,0,34,Veneto,ITH3
2021-01-12,PF/BT,50506,CAMPOSAMPIERO MEDICO COMPETENT,VEN,50-59,8,23,0,26,5,0,0,31,0,31,Veneto,ITH3
2021-01-12,PF/BT,50506,CAMPOSAMPIERO MEDICO COMPETENT,VEN,60-69,5,9,0,12,2,0,0,14,0,14,Veneto,ITH3
2021-01-12,PF/BT,50506,CAMPOSAMPIERO MEDICO COMPETENT,VEN,70-79,1,0,0,0,1,0,0,1,0,1,Veneto,ITH3
2021-01-12,PF/BT,50506,COLLI VACC. ADULTI,VEN,20-29,0,1,0,1,0,0,0,1,0,1,Veneto,ITH3
2021-01-12,PF/BT,50506,COLLI VACC. ADULTI,VEN,30-39,3,7,0,3,5,0,2,10,0,10,Veneto,ITH3
2021-01-12,PF/BT,50506,COLLI VACC. ADULTI,VEN,40-49,3,7,0,5,2,0,3,10,0,10,Veneto,ITH3
2021-01-12,PF/BT,50506,COLLI VACC. ADULTI,VEN,50-59,4,18,0,13,4,0,5,22,0,22,Veneto,ITH3
2021-01-12,PF/BT,50506,COLLI VACC. ADULTI,VEN,60-69,10,4,0,10,0,0,4,14,0,14,Veneto,ITH3
2021-01-12,PF/BT,50506,DIRIGENZA MEDICA P.D.SACCO,VEN,16-19,0,1,0,0,1,0,0,1,0,1,Veneto,ITH3
2021-01-12,PF/BT,50506,DIRIGENZA MEDICA P.D.SACCO,VEN,20-29,0,1,0,0,1,0,0,1,0,1,Veneto,ITH3
2021-01-12,PF/BT,50506,DIRIGENZA MEDICA P.D.SACCO,VEN,30-39,6,3,0,1,8,0,0,9,0,9,Veneto,ITH3
2021-01-12,PF/BT,50506,DIRIGENZA MEDICA P.D.SACCO,VEN,40-49,3,4,0,0,7,0,0,7,0,7,Veneto,ITH3
2021-01-12,PF/BT,50506,DIRIGENZA MEDICA P.D.SACCO,VEN,50-59,7,12,0,1,18,0,0,19,0,19,Veneto,ITH3
2021-01-12,PF/BT,50506,DIRIGENZA MEDICA P.D.SACCO,VEN,60-69,0,5,0,2,3,0,0,5,0,5,Veneto,ITH3
2021-01-12,PF/BT,50506,IGIENE PUBBLICA RUBANO,VEN,20-29,1,0,0,1,0,0,0,1,0,1,Veneto,ITH3
2021-01-12,PF/BT,50506,IGIENE PUBBLICA RUBANO,VEN,40-49,2,4,0,4,1,0,1,6,0,6,Veneto,ITH3
2021-01-12,PF/BT,50506,IGIENE PUBBLICA RUBANO,VEN,50-59,2,13,0,7,8,0,0,15,0,15,Veneto,ITH3
2021-01-12,PF/BT,50506,IGIENE PUBBLICA RUBANO,VEN,60-69,5,3,0,7,1,0,0,8,0,8,Veneto,ITH3
2021-01-12,PF/BT,50506,MONSELICE,VEN,16-19,0,3,0,0,0,3,0,3,0,3,Veneto,ITH3
2021-01-12,PF/BT,50506,MONSELICE,VEN,20-29,19,19,0,5,1,32,0,38,0,38,Veneto,ITH3
2021-01-12,PF/BT,50506,MONSELICE,VEN,30-39,9,8,0,3,4,9,1,17,0,17,Veneto,ITH3
2021-01-12,PF/BT,50506,MONSELICE,VEN,40-49,18,27,0,8,8,27,2,45,0,45,Veneto,ITH3
2021-01-12,PF/BT,50506,MONSELICE,VEN,50-59,17,26,0,16,8,16,3,43,0,43,Veneto,ITH3
2021-01-12,PF/BT,50506,MONSELICE,VEN,60-69,9,6,0,10,0,5,0,15,0,15,Veneto,ITH3
2021-01-12,PF/BT,50506,SCHIAVONIA AMBULATORIO,VEN,20-29,6,3,0,1,8,0,0,9,0,9,Veneto,ITH3
2021-01-12,PF/BT,50506,SCHIAVONIA AMBULATORIO,VEN,30-39,4,5,0,3,6,0,0,9,0,9,Veneto,ITH3
2021-01-12,PF/BT,50506,SCHIAVONIA AMBULATORIO,VEN,40-49,8,19,0,17,10,0,0,27,0,27,Veneto,ITH3
2021-01-12,PF/BT,50506,SCHIAVONIA AMBULATORIO,VEN,50-59,9,27,0,14,22,0,0,36,0,36,Veneto,ITH3
2021-01-12,PF/BT,50506,SCHIAVONIA AMBULATORIO,VEN,60-69,3,6,0,3,6,0,0,9,0,9,Veneto,ITH3
2021-01-12,PF/BT,50506,VIA SCROVEGNI ANTI INFLUENZALE,VEN,20-29,1,4,0,1,3,1,0,5,0,5,Veneto,ITH3
2021-01-12,PF/BT,50506,VIA SCROVEGNI ANTI INFLUENZALE,VEN,30-39,1,7,0,3,2,3,0,8,0,8,Veneto,ITH3
2021-01-12,PF/BT,50506,VIA SCROVEGNI ANTI INFLUENZALE,VEN,40-49,1,9,0,1,8,1,0,10,0,10,Veneto,ITH3
2021-01-12,PF/BT,50506,VIA SCROVEGNI ANTI INFLUENZALE,VEN,50-59,6,10,0,10,6,0,0,16,0,16,Veneto,ITH3
2021-01-12,PF/BT,50506,VIA SCROVEGNI ANTI INFLUENZALE,VEN,60-69,0,3,0,1,2,0,0,3,0,3,Veneto,ITH3
2021-01-12,PF/BT,50506,VIA TEMANZA ANTI INFLUENZALE,VEN,20-29,1,1,0,2,0,0,0,2,0,2,Veneto,ITH3
2021-01-12,PF/BT,50506,VIA TEMANZA ANTI INFLUENZALE,VEN,30-39,3,2,0,5,0,0,0,5,0,5,Veneto,ITH3
2021-01-12,PF/BT,50506,VIA TEMANZA ANTI INFLUENZALE,VEN,40-49,1,3,0,4,0,0,0,4,0,4,Veneto,ITH3
2021-01-12,PF/BT,50506,VIA TEMANZA ANTI INFLUENZALE,VEN,50-59,3,4,0,7,0,0,0,7,0,7,Veneto,ITH3
2021-01-12,PF/BT,50506,VIA TEMANZA ANTI INFLUENZALE,VEN,60-69,7,5,0,12,0,0,0,12,0,12,Veneto,ITH3
2021-01-12,PF/BT,50507,DIPARTIMENTO DI PREVENZIONE,VEN,20-29,1,1,0,0,0,2,0,2,0,2,Veneto,ITH3
2021-01-12,PF/BT,50507,DIPARTIMENTO DI PREVENZIONE,VEN,30-39,2,1,0,3,0,0,0,3,0,3,Veneto,ITH3
2021-01-12,PF/BT,50507,DIPARTIMENTO DI PREVENZIONE,VEN,50-59,0,3,0,2,0,1,0,3,0,3,Veneto,ITH3
2021-01-12,PF/BT,50507,DIPARTIMENTO DI PREVENZIONE,VEN,70-79,1,0,0,1,0,0,0,1,0,1,Veneto,ITH3
2021-01-12,PF/BT,50507,EX OSPEDALE - BOLDRINI,VEN,30-39,1,2,0,3,0,0,0,3,0,3,Veneto,ITH3
2021-01-12,PF/BT,50507,EX OSPEDALE - BOLDRINI,VEN,40-49,3,6,0,9,0,0,0,9,0,9,Veneto,ITH3
2021-01-12,PF/BT,50507,EX OSPEDALE - BOLDRINI,VEN,50-59,7,14,0,21,0,0,0,21,0,21,Veneto,ITH3
2021-01-12,PF/BT,50507,EX OSPEDALE - BOLDRINI,VEN,60-69,3,7,0,10,0,0,0,10,0,10,Veneto,ITH3
2021-01-12,PF/BT,50507,EX OSPEDALE - BOLDRINI,VEN,70-79,0,2,0,2,0,0,0,2,0,2,Veneto,ITH3
2021-01-12,PF/BT,50507,EX OSPEDALE - BOLDRINI,VEN,80-89,0,1,0,1,0,0,0,1,0,1,Veneto,ITH3
2021-01-12,PF/BT,50507,H BASSANO,VEN,20-29,3,3,0,0,6,0,0,6,0,6,Veneto,ITH3
2021-01-12,PF/BT,50507,H BASSANO,VEN,30-39,4,3,0,1,6,0,0,7,0,7,Veneto,ITH3
2021-01-12,PF/BT,50507,H BASSANO,VEN,40-49,3,5,0,2,6,0,0,8,0,8,Veneto,ITH3
2021-01-12,PF/BT,50507,H BASSANO,VEN,50-59,5,16,0,5,16,0,0,21,0,21,Veneto,ITH3
2021-01-12,PF/BT,50507,H BASSANO,VEN,60-69,2,4,0,4,2,0,0,6,0,6,Veneto,ITH3
2021-01-12,PF/BT,5050801,MED.COMP. - OSP. SAN BORTOLO,VEN,16-19,2,1,0,0,1,0,2,3,0,3,Veneto,ITH3
2021-01-12,PF/BT,5050801,MED.COMP. - OSP. SAN BORTOLO,VEN,20-29,8,23,0,18,6,0,7,31,0,31,Veneto,ITH3
2021-01-12,PF/BT,5050801,MED.COMP. - OSP. SAN BORTOLO,VEN,30-39,20,26,0,24,14,0,8,46,0,46,Veneto,ITH3
2021-01-12,PF/BT,5050801,MED.COMP. - OSP. SAN BORTOLO,VEN,40-49,19,49,0,28,22,0,18,68,0,68,Veneto,ITH3
2021-01-12,PF/BT,5050801,MED.COMP. - OSP. SAN BORTOLO,VEN,50-59,24,63,0,59,14,0,14,87,0,87,Veneto,ITH3
2021-01-12,PF/BT,5050801,MED.COMP. - OSP. SAN BORTOLO,VEN,60-69,12,14,0,11,14,0,1,26,0,26,Veneto,ITH3
2021-01-12,PF/BT,5050801,MED.COMP. - OSP. SAN BORTOLO,VEN,70-79,4,1,0,2,3,0,0,5,0,5,Veneto,ITH3
2021-01-12,PF/BT,5050801,MED.COMP. - OSP. SAN BORTOLO,VEN,80-89,2,1,0,1,0,0,2,3,0,3,Veneto,ITH3
2021-01-12,PF/BT,5050806,MED.COMP. - OSP. NUOVO SAN LOR,VEN,20-29,5,7,0,10,2,0,0,12,0,12,Veneto,ITH3
2021-01-12,PF/BT,5050806,MED.COMP. - OSP. NUOVO SAN LOR,VEN,30-39,6,10,0,13,2,0,1,16,0,16,Veneto,ITH3
2021-01-12,PF/BT,5050806,MED.COMP. - OSP. NUOVO SAN LOR,VEN,40-49,4,40,0,37,6,0,1,44,0,44,Veneto,ITH3
2021-01-12,PF/BT,5050806,MED.COMP. - OSP. NUOVO SAN LOR,VEN,50-59,18,84,0,81,19,0,2,102,0,102,Veneto,ITH3
2021-01-12,PF/BT,5050806,MED.COMP. - OSP. NUOVO SAN LOR,VEN,60-69,6,9,0,11,3,0,1,15,0,15,Veneto,ITH3
2021-01-12,PF/BT,5050806,MED.COMP. - OSP. NUOVO SAN LOR,VEN,70-79,1,0,0,1,0,0,0,1,0,1,Veneto,ITH3
2021-01-12,PF/BT,563033,R.S.A. VILLA BREDA,VEN,20-29,0,2,0,2,0,0,0,2,0,2,Veneto,ITH3
2021-01-12,PF/BT,563033,R.S.A. VILLA BREDA,VEN,30-39,0,5,0,2,3,0,0,5,0,5,Veneto,ITH3
2021-01-12,PF/BT,563033,R.S.A. VILLA BREDA,VEN,40-49,1,4,0,2,3,0,0,5,0,5,Veneto,ITH3
2021-01-12,PF/BT,563033,R.S.A. VILLA BREDA,VEN,50-59,0,3,0,3,0,0,0,3,0,3,Veneto,ITH3
2021-01-12,PF/BT,563033,R.S.A. VILLA BREDA,VEN,60-69,1,4,0,0,2,3,0,5,0,5,Veneto,ITH3
2021-01-12,PF/BT,563033,R.S.A. VILLA BREDA,VEN,70-79,0,3,0,0,0,3,0,3,0,3,Veneto,ITH3
2021-01-12,PF/BT,563033,R.S.A. VILLA BREDA,VEN,80-89,0,3,0,0,0,3,0,3,0,3,Veneto,ITH3
2021-01-12,PF/BT,563033,R.S.A. VILLA BREDA,VEN,90+,0,4,0,0,0,4,0,4,0,4,Veneto,ITH3
2021-01-12,PF/BT,610903,CASA DI CURA ABANO TERME SPA,VEN,20-29,9,9,0,17,0,0,1,18,0,18,Veneto,ITH3
2021-01-12,PF/BT,610903,CASA DI CURA ABANO TERME SPA,VEN,30-39,15,10,0,25,0,0,0,25,0,25,Veneto,ITH3
2021-01-12,PF/BT,610903,CASA DI CURA ABANO TERME SPA,VEN,40-49,16,12,0,28,0,0,0,28,0,28,Veneto,ITH3
2021-01-12,PF/BT,610903,CASA DI CURA ABANO TERME SPA,VEN,50-59,16,14,0,30,0,0,0,30,0,30,Veneto,ITH3
2021-01-12,PF/BT,610903,CASA DI CURA ABANO TERME SPA,VEN,60-69,4,5,0,9,0,0,0,9,0,9,Veneto,ITH3
2021-01-12,PF/BT,610903,CASA DI CURA ABANO TERME SPA,VEN,70-79,1,0,0,1,0,0,0,1,0,1,Veneto,ITH3
2021-01-12,PF/BT,610952,O.I.C. CENTRO NAZARETH,VEN,20-29,0,1,0,0,1,0,0,1,0,1,Veneto,ITH3
2021-01-12,PF/BT,610952,O.I.C. CENTRO NAZARETH,VEN,40-49,1,3,0,2,2,0,0,4,0,4,Veneto,ITH3
2021-01-12,PF/BT,610952,O.I.C. CENTRO NAZARETH,VEN,50-59,0,8,0,6,2,0,0,8,0,8,Veneto,ITH3
2021-01-12,PF/BT,610952,O.I.C. CENTRO NAZARETH,VEN,60-69,0,2,0,1,0,1,0,2,0,2,Veneto,ITH3
2021-01-12,PF/BT,610952,O.I.C. CENTRO NAZARETH,VEN,90+,0,1,0,0,0,1,0,1,0,1,Veneto,ITH3
2021-01-12,PF/BT,610955,OPSA - OPERA PROVVIDENZA S.ANTONIO DISABILI,VEN,20-29,2,1,0,1,2,0,0,3,0,3,Veneto,ITH3
2021-01-12,PF/BT,610955,OPSA - OPERA PROVVIDENZA S.ANTONIO DISABILI,VEN,30-39,4,1,0,3,1,1,0,5,0,5,Veneto,ITH3
2021-01-12,PF/BT,610955,OPSA - OPERA PROVVIDENZA S.ANTONIO DISABILI,VEN,40-49,4,10,0,8,5,1,0,14,0,14,Veneto,ITH3
2021-01-12,PF/BT,610955,OPSA - OPERA PROVVIDENZA S.ANTONIO DISABILI,VEN,50-59,10,13,0,17,2,4,0,23,0,23,Veneto,ITH3
2021-01-12,PF/BT,610955,OPSA - OPERA PROVVIDENZA S.ANTONIO DISABILI,VEN,60-69,2,2,0,0,2,2,0,4,0,4,Veneto,ITH3
2021-01-12,PF/BT,610955,OPSA - OPERA PROVVIDENZA S.ANTONIO DISABILI,VEN,80-89,0,2,0,0,0,2,0,2,0,2,Veneto,ITH3
2021-01-12,PF/BT,611145,OIC - CENTRO RESIDENZIALE CIVITAS VITAE,VEN,40-49,0,1,0,1,0,0,0,1,0,1,Veneto,ITH3
2021-01-12,PF/BT,611145,OIC - CENTRO RESIDENZIALE CIVITAS VITAE,VEN,50-59,1,1,0,1,1,0,0,2,0,2,Veneto,ITH3
2021-01-12,PF/BT,611145,OIC - CENTRO RESIDENZIALE CIVITAS VITAE,VEN,70-79,1,3,0,0,0,4,0,4,0,4,Veneto,ITH3
2021-01-12,PF/BT,611145,OIC - CENTRO RESIDENZIALE CIVITAS VITAE,VEN,80-89,0,10,0,0,0,10,0,10,0,10,Veneto,ITH3
2021-01-12,PF/BT,611145,OIC - CENTRO RESIDENZIALE CIVITAS VITAE,VEN,90+,0,13,0,0,0,13,0,13,0,13,Veneto,ITH3
2021-01-12,PF/BT,611160,CASA DI RIPOSO 'A. GALVAN',VEN,50-59,1,1,0,0,0,2,0,2,0,2,Veneto,ITH3
2021-01-12,PF/BT,611160,CASA DI RIPOSO 'A. GALVAN',VEN,60-69,4,2,0,1,0,5,0,6,0,6,Veneto,ITH3
2021-01-12,PF/BT,611160,CASA DI RIPOSO 'A. GALVAN',VEN,70-79,1,4,0,0,0,5,0,5,0,5,Veneto,ITH3
2021-01-12,PF/BT,611160,CASA DI RIPOSO 'A. GALVAN',VEN,80-89,4,10,0,0,0,14,0,14,0,14,Veneto,ITH3
2021-01-12,PF/BT,611160,CASA DI RIPOSO 'A. GALVAN',VEN,90+,2,7,0,0,0,9,0,9,0,9,Veneto,ITH3
2021-01-12,PF/BT,611182,ALTAVITA IRA - PALAZZO 'G.A. BOLIS',VEN,20-29,2,1,0,1,2,0,0,3,0,3,Veneto,ITH3
2021-01-12,PF/BT,611182,ALTAVITA IRA - PALAZZO 'G.A. BOLIS',VEN,30-39,2,3,0,3,2,0,0,5,0,5,Veneto,ITH3
2021-01-12,PF/BT,611182,ALTAVITA IRA - PALAZZO 'G.A. BOLIS',VEN,40-49,1,8,0,5,4,0,0,9,0,9,Veneto,ITH3
2021-01-12,PF/BT,611182,ALTAVITA IRA - PALAZZO 'G.A. BOLIS',VEN,50-59,3,8,0,6,4,1,0,11,0,11,Veneto,ITH3
2021-01-12,PF/BT,611182,ALTAVITA IRA - PALAZZO 'G.A. BOLIS',VEN,60-69,3,3,0,2,3,1,0,6,0,6,Veneto,ITH3
2021-01-12,PF/BT,611182,ALTAVITA IRA - PALAZZO 'G.A. BOLIS',VEN,70-79,2,1,0,0,0,3,0,3,0,3,Veneto,ITH3
2021-01-12,PF/BT,611182,ALTAVITA IRA - PALAZZO 'G.A. BOLIS',VEN,80-89,7,5,0,0,0,12,0,12,0,12,Veneto,ITH3
2021-01-12,PF/BT,611182,ALTAVITA IRA - PALAZZO 'G.A. BOLIS',VEN,90+,2,2,0,0,0,4,0,4,0,4,Veneto,ITH3
2021-01-12,PF/BT,611198,OPSA - CASA MASSIMILIANO KOLBE,VEN,90+,0,1,0,0,0,1,0,1,0,1,Veneto,ITH3
2021-01-12,PF/BT,611234,CASA DEI FONDATORI,VEN,90+,1,0,0,0,0,1,0,1,0,1,Veneto,ITH3
2021-01-12,PF/BT,611243,CENTRO DI RIFERIMENTO PER LE GRAVI DISABILITA' E DISTIURBI DEL COMPORTAMENTO,VEN,40-49,1,0,0,0,0,1,0,1,0,1,Veneto,ITH3
2021-01-12,PF/BT,611243,CENTRO DI RIFERIMENTO PER LE GRAVI DISABILITA' E DISTIURBI DEL COMPORTAMENTO,VEN,50-59,1,0,0,0,0,1,0,1,0,1,Veneto,ITH3
2021-01-12,PF/BT,611257,PROVINCIA DI S. ANTONIO ORDINE FRATI MINORI - CASA SACRO CUORE,VEN,30-39,1,0,0,1,0,0,0,1,0,1,Veneto,ITH3
2021-01-12,PF/BT,611257,PROVINCIA DI S. ANTONIO ORDINE FRATI MINORI - CASA SACRO CUORE,VEN,70-79,2,0,0,0,0,2,0,2,0,2,Veneto,ITH3
2021-01-12,PF/BT,611257,PROVINCIA DI S. ANTONIO ORDINE FRATI MINORI - CASA SACRO CUORE,VEN,80-89,1,0,0,0,0,1,0,1,0,1,Veneto,ITH3
2021-01-12,PF/BT,611257,PROVINCIA DI S. ANTONIO ORDINE FRATI MINORI - CASA SACRO CUORE,VEN,90+,2,0,0,0,0,2,0,2,0,2,Veneto,ITH3
2021-01-12,PF/BT,611275,"RESIDENZA SOCIO-SANITARIA PSICHIATRICA ""PARCO DEI TIGLI""",VEN,20-29,1,3,0,4,0,0,0,4,0,4,Veneto,ITH3
2021-01-12,PF/BT,611275,"RESIDENZA SOCIO-SANITARIA PSICHIATRICA ""PARCO DEI TIGLI""",VEN,30-39,0,4,0,3,0,0,1,4,0,4,Veneto,ITH3
2021-01-12,PF/BT,611275,"RESIDENZA SOCIO-SANITARIA PSICHIATRICA ""PARCO DEI TIGLI""",VEN,40-49,1,11,0,10,0,0,2,12,0,12,Veneto,ITH3
2021-01-12,PF/BT,611275,"RESIDENZA SOCIO-SANITARIA PSICHIATRICA ""PARCO DEI TIGLI""",VEN,50-59,3,11,0,9,0,2,3,14,0,14,Veneto,ITH3
2021-01-12,PF/BT,611275,"RESIDENZA SOCIO-SANITARIA PSICHIATRICA ""PARCO DEI TIGLI""",VEN,60-69,5,1,0,5,0,1,0,6,0,6,Veneto,ITH3
2021-01-12,PF/BT,611275,"RESIDENZA SOCIO-SANITARIA PSICHIATRICA ""PARCO DEI TIGLI""",VEN,80-89,1,1,0,0,0,0,2,2,0,2,Veneto,ITH3
2021-01-12,PF/BT,642093,"CASA DI RIPOSO ""SANTA TECLA"" ESTE",VEN,16-19,1,0,0,1,0,0,0,1,0,1,Veneto,ITH3
2021-01-12,PF/BT,642093,"CASA DI RIPOSO ""SANTA TECLA"" ESTE",VEN,20-29,0,3,0,3,0,0,0,3,0,3,Veneto,ITH3
2021-01-12,PF/BT,642093,"CASA DI RIPOSO ""SANTA TECLA"" ESTE",VEN,30-39,0,7,0,6,1,0,0,7,0,7,Veneto,ITH3
2021-01-12,PF/BT,642093,"CASA DI RIPOSO ""SANTA TECLA"" ESTE",VEN,40-49,3,8,0,6,5,0,0,11,0,11,Veneto,ITH3
2021-01-12,PF/BT,642093,"CASA DI RIPOSO ""SANTA TECLA"" ESTE",VEN,50-59,1,12,0,9,4,0,0,13,0,13,Veneto,ITH3
2021-01-12,PF/BT,642093,"CASA DI RIPOSO ""SANTA TECLA"" ESTE",VEN,60-69,0,1,0,1,0,0,0,1,0,1,Veneto,ITH3
2021-01-12,PF/BT,642095,CASA DI RIPOSO MONSELICE,VEN,20-29,0,2,0,1,1,0,0,2,0,2,Veneto,ITH3
2021-01-12,PF/BT,642095,CASA DI RIPOSO MONSELICE,VEN,30-39,0,6,0,4,2,0,0,6,0,6,Veneto,ITH3
2021-01-12,PF/BT,642095,CASA DI RIPOSO MONSELICE,VEN,40-49,4,6,0,6,4,0,0,10,0,10,Veneto,ITH3
2021-01-12,PF/BT,642095,CASA DI RIPOSO MONSELICE,VEN,50-59,3,12,0,12,3,0,0,15,0,15,Veneto,ITH3
2021-01-12,PF/BT,642095,CASA DI RIPOSO MONSELICE,VEN,60-69,4,6,0,2,3,5,0,10,0,10,Veneto,ITH3
2021-01-12,PF/BT,642095,CASA DI RIPOSO MONSELICE,VEN,70-79,8,9,0,0,1,16,0,17,0,17,Veneto,ITH3
2021-01-12,PF/BT,642095,CASA DI RIPOSO MONSELICE,VEN,80-89,5,32,0,0,0,37,0,37,0,37,Veneto,ITH3
2021-01-12,PF/BT,642095,CASA DI RIPOSO MONSELICE,VEN,90+,3,18,0,0,0,21,0,21,0,21,Veneto,ITH3
2021-01-12,PF/BT,642096,CASA DI RIPOSO MONTAGNANA,VEN,30-39,1,0,0,0,0,1,0,1,0,1,Veneto,ITH3
2021-01-12,PF/BT,642096,CASA DI RIPOSO MONTAGNANA,VEN,50-59,2,0,0,0,0,2,0,2,0,2,Veneto,ITH3
2021-01-12,PF/BT,642096,CASA DI RIPOSO MONTAGNANA,VEN,60-69,3,5,0,0,0,8,0,8,0,8,Veneto,ITH3
2021-01-12,PF/BT,642096,CASA DI RIPOSO MONTAGNANA,VEN,70-79,3,7,0,0,0,10,0,10,0,10,Veneto,ITH3
2021-01-12,PF/BT,642096,CASA DI RIPOSO MONTAGNANA,VEN,80-89,5,45,0,0,0,50,0,50,0,50,Veneto,ITH3
2021-01-12,PF/BT,642096,CASA DI RIPOSO MONTAGNANA,VEN,90+,1,35,0,0,0,36,0,36,0,36,Veneto,ITH3
2021-01-12,PF/BT,642114,C.S.A. 'VALGRANDE',VEN,20-29,0,4,0,4,0,0,0,4,0,4,Veneto,ITH3
2021-01-12,PF/BT,642114,C.S.A. 'VALGRANDE',VEN,30-39,0,6,0,6,0,0,0,6,0,6,Veneto,ITH3
2021-01-12,PF/BT,642114,C.S.A. 'VALGRANDE',VEN,40-49,0,8,0,6,2,0,0,8,0,8,Veneto,ITH3
2021-01-12,PF/BT,642114,C.S.A. 'VALGRANDE',VEN,50-59,0,4,0,2,2,0,0,4,0,4,Veneto,ITH3
2021-01-12,PF/BT,642114,C.S.A. 'VALGRANDE',VEN,60-69,0,3,0,3,0,0,0,3,0,3,Veneto,ITH3
2021-01-12,PF/BT,642114,C.S.A. 'VALGRANDE',VEN,70-79,1,2,0,0,0,3,0,3,0,3,Veneto,ITH3
2021-01-12,PF/BT,642114,C.S.A. 'VALGRANDE',VEN,80-89,2,8,0,0,0,10,0,10,0,10,Veneto,ITH3
2021-01-12,PF/BT,642114,C.S.A. 'VALGRANDE',VEN,90+,1,9,0,0,0,10,0,10,0,10,Veneto,ITH3
2021-01-12,PF/BT,642140,CENTRO SERVIZI 'VILLAGGIO ANZIANI TRA NOI' SOLESINO,VEN,30-39,0,1,0,1,0,0,0,1,0,1,Veneto,ITH3
2021-01-12,PF/BT,642140,CENTRO SERVIZI 'VILLAGGIO ANZIANI TRA NOI' SOLESINO,VEN,40-49,0,2,0,2,0,0,0,2,0,2,Veneto,ITH3
2021-01-12,PF/BT,642140,CENTRO SERVIZI 'VILLAGGIO ANZIANI TRA NOI' SOLESINO,VEN,50-59,0,3,0,3,0,0,0,3,0,3,Veneto,ITH3
2021-01-12,PF/BT,642140,CENTRO SERVIZI 'VILLAGGIO ANZIANI TRA NOI' SOLESINO,VEN,60-69,1,0,0,1,0,0,0,1,0,1,Veneto,ITH3
2021-01-12,PF/BT,642140,CENTRO SERVIZI 'VILLAGGIO ANZIANI TRA NOI' SOLESINO,VEN,80-89,0,2,0,0,0,2,0,2,0,2,Veneto,ITH3
2021-01-12,PF/BT,642140,CENTRO SERVIZI 'VILLAGGIO ANZIANI TRA NOI' SOLESINO,VEN,90+,1,1,0,0,0,2,0,2,0,2,Veneto,ITH3
2021-01-12,PF/BT,683013,IRAS IST. RODIGINO DI ASS. SOC,VEN,16-19,0,2,0,2,0,0,0,2,0,2,Veneto,ITH3
2021-01-12,PF/BT,683013,IRAS IST. RODIGINO DI ASS. SOC,VEN,20-29,1,1,0,2,0,0,0,2,0,2,Veneto,ITH3
2021-01-12,PF/BT,683013,IRAS IST. RODIGINO DI ASS. SOC,VEN,30-39,0,3,0,3,0,0,0,3,0,3,Veneto,ITH3
2021-01-12,PF/BT,683013,IRAS IST. RODIGINO DI ASS. SOC,VEN,40-49,0,12,0,12,0,0,0,12,0,12,Veneto,ITH3
2021-01-12,PF/BT,683013,IRAS IST. RODIGINO DI ASS. SOC,VEN,50-59,10,27,0,35,0,0,2,37,0,37,Veneto,ITH3
2021-01-12,PF/BT,683013,IRAS IST. RODIGINO DI ASS. SOC,VEN,60-69,7,4,0,4,0,4,3,11,0,11,Veneto,ITH3
2021-01-12,PF/BT,683013,IRAS IST. RODIGINO DI ASS. SOC,VEN,70-79,6,4,0,0,0,6,4,10,0,10,Veneto,ITH3
2021-01-12,PF/BT,683013,IRAS IST. RODIGINO DI ASS. SOC,VEN,80-89,9,15,0,0,0,16,8,24,0,24,Veneto,ITH3
2021-01-12,PF/BT,683013,IRAS IST. RODIGINO DI ASS. SOC,VEN,90+,4,11,0,0,0,14,1,15,0,15,Veneto,ITH3
2021-01-12,PF/BT,683026,RESIDENZA ANNI AZZURRI S.ANNA,VEN,20-29,2,10,0,11,1,0,0,12,0,12,Veneto,ITH3
2021-01-12,PF/BT,683026,RESIDENZA ANNI AZZURRI S.ANNA,VEN,30-39,1,9,0,7,3,0,0,10,0,10,Veneto,ITH3
2021-01-12,PF/BT,683026,RESIDENZA ANNI AZZURRI S.ANNA,VEN,40-49,1,9,0,5,5,0,0,10,0,10,Veneto,ITH3
2021-01-12,PF/BT,683026,RESIDENZA ANNI AZZURRI S.ANNA,VEN,50-59,4,13,0,11,5,1,0,17,0,17,Veneto,ITH3
2021-01-12,PF/BT,683026,RESIDENZA ANNI AZZURRI S.ANNA,VEN,60-69,0,1,0,0,1,0,0,1,0,1,Veneto,ITH3
2021-01-12,PF/BT,683026,RESIDENZA ANNI AZZURRI S.ANNA,VEN,70-79,2,3,0,1,0,4,0,5,0,5,Veneto,ITH3
2021-01-12,PF/BT,683026,RESIDENZA ANNI AZZURRI S.ANNA,VEN,80-89,3,22,0,0,0,25,0,25,0,25,Veneto,ITH3
2021-01-12,PF/BT,683026,RESIDENZA ANNI AZZURRI S.ANNA,VEN,90+,2,17,0,0,0,19,0,19,0,19,Veneto,ITH3
2021-01-12,PF/BT,765058,SOGGIORNO PER ANZIANI 'VILLA SPREA',VEN,20-29,0,2,0,1,1,0,0,2,0,2,Veneto,ITH3
2021-01-12,PF/BT,765058,SOGGIORNO PER ANZIANI 'VILLA SPREA',VEN,30-39,1,1,0,2,0,0,0,2,0,2,Veneto,ITH3
2021-01-12,PF/BT,765058,SOGGIORNO PER ANZIANI 'VILLA SPREA',VEN,40-49,1,5,0,6,0,0,0,6,0,6,Veneto,ITH3
2021-01-12,PF/BT,765058,SOGGIORNO PER ANZIANI 'VILLA SPREA',VEN,50-59,2,4,0,3,2,1,0,6,0,6,Veneto,ITH3
2021-01-12,PF/BT,765058,SOGGIORNO PER ANZIANI 'VILLA SPREA',VEN,60-69,1,0,0,0,0,1,0,1,0,1,Veneto,ITH3
2021-01-12,PF/BT,765058,SOGGIORNO PER ANZIANI 'VILLA SPREA',VEN,70-79,7,4,0,0,0,11,0,11,0,11,Veneto,ITH3
2021-01-12,PF/BT,765058,SOGGIORNO PER ANZIANI 'VILLA SPREA',VEN,80-89,9,13,0,0,0,22,0,22,0,22,Veneto,ITH3
2021-01-12,PF/BT,765058,SOGGIORNO PER ANZIANI 'VILLA SPREA',VEN,90+,0,16,0,0,0,16,0,16,0,16,Veneto,ITH3
2021-01-12,PF/BT,767059,C.D.R. 'DON MOZZATTI D'APRILI',VEN,16-19,0,1,0,1,0,0,0,1,0,1,Veneto,ITH3
2021-01-12,PF/BT,767059,C.D.R. 'DON MOZZATTI D'APRILI',VEN,20-29,4,10,0,12,2,0,0,14,0,14,Veneto,ITH3
2021-01-12,PF/BT,767059,C.D.R. 'DON MOZZATTI D'APRILI',VEN,30-39,2,14,0,13,3,0,0,16,0,16,Veneto,ITH3
2021-01-12,PF/BT,767059,C.D.R. 'DON MOZZATTI D'APRILI',VEN,40-49,7,30,0,32,4,1,0,37,0,37,Veneto,ITH3
2021-01-12,PF/BT,767059,C.D.R. 'DON MOZZATTI D'APRILI',VEN,50-59,2,34,0,33,3,0,0,36,0,36,Veneto,ITH3
2021-01-12,PF/BT,767059,C.D.R. 'DON MOZZATTI D'APRILI',VEN,60-69,1,4,0,4,1,0,0,5,0,5,Veneto,ITH3
2021-01-12,PF/BT,767059,C.D.R. 'DON MOZZATTI D'APRILI',VEN,70-79,4,5,0,0,0,9,0,9,0,9,Veneto,ITH3
2021-01-12,PF/BT,767059,C.D.R. 'DON MOZZATTI D'APRILI',VEN,80-89,5,7,0,0,0,12,0,12,0,12,Veneto,ITH3
2021-01-12,PF/BT,767059,C.D.R. 'DON MOZZATTI D'APRILI',VEN,90+,0,9,0,0,0,9,0,9,0,9,Veneto,ITH3
2021-01-12,PF/BT,768037,CEN. RES. PIA OPERA CICCARELLI,VEN,20-29,1,5,0,6,0,0,0,6,0,6,Veneto,ITH3
2021-01-12,PF/BT,768037,CEN. RES. PIA OPERA CICCARELLI,VEN,30-39,1,2,0,2,0,0,1,3,0,3,Veneto,ITH3
2021-01-12,PF/BT,768037,CEN. RES. PIA OPERA CICCARELLI,VEN,40-49,0,9,0,9,0,0,0,9,0,9,Veneto,ITH3
2021-01-12,PF/BT,768037,CEN. RES. PIA OPERA CICCARELLI,VEN,50-59,3,14,0,17,0,0,0,17,0,17,Veneto,ITH3
2021-01-12,PF/BT,768037,CEN. RES. PIA OPERA CICCARELLI,VEN,60-69,2,6,0,4,0,4,0,8,0,8,Veneto,ITH3
2021-01-12,PF/BT,768037,CEN. RES. PIA OPERA CICCARELLI,VEN,70-79,0,7,0,0,0,7,0,7,0,7,Veneto,ITH3
2021-01-12,PF/BT,768037,CEN. RES. PIA OPERA CICCARELLI,VEN,80-89,4,8,0,0,0,12,0,12,0,12,Veneto,ITH3
2021-01-12,PF/BT,768037,CEN. RES. PIA OPERA CICCARELLI,VEN,90+,1,8,0,0,0,9,0,9,0,9,Veneto,ITH3
2021-01-12,PF/BT,768049,C.D.R. 'CONTE A. DA PRATO',VEN,20-29,0,4,0,4,0,0,0,4,0,4,Veneto,ITH3
2021-01-12,PF/BT,768049,C.D.R. 'CONTE A. DA PRATO',VEN,40-49,2,6,0,8,0,0,0,8,0,8,Veneto,ITH3
2021-01-12,PF/BT,768049,C.D.R. 'CONTE A. DA PRATO',VEN,50-59,0,13,0,13,0,0,0,13,0,13,Veneto,ITH3
2021-01-12,PF/BT,768049,C.D.R. 'CONTE A. DA PRATO',VEN,60-69,0,3,0,3,0,0,0,3,0,3,Veneto,ITH3
2021-01-12,PF/BT,768049,C.D.R. 'CONTE A. DA PRATO',VEN,70-79,0,2,0,0,0,2,0,2,0,2,Veneto,ITH3
2021-01-12,PF/BT,768049,C.D.R. 'CONTE A. DA PRATO',VEN,80-89,3,10,0,0,0,13,0,13,0,13,Veneto,ITH3
2021-01-12,PF/BT,768049,C.D.R. 'CONTE A. DA PRATO',VEN,90+,1,12,0,0,0,13,0,13,0,13,Veneto,ITH3
2021-01-12,PF/BT,768203,CENTRO SERVIZI PER ANZIANI LE BETULLE,VEN,20-29,1,3,0,3,1,0,0,4,0,4,Veneto,ITH3
2021-01-12,PF/BT,768203,CENTRO SERVIZI PER ANZIANI LE BETULLE,VEN,30-39,0,3,0,3,0,0,0,3,0,3,Veneto,ITH3
2021-01-12,PF/BT,768203,CENTRO SERVIZI PER ANZIANI LE BETULLE,VEN,40-49,0,7,0,7,0,0,0,7,0,7,Veneto,ITH3
2021-01-12,PF/BT,768203,CENTRO SERVIZI PER ANZIANI LE BETULLE,VEN,50-59,1,3,0,4,0,0,0,4,0,4,Veneto,ITH3
2021-01-12,PF/BT,768203,CENTRO SERVIZI PER ANZIANI LE BETULLE,VEN,60-69,0,1,0,1,0,0,0,1,0,1,Veneto,ITH3
2021-01-12,PF/BT,768203,CENTRO SERVIZI PER ANZIANI LE BETULLE,VEN,70-79,2,7,0,0,0,9,0,9,0,9,Veneto,ITH3
2021-01-12,PF/BT,768203,CENTRO SERVIZI PER ANZIANI LE BETULLE,VEN,80-89,4,22,0,0,0,26,0,26,0,26,Veneto,ITH3
2021-01-12,PF/BT,768203,CENTRO SERVIZI PER ANZIANI LE BETULLE,VEN,90+,3,20,0,0,0,23,0,23,0,23,Veneto,ITH3
2021-01-12,PF/BT,802095,CASA DI RIPOSO G. DAL VECCHIO,VEN,20-29,0,3,0,2,1,0,0,3,0,3,Veneto,ITH3
2021-01-12,PF/BT,802095,CASA DI RIPOSO G. DAL VECCHIO,VEN,30-39,1,4,0,3,2,0,0,5,0,5,Veneto,ITH3
2021-01-12,PF/BT,802095,CASA DI RIPOSO G. DAL VECCHIO,VEN,40-49,1,15,0,13,3,0,0,16,0,16,Veneto,ITH3
2021-01-12,PF/BT,802095,CASA DI RIPOSO G. DAL VECCHIO,VEN,50-59,1,15,0,10,5,1,0,16,0,16,Veneto,ITH3
2021-01-12,PF/BT,802095,CASA DI RIPOSO G. DAL VECCHIO,VEN,60-69,0,4,0,2,2,0,0,4,0,4,Veneto,ITH3
2021-01-12,PF/BT,802095,CASA DI RIPOSO G. DAL VECCHIO,VEN,70-79,3,3,0,0,0,6,0,6,0,6,Veneto,ITH3
2021-01-12,PF/BT,802095,CASA DI RIPOSO G. DAL VECCHIO,VEN,80-89,7,12,0,0,0,19,0,19,0,19,Veneto,ITH3
2021-01-12,PF/BT,802095,CASA DI RIPOSO G. DAL VECCHIO,VEN,90+,1,14,0,0,0,15,0,15,0,15,Veneto,ITH3
2021-01-12,PF/BT,802099,CASA DI RIPOSO SAN MICHELE,VEN,30-39,2,1,0,3,0,0,0,3,0,3,Veneto,ITH3
2021-01-12,PF/BT,802099,CASA DI RIPOSO SAN MICHELE,VEN,40-49,0,4,0,4,0,0,0,4,0,4,Veneto,ITH3
2021-01-12,PF/BT,802099,CASA DI RIPOSO SAN MICHELE,VEN,50-59,0,3,0,3,0,0,0,3,0,3,Veneto,ITH3
2021-01-12,PF/BT,802099,CASA DI RIPOSO SAN MICHELE,VEN,60-69,1,1,0,1,1,0,0,2,0,2,Veneto,ITH3
2021-01-12,PF/BT,802099,CASA DI RIPOSO SAN MICHELE,VEN,90+,0,1,0,0,0,1,0,1,0,1,Veneto,ITH3
2021-01-12,PF/BT,802210,CASA DI RIPOSO 'M.GASPARINI',VEN,60-69,0,1,0,0,0,1,0,1,0,1,Veneto,ITH3
2021-01-12,PF/BT,802210,CASA DI RIPOSO 'M.GASPARINI',VEN,70-79,1,4,0,0,0,5,0,5,0,5,Veneto,ITH3
2021-01-12,PF/BT,802210,CASA DI RIPOSO 'M.GASPARINI',VEN,80-89,4,18,0,0,0,22,0,22,0,22,Veneto,ITH3
2021-01-12,PF/BT,802210,CASA DI RIPOSO 'M.GASPARINI',VEN,90+,3,8,0,0,0,11,0,11,0,11,Veneto,ITH3
2021-01-12,PF/BT,84010,CASA DI RIPOSO S. GIUSEPPE,VEN,20-29,0,7,0,5,2,0,0,7,0,7,Veneto,ITH3
2021-01-12,PF/BT,84010,CASA DI RIPOSO S. GIUSEPPE,VEN,30-39,0,9,0,4,5,0,0,9,0,9,Veneto,ITH3
2021-01-12,PF/BT,84010,CASA DI RIPOSO S. GIUSEPPE,VEN,40-49,4,15,0,10,9,0,0,19,0,19,Veneto,ITH3
2021-01-12,PF/BT,84010,CASA DI RIPOSO S. GIUSEPPE,VEN,50-59,2,16,0,11,7,0,0,18,0,18,Veneto,ITH3
2021-01-12,PF/BT,84010,CASA DI RIPOSO S. GIUSEPPE,VEN,60-69,2,2,0,1,2,1,0,4,0,4,Veneto,ITH3
2021-01-12,PF/BT,84010,CASA DI RIPOSO S. GIUSEPPE,VEN,70-79,3,5,0,0,1,7,0,8,0,8,Veneto,ITH3
2021-01-12,PF/BT,84010,CASA DI RIPOSO S. GIUSEPPE,VEN,80-89,9,27,0,0,1,35,0,36,0,36,Veneto,ITH3
2021-01-12,PF/BT,84010,CASA DI RIPOSO S. GIUSEPPE,VEN,90+,2,18,0,0,0,19,1,20,0,20,Veneto,ITH3
2021-01-12,PF/BT,845215,"IPAB ""VERONESI DR. GERMANO"" CASA DI RIPOSO",VEN,30-39,1,1,0,2,0,0,0,2,0,2,Veneto,ITH3
2021-01-12,PF/BT,845215,"IPAB ""VERONESI DR. GERMANO"" CASA DI RIPOSO",VEN,40-49,1,2,0,3,0,0,0,3,0,3,Veneto,ITH3
2021-01-12,PF/BT,845215,"IPAB ""VERONESI DR. GERMANO"" CASA DI RIPOSO",VEN,50-59,0,3,0,3,0,0,0,3,0,3,Veneto,ITH3
2021-01-12,PF/BT,845215,"IPAB ""VERONESI DR. GERMANO"" CASA DI RIPOSO",VEN,60-69,0,1,0,1,0,0,0,1,0,1,Veneto,ITH3
2021-01-12,PF/BT,845215,"IPAB ""VERONESI DR. GERMANO"" CASA DI RIPOSO",VEN,70-79,2,4,0,0,0,6,0,6,0,6,Veneto,ITH3
2021-01-12,PF/BT,845215,"IPAB ""VERONESI DR. GERMANO"" CASA DI RIPOSO",VEN,80-89,9,17,0,0,0,26,0,26,0,26,Veneto,ITH3
2021-01-12,PF/BT,845215,"IPAB ""VERONESI DR. GERMANO"" CASA DI RIPOSO",VEN,90+,9,14,0,0,0,23,0,23,0,23,Veneto,ITH3
2021-01-12,PF/BT,845224,IST. IMMACOLATA DI LOURDES,VEN,20-29,4,6,0,10,0,0,0,10,0,10,Veneto,ITH3
2021-01-12,PF/BT,845224,IST. IMMACOLATA DI LOURDES,VEN,30-39,1,2,0,2,1,0,0,3,0,3,Veneto,ITH3
2021-01-12,PF/BT,845224,IST. IMMACOLATA DI LOURDES,VEN,40-49,3,8,0,9,2,0,0,11,0,11,Veneto,ITH3
2021-01-12,PF/BT,845224,IST. IMMACOLATA DI LOURDES,VEN,50-59,4,14,0,10,7,1,0,18,0,18,Veneto,ITH3
2021-01-12,PF/BT,845224,IST. IMMACOLATA DI LOURDES,VEN,60-69,2,4,0,5,0,1,0,6,0,6,Veneto,ITH3
2021-01-12,PF/BT,845224,IST. IMMACOLATA DI LOURDES,VEN,70-79,2,1,0,1,1,1,0,3,0,3,Veneto,ITH3
2021-01-12,PF/BT,845224,IST. IMMACOLATA DI LOURDES,VEN,80-89,1,1,0,0,1,1,0,2,0,2,Veneto,ITH3
2021-01-12,PF/BT,845224,IST. IMMACOLATA DI LOURDES,VEN,90+,1,0,0,0,0,1,0,1,0,1,Veneto,ITH3
2021-01-13,PF/BT,0,MAGAZZINO RSA ULSS505,VEN,20-29,0,1,0,1,0,0,0,1,0,1,Veneto,ITH3
2021-01-13,PF/BT,0,MAGAZZINO RSA ULSS505,VEN,30-39,0,6,0,6,0,0,0,6,0,6,Veneto,ITH3
2021-01-13,PF/BT,0,MAGAZZINO RSA ULSS505,VEN,40-49,4,9,0,12,0,1,0,13,0,13,Veneto,ITH3
2021-01-13,PF/BT,0,MAGAZZINO RSA ULSS505,VEN,50-59,0,12,0,10,0,2,0,12,0,12,Veneto,ITH3
2021-01-13,PF/BT,0,MAGAZZINO RSA ULSS505,VEN,60-69,1,8,0,7,0,2,0,9,0,9,Veneto,ITH3
2021-01-13,PF/BT,0,MAGAZZINO RSA ULSS505,VEN,70-79,0,5,0,0,0,5,0,5,0,5,Veneto,ITH3
2021-01-13,PF/BT,0,MAGAZZINO RSA ULSS505,VEN,80-89,5,19,0,1,0,23,0,24,0,24,Veneto,ITH3
2021-01-13,PF/BT,0,MAGAZZINO RSA ULSS505,VEN,90+,0,16,0,0,0,16,0,16,0,16,Veneto,ITH3
2021-01-13,PF/BT,132237,C.R. LA CASA - VALBELLA,VEN,40-49,1,3,0,4,0,0,0,4,0,4,Veneto,ITH3
2021-01-13,PF/BT,132237,C.R. LA CASA - VALBELLA,VEN,50-59,0,6,0,6,0,0,0,6,0,6,Veneto,ITH3
2021-01-13,PF/BT,162426,RSA PER DISABILI 'AZZURRA' VALDAGNO,VEN,20-29,1,0,0,0,0,1,0,1,0,1,Veneto,ITH3
2021-01-13,PF/BT,162426,RSA PER DISABILI 'AZZURRA' VALDAGNO,VEN,30-39,6,0,0,1,0,5,0,6,0,6,Veneto,ITH3
2021-01-13,PF/BT,162426,RSA PER DISABILI 'AZZURRA' VALDAGNO,VEN,40-49,4,7,0,4,0,7,0,11,0,11,Veneto,ITH3
2021-01-13,PF/BT,162426,RSA PER DISABILI 'AZZURRA' VALDAGNO,VEN,50-59,10,16,0,8,4,14,0,26,0,26,Veneto,ITH3
2021-01-13,PF/BT,162426,RSA PER DISABILI 'AZZURRA' VALDAGNO,VEN,60-69,5,7,0,4,0,8,0,12,0,12,Veneto,ITH3
2021-01-13,PF/BT,200027,AQUILONE 1,VEN,20-29,5,4,0,0,1,8,0,9,0,9,Veneto,ITH3
2021-01-13,PF/BT,200027,AQUILONE 1,VEN,30-39,4,5,0,0,0,9,0,9,0,9,Veneto,ITH3
2021-01-13,PF/BT,200027,AQUILONE 1,VEN,40-49,10,3,0,1,0,12,0,13,0,13,Veneto,ITH3
2021-01-13,PF/BT,200027,AQUILONE 1,VEN,50-59,0,4,0,0,0,4,0,4,0,4,Veneto,ITH3
2021-01-13,PF/BT,208422,AQUILONE 2,VEN,16-19,0,1,0,0,0,1,0,1,0,1,Veneto,ITH3
2021-01-13,PF/BT,208422,AQUILONE 2,VEN,20-29,3,2,0,0,0,5,0,5,0,5,Veneto,ITH3
2021-01-13,PF/BT,208422,AQUILONE 2,VEN,30-39,1,1,0,0,0,2,0,2,0,2,Veneto,ITH3
2021-01-13,PF/BT,208422,AQUILONE 2,VEN,40-49,0,1,0,0,0,1,0,1,0,1,Veneto,ITH3
2021-01-13,PF/BT,208422,AQUILONE 2,VEN,50-59,1,0,0,0,0,1,0,1,0,1,Veneto,ITH3
2021-01-13,PF/BT,208422,AQUILONE 2,VEN,60-69,2,0,0,0,0,2,0,2,0,2,Veneto,ITH3
2021-01-13,PF/BT,244010,"CENTRO DI SERVIZI RESIDENZIALE ""OPERA IMMACOLATA DI LOURDES"" - CONEGLIANO",VEN,20-29,2,7,0,8,1,0,0,9,0,9,Veneto,ITH3
2021-01-13,PF/BT,244010,"CENTRO DI SERVIZI RESIDENZIALE ""OPERA IMMACOLATA DI LOURDES"" - CONEGLIANO",VEN,30-39,1,11,0,10,2,0,0,12,0,12,Veneto,ITH3
2021-01-13,PF/BT,244010,"CENTRO DI SERVIZI RESIDENZIALE ""OPERA IMMACOLATA DI LOURDES"" - CONEGLIANO",VEN,40-49,6,21,0,18,9,0,0,27,0,27,Veneto,ITH3
2021-01-13,PF/BT,244010,"CENTRO DI SERVIZI RESIDENZIALE ""OPERA IMMACOLATA DI LOURDES"" - CONEGLIANO",VEN,50-59,5,23,0,16,9,3,0,28,0,28,Veneto,ITH3
2021-01-13,PF/BT,244010,"CENTRO DI SERVIZI RESIDENZIALE ""OPERA IMMACOLATA DI LOURDES"" - CONEGLIANO",VEN,60-69,8,9,0,7,3,6,1,17,0,17,Veneto,ITH3
2021-01-13,PF/BT,244010,"CENTRO DI SERVIZI RESIDENZIALE ""OPERA IMMACOLATA DI LOURDES"" - CONEGLIANO",VEN,70-79,6,8,0,0,0,14,0,14,0,14,Veneto,ITH3
2021-01-13,PF/BT,244010,"CENTRO DI SERVIZI RESIDENZIALE ""OPERA IMMACOLATA DI LOURDES"" - CONEGLIANO",VEN,80-89,13,30,0,0,0,43,0,43,0,43,Veneto,ITH3
2021-01-13,PF/BT,244010,"CENTRO DI SERVIZI RESIDENZIALE ""OPERA IMMACOLATA DI LOURDES"" - CONEGLIANO",VEN,90+,5,30,0,0,0,35,0,35,0,35,Veneto,ITH3
2021-01-13,PF/BT,284001,"CENTRO DI SERVIZI RESIDENZIALE ""SARTOR"" CASTELFRANCO VENETO",VEN,20-29,3,32,0,32,3,0,0,35,0,35,Veneto,ITH3
2021-01-13,PF/BT,284001,"CENTRO DI SERVIZI RESIDENZIALE ""SARTOR"" CASTELFRANCO VENETO",VEN,30-39,9,30,0,36,3,0,0,39,0,39,Veneto,ITH3
2021-01-13,PF/BT,284001,"CENTRO DI SERVIZI RESIDENZIALE ""SARTOR"" CASTELFRANCO VENETO",VEN,40-49,12,60,0,52,20,0,0,72,0,72,Veneto,ITH3
2021-01-13,PF/BT,284001,"CENTRO DI SERVIZI RESIDENZIALE ""SARTOR"" CASTELFRANCO VENETO",VEN,50-59,12,63,0,59,16,0,0,75,0,75,Veneto,ITH3
2021-01-13,PF/BT,284001,"CENTRO DI SERVIZI RESIDENZIALE ""SARTOR"" CASTELFRANCO VENETO",VEN,60-69,4,20,0,16,8,0,0,24,0,24,Veneto,ITH3
2021-01-13,PF/BT,284001,"CENTRO DI SERVIZI RESIDENZIALE ""SARTOR"" CASTELFRANCO VENETO",VEN,70-79,1,0,0,0,1,0,0,1,0,1,Veneto,ITH3
2021-01-13,PF/BT,323201,"CENTRO DI SERVIZI RESIDENZIALE ""C. COSULICH"" - CASALE SUL SILE",VEN,20-29,3,7,0,8,2,0,0,10,0,10,Veneto,ITH3
2021-01-13,PF/BT,323201,"CENTRO DI SERVIZI RESIDENZIALE ""C. COSULICH"" - CASALE SUL SILE",VEN,30-39,1,12,0,9,4,0,0,13,0,13,Veneto,ITH3
2021-01-13,PF/BT,323201,"CENTRO DI SERVIZI RESIDENZIALE ""C. COSULICH"" - CASALE SUL SILE",VEN,40-49,2,14,0,9,7,0,0,16,0,16,Veneto,ITH3
2021-01-13,PF/BT,323201,"CENTRO DI SERVIZI RESIDENZIALE ""C. COSULICH"" - CASALE SUL SILE",VEN,50-59,3,13,0,12,2,2,0,16,0,16,Veneto,ITH3
2021-01-13,PF/BT,323201,"CENTRO DI SERVIZI RESIDENZIALE ""C. COSULICH"" - CASALE SUL SILE",VEN,60-69,0,11,0,3,5,3,0,11,0,11,Veneto,ITH3
2021-01-13,PF/BT,323201,"CENTRO DI SERVIZI RESIDENZIALE ""C. COSULICH"" - CASALE SUL SILE",VEN,70-79,10,4,0,0,0,14,0,14,0,14,Veneto,ITH3
2021-01-13,PF/BT,323201,"CENTRO DI SERVIZI RESIDENZIALE ""C. COSULICH"" - CASALE SUL SILE",VEN,80-89,6,24,0,0,0,30,0,30,0,30,Veneto,ITH3
2021-01-13,PF/BT,323201,"CENTRO DI SERVIZI RESIDENZIALE ""C. COSULICH"" - CASALE SUL SILE",VEN,90+,4,36,0,0,0,40,0,40,0,40,Veneto,ITH3
2021-01-13,PF/BT,323221,"CENTRO DI SERVIZI RESIDENZIALE ""ISTITUTO CANOSSIANO G. BAKHITA"" - TREVISO",VEN,30-39,0,2,0,1,1,0,0,2,0,2,Veneto,ITH3
2021-01-13,PF/BT,323221,"CENTRO DI SERVIZI RESIDENZIALE ""ISTITUTO CANOSSIANO G. BAKHITA"" - TREVISO",VEN,40-49,0,5,0,1,4,0,0,5,0,5,Veneto,ITH3
2021-01-13,PF/BT,323221,"CENTRO DI SERVIZI RESIDENZIALE ""ISTITUTO CANOSSIANO G. BAKHITA"" - TREVISO",VEN,50-59,0,15,0,6,9,0,0,15,0,15,Veneto,ITH3
2021-01-13,PF/BT,323221,"CENTRO DI SERVIZI RESIDENZIALE ""ISTITUTO CANOSSIANO G. BAKHITA"" - TREVISO",VEN,60-69,1,4,0,3,2,0,0,5,0,5,Veneto,ITH3
2021-01-13,PF/BT,323221,"CENTRO DI SERVIZI RESIDENZIALE ""ISTITUTO CANOSSIANO G. BAKHITA"" - TREVISO",VEN,70-79,1,3,0,1,1,2,0,4,0,4,Veneto,ITH3
2021-01-13,PF/BT,323221,"CENTRO DI SERVIZI RESIDENZIALE ""ISTITUTO CANOSSIANO G. BAKHITA"" - TREVISO",VEN,80-89,1,18,0,0,1,18,0,19,0,19,Veneto,ITH3
2021-01-13,PF/BT,323221,"CENTRO DI SERVIZI RESIDENZIALE ""ISTITUTO CANOSSIANO G. BAKHITA"" - TREVISO",VEN,90+,0,5,0,0,0,5,0,5,0,5,Veneto,ITH3
2021-01-13,PF/BT,323616,"CENTRO DI SERVIZI RESIDENZIALE ""RESIDENZA PER ANZIANI CITTÂ¿ DI RONCADE"" - RONCADE",VEN,20-29,4,3,0,7,0,0,0,7,0,7,Veneto,ITH3
2021-01-13,PF/BT,323616,"CENTRO DI SERVIZI RESIDENZIALE ""RESIDENZA PER ANZIANI CITTÂ¿ DI RONCADE"" - RONCADE",VEN,30-39,10,13,0,19,4,0,0,23,0,23,Veneto,ITH3
2021-01-13,PF/BT,323616,"CENTRO DI SERVIZI RESIDENZIALE ""RESIDENZA PER ANZIANI CITTÂ¿ DI RONCADE"" - RONCADE",VEN,40-49,4,28,0,25,7,0,0,32,0,32,Veneto,ITH3
2021-01-13,PF/BT,323616,"CENTRO DI SERVIZI RESIDENZIALE ""RESIDENZA PER ANZIANI CITTÂ¿ DI RONCADE"" - RONCADE",VEN,50-59,2,20,0,12,10,0,0,22,0,22,Veneto,ITH3
2021-01-13,PF/BT,323616,"CENTRO DI SERVIZI RESIDENZIALE ""RESIDENZA PER ANZIANI CITTÂ¿ DI RONCADE"" - RONCADE",VEN,60-69,2,0,0,1,0,1,0,2,0,2,Veneto,ITH3
2021-01-13,PF/BT,323616,"CENTRO DI SERVIZI RESIDENZIALE ""RESIDENZA PER ANZIANI CITTÂ¿ DI RONCADE"" - RONCADE",VEN,70-79,12,13,0,0,3,22,0,25,0,25,Veneto,ITH3
2021-01-13,PF/BT,323616,"CENTRO DI SERVIZI RESIDENZIALE ""RESIDENZA PER ANZIANI CITTÂ¿ DI RONCADE"" - RONCADE",VEN,80-89,15,31,0,0,0,46,0,46,0,46,Veneto,ITH3
2021-01-13,PF/BT,323616,"CENTRO DI SERVIZI RESIDENZIALE ""RESIDENZA PER ANZIANI CITTÂ¿ DI RONCADE"" - RONCADE",VEN,90+,2,34,0,0,0,36,0,36,0,36,Veneto,ITH3
2021-01-13,PF/BT,400001,POLIAMB. OSPEDALE FATEBENEFR.,VEN,20-29,1,2,0,3,0,0,0,3,0,3,Veneto,ITH3
2021-01-13,PF/BT,400001,POLIAMB. OSPEDALE FATEBENEFR.,VEN,30-39,0,1,0,1,0,0,0,1,0,1,Veneto,ITH3
2021-01-13,PF/BT,400001,POLIAMB. OSPEDALE FATEBENEFR.,VEN,40-49,2,0,0,2,0,0,0,2,0,2,Veneto,ITH3
2021-01-13,PF/BT,400001,POLIAMB. OSPEDALE FATEBENEFR.,VEN,50-59,0,2,0,2,0,0,0,2,0,2,Veneto,ITH3
2021-01-13,PF/BT,400001,POLIAMB. OSPEDALE FATEBENEFR.,VEN,60-69,1,1,0,0,0,2,0,2,0,2,Veneto,ITH3
2021-01-13,PF/BT,400001,POLIAMB. OSPEDALE FATEBENEFR.,VEN,70-79,1,3,0,0,0,4,0,4,0,4,Veneto,ITH3
2021-01-13,PF/BT,400001,POLIAMB. OSPEDALE FATEBENEFR.,VEN,80-89,4,5,0,0,0,9,0,9,0,9,Veneto,ITH3
2021-01-13,PF/BT,400001,POLIAMB. OSPEDALE FATEBENEFR.,VEN,90+,1,5,0,0,0,6,0,6,0,6,Veneto,ITH3
2021-01-13,PF/BT,42817,C.S.A. 'A. BRANDALISE',VEN,40-49,0,1,0,1,0,0,0,1,0,1,Veneto,ITH3
2021-01-13,PF/BT,42822,CASA DI RIPOSO DI MEL - C.S.A. 'SBARDELLA',VEN,20-29,2,1,0,2,1,0,0,3,0,3,Veneto,ITH3
2021-01-13,PF/BT,42822,CASA DI RIPOSO DI MEL - C.S.A. 'SBARDELLA',VEN,30-39,2,1,0,2,1,0,0,3,0,3,Veneto,ITH3
2021-01-13,PF/BT,42822,CASA DI RIPOSO DI MEL - C.S.A. 'SBARDELLA',VEN,40-49,1,4,0,2,3,0,0,5,0,5,Veneto,ITH3
2021-01-13,PF/BT,42822,CASA DI RIPOSO DI MEL - C.S.A. 'SBARDELLA',VEN,50-59,0,12,0,3,6,3,0,12,0,12,Veneto,ITH3
2021-01-13,PF/BT,42822,CASA DI RIPOSO DI MEL - C.S.A. 'SBARDELLA',VEN,60-69,4,4,0,0,1,7,0,8,0,8,Veneto,ITH3
2021-01-13,PF/BT,42822,CASA DI RIPOSO DI MEL - C.S.A. 'SBARDELLA',VEN,70-79,12,10,0,0,0,22,0,22,0,22,Veneto,ITH3
2021-01-13,PF/BT,42822,CASA DI RIPOSO DI MEL - C.S.A. 'SBARDELLA',VEN,80-89,8,27,0,0,0,35,0,35,0,35,Veneto,ITH3
2021-01-13,PF/BT,42822,CASA DI RIPOSO DI MEL - C.S.A. 'SBARDELLA',VEN,90+,2,19,0,0,0,21,0,21,0,21,Veneto,ITH3
2021-01-13,PF/BT,440101,POLIAMB. OSPEDALE VILLA SALUS,VEN,20-29,3,15,0,15,3,0,0,18,0,18,Veneto,ITH3
2021-01-13,PF/BT,440101,POLIAMB. OSPEDALE VILLA SALUS,VEN,30-39,11,19,0,18,12,0,0,30,0,30,Veneto,ITH3
2021-01-13,PF/BT,440101,POLIAMB. OSPEDALE VILLA SALUS,VEN,40-49,10,17,0,15,12,0,0,27,0,27,Veneto,ITH3
2021-01-13,PF/BT,440101,POLIAMB. OSPEDALE VILLA SALUS,VEN,50-59,8,21,0,13,16,0,0,29,0,29,Veneto,ITH3
2021-01-13,PF/BT,440101,POLIAMB. OSPEDALE VILLA SALUS,VEN,60-69,3,4,0,6,1,0,0,7,0,7,Veneto,ITH3
2021-01-13,PF/BT,440101,POLIAMB. OSPEDALE VILLA SALUS,VEN,70-79,1,0,0,1,0,0,0,1,0,1,Veneto,ITH3
2021-01-13,PF/BT,440101,POLIAMB. OSPEDALE VILLA SALUS,VEN,80-89,0,1,0,0,1,0,0,1,0,1,Veneto,ITH3
2021-01-13,PF/BT,440101,POLIAMB. OSPEDALE VILLA SALUS,VEN,90+,0,1,0,0,1,0,0,1,0,1,Veneto,ITH3
2021-01-13,PF/BT,441801,POLIAMB. OSPEDALE SAN MARCO,VEN,30-39,1,1,0,2,0,0,0,2,0,2,Veneto,ITH3
2021-01-13,PF/BT,441801,POLIAMB. OSPEDALE SAN MARCO,VEN,40-49,1,0,0,1,0,0,0,1,0,1,Veneto,ITH3
2021-01-13,PF/BT,441801,POLIAMB. OSPEDALE SAN MARCO,VEN,50-59,0,2,0,2,0,0,0,2,0,2,Veneto,ITH3
2021-01-13,PF/BT,441801,POLIAMB. OSPEDALE SAN MARCO,VEN,60-69,0,1,0,1,0,0,0,1,0,1,Veneto,ITH3
2021-01-13,PF/BT,445325,C. SERV.RES.ANZ.-S.LORENZO,VEN,30-39,1,0,0,1,0,0,0,1,0,1,Veneto,ITH3
2021-01-13,PF/BT,445325,C. SERV.RES.ANZ.-S.LORENZO,VEN,40-49,0,2,0,2,0,0,0,2,0,2,Veneto,ITH3
2021-01-13,PF/BT,445325,C. SERV.RES.ANZ.-S.LORENZO,VEN,50-59,0,3,0,3,0,0,0,3,0,3,Veneto,ITH3
2021-01-13,PF/BT,445331,C. SERV.RES.ANZ.-ANNI AZZ.QUARTO,VEN,20-29,0,2,0,2,0,0,0,2,0,2,Veneto,ITH3
2021-01-13,PF/BT,445331,C. SERV.RES.ANZ.-ANNI AZZ.QUARTO,VEN,30-39,0,3,0,2,1,0,0,3,0,3,Veneto,ITH3
2021-01-13,PF/BT,445331,C. SERV.RES.ANZ.-ANNI AZZ.QUARTO,VEN,40-49,2,4,0,3,3,0,0,6,0,6,Veneto,ITH3
2021-01-13,PF/BT,445331,C. SERV.RES.ANZ.-ANNI AZZ.QUARTO,VEN,50-59,2,6,0,3,3,2,0,8,0,8,Veneto,ITH3
2021-01-13,PF/BT,445331,C. SERV.RES.ANZ.-ANNI AZZ.QUARTO,VEN,60-69,0,1,0,1,0,0,0,1,0,1,Veneto,ITH3
2021-01-13,PF/BT,445331,C. SERV.RES.ANZ.-ANNI AZZ.QUARTO,VEN,70-79,4,5,0,0,0,9,0,9,0,9,Veneto,ITH3
2021-01-13,PF/BT,445331,C. SERV.RES.ANZ.-ANNI AZZ.QUARTO,VEN,80-89,6,16,0,0,0,22,0,22,0,22,Veneto,ITH3
2021-01-13,PF/BT,445331,C. SERV.RES.ANZ.-ANNI AZZ.QUARTO,VEN,90+,7,14,0,0,0,21,0,21,0,21,Veneto,ITH3
2021-01-13,PF/BT,445366,C. SERV.RES.ANZ.-NAZARET,VEN,40-49,0,1,0,1,0,0,0,1,0,1,Veneto,ITH3
2021-01-13,PF/BT,445366,C. SERV.RES.ANZ.-NAZARET,VEN,50-59,1,0,0,0,0,1,0,1,0,1,Veneto,ITH3
2021-01-13,PF/BT,445366,C. SERV.RES.ANZ.-NAZARET,VEN,60-69,1,0,0,0,0,1,0,1,0,1,Veneto,ITH3
2021-01-13,PF/BT,445366,C. SERV.RES.ANZ.-NAZARET,VEN,90+,2,1,0,0,0,3,0,3,0,3,Veneto,ITH3
2021-01-13,PF/BT,445385,C. SERV.RES.ANZ.-CONTARINI IRE,VEN,20-29,2,0,0,2,0,0,0,2,0,2,Veneto,ITH3
2021-01-13,PF/BT,445385,C. SERV.RES.ANZ.-CONTARINI IRE,VEN,30-39,2,3,0,5,0,0,0,5,0,5,Veneto,ITH3
2021-01-13,PF/BT,445385,C. SERV.RES.ANZ.-CONTARINI IRE,VEN,40-49,0,3,0,3,0,0,0,3,0,3,Veneto,ITH3
2021-01-13,PF/BT,445385,C. SERV.RES.ANZ.-CONTARINI IRE,VEN,50-59,1,4,0,5,0,0,0,5,0,5,Veneto,ITH3
2021-01-13,PF/BT,445385,C. SERV.RES.ANZ.-CONTARINI IRE,VEN,90+,0,1,0,0,0,1,0,1,0,1,Veneto,ITH3
2021-01-13,PF/BT,445388,C. SERV.RES.ANZ.-ZITELLE,VEN,30-39,0,1,0,1,0,0,0,1,0,1,Veneto,ITH3
2021-01-13,PF/BT,445388,C. SERV.RES.ANZ.-ZITELLE,VEN,40-49,0,2,0,0,0,0,2,2,0,2,Veneto,ITH3
2021-01-13,PF/BT,445388,C. SERV.RES.ANZ.-ZITELLE,VEN,50-59,0,3,0,2,0,0,1,3,0,3,Veneto,ITH3
2021-01-13,PF/BT,445388,C. SERV.RES.ANZ.-ZITELLE,VEN,80-89,0,4,0,0,0,4,0,4,0,4,Veneto,ITH3
2021-01-13,PF/BT,445388,C. SERV.RES.ANZ.-ZITELLE,VEN,90+,0,1,0,0,0,1,0,1,0,1,Veneto,ITH3
2021-01-13,PF/BT,445438,S.V.P. CENTRO SERV. ANTICA SCUOLA DEI BATTUTI,VEN,30-39,1,1,0,2,0,0,0,2,0,2,Veneto,ITH3
2021-01-13,PF/BT,445438,S.V.P. CENTRO SERV. ANTICA SCUOLA DEI BATTUTI,VEN,40-49,0,1,0,1,0,0,0,1,0,1,Veneto,ITH3
2021-01-13,PF/BT,445438,S.V.P. CENTRO SERV. ANTICA SCUOLA DEI BATTUTI,VEN,50-59,0,5,0,5,0,0,0,5,0,5,Veneto,ITH3
2021-01-13,PF/BT,445438,S.V.P. CENTRO SERV. ANTICA SCUOLA DEI BATTUTI,VEN,60-69,0,1,0,1,0,0,0,1,0,1,Veneto,ITH3
2021-01-13,PF/BT,445438,S.V.P. CENTRO SERV. ANTICA SCUOLA DEI BATTUTI,VEN,80-89,1,3,0,0,0,4,0,4,0,4,Veneto,ITH3
2021-01-13,PF/BT,445438,S.V.P. CENTRO SERV. ANTICA SCUOLA DEI BATTUTI,VEN,90+,0,1,0,0,0,1,0,1,0,1,Veneto,ITH3
2021-01-13,PF/BT,445440,C. SERV.RES.ANZ.- IRE SAN GIOBBE,VEN,50-59,2,2,0,0,4,0,0,4,0,4,Veneto,ITH3
2021-01-13,PF/BT,445440,C. SERV.RES.ANZ.- IRE SAN GIOBBE,VEN,60-69,1,1,0,0,2,0,0,2,0,2,Veneto,ITH3
2021-01-13,PF/BT,445444,C. SERV.RES.ANZ.- RESIDENZA VENEZIA,VEN,20-29,1,2,0,3,0,0,0,3,0,3,Veneto,ITH3
2021-01-13,PF/BT,445444,C. SERV.RES.ANZ.- RESIDENZA VENEZIA,VEN,30-39,1,1,0,2,0,0,0,2,0,2,Veneto,ITH3
2021-01-13,PF/BT,445444,C. SERV.RES.ANZ.- RESIDENZA VENEZIA,VEN,40-49,2,0,0,2,0,0,0,2,0,2,Veneto,ITH3
2021-01-13,PF/BT,445444,C. SERV.RES.ANZ.- RESIDENZA VENEZIA,VEN,60-69,1,2,0,0,0,3,0,3,0,3,Veneto,ITH3
2021-01-13,PF/BT,445444,C. SERV.RES.ANZ.- RESIDENZA VENEZIA,VEN,70-79,0,6,0,0,0,6,0,6,0,6,Veneto,ITH3
2021-01-13,PF/BT,445444,C. SERV.RES.ANZ.- RESIDENZA VENEZIA,VEN,80-89,7,30,0,0,0,37,0,37,0,37,Veneto,ITH3
2021-01-13,PF/BT,445444,C. SERV.RES.ANZ.- RESIDENZA VENEZIA,VEN,90+,7,23,0,0,0,30,0,30,0,30,Veneto,ITH3
2021-01-13,PF/BT,486001,C.A.S.A. MARIUTTO - MIRANO,VEN,60-69,1,0,0,0,0,1,0,1,0,1,Veneto,ITH3
2021-01-13,PF/BT,486001,C.A.S.A. MARIUTTO - MIRANO,VEN,70-79,1,1,0,0,0,2,0,2,0,2,Veneto,ITH3
2021-01-13,PF/BT,486001,C.A.S.A. MARIUTTO - MIRANO,VEN,80-89,1,0,0,0,0,1,0,1,0,1,Veneto,ITH3
2021-01-13,PF/BT,486001,C.A.S.A. MARIUTTO - MIRANO,VEN,90+,0,2,0,0,0,2,0,2,0,2,Veneto,ITH3
2021-01-13,PF/BT,486004,C.D.R. 'DON ALLEGRI' - SALZANO,VEN,30-39,0,1,0,0,1,0,0,1,0,1,Veneto,ITH3
2021-01-13,PF/BT,486004,C.D.R. 'DON ALLEGRI' - SALZANO,VEN,40-49,1,3,0,3,1,0,0,4,0,4,Veneto,ITH3
2021-01-13,PF/BT,486004,C.D.R. 'DON ALLEGRI' - SALZANO,VEN,50-59,0,2,0,1,1,0,0,2,0,2,Veneto,ITH3
2021-01-13,PF/BT,486004,C.D.R. 'DON ALLEGRI' - SALZANO,VEN,60-69,0,1,0,0,1,0,0,1,0,1,Veneto,ITH3
2021-01-13,PF/BT,486004,C.D.R. 'DON ALLEGRI' - SALZANO,VEN,70-79,0,1,0,0,0,1,0,1,0,1,Veneto,ITH3
2021-01-13,PF/BT,486004,C.D.R. 'DON ALLEGRI' - SALZANO,VEN,80-89,1,1,0,0,0,2,0,2,0,2,Veneto,ITH3
2021-01-13,PF/BT,486004,C.D.R. 'DON ALLEGRI' - SALZANO,VEN,90+,0,1,0,0,0,1,0,1,0,1,Veneto,ITH3
2021-01-13,PF/BT,486011,RESIDENZA DELLA SALUTE - FIESSO D'ARTICO,VEN,30-39,0,4,0,4,0,0,0,4,0,4,Veneto,ITH3
2021-01-13,PF/BT,486011,RESIDENZA DELLA SALUTE - FIESSO D'ARTICO,VEN,40-49,2,7,0,8,1,0,0,9,0,9,Veneto,ITH3
2021-01-13,PF/BT,486011,RESIDENZA DELLA SALUTE - FIESSO D'ARTICO,VEN,50-59,1,1,0,1,1,0,0,2,0,2,Veneto,ITH3
2021-01-13,PF/BT,486011,RESIDENZA DELLA SALUTE - FIESSO D'ARTICO,VEN,80-89,3,4,0,0,0,7,0,7,0,7,Veneto,ITH3
2021-01-13,PF/BT,486011,RESIDENZA DELLA SALUTE - FIESSO D'ARTICO,VEN,90+,0,2,0,0,0,2,0,2,0,2,Veneto,ITH3
2021-01-13,PF/BT,486013,CENTRO SERVIZI PER ANZIANI VILLA FIORITA,VEN,30-39,0,2,0,0,2,0,0,2,0,2,Veneto,ITH3
2021-01-13,PF/BT,486013,CENTRO SERVIZI PER ANZIANI VILLA FIORITA,VEN,40-49,1,2,0,0,3,0,0,3,0,3,Veneto,ITH3
2021-01-13,PF/BT,486013,CENTRO SERVIZI PER ANZIANI VILLA FIORITA,VEN,80-89,0,1,0,0,0,1,0,1,0,1,Veneto,ITH3
2021-01-13,PF/BT,486015,RESIDENZA ANZIANI 'ADELE ZARA',VEN,20-29,0,1,0,0,1,0,0,1,0,1,Veneto,ITH3
2021-01-13,PF/BT,486015,RESIDENZA ANZIANI 'ADELE ZARA',VEN,30-39,0,1,0,0,1,0,0,1,0,1,Veneto,ITH3
2021-01-13,PF/BT,486015,RESIDENZA ANZIANI 'ADELE ZARA',VEN,40-49,0,2,0,0,2,0,0,2,0,2,Veneto,ITH3
2021-01-13,PF/BT,486015,RESIDENZA ANZIANI 'ADELE ZARA',VEN,60-69,2,3,0,1,0,4,0,5,0,5,Veneto,ITH3
2021-01-13,PF/BT,486015,RESIDENZA ANZIANI 'ADELE ZARA',VEN,70-79,1,8,0,0,1,8,0,9,0,9,Veneto,ITH3
2021-01-13,PF/BT,486015,RESIDENZA ANZIANI 'ADELE ZARA',VEN,80-89,5,43,0,0,0,48,0,48,0,48,Veneto,ITH3
2021-01-13,PF/BT,486015,RESIDENZA ANZIANI 'ADELE ZARA',VEN,90+,4,38,0,0,0,42,0,42,0,42,Veneto,ITH3
2021-01-13,PF/BT,5002200,OSPEDALE P. PEDERZOLI,VEN,20-29,5,11,0,16,0,0,0,16,0,16,Veneto,ITH3
2021-01-13,PF/BT,5002200,OSPEDALE P. PEDERZOLI,VEN,30-39,3,8,0,11,0,0,0,11,0,11,Veneto,ITH3
2021-01-13,PF/BT,5002200,OSPEDALE P. PEDERZOLI,VEN,40-49,9,22,0,31,0,0,0,31,0,31,Veneto,ITH3
2021-01-13,PF/BT,5002200,OSPEDALE P. PEDERZOLI,VEN,50-59,8,14,0,22,0,0,0,22,0,22,Veneto,ITH3
2021-01-13,PF/BT,5002200,OSPEDALE P. PEDERZOLI,VEN,60-69,5,2,0,7,0,0,0,7,0,7,Veneto,ITH3
2021-01-13,PF/BT,5002200,OSPEDALE P. PEDERZOLI,VEN,70-79,2,0,0,2,0,0,0,2,0,2,Veneto,ITH3
2021-01-13,PF/BT,5002200,OSPEDALE P. PEDERZOLI,VEN,80-89,1,0,0,1,0,0,0,1,0,1,Veneto,ITH3
2021-01-13,PF/BT,5010000,CASA DI CURA ANNA E SILENO RIZZOLA,VEN,20-29,6,16,0,19,3,0,0,22,0,22,Veneto,ITH3
2021-01-13,PF/BT,5010000,CASA DI CURA ANNA E SILENO RIZZOLA,VEN,30-39,14,14,0,22,6,0,0,28,0,28,Veneto,ITH3
2021-01-13,PF/BT,5010000,CASA DI CURA ANNA E SILENO RIZZOLA,VEN,40-49,10,33,0,27,16,0,0,43,0,43,Veneto,ITH3
2021-01-13,PF/BT,5010000,CASA DI CURA ANNA E SILENO RIZZOLA,VEN,50-59,6,22,0,11,17,0,0,28,0,28,Veneto,ITH3
2021-01-13,PF/BT,5010000,CASA DI CURA ANNA E SILENO RIZZOLA,VEN,60-69,13,7,0,14,6,0,0,20,0,20,Veneto,ITH3
2021-01-13,PF/BT,5010000,CASA DI CURA ANNA E SILENO RIZZOLA,VEN,70-79,6,0,0,6,0,0,0,6,0,6,Veneto,ITH3
2021-01-13,PF/BT,50501,AURONZO,VEN,20-29,0,2,0,2,0,0,0,2,0,2,Veneto,ITH3
2021-01-13,PF/BT,50501,AURONZO,VEN,30-39,1,7,0,4,4,0,0,8,0,8,Veneto,ITH3
2021-01-13,PF/BT,50501,AURONZO,VEN,40-49,0,10,0,6,4,0,0,10,0,10,Veneto,ITH3
2021-01-13,PF/BT,50501,AURONZO,VEN,50-59,4,17,0,14,7,0,0,21,0,21,Veneto,ITH3
2021-01-13,PF/BT,50501,AURONZO,VEN,60-69,5,5,0,5,3,2,0,10,0,10,Veneto,ITH3
2021-01-13,PF/BT,50501,AURONZO,VEN,70-79,3,1,0,0,1,3,0,4,0,4,Veneto,ITH3
2021-01-13,PF/BT,50501,AURONZO,VEN,80-89,1,4,0,0,0,5,0,5,0,5,Veneto,ITH3
2021-01-13,PF/BT,50501,AURONZO,VEN,90+,0,4,0,0,0,4,0,4,0,4,Veneto,ITH3
2021-01-13,PF/BT,50501,"BELLUNO ""DRIVE-IN""",VEN,20-29,1,1,0,2,0,0,0,2,0,2,Veneto,ITH3
2021-01-13,PF/BT,50501,"BELLUNO ""DRIVE-IN""",VEN,30-39,0,2,0,2,0,0,0,2,0,2,Veneto,ITH3
2021-01-13,PF/BT,50501,"BELLUNO ""DRIVE-IN""",VEN,40-49,2,8,0,7,3,0,0,10,0,10,Veneto,ITH3
2021-01-13,PF/BT,50501,"BELLUNO ""DRIVE-IN""",VEN,50-59,3,8,0,7,4,0,0,11,0,11,Veneto,ITH3
2021-01-13,PF/BT,50501,"BELLUNO ""DRIVE-IN""",VEN,60-69,1,4,0,3,2,0,0,5,0,5,Veneto,ITH3
2021-01-13,PF/BT,50501,BELLUNO AMBULATORIO N.15,VEN,20-29,6,17,0,23,0,0,0,23,0,23,Veneto,ITH3
2021-01-13,PF/BT,50501,BELLUNO AMBULATORIO N.15,VEN,30-39,5,8,0,10,3,0,0,13,0,13,Veneto,ITH3
2021-01-13,PF/BT,50501,BELLUNO AMBULATORIO N.15,VEN,40-49,6,10,0,12,4,0,0,16,0,16,Veneto,ITH3
2021-01-13,PF/BT,50501,BELLUNO AMBULATORIO N.15,VEN,50-59,8,19,0,17,10,0,0,27,0,27,Veneto,ITH3
2021-01-13,PF/BT,50501,BELLUNO AMBULATORIO N.15,VEN,60-69,4,6,0,8,2,0,0,10,0,10,Veneto,ITH3
2021-01-13,PF/BT,50501,BELLUNO AMBULATORIO N.15,VEN,70-79,2,0,0,2,0,0,0,2,0,2,Veneto,ITH3
2021-01-13,PF/BT,50502,MONTEBELLUNA,VEN,50-59,1,0,0,1,0,0,0,1,0,1,Veneto,ITH3
2021-01-13,PF/BT,50502,MONTEBELLUNA,VEN,60-69,1,0,0,1,0,0,0,1,0,1,Veneto,ITH3
2021-01-13,PF/BT,50502,SISP - AMBULATORIO VIAGGIATORI,VEN,50-59,2,3,0,2,3,0,0,5,0,5,Veneto,ITH3
2021-01-13,PF/BT,5050207,OSPEDALE MONTEBELLUNA,VEN,30-39,0,1,0,1,0,0,0,1,0,1,Veneto,ITH3
2021-01-13,PF/BT,5050207,OSPEDALE MONTEBELLUNA,VEN,40-49,0,1,0,1,0,0,0,1,0,1,Veneto,ITH3
2021-01-13,PF/BT,5050207,OSPEDALE MONTEBELLUNA,VEN,50-59,0,1,0,1,0,0,0,1,0,1,Veneto,ITH3
2021-01-13,PF/BT,5050207,OSPEDALE MONTEBELLUNA,VEN,60-69,0,1,0,1,0,0,0,1,0,1,Veneto,ITH3
2021-01-13,PF/BT,50503,CAMPONOGARA ADULTI,VEN,20-29,1,1,0,2,0,0,0,2,0,2,Veneto,ITH3
2021-01-13,PF/BT,50503,CAMPONOGARA ADULTI,VEN,30-39,1,1,0,2,0,0,0,2,0,2,Veneto,ITH3
2021-01-13,PF/BT,50503,CAMPONOGARA ADULTI,VEN,40-49,1,3,0,4,0,0,0,4,0,4,Veneto,ITH3
2021-01-13,PF/BT,50503,CAMPONOGARA ADULTI,VEN,50-59,1,6,0,7,0,0,0,7,0,7,Veneto,ITH3
2021-01-13,PF/BT,50503,CAMPONOGARA ADULTI,VEN,60-69,1,1,0,2,0,0,0,2,0,2,Veneto,ITH3
2021-01-13,PF/BT,50503,CAMPONOGARA ADULTI,VEN,70-79,0,1,0,1,0,0,0,1,0,1,Veneto,ITH3
2021-01-13,PF/BT,50503,CHIOGGIA,VEN,20-29,2,6,0,6,0,0,2,8,0,8,Veneto,ITH3
2021-01-13,PF/BT,50503,CHIOGGIA,VEN,30-39,1,1,0,0,0,0,2,2,0,2,Veneto,ITH3
2021-01-13,PF/BT,50503,CHIOGGIA,VEN,40-49,0,5,0,3,0,0,2,5,0,5,Veneto,ITH3
2021-01-13,PF/BT,50503,CHIOGGIA,VEN,50-59,2,9,0,7,0,0,4,11,0,11,Veneto,ITH3
2021-01-13,PF/BT,50503,CHIOGGIA,VEN,60-69,9,0,0,9,0,0,0,9,0,9,Veneto,ITH3
2021-01-13,PF/BT,50503,CHIOGGIA,VEN,70-79,1,0,0,1,0,0,0,1,0,1,Veneto,ITH3
2021-01-13,PF/BT,50503,MEDICINA PREVENTIVA MESTRE,VEN,16-19,0,1,0,0,1,0,0,1,0,1,Veneto,ITH3
2021-01-13,PF/BT,50503,MEDICINA PREVENTIVA MESTRE,VEN,20-29,10,11,0,10,11,0,0,21,0,21,Veneto,ITH3
2021-01-13,PF/BT,50503,MEDICINA PREVENTIVA MESTRE,VEN,30-39,10,9,0,8,11,0,0,19,0,19,Veneto,ITH3
2021-01-13,PF/BT,50503,MEDICINA PREVENTIVA MESTRE,VEN,40-49,14,22,0,16,20,0,0,36,0,36,Veneto,ITH3
2021-01-13,PF/BT,50503,MEDICINA PREVENTIVA MESTRE,VEN,50-59,13,39,0,20,32,0,0,52,0,52,Veneto,ITH3
2021-01-13,PF/BT,50503,MEDICINA PREVENTIVA MESTRE,VEN,60-69,7,8,0,6,9,0,0,15,0,15,Veneto,ITH3
2021-01-13,PF/BT,50503,MEDICINA PREVENTIVA MESTRE,VEN,70-79,2,3,0,2,3,0,0,5,0,5,Veneto,ITH3
2021-01-13,PF/BT,50503,MEDICINA PREVENTIVA MESTRE,VEN,80-89,1,0,0,0,1,0,0,1,0,1,Veneto,ITH3
2021-01-13,PF/BT,50503,MEDICINA PREVENTIVA VENEZIA,VEN,20-29,4,3,0,5,2,0,0,7,0,7,Veneto,ITH3
2021-01-13,PF/BT,50503,MEDICINA PREVENTIVA VENEZIA,VEN,30-39,4,5,0,7,2,0,0,9,0,9,Veneto,ITH3
2021-01-13,PF/BT,50503,MEDICINA PREVENTIVA VENEZIA,VEN,40-49,4,5,0,7,2,0,0,9,0,9,Veneto,ITH3
2021-01-13,PF/BT,50503,MEDICINA PREVENTIVA VENEZIA,VEN,50-59,9,12,0,14,7,0,0,21,0,21,Veneto,ITH3
2021-01-13,PF/BT,50503,MEDICINA PREVENTIVA VENEZIA,VEN,60-69,5,5,0,8,2,0,0,10,0,10,Veneto,ITH3
2021-01-13,PF/BT,50503,MEDICINA PREVENTIVA VENEZIA,VEN,70-79,0,1,0,0,1,0,0,1,0,1,Veneto,ITH3
2021-01-13,PF/BT,50503,MEDICINA PREVENTIVA VENEZIA,VEN,80-89,2,1,0,0,3,0,0,3,0,3,Veneto,ITH3
2021-01-13,PF/BT,50503,NOALE ADULTI,VEN,20-29,0,2,0,2,0,0,0,2,0,2,Veneto,ITH3
2021-01-13,PF/BT,50503,NOALE ADULTI,VEN,30-39,1,3,0,4,0,0,0,4,0,4,Veneto,ITH3
2021-01-13,PF/BT,50503,NOALE ADULTI,VEN,40-49,4,1,0,5,0,0,0,5,0,5,Veneto,ITH3
2021-01-13,PF/BT,50503,NOALE ADULTI,VEN,50-59,4,5,0,9,0,0,0,9,0,9,Veneto,ITH3
2021-01-13,PF/BT,50503,NOALE ADULTI,VEN,60-69,4,4,0,8,0,0,0,8,0,8,Veneto,ITH3
2021-01-13,PF/BT,50503,NOALE ADULTI,VEN,70-79,0,2,0,2,0,0,0,2,0,2,Veneto,ITH3
2021-01-13,PF/BT,50503,S.I.S.P. MESTRE,VEN,16-19,1,0,0,1,0,0,0,1,0,1,Veneto,ITH3
2021-01-13,PF/BT,50503,S.I.S.P. MESTRE,VEN,20-29,1,7,0,8,0,0,0,8,0,8,Veneto,ITH3
2021-01-13,PF/BT,50503,S.I.S.P. MESTRE,VEN,30-39,2,19,0,21,0,0,0,21,0,21,Veneto,ITH3
2021-01-13,PF/BT,50503,S.I.S.P. MESTRE,VEN,40-49,1,23,0,24,0,0,0,24,0,24,Veneto,ITH3
2021-01-13,PF/BT,50503,S.I.S.P. MESTRE,VEN,50-59,11,23,0,33,1,0,0,34,0,34,Veneto,ITH3
2021-01-13,PF/BT,50503,S.I.S.P. MESTRE,VEN,60-69,1,8,0,9,0,0,0,9,0,9,Veneto,ITH3
2021-01-13,PF/BT,50503,S.I.S.P. MESTRE,VEN,70-79,4,0,0,4,0,0,0,4,0,4,Veneto,ITH3
2021-01-13,PF/BT,50503,S.I.S.P. MESTRE,VEN,80-89,1,0,0,1,0,0,0,1,0,1,Veneto,ITH3
2021-01-13,PF/BT,50503,S.I.S.P. VENEZIA,VEN,20-29,1,2,0,0,3,0,0,3,0,3,Veneto,ITH3
2021-01-13,PF/BT,50503,S.I.S.P. VENEZIA,VEN,30-39,2,2,0,0,4,0,0,4,0,4,Veneto,ITH3
2021-01-13,PF/BT,50503,S.I.S.P. VENEZIA,VEN,40-49,1,12,0,2,11,0,0,13,0,13,Veneto,ITH3
2021-01-13,PF/BT,50503,S.I.S.P. VENEZIA,VEN,50-59,1,12,0,3,10,0,0,13,0,13,Veneto,ITH3
2021-01-13,PF/BT,50503,S.I.S.P. VENEZIA,VEN,60-69,4,5,0,4,5,0,0,9,0,9,Veneto,ITH3
2021-01-13,PF/BT,50503,SISP DOLO ADULTI,VEN,20-29,5,10,0,15,0,0,0,15,0,15,Veneto,ITH3
2021-01-13,PF/BT,50503,SISP DOLO ADULTI,VEN,30-39,7,11,0,18,0,0,0,18,0,18,Veneto,ITH3
2021-01-13,PF/BT,50503,SISP DOLO ADULTI,VEN,40-49,9,34,0,38,0,0,5,43,0,43,Veneto,ITH3
2021-01-13,PF/BT,50503,SISP DOLO ADULTI,VEN,50-59,13,60,0,69,0,0,4,73,0,73,Veneto,ITH3
2021-01-13,PF/BT,50503,SISP DOLO ADULTI,VEN,60-69,4,13,0,16,0,0,1,17,0,17,Veneto,ITH3
2021-01-13,PF/BT,50503,SISP DOLO ADULTI,VEN,70-79,0,1,0,1,0,0,0,1,0,1,Veneto,ITH3
2021-01-13,PF/BT,50504,SANTO STINO DI LIVENZA,VEN,20-29,0,2,0,1,1,0,0,2,0,2,Veneto,ITH3
2021-01-13,PF/BT,50504,SANTO STINO DI LIVENZA,VEN,30-39,2,5,0,1,6,0,0,7,0,7,Veneto,ITH3
2021-01-13,PF/BT,50504,SANTO STINO DI LIVENZA,VEN,40-49,3,13,0,0,16,0,0,16,0,16,Veneto,ITH3
2021-01-13,PF/BT,50504,SANTO STINO DI LIVENZA,VEN,50-59,6,15,0,1,20,0,0,21,0,21,Veneto,ITH3
2021-01-13,PF/BT,50504,SANTO STINO DI LIVENZA,VEN,60-69,0,7,0,3,4,0,0,7,0,7,Veneto,ITH3
2021-01-13,PF/BT,50506,CAMPOSAMPIERO MEDICO COMPETENT,VEN,20-29,4,6,0,7,3,0,0,10,0,10,Veneto,ITH3
2021-01-13,PF/BT,50506,CAMPOSAMPIERO MEDICO COMPETENT,VEN,30-39,4,10,0,11,3,0,0,14,0,14,Veneto,ITH3
2021-01-13,PF/BT,50506,CAMPOSAMPIERO MEDICO COMPETENT,VEN,40-49,6,39,0,33,12,0,0,45,0,45,Veneto,ITH3
2021-01-13,PF/BT,50506,CAMPOSAMPIERO MEDICO COMPETENT,VEN,50-59,9,40,0,39,10,0,0,49,0,49,Veneto,ITH3
2021-01-13,PF/BT,50506,CAMPOSAMPIERO MEDICO COMPETENT,VEN,60-69,5,9,0,11,3,0,0,14,0,14,Veneto,ITH3
2021-01-13,PF/BT,50506,COLLI VACC. ADULTI,VEN,20-29,2,2,0,0,0,0,4,4,0,4,Veneto,ITH3
2021-01-13,PF/BT,50506,COLLI VACC. ADULTI,VEN,30-39,0,2,0,2,0,0,0,2,0,2,Veneto,ITH3
2021-01-13,PF/BT,50506,COLLI VACC. ADULTI,VEN,40-49,6,8,0,12,0,0,2,14,0,14,Veneto,ITH3
2021-01-13,PF/BT,50506,COLLI VACC. ADULTI,VEN,50-59,9,15,0,21,3,0,0,24,0,24,Veneto,ITH3
2021-01-13,PF/BT,50506,COLLI VACC. ADULTI,VEN,60-69,3,7,0,10,0,0,0,10,0,10,Veneto,ITH3
2021-01-13,PF/BT,50506,DISTR. 3 ALBIGNASEGO AMB.IGIEN,VEN,20-29,1,3,0,1,3,0,0,4,0,4,Veneto,ITH3
2021-01-13,PF/BT,50506,DISTR. 3 ALBIGNASEGO AMB.IGIEN,VEN,30-39,3,4,0,4,0,3,0,7,0,7,Veneto,ITH3
2021-01-13,PF/BT,50506,DISTR. 3 ALBIGNASEGO AMB.IGIEN,VEN,40-49,0,11,0,5,5,1,0,11,0,11,Veneto,ITH3
2021-01-13,PF/BT,50506,DISTR. 3 ALBIGNASEGO AMB.IGIEN,VEN,50-59,5,9,0,6,4,4,0,14,0,14,Veneto,ITH3
2021-01-13,PF/BT,50506,DISTR. 3 ALBIGNASEGO AMB.IGIEN,VEN,60-69,5,4,0,6,2,1,0,9,0,9,Veneto,ITH3
2021-01-13,PF/BT,50506,DISTR. 3 ALBIGNASEGO AMB.IGIEN,VEN,70-79,1,2,0,3,0,0,0,3,0,3,Veneto,ITH3
2021-01-13,PF/BT,50506,MONSELICE,VEN,16-19,0,2,0,0,2,0,0,2,0,2,Veneto,ITH3
2021-01-13,PF/BT,50506,MONSELICE,VEN,20-29,8,12,0,9,1,10,0,20,0,20,Veneto,ITH3
2021-01-13,PF/BT,50506,MONSELICE,VEN,30-39,9,13,0,10,3,9,0,22,0,22,Veneto,ITH3
2021-01-13,PF/BT,50506,MONSELICE,VEN,40-49,19,31,0,20,10,20,0,50,0,50,Veneto,ITH3
2021-01-13,PF/BT,50506,MONSELICE,VEN,50-59,14,30,0,18,8,18,0,44,0,44,Veneto,ITH3
2021-01-13,PF/BT,50506,MONSELICE,VEN,60-69,8,9,0,6,2,9,0,17,0,17,Veneto,ITH3
2021-01-13,PF/BT,50506,MONSELICE,VEN,70-79,5,2,0,0,6,1,0,7,0,7,Veneto,ITH3
2021-01-13,PF/BT,50506,SCHIAVONIA AMBULATORIO,VEN,20-29,0,5,0,2,3,0,0,5,0,5,Veneto,ITH3
2021-01-13,PF/BT,50506,SCHIAVONIA AMBULATORIO,VEN,30-39,8,7,0,5,10,0,0,15,0,15,Veneto,ITH3
2021-01-13,PF/BT,50506,SCHIAVONIA AMBULATORIO,VEN,40-49,10,28,0,2,36,0,0,38,0,38,Veneto,ITH3
2021-01-13,PF/BT,50506,SCHIAVONIA AMBULATORIO,VEN,50-59,10,48,0,7,51,0,0,58,0,58,Veneto,ITH3
2021-01-13,PF/BT,50506,SCHIAVONIA AMBULATORIO,VEN,60-69,4,5,0,0,9,0,0,9,0,9,Veneto,ITH3
2021-01-13,PF/BT,50506,VIA SCROVEGNI ANTI INFLUENZALE,VEN,20-29,2,2,0,0,1,3,0,4,0,4,Veneto,ITH3
2021-01-13,PF/BT,50506,VIA SCROVEGNI ANTI INFLUENZALE,VEN,30-39,1,2,0,0,1,2,0,3,0,3,Veneto,ITH3
2021-01-13,PF/BT,50506,VIA SCROVEGNI ANTI INFLUENZALE,VEN,40-49,6,10,0,5,10,1,0,16,0,16,Veneto,ITH3
2021-01-13,PF/BT,50506,VIA SCROVEGNI ANTI INFLUENZALE,VEN,50-59,4,7,0,7,4,0,0,11,0,11,Veneto,ITH3
2021-01-13,PF/BT,50506,VIA SCROVEGNI ANTI INFLUENZALE,VEN,60-69,0,2,0,1,1,0,0,2,0,2,Veneto,ITH3
2021-01-13,PF/BT,50506,VIGONZA,VEN,20-29,1,6,0,3,3,0,1,7,0,7,Veneto,ITH3
2021-01-13,PF/BT,50506,VIGONZA,VEN,30-39,1,2,0,1,2,0,0,3,0,3,Veneto,ITH3
2021-01-13,PF/BT,50506,VIGONZA,VEN,40-49,0,9,0,6,2,0,1,9,0,9,Veneto,ITH3
2021-01-13,PF/BT,50506,VIGONZA,VEN,50-59,6,11,0,6,9,0,2,17,0,17,Veneto,ITH3
2021-01-13,PF/BT,50506,VIGONZA,VEN,60-69,4,8,0,10,2,0,0,12,0,12,Veneto,ITH3
2021-01-13,PF/BT,50507,EX OSPEDALE - BOLDRINI,VEN,20-29,5,15,0,20,0,0,0,20,0,20,Veneto,ITH3
2021-01-13,PF/BT,50507,EX OSPEDALE - BOLDRINI,VEN,30-39,10,23,0,33,0,0,0,33,0,33,Veneto,ITH3
2021-01-13,PF/BT,50507,EX OSPEDALE - BOLDRINI,VEN,40-49,9,17,0,26,0,0,0,26,0,26,Veneto,ITH3
2021-01-13,PF/BT,50507,EX OSPEDALE - BOLDRINI,VEN,50-59,4,23,0,25,0,0,2,27,0,27,Veneto,ITH3
2021-01-13,PF/BT,50507,EX OSPEDALE - BOLDRINI,VEN,60-69,11,4,0,15,0,0,0,15,0,15,Veneto,ITH3
2021-01-13,PF/BT,50507,EX OSPEDALE - BOLDRINI,VEN,70-79,1,2,0,3,0,0,0,3,0,3,Veneto,ITH3
2021-01-13,PF/BT,5050801,MED.COMP. - OSP. SAN BORTOLO,VEN,16-19,2,0,0,0,1,0,1,2,0,2,Veneto,ITH3
2021-01-13,PF/BT,5050801,MED.COMP. - OSP. SAN BORTOLO,VEN,20-29,11,22,0,20,11,0,2,33,0,33,Veneto,ITH3
2021-01-13,PF/BT,5050801,MED.COMP. - OSP. SAN BORTOLO,VEN,30-39,14,29,0,28,12,0,3,43,0,43,Veneto,ITH3
2021-01-13,PF/BT,5050801,MED.COMP. - OSP. SAN BORTOLO,VEN,40-49,18,55,0,41,23,0,9,73,0,73,Veneto,ITH3
2021-01-13,PF/BT,5050801,MED.COMP. - OSP. SAN BORTOLO,VEN,50-59,27,92,0,63,43,0,13,119,0,119,Veneto,ITH3
2021-01-13,PF/BT,5050801,MED.COMP. - OSP. SAN BORTOLO,VEN,60-69,16,21,0,22,14,0,1,37,0,37,Veneto,ITH3
2021-01-13,PF/BT,5050801,MED.COMP. - OSP. SAN BORTOLO,VEN,70-79,7,1,0,6,1,0,1,8,0,8,Veneto,ITH3
2021-01-13,PF/BT,5050803,MED.COMP. - OSP. CAZZAVILLAN,VEN,20-29,2,14,0,12,2,0,2,16,0,16,Veneto,ITH3
2021-01-13,PF/BT,5050803,MED.COMP. - OSP. CAZZAVILLAN,VEN,30-39,11,16,0,22,5,0,0,27,0,27,Veneto,ITH3
2021-01-13,PF/BT,5050803,MED.COMP. - OSP. CAZZAVILLAN,VEN,40-49,12,34,0,30,14,0,2,46,0,46,Veneto,ITH3
2021-01-13,PF/BT,5050803,MED.COMP. - OSP. CAZZAVILLAN,VEN,50-59,12,40,0,26,22,0,4,52,0,52,Veneto,ITH3
2021-01-13,PF/BT,5050803,MED.COMP. - OSP. CAZZAVILLAN,VEN,60-69,4,9,0,9,3,0,1,13,0,13,Veneto,ITH3
2021-01-13,PF/BT,5050803,MED.COMP. - OSP. CAZZAVILLAN,VEN,70-79,2,0,0,2,0,0,0,2,0,2,Veneto,ITH3
2021-01-13,PF/BT,5091201,AOUIVR,VEN,20-29,7,10,0,17,0,0,0,17,0,17,Veneto,ITH3
2021-01-13,PF/BT,5091201,AOUIVR,VEN,30-39,5,5,0,10,0,0,0,10,0,10,Veneto,ITH3
2021-01-13,PF/BT,5091201,AOUIVR,VEN,40-49,1,4,0,5,0,0,0,5,0,5,Veneto,ITH3
2021-01-13,PF/BT,5091201,AOUIVR,VEN,50-59,10,6,0,15,1,0,0,16,0,16,Veneto,ITH3
2021-01-13,PF/BT,5091201,AOUIVR,VEN,60-69,18,11,0,27,0,0,2,29,0,29,Veneto,ITH3
2021-01-13,PF/BT,5091201,AOUIVR,VEN,70-79,5,3,0,8,0,0,0,8,0,8,Veneto,ITH3
2021-01-13,PF/BT,5091201,AOUIVR,VEN,80-89,1,0,0,1,0,0,0,1,0,1,Veneto,ITH3
2021-01-13,PF/BT,563042,C.D.R. CITTADELLA,VEN,60-69,1,0,0,0,0,1,0,1,0,1,Veneto,ITH3
2021-01-13,PF/BT,563042,C.D.R. CITTADELLA,VEN,70-79,0,1,0,0,0,1,0,1,0,1,Veneto,ITH3
2021-01-13,PF/BT,563069,CENTRO SERVIZI 'CAMERINI',VEN,16-19,0,1,0,1,0,0,0,1,0,1,Veneto,ITH3
2021-01-13,PF/BT,563069,CENTRO SERVIZI 'CAMERINI',VEN,20-29,3,8,0,11,0,0,0,11,0,11,Veneto,ITH3
2021-01-13,PF/BT,563069,CENTRO SERVIZI 'CAMERINI',VEN,30-39,0,7,0,5,2,0,0,7,0,7,Veneto,ITH3
2021-01-13,PF/BT,563069,CENTRO SERVIZI 'CAMERINI',VEN,40-49,2,10,0,6,6,0,0,12,0,12,Veneto,ITH3
2021-01-13,PF/BT,563069,CENTRO SERVIZI 'CAMERINI',VEN,50-59,0,10,0,4,6,0,0,10,0,10,Veneto,ITH3
2021-01-13,PF/BT,563069,CENTRO SERVIZI 'CAMERINI',VEN,60-69,0,2,0,1,1,0,0,2,0,2,Veneto,ITH3
2021-01-13,PF/BT,563069,CENTRO SERVIZI 'CAMERINI',VEN,70-79,1,0,0,0,1,0,0,1,0,1,Veneto,ITH3
2021-01-13,PF/BT,563069,CENTRO SERVIZI 'CAMERINI',VEN,90+,0,1,0,0,0,1,0,1,0,1,Veneto,ITH3
2021-01-13,PF/BT,610903,CASA DI CURA ABANO TERME SPA,VEN,20-29,4,18,0,22,0,0,0,22,0,22,Veneto,ITH3
2021-01-13,PF/BT,610903,CASA DI CURA ABANO TERME SPA,VEN,30-39,8,12,0,20,0,0,0,20,0,20,Veneto,ITH3
2021-01-13,PF/BT,610903,CASA DI CURA ABANO TERME SPA,VEN,40-49,6,10,0,16,0,0,0,16,0,16,Veneto,ITH3
2021-01-13,PF/BT,610903,CASA DI CURA ABANO TERME SPA,VEN,50-59,6,10,0,16,0,0,0,16,0,16,Veneto,ITH3
2021-01-13,PF/BT,610903,CASA DI CURA ABANO TERME SPA,VEN,60-69,4,2,0,6,0,0,0,6,0,6,Veneto,ITH3
2021-01-13,PF/BT,610903,CASA DI CURA ABANO TERME SPA,VEN,70-79,3,0,0,3,0,0,0,3,0,3,Veneto,ITH3
2021-01-13,PF/BT,610955,OPSA - OPERA PROVVIDENZA S.ANTONIO DISABILI,VEN,20-29,0,1,0,0,0,1,0,1,0,1,Veneto,ITH3
2021-01-13,PF/BT,610955,OPSA - OPERA PROVVIDENZA S.ANTONIO DISABILI,VEN,30-39,1,3,0,3,0,1,0,4,0,4,Veneto,ITH3
2021-01-13,PF/BT,610955,OPSA - OPERA PROVVIDENZA S.ANTONIO DISABILI,VEN,40-49,3,4,0,4,0,3,0,7,0,7,Veneto,ITH3
2021-01-13,PF/BT,610955,OPSA - OPERA PROVVIDENZA S.ANTONIO DISABILI,VEN,50-59,4,7,0,8,1,2,0,11,0,11,Veneto,ITH3
2021-01-13,PF/BT,610955,OPSA - OPERA PROVVIDENZA S.ANTONIO DISABILI,VEN,60-69,2,1,0,2,0,1,0,3,0,3,Veneto,ITH3
2021-01-13,PF/BT,610955,OPSA - OPERA PROVVIDENZA S.ANTONIO DISABILI,VEN,70-79,2,0,0,0,0,2,0,2,0,2,Veneto,ITH3
2021-01-13,PF/BT,611145,OIC - CENTRO RESIDENZIALE CIVITAS VITAE,VEN,20-29,0,1,0,0,1,0,0,1,0,1,Veneto,ITH3
2021-01-13,PF/BT,611145,OIC - CENTRO RESIDENZIALE CIVITAS VITAE,VEN,30-39,0,2,0,0,2,0,0,2,0,2,Veneto,ITH3
2021-01-13,PF/BT,611145,OIC - CENTRO RESIDENZIALE CIVITAS VITAE,VEN,40-49,2,3,0,0,5,0,0,5,0,5,Veneto,ITH3
2021-01-13,PF/BT,611145,OIC - CENTRO RESIDENZIALE CIVITAS VITAE,VEN,50-59,1,1,0,0,2,0,0,2,0,2,Veneto,ITH3
2021-01-13,PF/BT,611145,OIC - CENTRO RESIDENZIALE CIVITAS VITAE,VEN,60-69,2,0,0,0,2,0,0,2,0,2,Veneto,ITH3
2021-01-13,PF/BT,611160,CASA DI RIPOSO 'A. GALVAN',VEN,70-79,1,1,0,0,0,2,0,2,0,2,Veneto,ITH3
2021-01-13,PF/BT,611160,CASA DI RIPOSO 'A. GALVAN',VEN,80-89,1,5,0,0,0,6,0,6,0,6,Veneto,ITH3
2021-01-13,PF/BT,611160,CASA DI RIPOSO 'A. GALVAN',VEN,90+,1,3,0,0,0,4,0,4,0,4,Veneto,ITH3
2021-01-13,PF/BT,611198,OPSA - CASA MASSIMILIANO KOLBE,VEN,20-29,3,2,0,3,2,0,0,5,0,5,Veneto,ITH3
2021-01-13,PF/BT,611198,OPSA - CASA MASSIMILIANO KOLBE,VEN,30-39,2,2,0,4,0,0,0,4,0,4,Veneto,ITH3
2021-01-13,PF/BT,611198,OPSA - CASA MASSIMILIANO KOLBE,VEN,40-49,3,7,0,10,0,0,0,10,0,10,Veneto,ITH3
2021-01-13,PF/BT,611198,OPSA - CASA MASSIMILIANO KOLBE,VEN,50-59,8,5,0,8,4,0,1,13,0,13,Veneto,ITH3
2021-01-13,PF/BT,611198,OPSA - CASA MASSIMILIANO KOLBE,VEN,60-69,1,3,0,3,0,0,1,4,0,4,Veneto,ITH3
2021-01-13,PF/BT,611198,OPSA - CASA MASSIMILIANO KOLBE,VEN,90+,0,1,0,0,0,1,0,1,0,1,Veneto,ITH3
2021-01-13,PF/BT,611243,CENTRO DI RIFERIMENTO PER LE GRAVI DISABILITA' E DISTIURBI DEL COMPORTAMENTO,VEN,50-59,0,2,0,0,0,2,0,2,0,2,Veneto,ITH3
2021-01-13,PF/BT,611243,CENTRO DI RIFERIMENTO PER LE GRAVI DISABILITA' E DISTIURBI DEL COMPORTAMENTO,VEN,70-79,0,2,0,0,0,2,0,2,0,2,Veneto,ITH3
2021-01-13,PF/BT,611275,"RESIDENZA SOCIO-SANITARIA PSICHIATRICA ""PARCO DEI TIGLI""",VEN,20-29,0,1,0,1,0,0,0,1,0,1,Veneto,ITH3
2021-01-13,PF/BT,611275,"RESIDENZA SOCIO-SANITARIA PSICHIATRICA ""PARCO DEI TIGLI""",VEN,30-39,2,4,0,4,0,0,2,6,0,6,Veneto,ITH3
2021-01-13,PF/BT,611275,"RESIDENZA SOCIO-SANITARIA PSICHIATRICA ""PARCO DEI TIGLI""",VEN,40-49,4,9,0,10,0,0,3,13,0,13,Veneto,ITH3
2021-01-13,PF/BT,611275,"RESIDENZA SOCIO-SANITARIA PSICHIATRICA ""PARCO DEI TIGLI""",VEN,50-59,3,12,0,8,0,3,4,15,0,15,Veneto,ITH3
2021-01-13,PF/BT,611275,"RESIDENZA SOCIO-SANITARIA PSICHIATRICA ""PARCO DEI TIGLI""",VEN,60-69,3,4,0,5,0,0,2,7,0,7,Veneto,ITH3
2021-01-13,PF/BT,642092,CASA DI RIPOSO CONSELVE,VEN,20-29,2,4,0,5,1,0,0,6,0,6,Veneto,ITH3
2021-01-13,PF/BT,642092,CASA DI RIPOSO CONSELVE,VEN,30-39,0,8,0,6,2,0,0,8,0,8,Veneto,ITH3
2021-01-13,PF/BT,642092,CASA DI RIPOSO CONSELVE,VEN,40-49,1,18,0,13,6,0,0,19,0,19,Veneto,ITH3
2021-01-13,PF/BT,642092,CASA DI RIPOSO CONSELVE,VEN,50-59,4,38,0,33,9,0,0,42,0,42,Veneto,ITH3
2021-01-13,PF/BT,642092,CASA DI RIPOSO CONSELVE,VEN,60-69,2,11,0,9,3,1,0,13,0,13,Veneto,ITH3
2021-01-13,PF/BT,642092,CASA DI RIPOSO CONSELVE,VEN,70-79,1,0,0,0,0,1,0,1,0,1,Veneto,ITH3
2021-01-13,PF/BT,642131,CENTRO SERVIZI NON AUTOSUFF. LE ROSE,VEN,20-29,5,3,0,8,0,0,0,8,0,8,Veneto,ITH3
2021-01-13,PF/BT,642131,CENTRO SERVIZI NON AUTOSUFF. LE ROSE,VEN,30-39,0,3,0,3,0,0,0,3,0,3,Veneto,ITH3
2021-01-13,PF/BT,642131,CENTRO SERVIZI NON AUTOSUFF. LE ROSE,VEN,40-49,0,4,0,4,0,0,0,4,0,4,Veneto,ITH3
2021-01-13,PF/BT,642131,CENTRO SERVIZI NON AUTOSUFF. LE ROSE,VEN,50-59,0,2,0,2,0,0,0,2,0,2,Veneto,ITH3
2021-01-13,PF/BT,642131,CENTRO SERVIZI NON AUTOSUFF. LE ROSE,VEN,70-79,1,3,0,0,0,4,0,4,0,4,Veneto,ITH3
2021-01-13,PF/BT,642131,CENTRO SERVIZI NON AUTOSUFF. LE ROSE,VEN,80-89,1,9,0,0,0,10,0,10,0,10,Veneto,ITH3
2021-01-13,PF/BT,642131,CENTRO SERVIZI NON AUTOSUFF. LE ROSE,VEN,90+,2,9,0,0,0,11,0,11,0,11,Veneto,ITH3
2021-01-13,PF/BT,683013,IRAS IST. RODIGINO DI ASS. SOC,VEN,30-39,0,2,0,2,0,0,0,2,0,2,Veneto,ITH3
2021-01-13,PF/BT,683013,IRAS IST. RODIGINO DI ASS. SOC,VEN,40-49,0,2,0,2,0,0,0,2,0,2,Veneto,ITH3
2021-01-13,PF/BT,765055,C.D.R. 'BIANCA STECCANELLA',VEN,20-29,2,8,0,10,0,0,0,10,0,10,Veneto,ITH3
2021-01-13,PF/BT,765055,C.D.R. 'BIANCA STECCANELLA',VEN,30-39,2,9,0,5,6,0,0,11,0,11,Veneto,ITH3
2021-01-13,PF/BT,765055,C.D.R. 'BIANCA STECCANELLA',VEN,40-49,2,13,0,11,4,0,0,15,0,15,Veneto,ITH3
2021-01-13,PF/BT,765055,C.D.R. 'BIANCA STECCANELLA',VEN,50-59,1,24,0,19,6,0,0,25,0,25,Veneto,ITH3
2021-01-13,PF/BT,765055,C.D.R. 'BIANCA STECCANELLA',VEN,60-69,1,4,0,1,1,3,0,5,0,5,Veneto,ITH3
2021-01-13,PF/BT,765055,C.D.R. 'BIANCA STECCANELLA',VEN,70-79,1,7,0,0,0,8,0,8,0,8,Veneto,ITH3
2021-01-13,PF/BT,765055,C.D.R. 'BIANCA STECCANELLA',VEN,80-89,8,21,0,0,0,29,0,29,0,29,Veneto,ITH3
2021-01-13,PF/BT,765055,C.D.R. 'BIANCA STECCANELLA',VEN,90+,0,14,0,0,0,14,0,14,0,14,Veneto,ITH3
2021-01-13,PF/BT,765058,SOGGIORNO PER ANZIANI 'VILLA SPREA',VEN,20-29,0,4,0,3,1,0,0,4,0,4,Veneto,ITH3
2021-01-13,PF/BT,765058,SOGGIORNO PER ANZIANI 'VILLA SPREA',VEN,30-39,2,9,0,6,5,0,0,11,0,11,Veneto,ITH3
2021-01-13,PF/BT,765058,SOGGIORNO PER ANZIANI 'VILLA SPREA',VEN,40-49,5,16,0,13,8,0,0,21,0,21,Veneto,ITH3
2021-01-13,PF/BT,765058,SOGGIORNO PER ANZIANI 'VILLA SPREA',VEN,50-59,2,22,0,15,9,0,0,24,0,24,Veneto,ITH3
2021-01-13,PF/BT,765058,SOGGIORNO PER ANZIANI 'VILLA SPREA',VEN,60-69,2,2,0,2,2,0,0,4,0,4,Veneto,ITH3
2021-01-13,PF/BT,765058,SOGGIORNO PER ANZIANI 'VILLA SPREA',VEN,70-79,0,1,0,0,1,0,0,1,0,1,Veneto,ITH3
2021-01-13,PF/BT,765058,SOGGIORNO PER ANZIANI 'VILLA SPREA',VEN,80-89,0,1,0,0,1,0,0,1,0,1,Veneto,ITH3
2021-01-13,PF/BT,765066,CASA SOGG. 'P.C.C. BRESCIANI',VEN,20-29,1,2,0,2,1,0,0,3,0,3,Veneto,ITH3
2021-01-13,PF/BT,765066,CASA SOGG. 'P.C.C. BRESCIANI',VEN,30-39,0,3,0,2,1,0,0,3,0,3,Veneto,ITH3
2021-01-13,PF/BT,765066,CASA SOGG. 'P.C.C. BRESCIANI',VEN,40-49,0,3,0,2,1,0,0,3,0,3,Veneto,ITH3
2021-01-13,PF/BT,765066,CASA SOGG. 'P.C.C. BRESCIANI',VEN,50-59,2,9,0,7,4,0,0,11,0,11,Veneto,ITH3
2021-01-13,PF/BT,765066,CASA SOGG. 'P.C.C. BRESCIANI',VEN,60-69,1,0,0,1,0,0,0,1,0,1,Veneto,ITH3
2021-01-13,PF/BT,765066,CASA SOGG. 'P.C.C. BRESCIANI',VEN,70-79,5,10,0,0,0,15,0,15,0,15,Veneto,ITH3
2021-01-13,PF/BT,765066,CASA SOGG. 'P.C.C. BRESCIANI',VEN,80-89,9,22,0,0,0,31,0,31,0,31,Veneto,ITH3
2021-01-13,PF/BT,765066,CASA SOGG. 'P.C.C. BRESCIANI',VEN,90+,8,40,0,0,0,48,0,48,0,48,Veneto,ITH3
2021-01-13,PF/BT,768007,C.D.R. 'FILIPPO GODI',VEN,20-29,1,5,0,4,2,0,0,6,0,6,Veneto,ITH3
2021-01-13,PF/BT,768007,C.D.R. 'FILIPPO GODI',VEN,30-39,1,2,0,1,2,0,0,3,0,3,Veneto,ITH3
2021-01-13,PF/BT,768007,C.D.R. 'FILIPPO GODI',VEN,40-49,1,11,0,0,12,0,0,12,0,12,Veneto,ITH3
2021-01-13,PF/BT,768007,C.D.R. 'FILIPPO GODI',VEN,50-59,3,15,0,1,17,0,0,18,0,18,Veneto,ITH3
2021-01-13,PF/BT,768007,C.D.R. 'FILIPPO GODI',VEN,60-69,2,2,0,1,3,0,0,4,0,4,Veneto,ITH3
2021-01-13,PF/BT,768007,C.D.R. 'FILIPPO GODI',VEN,70-79,2,1,0,0,0,3,0,3,0,3,Veneto,ITH3
2021-01-13,PF/BT,768007,C.D.R. 'FILIPPO GODI',VEN,80-89,4,15,0,0,0,18,1,19,0,19,Veneto,ITH3
2021-01-13,PF/BT,768007,C.D.R. 'FILIPPO GODI',VEN,90+,1,18,0,0,0,17,2,19,0,19,Veneto,ITH3
2021-01-13,PF/BT,768037,CEN. RES. PIA OPERA CICCARELLI,VEN,20-29,0,1,0,1,0,0,0,1,0,1,Veneto,ITH3
2021-01-13,PF/BT,768037,CEN. RES. PIA OPERA CICCARELLI,VEN,30-39,0,1,0,1,0,0,0,1,0,1,Veneto,ITH3
2021-01-13,PF/BT,768037,CEN. RES. PIA OPERA CICCARELLI,VEN,40-49,0,4,0,4,0,0,0,4,0,4,Veneto,ITH3
2021-01-13,PF/BT,768037,CEN. RES. PIA OPERA CICCARELLI,VEN,50-59,0,9,0,9,0,0,0,9,0,9,Veneto,ITH3
2021-01-13,PF/BT,768037,CEN. RES. PIA OPERA CICCARELLI,VEN,60-69,0,3,0,3,0,0,0,3,0,3,Veneto,ITH3
2021-01-13,PF/BT,802201,CASA S.GIUSEPPE ASS.G.GIRELLI,VEN,20-29,8,3,0,0,2,9,0,11,0,11,Veneto,ITH3
2021-01-13,PF/BT,802201,CASA S.GIUSEPPE ASS.G.GIRELLI,VEN,30-39,5,0,0,0,0,5,0,5,0,5,Veneto,ITH3
2021-01-13,PF/BT,802201,CASA S.GIUSEPPE ASS.G.GIRELLI,VEN,40-49,7,5,0,4,2,6,0,12,0,12,Veneto,ITH3
2021-01-13,PF/BT,802201,CASA S.GIUSEPPE ASS.G.GIRELLI,VEN,50-59,9,3,0,1,2,9,0,12,0,12,Veneto,ITH3
2021-01-13,PF/BT,802201,CASA S.GIUSEPPE ASS.G.GIRELLI,VEN,60-69,1,0,0,0,0,1,0,1,0,1,Veneto,ITH3
2021-01-13,PF/BT,802201,CASA S.GIUSEPPE ASS.G.GIRELLI,VEN,70-79,5,1,0,0,0,6,0,6,0,6,Veneto,ITH3
2021-01-13,PF/BT,802201,CASA S.GIUSEPPE ASS.G.GIRELLI,VEN,80-89,1,0,0,0,0,1,0,1,0,1,Veneto,ITH3
2021-01-13,PF/BT,84013,CENTRO ANZIANI 'VILLA ALDINA',VEN,20-29,1,12,0,13,0,0,0,13,0,13,Veneto,ITH3
2021-01-13,PF/BT,84013,CENTRO ANZIANI 'VILLA ALDINA',VEN,30-39,3,8,0,11,0,0,0,11,0,11,Veneto,ITH3
2021-01-13,PF/BT,84013,CENTRO ANZIANI 'VILLA ALDINA',VEN,40-49,2,19,0,16,5,0,0,21,0,21,Veneto,ITH3
2021-01-13,PF/BT,84013,CENTRO ANZIANI 'VILLA ALDINA',VEN,50-59,1,16,0,8,9,0,0,17,0,17,Veneto,ITH3
2021-01-13,PF/BT,84013,CENTRO ANZIANI 'VILLA ALDINA',VEN,60-69,6,4,0,1,2,7,0,10,0,10,Veneto,ITH3
2021-01-13,PF/BT,84013,CENTRO ANZIANI 'VILLA ALDINA',VEN,70-79,8,9,0,0,1,16,0,17,0,17,Veneto,ITH3
2021-01-13,PF/BT,84013,CENTRO ANZIANI 'VILLA ALDINA',VEN,80-89,15,23,0,0,0,38,0,38,0,38,Veneto,ITH3
2021-01-13,PF/BT,84013,CENTRO ANZIANI 'VILLA ALDINA',VEN,90+,1,15,0,0,0,16,0,16,0,16,Veneto,ITH3
2021-01-13,PF/BT,845224,IST. IMMACOLATA DI LOURDES,VEN,20-29,1,0,0,1,0,0,0,1,0,1,Veneto,ITH3
2021-01-13,PF/BT,845224,IST. IMMACOLATA DI LOURDES,VEN,50-59,2,4,0,3,0,3,0,6,0,6,Veneto,ITH3
2021-01-13,PF/BT,845224,IST. IMMACOLATA DI LOURDES,VEN,60-69,2,3,0,0,0,5,0,5,0,5,Veneto,ITH3
2021-01-13,PF/BT,845224,IST. IMMACOLATA DI LOURDES,VEN,70-79,8,7,0,0,0,15,0,15,0,15,Veneto,ITH3
2021-01-13,PF/BT,845224,IST. IMMACOLATA DI LOURDES,VEN,80-89,9,24,0,0,0,33,0,33,0,33,Veneto,ITH3
2021-01-13,PF/BT,845224,IST. IMMACOLATA DI LOURDES,VEN,90+,3,15,0,0,0,18,0,18,0,18,Veneto,ITH3
2021-01-13,PF/BT,845239,IPAB PIO RICOVERO P.SEGATTINI,VEN,16-19,1,0,0,1,0,0,0,1,0,1,Veneto,ITH3
2021-01-13,PF/BT,845239,IPAB PIO RICOVERO P.SEGATTINI,VEN,20-29,0,3,0,2,1,0,0,3,0,3,Veneto,ITH3
2021-01-13,PF/BT,845239,IPAB PIO RICOVERO P.SEGATTINI,VEN,30-39,1,7,0,8,0,0,0,8,0,8,Veneto,ITH3
2021-01-13,PF/BT,845239,IPAB PIO RICOVERO P.SEGATTINI,VEN,40-49,1,7,0,6,2,0,0,8,0,8,Veneto,ITH3
2021-01-13,PF/BT,845239,IPAB PIO RICOVERO P.SEGATTINI,VEN,50-59,2,9,0,9,2,0,0,11,0,11,Veneto,ITH3
2021-01-13,PF/BT,845239,IPAB PIO RICOVERO P.SEGATTINI,VEN,60-69,3,0,0,1,1,1,0,3,0,3,Veneto,ITH3
2021-01-13,PF/BT,845239,IPAB PIO RICOVERO P.SEGATTINI,VEN,70-79,4,3,0,0,1,6,0,7,0,7,Veneto,ITH3
2021-01-13,PF/BT,845239,IPAB PIO RICOVERO P.SEGATTINI,VEN,80-89,4,16,0,0,0,20,0,20,0,20,Veneto,ITH3
2021-01-13,PF/BT,845239,IPAB PIO RICOVERO P.SEGATTINI,VEN,90+,1,13,0,0,0,14,0,14,0,14,Veneto,ITH3
2021-01-13,PF/BT,845274,RESIDENZA PER ANZIANI GAETANO TOFFOLI,VEN,20-29,0,3,0,3,0,0,0,3,0,3,Veneto,ITH3
2021-01-13,PF/BT,845274,RESIDENZA PER ANZIANI GAETANO TOFFOLI,VEN,30-39,3,3,0,6,0,0,0,6,0,6,Veneto,ITH3
2021-01-13,PF/BT,845274,RESIDENZA PER ANZIANI GAETANO TOFFOLI,VEN,40-49,1,11,0,12,0,0,0,12,0,12,Veneto,ITH3
2021-01-13,PF/BT,845274,RESIDENZA PER ANZIANI GAETANO TOFFOLI,VEN,50-59,2,9,0,8,3,0,0,11,0,11,Veneto,ITH3
2021-01-13,PF/BT,845274,RESIDENZA PER ANZIANI GAETANO TOFFOLI,VEN,60-69,2,2,0,1,0,3,0,4,0,4,Veneto,ITH3
2021-01-13,PF/BT,845274,RESIDENZA PER ANZIANI GAETANO TOFFOLI,VEN,70-79,3,6,0,0,0,9,0,9,0,9,Veneto,ITH3
2021-01-13,PF/BT,845274,RESIDENZA PER ANZIANI GAETANO TOFFOLI,VEN,80-89,4,12,0,0,0,16,0,16,0,16,Veneto,ITH3
2021-01-13,PF/BT,845274,RESIDENZA PER ANZIANI GAETANO TOFFOLI,VEN,90+,0,8,0,0,0,8,0,8,0,8,Veneto,ITH3
2021-01-13,PF/BT,845317,CENTRO SERVIZI DOTT. PEDERZOLI,VEN,50-59,0,1,0,0,0,1,0,1,0,1,Veneto,ITH3
2021-01-13,PF/BT,845317,CENTRO SERVIZI DOTT. PEDERZOLI,VEN,60-69,3,2,0,0,0,5,0,5,0,5,Veneto,ITH3
2021-01-13,PF/BT,845317,CENTRO SERVIZI DOTT. PEDERZOLI,VEN,70-79,6,9,0,0,0,15,0,15,0,15,Veneto,ITH3
2021-01-13,PF/BT,845317,CENTRO SERVIZI DOTT. PEDERZOLI,VEN,80-89,3,20,0,0,0,23,0,23,0,23,Veneto,ITH3
2021-01-13,PF/BT,845317,CENTRO SERVIZI DOTT. PEDERZOLI,VEN,90+,1,9,0,0,0,10,0,10,0,10,Veneto,ITH3
2021-01-14,PF/BT,0,Mancante,VEN,16-19,2,3,0,0,5,0,0,5,0,5,Veneto,ITH3
2021-01-14,PF/BT,0,Mancante,VEN,20-29,20,28,0,0,48,0,0,48,0,48,Veneto,ITH3
2021-01-14,PF/BT,0,Mancante,VEN,30-39,26,17,0,0,43,0,0,43,0,43,Veneto,ITH3
2021-01-14,PF/BT,0,Mancante,VEN,40-49,32,26,0,0,58,0,0,58,0,58,Veneto,ITH3
2021-01-14,PF/BT,0,Mancante,VEN,50-59,35,21,0,0,56,0,0,56,0,56,Veneto,ITH3
2021-01-14,PF/BT,0,Mancante,VEN,60-69,22,18,0,0,40,0,0,40,0,40,Veneto,ITH3
2021-01-14,PF/BT,0,Mancante,VEN,70-79,6,4,0,0,10,0,0,10,0,10,Veneto,ITH3
2021-01-14,PF/BT,0,Mancante,VEN,80-89,0,2,0,0,2,0,0,2,0,2,Veneto,ITH3
2021-01-14,PF/BT,208009,CASA DI RIPOSO SERSE PANIZZONI,VEN,20-29,3,4,0,7,0,0,0,7,0,7,Veneto,ITH3
2021-01-14,PF/BT,208009,CASA DI RIPOSO SERSE PANIZZONI,VEN,30-39,0,8,0,5,3,0,0,8,0,8,Veneto,ITH3
2021-01-14,PF/BT,208009,CASA DI RIPOSO SERSE PANIZZONI,VEN,40-49,0,18,0,13,5,0,0,18,0,18,Veneto,ITH3
2021-01-14,PF/BT,208009,CASA DI RIPOSO SERSE PANIZZONI,VEN,50-59,2,10,0,6,5,1,0,12,0,12,Veneto,ITH3
2021-01-14,PF/BT,208009,CASA DI RIPOSO SERSE PANIZZONI,VEN,60-69,0,3,0,2,0,1,0,3,0,3,Veneto,ITH3
2021-01-14,PF/BT,208009,CASA DI RIPOSO SERSE PANIZZONI,VEN,70-79,6,6,0,1,0,11,0,12,0,12,Veneto,ITH3
2021-01-14,PF/BT,208009,CASA DI RIPOSO SERSE PANIZZONI,VEN,80-89,6,19,0,0,0,25,0,25,0,25,Veneto,ITH3
2021-01-14,PF/BT,208009,CASA DI RIPOSO SERSE PANIZZONI,VEN,90+,0,14,0,0,0,14,0,14,0,14,Veneto,ITH3
2021-01-14,PF/BT,208422,AQUILONE 2,VEN,30-39,0,2,0,2,0,0,0,2,0,2,Veneto,ITH3
2021-01-14,PF/BT,208422,AQUILONE 2,VEN,40-49,0,3,0,3,0,0,0,3,0,3,Veneto,ITH3
2021-01-14,PF/BT,208422,AQUILONE 2,VEN,50-59,0,4,0,4,0,0,0,4,0,4,Veneto,ITH3
2021-01-14,PF/BT,208422,AQUILONE 2,VEN,60-69,0,1,0,1,0,0,0,1,0,1,Veneto,ITH3
2021-01-14,PF/BT,244009,"CENTRO DI SERVIZI RESIDENZIALE ""CASA FENZI - RESIDENZA OVEST"" - CONEGLIANO",VEN,20-29,3,3,0,5,1,0,0,6,0,6,Veneto,ITH3
2021-01-14,PF/BT,244009,"CENTRO DI SERVIZI RESIDENZIALE ""CASA FENZI - RESIDENZA OVEST"" - CONEGLIANO",VEN,30-39,5,7,0,11,1,0,0,12,0,12,Veneto,ITH3
2021-01-14,PF/BT,244009,"CENTRO DI SERVIZI RESIDENZIALE ""CASA FENZI - RESIDENZA OVEST"" - CONEGLIANO",VEN,40-49,4,21,0,18,6,1,0,25,0,25,Veneto,ITH3
2021-01-14,PF/BT,244009,"CENTRO DI SERVIZI RESIDENZIALE ""CASA FENZI - RESIDENZA OVEST"" - CONEGLIANO",VEN,50-59,11,34,0,26,16,3,0,45,0,45,Veneto,ITH3
2021-01-14,PF/BT,244009,"CENTRO DI SERVIZI RESIDENZIALE ""CASA FENZI - RESIDENZA OVEST"" - CONEGLIANO",VEN,60-69,9,24,0,12,12,9,0,33,0,33,Veneto,ITH3
2021-01-14,PF/BT,244009,"CENTRO DI SERVIZI RESIDENZIALE ""CASA FENZI - RESIDENZA OVEST"" - CONEGLIANO",VEN,70-79,11,9,0,0,2,18,0,20,0,20,Veneto,ITH3
2021-01-14,PF/BT,244009,"CENTRO DI SERVIZI RESIDENZIALE ""CASA FENZI - RESIDENZA OVEST"" - CONEGLIANO",VEN,80-89,9,26,0,0,0,35,0,35,0,35,Veneto,ITH3
2021-01-14,PF/BT,244009,"CENTRO DI SERVIZI RESIDENZIALE ""CASA FENZI - RESIDENZA OVEST"" - CONEGLIANO",VEN,90+,2,19,0,0,0,21,0,21,0,21,Veneto,ITH3
2021-01-14,PF/BT,244065,"CENTRO DI SERVIZI RESIDENZIALE ""CASA FENZI - RESIDENZA EST"" - CONEGLIANO",VEN,20-29,0,1,0,1,0,0,0,1,0,1,Veneto,ITH3
2021-01-14,PF/BT,244065,"CENTRO DI SERVIZI RESIDENZIALE ""CASA FENZI - RESIDENZA EST"" - CONEGLIANO",VEN,40-49,0,1,0,1,0,0,0,1,0,1,Veneto,ITH3
2021-01-14,PF/BT,244065,"CENTRO DI SERVIZI RESIDENZIALE ""CASA FENZI - RESIDENZA EST"" - CONEGLIANO",VEN,50-59,1,2,0,1,0,2,0,3,0,3,Veneto,ITH3
2021-01-14,PF/BT,244065,"CENTRO DI SERVIZI RESIDENZIALE ""CASA FENZI - RESIDENZA EST"" - CONEGLIANO",VEN,60-69,3,2,0,2,0,3,0,5,0,5,Veneto,ITH3
2021-01-14,PF/BT,244065,"CENTRO DI SERVIZI RESIDENZIALE ""CASA FENZI - RESIDENZA EST"" - CONEGLIANO",VEN,70-79,3,2,0,0,0,5,0,5,0,5,Veneto,ITH3
2021-01-14,PF/BT,244065,"CENTRO DI SERVIZI RESIDENZIALE ""CASA FENZI - RESIDENZA EST"" - CONEGLIANO",VEN,80-89,13,24,0,0,0,37,0,37,0,37,Veneto,ITH3
2021-01-14,PF/BT,244065,"CENTRO DI SERVIZI RESIDENZIALE ""CASA FENZI - RESIDENZA EST"" - CONEGLIANO",VEN,90+,4,16,0,0,0,20,0,20,0,20,Veneto,ITH3
2021-01-14,PF/BT,284006,"CENTRO DI SERVIZI RESIDENZIALE ""UMBERTO I"" MONTEBELLUNA",VEN,16-19,0,1,0,0,1,0,0,1,0,1,Veneto,ITH3
2021-01-14,PF/BT,284006,"CENTRO DI SERVIZI RESIDENZIALE ""UMBERTO I"" MONTEBELLUNA",VEN,20-29,3,12,0,12,3,0,0,15,0,15,Veneto,ITH3
2021-01-14,PF/BT,284006,"CENTRO DI SERVIZI RESIDENZIALE ""UMBERTO I"" MONTEBELLUNA",VEN,30-39,3,14,0,12,5,0,0,17,0,17,Veneto,ITH3
2021-01-14,PF/BT,284006,"CENTRO DI SERVIZI RESIDENZIALE ""UMBERTO I"" MONTEBELLUNA",VEN,40-49,2,25,0,21,6,0,0,27,0,27,Veneto,ITH3
2021-01-14,PF/BT,284006,"CENTRO DI SERVIZI RESIDENZIALE ""UMBERTO I"" MONTEBELLUNA",VEN,50-59,3,29,0,18,13,1,0,32,0,32,Veneto,ITH3
2021-01-14,PF/BT,284006,"CENTRO DI SERVIZI RESIDENZIALE ""UMBERTO I"" MONTEBELLUNA",VEN,60-69,3,9,0,2,5,5,0,12,0,12,Veneto,ITH3
2021-01-14,PF/BT,284006,"CENTRO DI SERVIZI RESIDENZIALE ""UMBERTO I"" MONTEBELLUNA",VEN,70-79,4,10,0,0,0,14,0,14,0,14,Veneto,ITH3
2021-01-14,PF/BT,284006,"CENTRO DI SERVIZI RESIDENZIALE ""UMBERTO I"" MONTEBELLUNA",VEN,80-89,10,30,0,0,0,40,0,40,0,40,Veneto,ITH3
2021-01-14,PF/BT,284006,"CENTRO DI SERVIZI RESIDENZIALE ""UMBERTO I"" MONTEBELLUNA",VEN,90+,4,21,0,0,0,25,0,25,0,25,Veneto,ITH3
2021-01-14,PF/BT,323202,"CENTRO DI SERVIZI RESIDENZIALE ""CASA ALBERGO ANGELA RUSALEN"" - MEDUNA DI LIVENZA",VEN,20-29,0,2,0,1,1,0,0,2,0,2,Veneto,ITH3
2021-01-14,PF/BT,323202,"CENTRO DI SERVIZI RESIDENZIALE ""CASA ALBERGO ANGELA RUSALEN"" - MEDUNA DI LIVENZA",VEN,30-39,1,0,0,1,0,0,0,1,0,1,Veneto,ITH3
2021-01-14,PF/BT,323202,"CENTRO DI SERVIZI RESIDENZIALE ""CASA ALBERGO ANGELA RUSALEN"" - MEDUNA DI LIVENZA",VEN,40-49,0,7,0,4,3,0,0,7,0,7,Veneto,ITH3
2021-01-14,PF/BT,323202,"CENTRO DI SERVIZI RESIDENZIALE ""CASA ALBERGO ANGELA RUSALEN"" - MEDUNA DI LIVENZA",VEN,50-59,0,2,0,2,0,0,0,2,0,2,Veneto,ITH3
2021-01-14,PF/BT,323202,"CENTRO DI SERVIZI RESIDENZIALE ""CASA ALBERGO ANGELA RUSALEN"" - MEDUNA DI LIVENZA",VEN,60-69,1,2,0,1,1,0,1,3,0,3,Veneto,ITH3
2021-01-14,PF/BT,323202,"CENTRO DI SERVIZI RESIDENZIALE ""CASA ALBERGO ANGELA RUSALEN"" - MEDUNA DI LIVENZA",VEN,70-79,1,1,0,0,0,2,0,2,0,2,Veneto,ITH3
2021-01-14,PF/BT,323202,"CENTRO DI SERVIZI RESIDENZIALE ""CASA ALBERGO ANGELA RUSALEN"" - MEDUNA DI LIVENZA",VEN,80-89,0,7,0,0,0,7,0,7,0,7,Veneto,ITH3
2021-01-14,PF/BT,323202,"CENTRO DI SERVIZI RESIDENZIALE ""CASA ALBERGO ANGELA RUSALEN"" - MEDUNA DI LIVENZA",VEN,90+,1,5,0,0,0,6,0,6,0,6,Veneto,ITH3
2021-01-14,PF/BT,363708,RESIDENZA 'SANTA MARGHERITA',VEN,20-29,4,4,0,5,2,1,0,8,0,8,Veneto,ITH3
2021-01-14,PF/BT,363708,RESIDENZA 'SANTA MARGHERITA',VEN,30-39,6,13,0,15,2,1,1,19,0,19,Veneto,ITH3
2021-01-14,PF/BT,363708,RESIDENZA 'SANTA MARGHERITA',VEN,40-49,6,27,0,22,9,2,0,33,0,33,Veneto,ITH3
2021-01-14,PF/BT,363708,RESIDENZA 'SANTA MARGHERITA',VEN,50-59,4,27,0,21,8,2,0,31,0,31,Veneto,ITH3
2021-01-14,PF/BT,363708,RESIDENZA 'SANTA MARGHERITA',VEN,60-69,4,11,0,6,6,3,0,15,0,15,Veneto,ITH3
2021-01-14,PF/BT,363708,RESIDENZA 'SANTA MARGHERITA',VEN,70-79,3,5,0,1,1,6,0,8,0,8,Veneto,ITH3
2021-01-14,PF/BT,363708,RESIDENZA 'SANTA MARGHERITA',VEN,80-89,10,19,0,0,0,28,1,29,0,29,Veneto,ITH3
2021-01-14,PF/BT,363708,RESIDENZA 'SANTA MARGHERITA',VEN,90+,4,7,0,0,0,10,1,11,0,11,Veneto,ITH3
2021-01-14,PF/BT,42817,C.S.A. 'A. BRANDALISE',VEN,20-29,0,1,0,0,1,0,0,1,0,1,Veneto,ITH3
2021-01-14,PF/BT,42817,C.S.A. 'A. BRANDALISE',VEN,30-39,1,3,0,1,2,1,0,4,0,4,Veneto,ITH3
2021-01-14,PF/BT,42817,C.S.A. 'A. BRANDALISE',VEN,40-49,2,5,0,1,6,0,0,7,0,7,Veneto,ITH3
2021-01-14,PF/BT,42817,C.S.A. 'A. BRANDALISE',VEN,50-59,1,4,0,2,3,0,0,5,0,5,Veneto,ITH3
2021-01-14,PF/BT,42817,C.S.A. 'A. BRANDALISE',VEN,60-69,3,1,0,0,1,3,0,4,0,4,Veneto,ITH3
2021-01-14,PF/BT,42817,C.S.A. 'A. BRANDALISE',VEN,70-79,5,8,0,0,0,13,0,13,0,13,Veneto,ITH3
2021-01-14,PF/BT,42817,C.S.A. 'A. BRANDALISE',VEN,80-89,7,24,0,0,0,31,0,31,0,31,Veneto,ITH3
2021-01-14,PF/BT,42817,C.S.A. 'A. BRANDALISE',VEN,90+,1,24,0,0,0,25,0,25,0,25,Veneto,ITH3
2021-01-14,PF/BT,445326,C. SERV.RES.ANZ.-CARLO STEEB,VEN,40-49,0,4,0,4,0,0,0,4,0,4,Veneto,ITH3
2021-01-14,PF/BT,445326,C. SERV.RES.ANZ.-CARLO STEEB,VEN,50-59,1,5,0,6,0,0,0,6,0,6,Veneto,ITH3
2021-01-14,PF/BT,445326,C. SERV.RES.ANZ.-CARLO STEEB,VEN,60-69,6,2,0,2,0,6,0,8,0,8,Veneto,ITH3
2021-01-14,PF/BT,445326,C. SERV.RES.ANZ.-CARLO STEEB,VEN,70-79,4,9,0,0,0,13,0,13,0,13,Veneto,ITH3
2021-01-14,PF/BT,445326,C. SERV.RES.ANZ.-CARLO STEEB,VEN,80-89,7,8,0,0,0,15,0,15,0,15,Veneto,ITH3
2021-01-14,PF/BT,445326,C. SERV.RES.ANZ.-CARLO STEEB,VEN,90+,0,8,0,0,0,8,0,8,0,8,Veneto,ITH3
2021-01-14,PF/BT,445331,C. SERV.RES.ANZ.-ANNI AZZ.QUARTO,VEN,20-29,0,1,0,1,0,0,0,1,0,1,Veneto,ITH3
2021-01-14,PF/BT,445331,C. SERV.RES.ANZ.-ANNI AZZ.QUARTO,VEN,30-39,0,1,0,0,1,0,0,1,0,1,Veneto,ITH3
2021-01-14,PF/BT,445331,C. SERV.RES.ANZ.-ANNI AZZ.QUARTO,VEN,40-49,0,2,0,2,0,0,0,2,0,2,Veneto,ITH3
2021-01-14,PF/BT,445331,C. SERV.RES.ANZ.-ANNI AZZ.QUARTO,VEN,50-59,0,2,0,1,1,0,0,2,0,2,Veneto,ITH3
2021-01-14,PF/BT,445371,C. SERV.RES.ANZ.-ANNI AZZ.FAVARO,VEN,20-29,1,0,0,1,0,0,0,1,0,1,Veneto,ITH3
2021-01-14,PF/BT,445371,C. SERV.RES.ANZ.-ANNI AZZ.FAVARO,VEN,30-39,1,1,0,2,0,0,0,2,0,2,Veneto,ITH3
2021-01-14,PF/BT,445371,C. SERV.RES.ANZ.-ANNI AZZ.FAVARO,VEN,40-49,0,1,0,0,0,1,0,1,0,1,Veneto,ITH3
2021-01-14,PF/BT,445371,C. SERV.RES.ANZ.-ANNI AZZ.FAVARO,VEN,50-59,0,3,0,1,2,0,0,3,0,3,Veneto,ITH3
2021-01-14,PF/BT,445371,C. SERV.RES.ANZ.-ANNI AZZ.FAVARO,VEN,60-69,0,1,0,1,0,0,0,1,0,1,Veneto,ITH3
2021-01-14,PF/BT,445371,C. SERV.RES.ANZ.-ANNI AZZ.FAVARO,VEN,70-79,0,1,0,0,0,1,0,1,0,1,Veneto,ITH3
2021-01-14,PF/BT,445371,C. SERV.RES.ANZ.-ANNI AZZ.FAVARO,VEN,80-89,0,1,0,0,0,1,0,1,0,1,Veneto,ITH3
2021-01-14,PF/BT,445438,S.V.P. CENTRO SERV. ANTICA SCUOLA DEI BATTUTI,VEN,30-39,2,0,0,1,1,0,0,2,0,2,Veneto,ITH3
2021-01-14,PF/BT,445438,S.V.P. CENTRO SERV. ANTICA SCUOLA DEI BATTUTI,VEN,40-49,3,3,0,3,3,0,0,6,0,6,Veneto,ITH3
2021-01-14,PF/BT,445438,S.V.P. CENTRO SERV. ANTICA SCUOLA DEI BATTUTI,VEN,50-59,0,2,0,1,1,0,0,2,0,2,Veneto,ITH3
2021-01-14,PF/BT,445438,S.V.P. CENTRO SERV. ANTICA SCUOLA DEI BATTUTI,VEN,60-69,1,2,0,2,1,0,0,3,0,3,Veneto,ITH3
2021-01-14,PF/BT,445438,S.V.P. CENTRO SERV. ANTICA SCUOLA DEI BATTUTI,VEN,70-79,1,5,0,0,0,6,0,6,0,6,Veneto,ITH3
2021-01-14,PF/BT,445438,S.V.P. CENTRO SERV. ANTICA SCUOLA DEI BATTUTI,VEN,80-89,4,10,0,1,0,13,0,14,0,14,Veneto,ITH3
2021-01-14,PF/BT,445438,S.V.P. CENTRO SERV. ANTICA SCUOLA DEI BATTUTI,VEN,90+,1,9,0,1,0,9,0,10,0,10,Veneto,ITH3
2021-01-14,PF/BT,445444,C. SERV.RES.ANZ.- RESIDENZA VENEZIA,VEN,30-39,1,0,0,1,0,0,0,1,0,1,Veneto,ITH3
2021-01-14,PF/BT,445450,C. SERV.RES.ANZ.-SAN CAMILLO - STELLA MARIS,VEN,20-29,3,2,0,5,0,0,0,5,0,5,Veneto,ITH3
2021-01-14,PF/BT,445450,C. SERV.RES.ANZ.-SAN CAMILLO - STELLA MARIS,VEN,30-39,0,2,0,1,1,0,0,2,0,2,Veneto,ITH3
2021-01-14,PF/BT,445450,C. SERV.RES.ANZ.-SAN CAMILLO - STELLA MARIS,VEN,40-49,2,5,0,3,0,0,4,7,0,7,Veneto,ITH3
2021-01-14,PF/BT,445450,C. SERV.RES.ANZ.-SAN CAMILLO - STELLA MARIS,VEN,50-59,2,10,0,7,1,0,4,12,0,12,Veneto,ITH3
2021-01-14,PF/BT,445450,C. SERV.RES.ANZ.-SAN CAMILLO - STELLA MARIS,VEN,60-69,3,3,0,1,1,2,2,6,0,6,Veneto,ITH3
2021-01-14,PF/BT,445450,C. SERV.RES.ANZ.-SAN CAMILLO - STELLA MARIS,VEN,70-79,5,3,0,1,0,7,0,8,0,8,Veneto,ITH3
2021-01-14,PF/BT,445450,C. SERV.RES.ANZ.-SAN CAMILLO - STELLA MARIS,VEN,80-89,3,9,0,0,0,12,0,12,0,12,Veneto,ITH3
2021-01-14,PF/BT,445450,C. SERV.RES.ANZ.-SAN CAMILLO - STELLA MARIS,VEN,90+,0,4,0,0,0,4,0,4,0,4,Veneto,ITH3
2021-01-14,PF/BT,445451,S.V.P. SAN CAMILLO STELLA MARIS,VEN,40-49,1,0,0,0,0,1,0,1,0,1,Veneto,ITH3
2021-01-14,PF/BT,445451,S.V.P. SAN CAMILLO STELLA MARIS,VEN,60-69,0,1,0,0,0,1,0,1,0,1,Veneto,ITH3
2021-01-14,PF/BT,486001,C.A.S.A. MARIUTTO - MIRANO,VEN,70-79,1,3,0,0,0,4,0,4,0,4,Veneto,ITH3
2021-01-14,PF/BT,486001,C.A.S.A. MARIUTTO - MIRANO,VEN,80-89,3,0,0,0,0,3,0,3,0,3,Veneto,ITH3
2021-01-14,PF/BT,486001,C.A.S.A. MARIUTTO - MIRANO,VEN,90+,0,4,0,0,0,4,0,4,0,4,Veneto,ITH3
2021-01-14,PF/BT,5002200,OSPEDALE P. PEDERZOLI,VEN,20-29,8,4,0,12,0,0,0,12,0,12,Veneto,ITH3
2021-01-14,PF/BT,5002200,OSPEDALE P. PEDERZOLI,VEN,30-39,9,14,0,23,0,0,0,23,0,23,Veneto,ITH3
2021-01-14,PF/BT,5002200,OSPEDALE P. PEDERZOLI,VEN,40-49,8,16,0,24,0,0,0,24,0,24,Veneto,ITH3
2021-01-14,PF/BT,5002200,OSPEDALE P. PEDERZOLI,VEN,50-59,9,14,0,23,0,0,0,23,0,23,Veneto,ITH3
2021-01-14,PF/BT,5002200,OSPEDALE P. PEDERZOLI,VEN,60-69,6,1,0,7,0,0,0,7,0,7,Veneto,ITH3
2021-01-14,PF/BT,5002200,OSPEDALE P. PEDERZOLI,VEN,70-79,1,0,0,1,0,0,0,1,0,1,Veneto,ITH3
2021-01-14,PF/BT,5032,CASA DI RIPOSO LIVINALLONGO,VEN,16-19,0,2,0,2,0,0,0,2,0,2,Veneto,ITH3
2021-01-14,PF/BT,5032,CASA DI RIPOSO LIVINALLONGO,VEN,20-29,1,4,0,4,1,0,0,5,0,5,Veneto,ITH3
2021-01-14,PF/BT,5032,CASA DI RIPOSO LIVINALLONGO,VEN,30-39,1,6,0,5,2,0,0,7,0,7,Veneto,ITH3
2021-01-14,PF/BT,5032,CASA DI RIPOSO LIVINALLONGO,VEN,40-49,2,8,0,4,6,0,0,10,0,10,Veneto,ITH3
2021-01-14,PF/BT,5032,CASA DI RIPOSO LIVINALLONGO,VEN,50-59,2,11,0,8,5,0,0,13,0,13,Veneto,ITH3
2021-01-14,PF/BT,5032,CASA DI RIPOSO LIVINALLONGO,VEN,60-69,4,9,0,4,6,3,0,13,0,13,Veneto,ITH3
2021-01-14,PF/BT,5032,CASA DI RIPOSO LIVINALLONGO,VEN,70-79,3,3,0,0,1,5,0,6,0,6,Veneto,ITH3
2021-01-14,PF/BT,5032,CASA DI RIPOSO LIVINALLONGO,VEN,80-89,5,15,0,0,0,20,0,20,0,20,Veneto,ITH3
2021-01-14,PF/BT,5032,CASA DI RIPOSO LIVINALLONGO,VEN,90+,1,21,0,0,0,22,0,22,0,22,Veneto,ITH3
2021-01-14,PF/BT,50501,BELLUNO AMBULATORIO N.15,VEN,30-39,1,0,0,1,0,0,0,1,0,1,Veneto,ITH3
2021-01-14,PF/BT,50501,BELLUNO AMBULATORIO N.15,VEN,50-59,1,0,0,1,0,0,0,1,0,1,Veneto,ITH3
2021-01-14,PF/BT,50501,FELTRE,VEN,20-29,0,1,0,1,0,0,0,1,0,1,Veneto,ITH3
2021-01-14,PF/BT,50501,FELTRE,VEN,40-49,0,4,0,0,4,0,0,4,0,4,Veneto,ITH3
2021-01-14,PF/BT,50501,FELTRE,VEN,50-59,0,7,0,3,4,0,0,7,0,7,Veneto,ITH3
2021-01-14,PF/BT,50501,FELTRE,VEN,60-69,1,5,0,2,4,0,0,6,0,6,Veneto,ITH3
2021-01-14,PF/BT,50501,FELTRE,VEN,70-79,1,2,0,0,3,0,0,3,0,3,Veneto,ITH3
2021-01-14,PF/BT,50501,PIEVE DI CADORE,VEN,20-29,1,11,0,11,1,0,0,12,0,12,Veneto,ITH3
2021-01-14,PF/BT,50501,PIEVE DI CADORE,VEN,30-39,10,5,0,14,1,0,0,15,0,15,Veneto,ITH3
2021-01-14,PF/BT,50501,PIEVE DI CADORE,VEN,40-49,2,15,0,10,7,0,0,17,0,17,Veneto,ITH3
2021-01-14,PF/BT,50501,PIEVE DI CADORE,VEN,50-59,1,20,0,8,13,0,0,21,0,21,Veneto,ITH3
2021-01-14,PF/BT,50501,PIEVE DI CADORE,VEN,60-69,1,6,0,5,2,0,0,7,0,7,Veneto,ITH3
2021-01-14,PF/BT,50501,PIEVE DI CADORE,VEN,70-79,3,9,0,0,0,12,0,12,0,12,Veneto,ITH3
2021-01-14,PF/BT,50501,PIEVE DI CADORE,VEN,80-89,1,22,0,1,0,22,0,23,0,23,Veneto,ITH3
2021-01-14,PF/BT,50501,PIEVE DI CADORE,VEN,90+,2,20,0,0,0,22,0,22,0,22,Veneto,ITH3
2021-01-14,PF/BT,50502,CONEGLIANO,VEN,20-29,0,1,0,1,0,0,0,1,0,1,Veneto,ITH3
2021-01-14,PF/BT,50502,CONEGLIANO,VEN,30-39,1,0,0,1,0,0,0,1,0,1,Veneto,ITH3
2021-01-14,PF/BT,50502,CONEGLIANO,VEN,40-49,1,1,0,2,0,0,0,2,0,2,Veneto,ITH3
2021-01-14,PF/BT,50502,CONEGLIANO,VEN,50-59,1,1,0,2,0,0,0,2,0,2,Veneto,ITH3
2021-01-14,PF/BT,50502,MONTEBELLUNA,VEN,50-59,1,0,0,1,0,0,0,1,0,1,Veneto,ITH3
2021-01-14,PF/BT,50503,CHIOGGIA,VEN,20-29,7,12,0,11,0,0,8,19,0,19,Veneto,ITH3
2021-01-14,PF/BT,50503,CHIOGGIA,VEN,30-39,7,14,0,10,0,0,11,21,0,21,Veneto,ITH3
2021-01-14,PF/BT,50503,CHIOGGIA,VEN,40-49,12,26,0,20,0,0,18,38,0,38,Veneto,ITH3
2021-01-14,PF/BT,50503,CHIOGGIA,VEN,50-59,6,13,0,7,0,0,12,19,0,19,Veneto,ITH3
2021-01-14,PF/BT,50503,CHIOGGIA,VEN,60-69,5,5,0,9,0,0,1,10,0,10,Veneto,ITH3
2021-01-14,PF/BT,50503,CHIOGGIA,VEN,70-79,7,0,0,7,0,0,0,7,0,7,Veneto,ITH3
2021-01-14,PF/BT,50503,NOALE ADULTI,VEN,16-19,1,0,0,0,0,0,1,1,0,1,Veneto,ITH3
2021-01-14,PF/BT,50503,NOALE ADULTI,VEN,20-29,1,2,0,2,1,0,0,3,0,3,Veneto,ITH3
2021-01-14,PF/BT,50503,NOALE ADULTI,VEN,30-39,2,6,0,5,1,0,2,8,0,8,Veneto,ITH3
2021-01-14,PF/BT,50503,NOALE ADULTI,VEN,40-49,5,3,0,4,0,0,4,8,0,8,Veneto,ITH3
2021-01-14,PF/BT,50503,NOALE ADULTI,VEN,50-59,8,2,0,4,0,0,6,10,0,10,Veneto,ITH3
2021-01-14,PF/BT,50503,NOALE ADULTI,VEN,60-69,2,2,0,1,1,0,2,4,0,4,Veneto,ITH3
2021-01-14,PF/BT,50503,NOALE ADULTI,VEN,80-89,2,0,0,1,1,0,0,2,0,2,Veneto,ITH3
2021-01-14,PF/BT,50503,S.I.S.P. MESTRE,VEN,20-29,1,6,0,7,0,0,0,7,0,7,Veneto,ITH3
2021-01-14,PF/BT,50503,S.I.S.P. MESTRE,VEN,30-39,4,18,0,22,0,0,0,22,0,22,Veneto,ITH3
2021-01-14,PF/BT,50503,S.I.S.P. MESTRE,VEN,40-49,8,15,0,23,0,0,0,23,0,23,Veneto,ITH3
2021-01-14,PF/BT,50503,S.I.S.P. MESTRE,VEN,50-59,11,27,0,38,0,0,0,38,0,38,Veneto,ITH3
2021-01-14,PF/BT,50503,S.I.S.P. MESTRE,VEN,60-69,7,9,0,16,0,0,0,16,0,16,Veneto,ITH3
2021-01-14,PF/BT,50503,S.I.S.P. MESTRE,VEN,70-79,2,0,0,2,0,0,0,2,0,2,Veneto,ITH3
2021-01-14,PF/BT,50503,S.I.S.P. VENEZIA,VEN,20-29,1,5,0,6,0,0,0,6,0,6,Veneto,ITH3
2021-01-14,PF/BT,50503,S.I.S.P. VENEZIA,VEN,30-39,9,18,0,24,3,0,0,27,0,27,Veneto,ITH3
2021-01-14,PF/BT,50503,S.I.S.P. VENEZIA,VEN,40-49,5,19,0,20,4,0,0,24,0,24,Veneto,ITH3
2021-01-14,PF/BT,50503,S.I.S.P. VENEZIA,VEN,50-59,8,17,0,22,3,0,0,25,0,25,Veneto,ITH3
2021-01-14,PF/BT,50503,S.I.S.P. VENEZIA,VEN,60-69,5,8,0,11,2,0,0,13,0,13,Veneto,ITH3
2021-01-14,PF/BT,50503,S.I.S.P. VENEZIA,VEN,70-79,1,0,0,1,0,0,0,1,0,1,Veneto,ITH3
2021-01-14,PF/BT,50506,AZ OSPEDALIERA DI PADOVA MAL. INFET.E TR,VEN,20-29,0,1,0,1,0,0,0,1,0,1,Veneto,ITH3
2021-01-14,PF/BT,50506,AZ OSPEDALIERA DI PADOVA MAL. INFET.E TR,VEN,40-49,0,1,0,1,0,0,0,1,0,1,Veneto,ITH3
2021-01-14,PF/BT,50506,AZ OSPEDALIERA DI PADOVA MAL. INFET.E TR,VEN,50-59,19,34,0,53,0,0,0,53,0,53,Veneto,ITH3
2021-01-14,PF/BT,50506,AZ OSPEDALIERA DI PADOVA MAL. INFET.E TR,VEN,60-69,21,15,0,36,0,0,0,36,0,36,Veneto,ITH3
2021-01-14,PF/BT,50506,CAMPOSAMPIERO MEDICO COMPETENT,VEN,20-29,2,4,0,6,0,0,0,6,0,6,Veneto,ITH3
2021-01-14,PF/BT,50506,CAMPOSAMPIERO MEDICO COMPETENT,VEN,30-39,9,9,0,9,9,0,0,18,0,18,Veneto,ITH3
2021-01-14,PF/BT,50506,CAMPOSAMPIERO MEDICO COMPETENT,VEN,40-49,1,23,0,6,18,0,0,24,0,24,Veneto,ITH3
2021-01-14,PF/BT,50506,CAMPOSAMPIERO MEDICO COMPETENT,VEN,50-59,7,37,0,19,25,0,0,44,0,44,Veneto,ITH3
2021-01-14,PF/BT,50506,CAMPOSAMPIERO MEDICO COMPETENT,VEN,60-69,2,8,0,3,7,0,0,10,0,10,Veneto,ITH3
2021-01-14,PF/BT,50506,CITTADELLA MEDICO COMPETENTE,VEN,20-29,2,2,0,2,1,0,1,4,0,4,Veneto,ITH3
2021-01-14,PF/BT,50506,CITTADELLA MEDICO COMPETENTE,VEN,30-39,2,7,0,4,4,0,1,9,0,9,Veneto,ITH3
2021-01-14,PF/BT,50506,CITTADELLA MEDICO COMPETENTE,VEN,40-49,4,6,0,4,3,0,3,10,0,10,Veneto,ITH3
2021-01-14,PF/BT,50506,CITTADELLA MEDICO COMPETENTE,VEN,50-59,5,21,0,12,7,0,7,26,0,26,Veneto,ITH3
2021-01-14,PF/BT,50506,CITTADELLA MEDICO COMPETENTE,VEN,60-69,5,2,0,2,5,0,0,7,0,7,Veneto,ITH3
2021-01-14,PF/BT,50506,CITTADELLA MEDICO COMPETENTE,VEN,70-79,2,1,0,2,1,0,0,3,0,3,Veneto,ITH3
2021-01-14,PF/BT,50506,CITTADELLA MEDICO COMPETENTE,VEN,80-89,0,1,0,0,1,0,0,1,0,1,Veneto,ITH3
2021-01-14,PF/BT,50506,COLLI VACC. ADULTI,VEN,20-29,3,1,0,2,0,0,2,4,0,4,Veneto,ITH3
2021-01-14,PF/BT,50506,COLLI VACC. ADULTI,VEN,30-39,3,5,0,4,0,0,4,8,0,8,Veneto,ITH3
2021-01-14,PF/BT,50506,COLLI VACC. ADULTI,VEN,40-49,4,5,0,7,0,0,2,9,0,9,Veneto,ITH3
2021-01-14,PF/BT,50506,COLLI VACC. ADULTI,VEN,50-59,7,13,0,11,1,0,8,20,0,20,Veneto,ITH3
2021-01-14,PF/BT,50506,COLLI VACC. ADULTI,VEN,60-69,7,5,0,9,1,0,2,12,0,12,Veneto,ITH3
2021-01-14,PF/BT,50506,COLLI VACC. ADULTI,VEN,70-79,1,0,0,1,0,0,0,1,0,1,Veneto,ITH3
2021-01-14,PF/BT,50506,DISTR. 3 ALBIGNASEGO AMB.IGIEN,VEN,20-29,1,3,0,0,4,0,0,4,0,4,Veneto,ITH3
2021-01-14,PF/BT,50506,DISTR. 3 ALBIGNASEGO AMB.IGIEN,VEN,30-39,2,3,0,0,5,0,0,5,0,5,Veneto,ITH3
2021-01-14,PF/BT,50506,DISTR. 3 ALBIGNASEGO AMB.IGIEN,VEN,40-49,0,2,0,0,2,0,0,2,0,2,Veneto,ITH3
2021-01-14,PF/BT,50506,DISTR. 3 ALBIGNASEGO AMB.IGIEN,VEN,50-59,0,4,0,2,2,0,0,4,0,4,Veneto,ITH3
2021-01-14,PF/BT,50506,DISTR. 3 ALBIGNASEGO AMB.IGIEN,VEN,60-69,3,0,0,3,0,0,0,3,0,3,Veneto,ITH3
2021-01-14,PF/BT,50506,MONSELICE,VEN,16-19,2,1,0,0,0,3,0,3,0,3,Veneto,ITH3
2021-01-14,PF/BT,50506,MONSELICE,VEN,20-29,17,38,0,16,12,27,0,55,0,55,Veneto,ITH3
2021-01-14,PF/BT,50506,MONSELICE,VEN,30-39,16,27,0,16,5,22,0,43,0,43,Veneto,ITH3
2021-01-14,PF/BT,50506,MONSELICE,VEN,40-49,25,50,0,26,9,40,0,75,0,75,Veneto,ITH3
2021-01-14,PF/BT,50506,MONSELICE,VEN,50-59,38,55,0,27,14,52,0,93,0,93,Veneto,ITH3
2021-01-14,PF/BT,50506,MONSELICE,VEN,60-69,10,13,0,4,6,13,0,23,0,23,Veneto,ITH3
2021-01-14,PF/BT,50506,MONSELICE,VEN,70-79,2,0,0,0,0,2,0,2,0,2,Veneto,ITH3
2021-01-14,PF/BT,50506,SCHIAVONIA AMBULATORIO,VEN,20-29,10,12,0,10,12,0,0,22,0,22,Veneto,ITH3
2021-01-14,PF/BT,50506,SCHIAVONIA AMBULATORIO,VEN,30-39,12,15,0,3,24,0,0,27,0,27,Veneto,ITH3
2021-01-14,PF/BT,50506,SCHIAVONIA AMBULATORIO,VEN,40-49,16,15,0,2,29,0,0,31,0,31,Veneto,ITH3
2021-01-14,PF/BT,50506,SCHIAVONIA AMBULATORIO,VEN,50-59,11,20,0,5,26,0,0,31,0,31,Veneto,ITH3
2021-01-14,PF/BT,50506,SCHIAVONIA AMBULATORIO,VEN,60-69,8,2,0,0,10,0,0,10,0,10,Veneto,ITH3
2021-01-14,PF/BT,50506,VIA SCROVEGNI ANTI INFLUENZALE,VEN,20-29,5,3,0,3,1,4,0,8,0,8,Veneto,ITH3
2021-01-14,PF/BT,50506,VIA SCROVEGNI ANTI INFLUENZALE,VEN,30-39,0,3,0,1,1,1,0,3,0,3,Veneto,ITH3
2021-01-14,PF/BT,50506,VIA SCROVEGNI ANTI INFLUENZALE,VEN,40-49,5,5,0,6,2,2,0,10,0,10,Veneto,ITH3
2021-01-14,PF/BT,50506,VIA SCROVEGNI ANTI INFLUENZALE,VEN,50-59,1,8,0,5,2,2,0,9,0,9,Veneto,ITH3
2021-01-14,PF/BT,50506,VIA SCROVEGNI ANTI INFLUENZALE,VEN,60-69,3,2,0,1,3,1,0,5,0,5,Veneto,ITH3
2021-01-14,PF/BT,50506,VIA SCROVEGNI ANTI INFLUENZALE,VEN,70-79,0,1,0,0,0,1,0,1,0,1,Veneto,ITH3
2021-01-14,PF/BT,50506,VIA TEMANZA ANTI INFLUENZALE,VEN,20-29,1,0,0,1,0,0,0,1,0,1,Veneto,ITH3
2021-01-14,PF/BT,50506,VIA TEMANZA ANTI INFLUENZALE,VEN,30-39,2,2,0,4,0,0,0,4,0,4,Veneto,ITH3
2021-01-14,PF/BT,50506,VIA TEMANZA ANTI INFLUENZALE,VEN,40-49,0,7,0,7,0,0,0,7,0,7,Veneto,ITH3
2021-01-14,PF/BT,50506,VIA TEMANZA ANTI INFLUENZALE,VEN,50-59,2,9,0,10,1,0,0,11,0,11,Veneto,ITH3
2021-01-14,PF/BT,50506,VIA TEMANZA ANTI INFLUENZALE,VEN,60-69,4,3,0,7,0,0,0,7,0,7,Veneto,ITH3
2021-01-14,PF/BT,50507,DIPARTIMENTO DI PREVENZIONE,VEN,20-29,0,1,0,1,0,0,0,1,0,1,Veneto,ITH3
2021-01-14,PF/BT,50507,EX OSPEDALE - BOLDRINI,VEN,20-29,6,11,0,17,0,0,0,17,0,17,Veneto,ITH3
2021-01-14,PF/BT,50507,EX OSPEDALE - BOLDRINI,VEN,30-39,4,19,0,23,0,0,0,23,0,23,Veneto,ITH3
2021-01-14,PF/BT,50507,EX OSPEDALE - BOLDRINI,VEN,40-49,1,13,0,14,0,0,0,14,0,14,Veneto,ITH3
2021-01-14,PF/BT,50507,EX OSPEDALE - BOLDRINI,VEN,50-59,3,18,0,21,0,0,0,21,0,21,Veneto,ITH3
2021-01-14,PF/BT,50507,EX OSPEDALE - BOLDRINI,VEN,60-69,10,5,0,15,0,0,0,15,0,15,Veneto,ITH3
2021-01-14,PF/BT,50507,EX OSPEDALE - BOLDRINI,VEN,70-79,3,1,0,4,0,0,0,4,0,4,Veneto,ITH3
2021-01-14,PF/BT,50507,H ASIAGO,VEN,40-49,0,5,0,4,1,0,0,5,0,5,Veneto,ITH3
2021-01-14,PF/BT,50507,H ASIAGO,VEN,50-59,2,10,0,9,3,0,0,12,0,12,Veneto,ITH3
2021-01-14,PF/BT,50507,H ASIAGO,VEN,60-69,1,2,0,3,0,0,0,3,0,3,Veneto,ITH3
2021-01-14,PF/BT,50507,H BASSANO,VEN,20-29,0,5,0,5,0,0,0,5,0,5,Veneto,ITH3
2021-01-14,PF/BT,50507,H BASSANO,VEN,30-39,2,12,0,10,4,0,0,14,0,14,Veneto,ITH3
2021-01-14,PF/BT,50507,H BASSANO,VEN,40-49,10,22,0,28,4,0,0,32,0,32,Veneto,ITH3
2021-01-14,PF/BT,50507,H BASSANO,VEN,50-59,4,19,0,14,9,0,0,23,0,23,Veneto,ITH3
2021-01-14,PF/BT,50507,H BASSANO,VEN,60-69,6,1,0,1,6,0,0,7,0,7,Veneto,ITH3
2021-01-14,PF/BT,50507,H BASSANO,VEN,70-79,1,0,0,0,1,0,0,1,0,1,Veneto,ITH3
2021-01-14,PF/BT,50507,H BASSANO,VEN,80-89,1,0,0,1,0,0,0,1,0,1,Veneto,ITH3
2021-01-14,PF/BT,50507,SANTORSO,VEN,16-19,0,3,0,3,0,0,0,3,0,3,Veneto,ITH3
2021-01-14,PF/BT,50507,SANTORSO,VEN,20-29,6,25,0,31,0,0,0,31,0,31,Veneto,ITH3
2021-01-14,PF/BT,50507,SANTORSO,VEN,30-39,2,6,0,8,0,0,0,8,0,8,Veneto,ITH3
2021-01-14,PF/BT,50507,SANTORSO,VEN,40-49,2,6,0,8,0,0,0,8,0,8,Veneto,ITH3
2021-01-14,PF/BT,50507,SANTORSO,VEN,50-59,1,10,0,11,0,0,0,11,0,11,Veneto,ITH3
2021-01-14,PF/BT,50507,SANTORSO,VEN,60-69,0,1,0,1,0,0,0,1,0,1,Veneto,ITH3
2021-01-14,PF/BT,5050801,MED.COMP. - OSP. SAN BORTOLO,VEN,16-19,0,2,0,0,2,0,0,2,0,2,Veneto,ITH3
2021-01-14,PF/BT,5050801,MED.COMP. - OSP. SAN BORTOLO,VEN,20-29,7,31,0,25,6,0,7,38,0,38,Veneto,ITH3
2021-01-14,PF/BT,5050801,MED.COMP. - OSP. SAN BORTOLO,VEN,30-39,20,47,0,47,18,0,2,67,0,67,Veneto,ITH3
2021-01-14,PF/BT,5050801,MED.COMP. - OSP. SAN BORTOLO,VEN,40-49,23,67,0,55,23,0,12,90,0,90,Veneto,ITH3
2021-01-14,PF/BT,5050801,MED.COMP. - OSP. SAN BORTOLO,VEN,50-59,27,98,0,65,43,0,17,125,0,125,Veneto,ITH3
2021-01-14,PF/BT,5050801,MED.COMP. - OSP. SAN BORTOLO,VEN,60-69,19,22,0,22,16,0,3,41,0,41,Veneto,ITH3
2021-01-14,PF/BT,5050801,MED.COMP. - OSP. SAN BORTOLO,VEN,70-79,7,1,0,6,2,0,0,8,0,8,Veneto,ITH3
2021-01-14,PF/BT,5050804,MED.COMP. - OSP. SAN GIOVANNI,VEN,20-29,5,8,0,12,1,0,0,13,0,13,Veneto,ITH3
2021-01-14,PF/BT,5050804,MED.COMP. - OSP. SAN GIOVANNI,VEN,30-39,4,18,0,16,5,0,1,22,0,22,Veneto,ITH3
2021-01-14,PF/BT,5050804,MED.COMP. - OSP. SAN GIOVANNI,VEN,40-49,8,43,0,35,14,0,2,51,0,51,Veneto,ITH3
2021-01-14,PF/BT,5050804,MED.COMP. - OSP. SAN GIOVANNI,VEN,50-59,18,55,0,46,25,0,2,73,0,73,Veneto,ITH3
2021-01-14,PF/BT,5050804,MED.COMP. - OSP. SAN GIOVANNI,VEN,60-69,7,18,0,13,11,0,1,25,0,25,Veneto,ITH3
2021-01-14,PF/BT,5091201,AOUIVR,VEN,20-29,4,6,0,10,0,0,0,10,0,10,Veneto,ITH3
2021-01-14,PF/BT,5091201,AOUIVR,VEN,30-39,4,15,0,19,0,0,0,19,0,19,Veneto,ITH3
2021-01-14,PF/BT,5091201,AOUIVR,VEN,40-49,5,17,0,22,0,0,0,22,0,22,Veneto,ITH3
2021-01-14,PF/BT,5091201,AOUIVR,VEN,50-59,9,32,0,41,0,0,0,41,0,41,Veneto,ITH3
2021-01-14,PF/BT,5091201,AOUIVR,VEN,60-69,27,29,0,56,0,0,0,56,0,56,Veneto,ITH3
2021-01-14,PF/BT,5091201,AOUIVR,VEN,70-79,4,3,0,7,0,0,0,7,0,7,Veneto,ITH3
2021-01-14,PF/BT,5091201,AOUIVR,VEN,80-89,1,1,0,2,0,0,0,2,0,2,Veneto,ITH3
2021-01-14,PF/BT,5095201,IOV,VEN,20-29,1,6,0,7,0,0,0,7,0,7,Veneto,ITH3
2021-01-14,PF/BT,5095201,IOV,VEN,30-39,4,9,0,13,0,0,0,13,0,13,Veneto,ITH3
2021-01-14,PF/BT,5095201,IOV,VEN,40-49,6,5,0,11,0,0,0,11,0,11,Veneto,ITH3
2021-01-14,PF/BT,5095201,IOV,VEN,50-59,1,12,0,13,0,0,0,13,0,13,Veneto,ITH3
2021-01-14,PF/BT,5095201,IOV,VEN,60-69,2,2,0,4,0,0,0,4,0,4,Veneto,ITH3
2021-01-14,PF/BT,563022,C.D.R. VILLA IMPERIALE,VEN,20-29,0,6,0,6,0,0,0,6,0,6,Veneto,ITH3
2021-01-14,PF/BT,563022,C.D.R. VILLA IMPERIALE,VEN,30-39,1,11,0,9,3,0,0,12,0,12,Veneto,ITH3
2021-01-14,PF/BT,563022,C.D.R. VILLA IMPERIALE,VEN,40-49,0,19,0,13,6,0,0,19,0,19,Veneto,ITH3
2021-01-14,PF/BT,563022,C.D.R. VILLA IMPERIALE,VEN,50-59,2,14,0,8,7,1,0,16,0,16,Veneto,ITH3
2021-01-14,PF/BT,563022,C.D.R. VILLA IMPERIALE,VEN,60-69,0,5,0,3,2,0,0,5,0,5,Veneto,ITH3
2021-01-14,PF/BT,563022,C.D.R. VILLA IMPERIALE,VEN,80-89,0,1,0,0,0,1,0,1,0,1,Veneto,ITH3
2021-01-14,PF/BT,563022,C.D.R. VILLA IMPERIALE,VEN,90+,0,1,0,0,0,1,0,1,0,1,Veneto,ITH3
2021-01-14,PF/BT,563044,C.D.R. DON ORIONE,VEN,20-29,0,3,0,3,0,0,0,3,0,3,Veneto,ITH3
2021-01-14,PF/BT,563044,C.D.R. DON ORIONE,VEN,30-39,0,4,0,4,0,0,0,4,0,4,Veneto,ITH3
2021-01-14,PF/BT,563044,C.D.R. DON ORIONE,VEN,40-49,2,5,0,2,4,1,0,7,0,7,Veneto,ITH3
2021-01-14,PF/BT,563044,C.D.R. DON ORIONE,VEN,50-59,0,9,0,3,5,1,0,9,0,9,Veneto,ITH3
2021-01-14,PF/BT,563044,C.D.R. DON ORIONE,VEN,60-69,1,3,0,1,1,2,0,4,0,4,Veneto,ITH3
2021-01-14,PF/BT,563044,C.D.R. DON ORIONE,VEN,70-79,2,3,0,0,0,5,0,5,0,5,Veneto,ITH3
2021-01-14,PF/BT,563044,C.D.R. DON ORIONE,VEN,80-89,3,16,0,0,0,19,0,19,0,19,Veneto,ITH3
2021-01-14,PF/BT,563044,C.D.R. DON ORIONE,VEN,90+,2,12,0,0,0,14,0,14,0,14,Veneto,ITH3
2021-01-14,PF/BT,563068,CASA DON L. MARAN,VEN,50-59,0,1,0,0,0,1,0,1,0,1,Veneto,ITH3
2021-01-14,PF/BT,563068,CASA DON L. MARAN,VEN,60-69,0,1,0,0,0,1,0,1,0,1,Veneto,ITH3
2021-01-14,PF/BT,563068,CASA DON L. MARAN,VEN,70-79,1,17,0,1,1,16,0,18,0,18,Veneto,ITH3
2021-01-14,PF/BT,563068,CASA DON L. MARAN,VEN,80-89,4,80,0,0,1,83,0,84,0,84,Veneto,ITH3
2021-01-14,PF/BT,563068,CASA DON L. MARAN,VEN,90+,2,92,0,0,0,94,0,94,0,94,Veneto,ITH3
2021-01-14,PF/BT,610903,CASA DI CURA ABANO TERME SPA,VEN,20-29,5,5,0,10,0,0,0,10,0,10,Veneto,ITH3
2021-01-14,PF/BT,610903,CASA DI CURA ABANO TERME SPA,VEN,30-39,3,4,0,7,0,0,0,7,0,7,Veneto,ITH3
2021-01-14,PF/BT,610903,CASA DI CURA ABANO TERME SPA,VEN,40-49,5,19,0,24,0,0,0,24,0,24,Veneto,ITH3
2021-01-14,PF/BT,610903,CASA DI CURA ABANO TERME SPA,VEN,50-59,8,15,0,23,0,0,0,23,0,23,Veneto,ITH3
2021-01-14,PF/BT,610903,CASA DI CURA ABANO TERME SPA,VEN,60-69,1,1,0,2,0,0,0,2,0,2,Veneto,ITH3
2021-01-14,PF/BT,610947,CONGR. SUORE CARITA' SS. CAPITANIO E GEROSA CASA DI RIPOSO MARIA BAMBINA,VEN,40-49,0,1,0,1,0,0,0,1,0,1,Veneto,ITH3
2021-01-14,PF/BT,610947,CONGR. SUORE CARITA' SS. CAPITANIO E GEROSA CASA DI RIPOSO MARIA BAMBINA,VEN,50-59,0,2,0,2,0,0,0,2,0,2,Veneto,ITH3
2021-01-14,PF/BT,610947,CONGR. SUORE CARITA' SS. CAPITANIO E GEROSA CASA DI RIPOSO MARIA BAMBINA,VEN,80-89,0,1,0,0,0,1,0,1,0,1,Veneto,ITH3
2021-01-14,PF/BT,610947,CONGR. SUORE CARITA' SS. CAPITANIO E GEROSA CASA DI RIPOSO MARIA BAMBINA,VEN,90+,0,2,0,0,0,2,0,2,0,2,Veneto,ITH3
2021-01-14,PF/BT,610955,OPSA - OPERA PROVVIDENZA S.ANTONIO DISABILI,VEN,20-29,1,1,0,2,0,0,0,2,0,2,Veneto,ITH3
2021-01-14,PF/BT,610955,OPSA - OPERA PROVVIDENZA S.ANTONIO DISABILI,VEN,30-39,2,2,0,3,0,0,1,4,0,4,Veneto,ITH3
2021-01-14,PF/BT,610955,OPSA - OPERA PROVVIDENZA S.ANTONIO DISABILI,VEN,40-49,1,7,0,8,0,0,0,8,0,8,Veneto,ITH3
2021-01-14,PF/BT,610955,OPSA - OPERA PROVVIDENZA S.ANTONIO DISABILI,VEN,50-59,3,9,0,9,0,0,3,12,0,12,Veneto,ITH3
2021-01-14,PF/BT,610955,OPSA - OPERA PROVVIDENZA S.ANTONIO DISABILI,VEN,60-69,2,0,0,1,0,1,0,2,0,2,Veneto,ITH3
2021-01-14,PF/BT,611113,RSA CASA BREDA,VEN,30-39,0,3,0,3,0,0,0,3,0,3,Veneto,ITH3
2021-01-14,PF/BT,611113,RSA CASA BREDA,VEN,40-49,1,6,0,6,0,1,0,7,0,7,Veneto,ITH3
2021-01-14,PF/BT,611113,RSA CASA BREDA,VEN,50-59,4,9,0,4,0,9,0,13,0,13,Veneto,ITH3
2021-01-14,PF/BT,611113,RSA CASA BREDA,VEN,60-69,4,7,0,3,0,8,0,11,0,11,Veneto,ITH3
2021-01-14,PF/BT,611113,RSA CASA BREDA,VEN,70-79,0,2,0,0,0,2,0,2,0,2,Veneto,ITH3
2021-01-14,PF/BT,611115,CODESS SOCIALE RESIDENZA PARCO DEL SOLE,VEN,20-29,0,3,0,1,2,0,0,3,0,3,Veneto,ITH3
2021-01-14,PF/BT,611115,CODESS SOCIALE RESIDENZA PARCO DEL SOLE,VEN,30-39,6,6,0,6,6,0,0,12,0,12,Veneto,ITH3
2021-01-14,PF/BT,611115,CODESS SOCIALE RESIDENZA PARCO DEL SOLE,VEN,40-49,8,20,0,13,14,1,0,28,0,28,Veneto,ITH3
2021-01-14,PF/BT,611115,CODESS SOCIALE RESIDENZA PARCO DEL SOLE,VEN,50-59,5,11,0,5,11,0,0,16,0,16,Veneto,ITH3
2021-01-14,PF/BT,611115,CODESS SOCIALE RESIDENZA PARCO DEL SOLE,VEN,60-69,4,4,0,2,3,3,0,8,0,8,Veneto,ITH3
2021-01-14,PF/BT,611115,CODESS SOCIALE RESIDENZA PARCO DEL SOLE,VEN,70-79,2,1,0,0,0,3,0,3,0,3,Veneto,ITH3
2021-01-14,PF/BT,611115,CODESS SOCIALE RESIDENZA PARCO DEL SOLE,VEN,80-89,1,8,0,0,0,9,0,9,0,9,Veneto,ITH3
2021-01-14,PF/BT,611115,CODESS SOCIALE RESIDENZA PARCO DEL SOLE,VEN,90+,2,6,0,0,0,8,0,8,0,8,Veneto,ITH3
2021-01-14,PF/BT,611121,OPSA - CENTRO RESIDENZIALE MADRE TERESA DI CALCUTTA,VEN,40-49,0,1,0,1,0,0,0,1,0,1,Veneto,ITH3
2021-01-14,PF/BT,611171,C.A. IL PORTICO - ABITARE IL TEMPO,VEN,70-79,1,0,0,0,0,0,1,1,0,1,Veneto,ITH3
2021-01-14,PF/BT,611198,OPSA - CASA MASSIMILIANO KOLBE,VEN,40-49,0,1,0,1,0,0,0,1,0,1,Veneto,ITH3
2021-01-14,PF/BT,611198,OPSA - CASA MASSIMILIANO KOLBE,VEN,50-59,1,1,0,1,1,0,0,2,0,2,Veneto,ITH3
2021-01-14,PF/BT,611223,OPSA CENTRO DIURNO SAN RAFFAELE,VEN,40-49,0,1,0,1,0,0,0,1,0,1,Veneto,ITH3
2021-01-14,PF/BT,611223,OPSA CENTRO DIURNO SAN RAFFAELE,VEN,60-69,1,0,0,0,0,1,0,1,0,1,Veneto,ITH3
2021-01-14,PF/BT,611223,OPSA CENTRO DIURNO SAN RAFFAELE,VEN,70-79,2,2,0,0,0,4,0,4,0,4,Veneto,ITH3
2021-01-14,PF/BT,611223,OPSA CENTRO DIURNO SAN RAFFAELE,VEN,80-89,2,7,0,0,0,9,0,9,0,9,Veneto,ITH3
2021-01-14,PF/BT,611223,OPSA CENTRO DIURNO SAN RAFFAELE,VEN,90+,1,0,0,0,0,1,0,1,0,1,Veneto,ITH3
2021-01-14,PF/BT,611224,OPSA -CENTRO DIURNO SAN CAMILLO,VEN,40-49,0,1,0,1,0,0,0,1,0,1,Veneto,ITH3
2021-01-14,PF/BT,611224,OPSA -CENTRO DIURNO SAN CAMILLO,VEN,50-59,1,1,0,0,0,2,0,2,0,2,Veneto,ITH3
2021-01-14,PF/BT,611224,OPSA -CENTRO DIURNO SAN CAMILLO,VEN,60-69,1,1,0,0,0,2,0,2,0,2,Veneto,ITH3
2021-01-14,PF/BT,611224,OPSA -CENTRO DIURNO SAN CAMILLO,VEN,70-79,3,3,0,0,0,6,0,6,0,6,Veneto,ITH3
2021-01-14,PF/BT,611224,OPSA -CENTRO DIURNO SAN CAMILLO,VEN,80-89,3,2,0,0,0,5,0,5,0,5,Veneto,ITH3
2021-01-14,PF/BT,611243,CENTRO DI RIFERIMENTO PER LE GRAVI DISABILITA' E DISTIURBI DEL COMPORTAMENTO,VEN,50-59,0,1,0,0,0,1,0,1,0,1,Veneto,ITH3
2021-01-14,PF/BT,611243,CENTRO DI RIFERIMENTO PER LE GRAVI DISABILITA' E DISTIURBI DEL COMPORTAMENTO,VEN,60-69,0,1,0,0,0,1,0,1,0,1,Veneto,ITH3
2021-01-14,PF/BT,611275,"RESIDENZA SOCIO-SANITARIA PSICHIATRICA ""PARCO DEI TIGLI""",VEN,20-29,0,1,0,1,0,0,0,1,0,1,Veneto,ITH3
2021-01-14,PF/BT,611275,"RESIDENZA SOCIO-SANITARIA PSICHIATRICA ""PARCO DEI TIGLI""",VEN,30-39,0,1,0,1,0,0,0,1,0,1,Veneto,ITH3
2021-01-14,PF/BT,611275,"RESIDENZA SOCIO-SANITARIA PSICHIATRICA ""PARCO DEI TIGLI""",VEN,40-49,3,8,0,9,0,0,2,11,0,11,Veneto,ITH3
2021-01-14,PF/BT,611275,"RESIDENZA SOCIO-SANITARIA PSICHIATRICA ""PARCO DEI TIGLI""",VEN,50-59,11,8,0,6,0,7,6,19,0,19,Veneto,ITH3
2021-01-14,PF/BT,611275,"RESIDENZA SOCIO-SANITARIA PSICHIATRICA ""PARCO DEI TIGLI""",VEN,60-69,3,1,0,2,0,1,1,4,0,4,Veneto,ITH3
2021-01-14,PF/BT,642092,CASA DI RIPOSO CONSELVE,VEN,20-29,0,1,0,0,1,0,0,1,0,1,Veneto,ITH3
2021-01-14,PF/BT,642092,CASA DI RIPOSO CONSELVE,VEN,50-59,0,1,0,0,1,0,0,1,0,1,Veneto,ITH3
2021-01-14,PF/BT,642092,CASA DI RIPOSO CONSELVE,VEN,60-69,1,3,0,0,0,4,0,4,0,4,Veneto,ITH3
2021-01-14,PF/BT,642092,CASA DI RIPOSO CONSELVE,VEN,70-79,9,7,0,0,1,15,0,16,0,16,Veneto,ITH3
2021-01-14,PF/BT,642092,CASA DI RIPOSO CONSELVE,VEN,80-89,8,34,0,0,0,42,0,42,0,42,Veneto,ITH3
2021-01-14,PF/BT,642092,CASA DI RIPOSO CONSELVE,VEN,90+,5,33,0,0,0,38,0,38,0,38,Veneto,ITH3
2021-01-14,PF/BT,642093,"CASA DI RIPOSO ""SANTA TECLA"" ESTE",VEN,20-29,0,2,0,1,1,0,0,2,0,2,Veneto,ITH3
2021-01-14,PF/BT,642093,"CASA DI RIPOSO ""SANTA TECLA"" ESTE",VEN,30-39,2,0,0,0,2,0,0,2,0,2,Veneto,ITH3
2021-01-14,PF/BT,642093,"CASA DI RIPOSO ""SANTA TECLA"" ESTE",VEN,40-49,1,1,0,0,2,0,0,2,0,2,Veneto,ITH3
2021-01-14,PF/BT,642093,"CASA DI RIPOSO ""SANTA TECLA"" ESTE",VEN,50-59,0,2,0,2,0,0,0,2,0,2,Veneto,ITH3
2021-01-14,PF/BT,642093,"CASA DI RIPOSO ""SANTA TECLA"" ESTE",VEN,70-79,2,0,0,0,2,0,0,2,0,2,Veneto,ITH3
2021-01-14,PF/BT,642093,"CASA DI RIPOSO ""SANTA TECLA"" ESTE",VEN,80-89,0,1,0,0,0,1,0,1,0,1,Veneto,ITH3
2021-01-14,PF/BT,642093,"CASA DI RIPOSO ""SANTA TECLA"" ESTE",VEN,90+,0,1,0,0,0,1,0,1,0,1,Veneto,ITH3
2021-01-14,PF/BT,642114,C.S.A. 'VALGRANDE',VEN,20-29,1,2,0,3,0,0,0,3,0,3,Veneto,ITH3
2021-01-14,PF/BT,642114,C.S.A. 'VALGRANDE',VEN,30-39,1,1,0,1,1,0,0,2,0,2,Veneto,ITH3
2021-01-14,PF/BT,642114,C.S.A. 'VALGRANDE',VEN,40-49,0,4,0,2,2,0,0,4,0,4,Veneto,ITH3
2021-01-14,PF/BT,642114,C.S.A. 'VALGRANDE',VEN,50-59,1,1,0,1,0,1,0,2,0,2,Veneto,ITH3
2021-01-14,PF/BT,642114,C.S.A. 'VALGRANDE',VEN,70-79,0,2,0,0,0,2,0,2,0,2,Veneto,ITH3
2021-01-14,PF/BT,642114,C.S.A. 'VALGRANDE',VEN,80-89,1,10,0,0,0,11,0,11,0,11,Veneto,ITH3
2021-01-14,PF/BT,642114,C.S.A. 'VALGRANDE',VEN,90+,0,11,0,0,0,11,0,11,0,11,Veneto,ITH3
2021-01-14,PF/BT,642131,CENTRO SERVIZI NON AUTOSUFF. LE ROSE,VEN,20-29,1,9,0,8,2,0,0,10,0,10,Veneto,ITH3
2021-01-14,PF/BT,642131,CENTRO SERVIZI NON AUTOSUFF. LE ROSE,VEN,30-39,0,4,0,2,2,0,0,4,0,4,Veneto,ITH3
2021-01-14,PF/BT,642131,CENTRO SERVIZI NON AUTOSUFF. LE ROSE,VEN,40-49,1,6,0,4,3,0,0,7,0,7,Veneto,ITH3
2021-01-14,PF/BT,642131,CENTRO SERVIZI NON AUTOSUFF. LE ROSE,VEN,50-59,2,7,0,4,4,1,0,9,0,9,Veneto,ITH3
2021-01-14,PF/BT,642131,CENTRO SERVIZI NON AUTOSUFF. LE ROSE,VEN,60-69,2,0,0,0,0,2,0,2,0,2,Veneto,ITH3
2021-01-14,PF/BT,642131,CENTRO SERVIZI NON AUTOSUFF. LE ROSE,VEN,70-79,4,7,0,0,0,11,0,11,0,11,Veneto,ITH3
2021-01-14,PF/BT,642131,CENTRO SERVIZI NON AUTOSUFF. LE ROSE,VEN,80-89,4,22,0,0,0,26,0,26,0,26,Veneto,ITH3
2021-01-14,PF/BT,642131,CENTRO SERVIZI NON AUTOSUFF. LE ROSE,VEN,90+,0,12,0,0,0,12,0,12,0,12,Veneto,ITH3
2021-01-14,PF/BT,642147,"C.S.A. NON AUTOSUFFICIENTI ""RESIDENZA AL PARCO"" GALZIGNANO TERME",VEN,40-49,1,2,0,0,3,0,0,3,0,3,Veneto,ITH3
2021-01-14,PF/BT,642147,"C.S.A. NON AUTOSUFFICIENTI ""RESIDENZA AL PARCO"" GALZIGNANO TERME",VEN,50-59,0,3,0,0,3,0,0,3,0,3,Veneto,ITH3
2021-01-14,PF/BT,642147,"C.S.A. NON AUTOSUFFICIENTI ""RESIDENZA AL PARCO"" GALZIGNANO TERME",VEN,60-69,1,1,0,0,0,2,0,2,0,2,Veneto,ITH3
2021-01-14,PF/BT,642147,"C.S.A. NON AUTOSUFFICIENTI ""RESIDENZA AL PARCO"" GALZIGNANO TERME",VEN,70-79,1,3,0,0,0,4,0,4,0,4,Veneto,ITH3
2021-01-14,PF/BT,642147,"C.S.A. NON AUTOSUFFICIENTI ""RESIDENZA AL PARCO"" GALZIGNANO TERME",VEN,80-89,5,17,0,0,0,22,0,22,0,22,Veneto,ITH3
2021-01-14,PF/BT,642147,"C.S.A. NON AUTOSUFFICIENTI ""RESIDENZA AL PARCO"" GALZIGNANO TERME",VEN,90+,1,12,0,0,0,13,0,13,0,13,Veneto,ITH3
2021-01-14,PF/BT,683013,IRAS IST. RODIGINO DI ASS. SOC,VEN,20-29,2,4,0,2,4,0,0,6,0,6,Veneto,ITH3
2021-01-14,PF/BT,683013,IRAS IST. RODIGINO DI ASS. SOC,VEN,30-39,1,11,0,10,2,0,0,12,0,12,Veneto,ITH3
2021-01-14,PF/BT,683013,IRAS IST. RODIGINO DI ASS. SOC,VEN,40-49,2,28,0,24,5,1,0,30,0,30,Veneto,ITH3
2021-01-14,PF/BT,683013,IRAS IST. RODIGINO DI ASS. SOC,VEN,50-59,11,55,0,50,11,5,0,66,0,66,Veneto,ITH3
2021-01-14,PF/BT,683013,IRAS IST. RODIGINO DI ASS. SOC,VEN,60-69,9,18,0,12,5,10,0,27,0,27,Veneto,ITH3
2021-01-14,PF/BT,683013,IRAS IST. RODIGINO DI ASS. SOC,VEN,70-79,7,15,0,0,0,22,0,22,0,22,Veneto,ITH3
2021-01-14,PF/BT,683013,IRAS IST. RODIGINO DI ASS. SOC,VEN,80-89,12,60,0,0,0,70,2,72,0,72,Veneto,ITH3
2021-01-14,PF/BT,683013,IRAS IST. RODIGINO DI ASS. SOC,VEN,90+,2,59,0,0,0,58,3,61,0,61,Veneto,ITH3
2021-01-14,PF/BT,765012,CEN. RES. 'MARZANA',VEN,20-29,2,0,0,2,0,0,0,2,0,2,Veneto,ITH3
2021-01-14,PF/BT,765012,CEN. RES. 'MARZANA',VEN,30-39,2,5,0,7,0,0,0,7,0,7,Veneto,ITH3
2021-01-14,PF/BT,765012,CEN. RES. 'MARZANA',VEN,40-49,2,18,0,20,0,0,0,20,0,20,Veneto,ITH3
2021-01-14,PF/BT,765012,CEN. RES. 'MARZANA',VEN,50-59,4,27,0,29,0,2,0,31,0,31,Veneto,ITH3
2021-01-14,PF/BT,765012,CEN. RES. 'MARZANA',VEN,60-69,0,11,0,6,0,5,0,11,0,11,Veneto,ITH3
2021-01-14,PF/BT,765012,CEN. RES. 'MARZANA',VEN,70-79,10,7,0,0,0,16,1,17,0,17,Veneto,ITH3
2021-01-14,PF/BT,765012,CEN. RES. 'MARZANA',VEN,80-89,7,25,0,0,0,32,0,32,0,32,Veneto,ITH3
2021-01-14,PF/BT,765012,CEN. RES. 'MARZANA',VEN,90+,1,13,0,0,0,14,0,14,0,14,Veneto,ITH3
2021-01-14,PF/BT,765019,C.D.R. 'DON B. MUSSOLIN',VEN,20-29,1,15,0,13,3,0,0,16,0,16,Veneto,ITH3
2021-01-14,PF/BT,765019,C.D.R. 'DON B. MUSSOLIN',VEN,30-39,3,13,0,11,5,0,0,16,0,16,Veneto,ITH3
2021-01-14,PF/BT,765019,C.D.R. 'DON B. MUSSOLIN',VEN,40-49,7,28,0,18,15,2,0,35,0,35,Veneto,ITH3
2021-01-14,PF/BT,765019,C.D.R. 'DON B. MUSSOLIN',VEN,50-59,9,42,0,31,20,0,0,51,0,51,Veneto,ITH3
2021-01-14,PF/BT,765019,C.D.R. 'DON B. MUSSOLIN',VEN,60-69,4,9,0,5,7,1,0,13,0,13,Veneto,ITH3
2021-01-14,PF/BT,765019,C.D.R. 'DON B. MUSSOLIN',VEN,70-79,4,4,0,0,0,8,0,8,0,8,Veneto,ITH3
2021-01-14,PF/BT,765019,C.D.R. 'DON B. MUSSOLIN',VEN,80-89,8,25,0,0,0,33,0,33,0,33,Veneto,ITH3
2021-01-14,PF/BT,765019,C.D.R. 'DON B. MUSSOLIN',VEN,90+,4,37,0,0,0,41,0,41,0,41,Veneto,ITH3
2021-01-14,PF/BT,765055,C.D.R. 'BIANCA STECCANELLA',VEN,70-79,0,1,0,0,0,1,0,1,0,1,Veneto,ITH3
2021-01-14,PF/BT,765056,C.D.R. 'DOMENICO CARDO',VEN,20-29,0,1,0,1,0,0,0,1,0,1,Veneto,ITH3
2021-01-14,PF/BT,765056,C.D.R. 'DOMENICO CARDO',VEN,40-49,0,4,0,4,0,0,0,4,0,4,Veneto,ITH3
2021-01-14,PF/BT,765056,C.D.R. 'DOMENICO CARDO',VEN,50-59,0,6,0,5,1,0,0,6,0,6,Veneto,ITH3
2021-01-14,PF/BT,765056,C.D.R. 'DOMENICO CARDO',VEN,60-69,0,1,0,1,0,0,0,1,0,1,Veneto,ITH3
2021-01-14,PF/BT,765066,CASA SOGG. 'P.C.C. BRESCIANI',VEN,20-29,2,2,0,4,0,0,0,4,0,4,Veneto,ITH3
2021-01-14,PF/BT,765066,CASA SOGG. 'P.C.C. BRESCIANI',VEN,30-39,0,3,0,3,0,0,0,3,0,3,Veneto,ITH3
2021-01-14,PF/BT,765066,CASA SOGG. 'P.C.C. BRESCIANI',VEN,40-49,1,3,0,4,0,0,0,4,0,4,Veneto,ITH3
2021-01-14,PF/BT,765066,CASA SOGG. 'P.C.C. BRESCIANI',VEN,50-59,5,11,0,15,1,0,0,16,0,16,Veneto,ITH3
2021-01-14,PF/BT,765066,CASA SOGG. 'P.C.C. BRESCIANI',VEN,60-69,0,2,0,2,0,0,0,2,0,2,Veneto,ITH3
2021-01-14,PF/BT,768001,CENTRO ASSISTENZA MISSIONARI COMBONIANI,VEN,20-29,2,8,0,9,1,0,0,10,0,10,Veneto,ITH3
2021-01-14,PF/BT,768001,CENTRO ASSISTENZA MISSIONARI COMBONIANI,VEN,30-39,1,4,0,3,2,0,0,5,0,5,Veneto,ITH3
2021-01-14,PF/BT,768001,CENTRO ASSISTENZA MISSIONARI COMBONIANI,VEN,40-49,4,10,0,7,7,0,0,14,0,14,Veneto,ITH3
2021-01-14,PF/BT,768001,CENTRO ASSISTENZA MISSIONARI COMBONIANI,VEN,50-59,6,6,0,4,6,2,0,12,0,12,Veneto,ITH3
2021-01-14,PF/BT,768001,CENTRO ASSISTENZA MISSIONARI COMBONIANI,VEN,60-69,11,5,0,4,4,8,0,16,0,16,Veneto,ITH3
2021-01-14,PF/BT,768001,CENTRO ASSISTENZA MISSIONARI COMBONIANI,VEN,70-79,18,0,0,0,2,16,0,18,0,18,Veneto,ITH3
2021-01-14,PF/BT,768001,CENTRO ASSISTENZA MISSIONARI COMBONIANI,VEN,80-89,28,0,0,0,0,28,0,28,0,28,Veneto,ITH3
2021-01-14,PF/BT,768001,CENTRO ASSISTENZA MISSIONARI COMBONIANI,VEN,90+,11,0,0,0,0,11,0,11,0,11,Veneto,ITH3
2021-01-14,PF/BT,768005,C.D.R. 'CITTA' DI VERONA',VEN,20-29,0,4,0,4,0,0,0,4,0,4,Veneto,ITH3
2021-01-14,PF/BT,768005,C.D.R. 'CITTA' DI VERONA',VEN,30-39,2,4,0,6,0,0,0,6,0,6,Veneto,ITH3
2021-01-14,PF/BT,768005,C.D.R. 'CITTA' DI VERONA',VEN,40-49,1,10,0,11,0,0,0,11,0,11,Veneto,ITH3
2021-01-14,PF/BT,768005,C.D.R. 'CITTA' DI VERONA',VEN,50-59,2,8,0,10,0,0,0,10,0,10,Veneto,ITH3
2021-01-14,PF/BT,768005,C.D.R. 'CITTA' DI VERONA',VEN,60-69,2,5,0,4,0,3,0,7,0,7,Veneto,ITH3
2021-01-14,PF/BT,768005,C.D.R. 'CITTA' DI VERONA',VEN,70-79,4,4,0,0,0,8,0,8,0,8,Veneto,ITH3
2021-01-14,PF/BT,768005,C.D.R. 'CITTA' DI VERONA',VEN,80-89,4,31,0,0,0,35,0,35,0,35,Veneto,ITH3
2021-01-14,PF/BT,768005,C.D.R. 'CITTA' DI VERONA',VEN,90+,10,15,0,0,0,25,0,25,0,25,Veneto,ITH3
2021-01-14,PF/BT,768037,CEN. RES. PIA OPERA CICCARELLI,VEN,20-29,0,2,0,2,0,0,0,2,0,2,Veneto,ITH3
2021-01-14,PF/BT,768037,CEN. RES. PIA OPERA CICCARELLI,VEN,30-39,0,4,0,4,0,0,0,4,0,4,Veneto,ITH3
2021-01-14,PF/BT,768037,CEN. RES. PIA OPERA CICCARELLI,VEN,40-49,1,15,0,16,0,0,0,16,0,16,Veneto,ITH3
2021-01-14,PF/BT,768037,CEN. RES. PIA OPERA CICCARELLI,VEN,50-59,2,8,0,10,0,0,0,10,0,10,Veneto,ITH3
2021-01-14,PF/BT,768037,CEN. RES. PIA OPERA CICCARELLI,VEN,60-69,0,3,0,3,0,0,0,3,0,3,Veneto,ITH3
2021-01-14,PF/BT,768037,CEN. RES. PIA OPERA CICCARELLI,VEN,70-79,4,0,0,0,0,4,0,4,0,4,Veneto,ITH3
2021-01-14,PF/BT,768037,CEN. RES. PIA OPERA CICCARELLI,VEN,80-89,5,8,0,0,0,13,0,13,0,13,Veneto,ITH3
2021-01-14,PF/BT,768037,CEN. RES. PIA OPERA CICCARELLI,VEN,90+,1,7,0,0,0,8,0,8,0,8,Veneto,ITH3
2021-01-14,PF/BT,802092,CASA DI RIPOSO SAN BIAGIO,VEN,20-29,2,5,0,7,0,0,0,7,0,7,Veneto,ITH3
2021-01-14,PF/BT,802092,CASA DI RIPOSO SAN BIAGIO,VEN,30-39,1,6,0,6,1,0,0,7,0,7,Veneto,ITH3
2021-01-14,PF/BT,802092,CASA DI RIPOSO SAN BIAGIO,VEN,40-49,0,11,0,9,2,0,0,11,0,11,Veneto,ITH3
2021-01-14,PF/BT,802092,CASA DI RIPOSO SAN BIAGIO,VEN,50-59,0,4,0,3,1,0,0,4,0,4,Veneto,ITH3
2021-01-14,PF/BT,802092,CASA DI RIPOSO SAN BIAGIO,VEN,60-69,0,3,0,2,1,0,0,3,0,3,Veneto,ITH3
2021-01-14,PF/BT,802094,IST.PER ANZIANI DE BATTISTI,VEN,70-79,3,3,0,0,0,6,0,6,0,6,Veneto,ITH3
2021-01-14,PF/BT,802094,IST.PER ANZIANI DE BATTISTI,VEN,80-89,5,12,0,0,0,17,0,17,0,17,Veneto,ITH3
2021-01-14,PF/BT,802094,IST.PER ANZIANI DE BATTISTI,VEN,90+,4,8,0,0,0,12,0,12,0,12,Veneto,ITH3
2021-01-14,PF/BT,802096,FONDAZIONE LUIGI FERRARI,VEN,30-39,0,1,0,1,0,0,0,1,0,1,Veneto,ITH3
2021-01-14,PF/BT,802096,FONDAZIONE LUIGI FERRARI,VEN,40-49,0,1,0,1,0,0,0,1,0,1,Veneto,ITH3
2021-01-14,PF/BT,802096,FONDAZIONE LUIGI FERRARI,VEN,50-59,0,1,0,0,1,0,0,1,0,1,Veneto,ITH3
2021-01-14,PF/BT,802096,FONDAZIONE LUIGI FERRARI,VEN,60-69,0,1,0,0,0,1,0,1,0,1,Veneto,ITH3
2021-01-14,PF/BT,802096,FONDAZIONE LUIGI FERRARI,VEN,70-79,1,2,0,0,0,1,2,3,0,3,Veneto,ITH3
2021-01-14,PF/BT,802096,FONDAZIONE LUIGI FERRARI,VEN,80-89,3,10,0,0,0,9,4,13,0,13,Veneto,ITH3
2021-01-14,PF/BT,802096,FONDAZIONE LUIGI FERRARI,VEN,90+,1,8,0,0,0,5,4,9,0,9,Veneto,ITH3
2021-01-14,PF/BT,802097,CASA DI RIPOSO LEGNAGO,VEN,20-29,4,3,0,6,0,0,1,7,0,7,Veneto,ITH3
2021-01-14,PF/BT,802097,CASA DI RIPOSO LEGNAGO,VEN,30-39,2,6,0,4,3,0,1,8,0,8,Veneto,ITH3
2021-01-14,PF/BT,802097,CASA DI RIPOSO LEGNAGO,VEN,40-49,4,23,0,19,4,0,4,27,0,27,Veneto,ITH3
2021-01-14,PF/BT,802097,CASA DI RIPOSO LEGNAGO,VEN,50-59,5,35,0,30,9,0,1,40,0,40,Veneto,ITH3
2021-01-14,PF/BT,802097,CASA DI RIPOSO LEGNAGO,VEN,60-69,4,8,0,7,3,0,2,12,0,12,Veneto,ITH3
2021-01-14,PF/BT,802201,CASA S.GIUSEPPE ASS.G.GIRELLI,VEN,30-39,2,6,0,5,3,0,0,8,0,8,Veneto,ITH3
2021-01-14,PF/BT,802201,CASA S.GIUSEPPE ASS.G.GIRELLI,VEN,40-49,10,4,0,9,4,1,0,14,0,14,Veneto,ITH3
2021-01-14,PF/BT,802201,CASA S.GIUSEPPE ASS.G.GIRELLI,VEN,50-59,2,4,0,4,2,0,0,6,0,6,Veneto,ITH3
2021-01-14,PF/BT,802201,CASA S.GIUSEPPE ASS.G.GIRELLI,VEN,60-69,1,0,0,0,1,0,0,1,0,1,Veneto,ITH3
2021-01-14,PF/BT,802201,CASA S.GIUSEPPE ASS.G.GIRELLI,VEN,70-79,1,0,0,0,1,0,0,1,0,1,Veneto,ITH3
2021-01-14,PF/BT,802202,FONDAZIONE 'BALDO IPPOLITA,VEN,20-29,0,4,0,4,0,0,0,4,0,4,Veneto,ITH3
2021-01-14,PF/BT,802202,FONDAZIONE 'BALDO IPPOLITA,VEN,30-39,1,4,0,2,3,0,0,5,0,5,Veneto,ITH3
2021-01-14,PF/BT,802202,FONDAZIONE 'BALDO IPPOLITA,VEN,40-49,1,15,0,9,7,0,0,16,0,16,Veneto,ITH3
2021-01-14,PF/BT,802202,FONDAZIONE 'BALDO IPPOLITA,VEN,50-59,2,27,0,23,6,0,0,29,0,29,Veneto,ITH3
2021-01-14,PF/BT,802202,FONDAZIONE 'BALDO IPPOLITA,VEN,60-69,1,3,0,3,0,1,0,4,0,4,Veneto,ITH3
2021-01-14,PF/BT,802202,FONDAZIONE 'BALDO IPPOLITA,VEN,70-79,4,1,0,1,0,4,0,5,0,5,Veneto,ITH3
2021-01-14,PF/BT,802202,FONDAZIONE 'BALDO IPPOLITA,VEN,80-89,4,28,0,1,0,31,0,32,0,32,Veneto,ITH3
2021-01-14,PF/BT,802202,FONDAZIONE 'BALDO IPPOLITA,VEN,90+,5,19,0,0,0,24,0,24,0,24,Veneto,ITH3
2021-01-14,PF/BT,802204,FONDAZIONE 'M.ZANETTI',VEN,20-29,0,1,0,1,0,0,0,1,0,1,Veneto,ITH3
2021-01-14,PF/BT,802204,FONDAZIONE 'M.ZANETTI',VEN,30-39,2,3,0,5,0,0,0,5,0,5,Veneto,ITH3
2021-01-14,PF/BT,802204,FONDAZIONE 'M.ZANETTI',VEN,40-49,0,9,0,9,0,0,0,9,0,9,Veneto,ITH3
2021-01-14,PF/BT,802204,FONDAZIONE 'M.ZANETTI',VEN,50-59,1,13,0,12,0,1,1,14,0,14,Veneto,ITH3
2021-01-14,PF/BT,802204,FONDAZIONE 'M.ZANETTI',VEN,60-69,1,3,0,3,0,1,0,4,0,4,Veneto,ITH3
2021-01-14,PF/BT,802204,FONDAZIONE 'M.ZANETTI',VEN,70-79,1,7,0,0,0,8,0,8,0,8,Veneto,ITH3
2021-01-14,PF/BT,802204,FONDAZIONE 'M.ZANETTI',VEN,80-89,7,15,0,0,0,20,2,22,0,22,Veneto,ITH3
2021-01-14,PF/BT,802204,FONDAZIONE 'M.ZANETTI',VEN,90+,1,6,0,0,0,6,1,7,0,7,Veneto,ITH3
2021-01-14,PF/BT,84002,CASA DI RIPOSO ASIAGO,VEN,20-29,0,1,0,1,0,0,0,1,0,1,Veneto,ITH3
2021-01-14,PF/BT,84002,CASA DI RIPOSO ASIAGO,VEN,30-39,1,3,0,3,1,0,0,4,0,4,Veneto,ITH3
2021-01-14,PF/BT,84002,CASA DI RIPOSO ASIAGO,VEN,40-49,0,7,0,6,1,0,0,7,0,7,Veneto,ITH3
2021-01-14,PF/BT,84002,CASA DI RIPOSO ASIAGO,VEN,50-59,0,5,0,4,1,0,0,5,0,5,Veneto,ITH3
2021-01-14,PF/BT,84002,CASA DI RIPOSO ASIAGO,VEN,60-69,1,1,0,1,0,1,0,2,0,2,Veneto,ITH3
2021-01-14,PF/BT,84002,CASA DI RIPOSO ASIAGO,VEN,70-79,6,1,0,0,0,7,0,7,0,7,Veneto,ITH3
2021-01-14,PF/BT,84002,CASA DI RIPOSO ASIAGO,VEN,80-89,4,16,0,0,0,20,0,20,0,20,Veneto,ITH3
2021-01-14,PF/BT,84002,CASA DI RIPOSO ASIAGO,VEN,90+,1,10,0,0,0,11,0,11,0,11,Veneto,ITH3
2021-01-14,PF/BT,84016,I.S.A.C.C. - VILLA SERENA,VEN,20-29,2,14,0,14,2,0,0,16,0,16,Veneto,ITH3
2021-01-14,PF/BT,84016,I.S.A.C.C. - VILLA SERENA,VEN,30-39,3,6,0,8,1,0,0,9,0,9,Veneto,ITH3
2021-01-14,PF/BT,84016,I.S.A.C.C. - VILLA SERENA,VEN,40-49,5,28,0,26,7,0,0,33,0,33,Veneto,ITH3
2021-01-14,PF/BT,84016,I.S.A.C.C. - VILLA SERENA,VEN,50-59,5,32,0,30,7,0,0,37,0,37,Veneto,ITH3
2021-01-14,PF/BT,84016,I.S.A.C.C. - VILLA SERENA,VEN,60-69,5,13,0,9,4,5,0,18,0,18,Veneto,ITH3
2021-01-14,PF/BT,84016,I.S.A.C.C. - VILLA SERENA,VEN,70-79,11,10,0,0,1,20,0,21,0,21,Veneto,ITH3
2021-01-14,PF/BT,84016,I.S.A.C.C. - VILLA SERENA,VEN,80-89,13,36,0,0,0,49,0,49,0,49,Veneto,ITH3
2021-01-14,PF/BT,84016,I.S.A.C.C. - VILLA SERENA,VEN,90+,5,27,0,0,0,32,0,32,0,32,Veneto,ITH3
2021-01-14,PF/BT,845215,"IPAB ""VERONESI DR. GERMANO"" CASA DI RIPOSO",VEN,20-29,0,3,0,3,0,0,0,3,0,3,Veneto,ITH3
2021-01-14,PF/BT,845215,"IPAB ""VERONESI DR. GERMANO"" CASA DI RIPOSO",VEN,30-39,1,5,0,1,5,0,0,6,0,6,Veneto,ITH3
2021-01-14,PF/BT,845215,"IPAB ""VERONESI DR. GERMANO"" CASA DI RIPOSO",VEN,40-49,0,15,0,5,10,0,0,15,0,15,Veneto,ITH3
2021-01-14,PF/BT,845215,"IPAB ""VERONESI DR. GERMANO"" CASA DI RIPOSO",VEN,50-59,3,22,0,14,11,0,0,25,0,25,Veneto,ITH3
2021-01-14,PF/BT,845215,"IPAB ""VERONESI DR. GERMANO"" CASA DI RIPOSO",VEN,60-69,2,4,0,3,1,2,0,6,0,6,Veneto,ITH3
2021-01-14,PF/BT,845215,"IPAB ""VERONESI DR. GERMANO"" CASA DI RIPOSO",VEN,70-79,0,2,0,0,1,1,0,2,0,2,Veneto,ITH3
2021-01-14,PF/BT,845215,"IPAB ""VERONESI DR. GERMANO"" CASA DI RIPOSO",VEN,80-89,2,2,0,0,0,4,0,4,0,4,Veneto,ITH3
2021-01-14,PF/BT,845215,"IPAB ""VERONESI DR. GERMANO"" CASA DI RIPOSO",VEN,90+,1,2,0,0,0,3,0,3,0,3,Veneto,ITH3
2021-01-14,PF/BT,845231,CASA RIPOSO SPAZIO APERTO LAZISE,VEN,30-39,1,2,0,3,0,0,0,3,0,3,Veneto,ITH3
2021-01-14,PF/BT,845231,CASA RIPOSO SPAZIO APERTO LAZISE,VEN,40-49,0,5,0,5,0,0,0,5,0,5,Veneto,ITH3
2021-01-14,PF/BT,845231,CASA RIPOSO SPAZIO APERTO LAZISE,VEN,50-59,2,3,0,4,0,1,0,5,0,5,Veneto,ITH3
2021-01-14,PF/BT,845231,CASA RIPOSO SPAZIO APERTO LAZISE,VEN,60-69,0,1,0,0,0,1,0,1,0,1,Veneto,ITH3
2021-01-14,PF/BT,845231,CASA RIPOSO SPAZIO APERTO LAZISE,VEN,70-79,3,2,0,0,0,5,0,5,0,5,Veneto,ITH3
2021-01-14,PF/BT,845231,CASA RIPOSO SPAZIO APERTO LAZISE,VEN,80-89,2,3,0,0,0,5,0,5,0,5,Veneto,ITH3
2021-01-14,PF/BT,845231,CASA RIPOSO SPAZIO APERTO LAZISE,VEN,90+,0,4,0,0,0,4,0,4,0,4,Veneto,ITH3
2021-01-14,PF/BT,845239,IPAB PIO RICOVERO P.SEGATTINI,VEN,80-89,1,0,0,0,0,1,0,1,0,1,Veneto,ITH3
2021-01-14,PF/BT,845273,RESIDENZA ANNI D'ARGENTO CASTELNUOVO,VEN,20-29,1,0,0,1,0,0,0,1,0,1,Veneto,ITH3
2021-01-14,PF/BT,845273,RESIDENZA ANNI D'ARGENTO CASTELNUOVO,VEN,30-39,0,1,0,1,0,0,0,1,0,1,Veneto,ITH3
2021-01-14,PF/BT,845273,RESIDENZA ANNI D'ARGENTO CASTELNUOVO,VEN,40-49,0,4,0,4,0,0,0,4,0,4,Veneto,ITH3
2021-01-14,PF/BT,845273,RESIDENZA ANNI D'ARGENTO CASTELNUOVO,VEN,50-59,0,5,0,5,0,0,0,5,0,5,Veneto,ITH3
2021-01-14,PF/BT,845273,RESIDENZA ANNI D'ARGENTO CASTELNUOVO,VEN,60-69,0,2,0,1,0,1,0,2,0,2,Veneto,ITH3
2021-01-14,PF/BT,845273,RESIDENZA ANNI D'ARGENTO CASTELNUOVO,VEN,70-79,0,1,0,0,0,1,0,1,0,1,Veneto,ITH3
2021-01-14,PF/BT,845273,RESIDENZA ANNI D'ARGENTO CASTELNUOVO,VEN,80-89,2,4,0,0,0,6,0,6,0,6,Veneto,ITH3
2021-01-14,PF/BT,845273,RESIDENZA ANNI D'ARGENTO CASTELNUOVO,VEN,90+,2,7,0,0,0,9,0,9,0,9,Veneto,ITH3
2021-01-14,PF/BT,CASAOSP,CASA DELL'OSPITALITA',VEN,20-29,0,2,0,1,1,0,0,2,0,2,Veneto,ITH3
2021-01-14,PF/BT,CASAOSP,CASA DELL'OSPITALITA',VEN,30-39,1,2,0,2,1,0,0,3,0,3,Veneto,ITH3
2021-01-14,PF/BT,CASAOSP,CASA DELL'OSPITALITA',VEN,40-49,1,3,0,3,1,0,0,4,0,4,Veneto,ITH3
2021-01-14,PF/BT,CASAOSP,CASA DELL'OSPITALITA',VEN,50-59,1,8,0,6,3,0,0,9,0,9,Veneto,ITH3
2021-01-14,PF/BT,CASAOSP,CASA DELL'OSPITALITA',VEN,60-69,0,1,0,1,0,0,0,1,0,1,Veneto,ITH3
2021-01-14,PF/BT,MANTEGNA,CSA MANTEGNA CAMPODARSEGO,VEN,20-29,0,2,0,2,0,0,0,2,0,2,Veneto,ITH3
2021-01-14,PF/BT,MANTEGNA,CSA MANTEGNA CAMPODARSEGO,VEN,30-39,0,2,0,1,1,0,0,2,0,2,Veneto,ITH3
2021-01-14,PF/BT,MANTEGNA,CSA MANTEGNA CAMPODARSEGO,VEN,40-49,1,7,0,7,1,0,0,8,0,8,Veneto,ITH3
2021-01-14,PF/BT,MANTEGNA,CSA MANTEGNA CAMPODARSEGO,VEN,50-59,2,5,0,1,6,0,0,7,0,7,Veneto,ITH3
2021-01-14,PF/BT,MANTEGNA,CSA MANTEGNA CAMPODARSEGO,VEN,70-79,2,1,0,0,0,3,0,3,0,3,Veneto,ITH3
2021-01-14,PF/BT,MANTEGNA,CSA MANTEGNA CAMPODARSEGO,VEN,80-89,3,6,0,0,0,9,0,9,0,9,Veneto,ITH3
2021-01-14,PF/BT,MANTEGNA,CSA MANTEGNA CAMPODARSEGO,VEN,90+,1,4,0,0,0,5,0,5,0,5,Veneto,ITH3
2021-01-15,PF/BT,0,Mancante,VEN,16-19,1,0,0,0,1,0,0,1,0,1,Veneto,ITH3
2021-01-15,PF/BT,0,Mancante,VEN,20-29,8,6,0,0,14,0,0,14,0,14,Veneto,ITH3
2021-01-15,PF/BT,0,Mancante,VEN,30-39,0,8,0,0,8,0,0,8,0,8,Veneto,ITH3
2021-01-15,PF/BT,0,Mancante,VEN,40-49,15,10,0,0,25,0,0,25,0,25,Veneto,ITH3
2021-01-15,PF/BT,0,Mancante,VEN,50-59,9,8,0,0,17,0,0,17,0,17,Veneto,ITH3
2021-01-15,PF/BT,0,Mancante,VEN,60-69,11,7,0,0,18,0,0,18,0,18,Veneto,ITH3
2021-01-15,PF/BT,0,Mancante,VEN,70-79,2,2,0,0,4,0,0,4,0,4,Veneto,ITH3
2021-01-15,PF/BT,132237,C.R. LA CASA - VALBELLA,VEN,40-49,0,1,0,1,0,0,0,1,0,1,Veneto,ITH3
2021-01-15,PF/BT,162441,CENTRO SERVIZI ASSISTENZIALI S. ANTONIO - CHIAMPO E ALTA VALLE,VEN,40-49,1,0,0,0,1,0,0,1,0,1,Veneto,ITH3
2021-01-15,PF/BT,162441,CENTRO SERVIZI ASSISTENZIALI S. ANTONIO - CHIAMPO E ALTA VALLE,VEN,50-59,0,1,0,0,1,0,0,1,0,1,Veneto,ITH3
2021-01-15,PF/BT,162441,CENTRO SERVIZI ASSISTENZIALI S. ANTONIO - CHIAMPO E ALTA VALLE,VEN,60-69,0,1,0,0,1,0,0,1,0,1,Veneto,ITH3
2021-01-15,PF/BT,162543,CENTRO DIURNO CHIAMPO E ALTA VALLE,VEN,20-29,2,2,0,0,0,4,0,4,0,4,Veneto,ITH3
2021-01-15,PF/BT,162543,CENTRO DIURNO CHIAMPO E ALTA VALLE,VEN,30-39,5,2,0,0,0,7,0,7,0,7,Veneto,ITH3
2021-01-15,PF/BT,162543,CENTRO DIURNO CHIAMPO E ALTA VALLE,VEN,40-49,0,3,0,2,0,1,0,3,0,3,Veneto,ITH3
2021-01-15,PF/BT,162543,CENTRO DIURNO CHIAMPO E ALTA VALLE,VEN,50-59,0,6,0,4,0,2,0,6,0,6,Veneto,ITH3
2021-01-15,PF/BT,162543,CENTRO DIURNO CHIAMPO E ALTA VALLE,VEN,60-69,0,1,0,0,0,1,0,1,0,1,Veneto,ITH3
2021-01-15,PF/BT,208010,IPAB - CENTRO SERVIZI ANZIANI,VEN,20-29,2,4,0,5,1,0,0,6,0,6,Veneto,ITH3
2021-01-15,PF/BT,208010,IPAB - CENTRO SERVIZI ANZIANI,VEN,30-39,5,19,0,21,3,0,0,24,0,24,Veneto,ITH3
2021-01-15,PF/BT,208010,IPAB - CENTRO SERVIZI ANZIANI,VEN,40-49,2,16,0,15,3,0,0,18,0,18,Veneto,ITH3
2021-01-15,PF/BT,208010,IPAB - CENTRO SERVIZI ANZIANI,VEN,50-59,4,21,0,15,9,1,0,25,0,25,Veneto,ITH3
2021-01-15,PF/BT,208010,IPAB - CENTRO SERVIZI ANZIANI,VEN,60-69,5,10,0,4,5,6,0,15,0,15,Veneto,ITH3
2021-01-15,PF/BT,208010,IPAB - CENTRO SERVIZI ANZIANI,VEN,70-79,9,4,0,1,0,12,0,13,0,13,Veneto,ITH3
2021-01-15,PF/BT,208010,IPAB - CENTRO SERVIZI ANZIANI,VEN,80-89,8,20,0,0,0,28,0,28,0,28,Veneto,ITH3
2021-01-15,PF/BT,208010,IPAB - CENTRO SERVIZI ANZIANI,VEN,90+,2,25,0,0,0,27,0,27,0,27,Veneto,ITH3
2021-01-15,PF/BT,244018,"CENTRO DI SERVIZI RESIDENZIALE ""CASA DI RIPOSO VILLA BIANCA"" - TARZO",VEN,20-29,0,3,0,2,1,0,0,3,0,3,Veneto,ITH3
2021-01-15,PF/BT,244018,"CENTRO DI SERVIZI RESIDENZIALE ""CASA DI RIPOSO VILLA BIANCA"" - TARZO",VEN,30-39,2,6,0,7,1,0,0,8,0,8,Veneto,ITH3
2021-01-15,PF/BT,244018,"CENTRO DI SERVIZI RESIDENZIALE ""CASA DI RIPOSO VILLA BIANCA"" - TARZO",VEN,40-49,3,17,0,15,5,0,0,20,0,20,Veneto,ITH3
2021-01-15,PF/BT,244018,"CENTRO DI SERVIZI RESIDENZIALE ""CASA DI RIPOSO VILLA BIANCA"" - TARZO",VEN,50-59,4,22,0,20,6,0,0,26,0,26,Veneto,ITH3
2021-01-15,PF/BT,244018,"CENTRO DI SERVIZI RESIDENZIALE ""CASA DI RIPOSO VILLA BIANCA"" - TARZO",VEN,60-69,0,8,0,5,0,3,0,8,0,8,Veneto,ITH3
2021-01-15,PF/BT,244018,"CENTRO DI SERVIZI RESIDENZIALE ""CASA DI RIPOSO VILLA BIANCA"" - TARZO",VEN,70-79,0,12,0,3,0,9,0,12,0,12,Veneto,ITH3
2021-01-15,PF/BT,244018,"CENTRO DI SERVIZI RESIDENZIALE ""CASA DI RIPOSO VILLA BIANCA"" - TARZO",VEN,80-89,0,45,0,1,1,43,0,45,0,45,Veneto,ITH3
2021-01-15,PF/BT,244018,"CENTRO DI SERVIZI RESIDENZIALE ""CASA DI RIPOSO VILLA BIANCA"" - TARZO",VEN,90+,0,31,0,0,0,31,0,31,0,31,Veneto,ITH3
2021-01-15,PF/BT,323205,"CENTRO DI SERVIZI RESIDENZIALE ""ARTURO E IRMA SIMONETTI"" - ODERZO",VEN,20-29,0,6,0,4,1,1,0,6,0,6,Veneto,ITH3
2021-01-15,PF/BT,323205,"CENTRO DI SERVIZI RESIDENZIALE ""ARTURO E IRMA SIMONETTI"" - ODERZO",VEN,30-39,0,4,0,4,0,0,0,4,0,4,Veneto,ITH3
2021-01-15,PF/BT,323205,"CENTRO DI SERVIZI RESIDENZIALE ""ARTURO E IRMA SIMONETTI"" - ODERZO",VEN,40-49,3,8,0,7,2,2,0,11,0,11,Veneto,ITH3
2021-01-15,PF/BT,323205,"CENTRO DI SERVIZI RESIDENZIALE ""ARTURO E IRMA SIMONETTI"" - ODERZO",VEN,50-59,6,12,0,11,4,3,0,18,0,18,Veneto,ITH3
2021-01-15,PF/BT,323205,"CENTRO DI SERVIZI RESIDENZIALE ""ARTURO E IRMA SIMONETTI"" - ODERZO",VEN,60-69,1,5,0,5,1,0,0,6,0,6,Veneto,ITH3
2021-01-15,PF/BT,323205,"CENTRO DI SERVIZI RESIDENZIALE ""ARTURO E IRMA SIMONETTI"" - ODERZO",VEN,70-79,2,4,0,0,1,5,0,6,0,6,Veneto,ITH3
2021-01-15,PF/BT,323205,"CENTRO DI SERVIZI RESIDENZIALE ""ARTURO E IRMA SIMONETTI"" - ODERZO",VEN,80-89,8,23,0,0,0,31,0,31,0,31,Veneto,ITH3
2021-01-15,PF/BT,323205,"CENTRO DI SERVIZI RESIDENZIALE ""ARTURO E IRMA SIMONETTI"" - ODERZO",VEN,90+,4,28,0,0,0,32,0,32,0,32,Veneto,ITH3
2021-01-15,PF/BT,323235,"CENTRO DI SERVIZI RESIDENZIALE ""CASA SANTA MARIA DE ZAIRO"" - ZERO BRANCO",VEN,20-29,1,5,0,5,1,0,0,6,0,6,Veneto,ITH3
2021-01-15,PF/BT,323235,"CENTRO DI SERVIZI RESIDENZIALE ""CASA SANTA MARIA DE ZAIRO"" - ZERO BRANCO",VEN,30-39,2,13,0,14,1,0,0,15,0,15,Veneto,ITH3
2021-01-15,PF/BT,323235,"CENTRO DI SERVIZI RESIDENZIALE ""CASA SANTA MARIA DE ZAIRO"" - ZERO BRANCO",VEN,40-49,2,17,0,14,5,0,0,19,0,19,Veneto,ITH3
2021-01-15,PF/BT,323235,"CENTRO DI SERVIZI RESIDENZIALE ""CASA SANTA MARIA DE ZAIRO"" - ZERO BRANCO",VEN,50-59,1,19,0,15,4,1,0,20,0,20,Veneto,ITH3
2021-01-15,PF/BT,323235,"CENTRO DI SERVIZI RESIDENZIALE ""CASA SANTA MARIA DE ZAIRO"" - ZERO BRANCO",VEN,60-69,6,12,0,9,0,9,0,18,0,18,Veneto,ITH3
2021-01-15,PF/BT,323235,"CENTRO DI SERVIZI RESIDENZIALE ""CASA SANTA MARIA DE ZAIRO"" - ZERO BRANCO",VEN,70-79,5,8,0,1,0,12,0,13,0,13,Veneto,ITH3
2021-01-15,PF/BT,323235,"CENTRO DI SERVIZI RESIDENZIALE ""CASA SANTA MARIA DE ZAIRO"" - ZERO BRANCO",VEN,80-89,10,18,0,0,0,28,0,28,0,28,Veneto,ITH3
2021-01-15,PF/BT,323235,"CENTRO DI SERVIZI RESIDENZIALE ""CASA SANTA MARIA DE ZAIRO"" - ZERO BRANCO",VEN,90+,5,24,0,0,0,29,0,29,0,29,Veneto,ITH3
2021-01-15,PF/BT,42835,CASA DI RIPOSO CESIOMAGGIORE - C.S.A. 'DON G.ROSTIROLLA',VEN,30-39,1,1,0,2,0,0,0,2,0,2,Veneto,ITH3
2021-01-15,PF/BT,42835,CASA DI RIPOSO CESIOMAGGIORE - C.S.A. 'DON G.ROSTIROLLA',VEN,40-49,0,3,0,2,1,0,0,3,0,3,Veneto,ITH3
2021-01-15,PF/BT,42835,CASA DI RIPOSO CESIOMAGGIORE - C.S.A. 'DON G.ROSTIROLLA',VEN,50-59,0,2,0,1,0,1,0,2,0,2,Veneto,ITH3
2021-01-15,PF/BT,42835,CASA DI RIPOSO CESIOMAGGIORE - C.S.A. 'DON G.ROSTIROLLA',VEN,60-69,0,1,0,1,0,0,0,1,0,1,Veneto,ITH3
2021-01-15,PF/BT,42835,CASA DI RIPOSO CESIOMAGGIORE - C.S.A. 'DON G.ROSTIROLLA',VEN,70-79,3,0,0,0,0,3,0,3,0,3,Veneto,ITH3
2021-01-15,PF/BT,42835,CASA DI RIPOSO CESIOMAGGIORE - C.S.A. 'DON G.ROSTIROLLA',VEN,80-89,2,3,0,0,0,5,0,5,0,5,Veneto,ITH3
2021-01-15,PF/BT,42835,CASA DI RIPOSO CESIOMAGGIORE - C.S.A. 'DON G.ROSTIROLLA',VEN,90+,0,1,0,0,0,1,0,1,0,1,Veneto,ITH3
2021-01-15,PF/BT,42860,C.S.A. 'FONDAZIONE CASA DI RIPOSO DI MEANO',VEN,20-29,1,4,0,4,1,0,0,5,0,5,Veneto,ITH3
2021-01-15,PF/BT,42860,C.S.A. 'FONDAZIONE CASA DI RIPOSO DI MEANO',VEN,30-39,1,6,0,3,4,0,0,7,0,7,Veneto,ITH3
2021-01-15,PF/BT,42860,C.S.A. 'FONDAZIONE CASA DI RIPOSO DI MEANO',VEN,40-49,0,4,0,2,2,0,0,4,0,4,Veneto,ITH3
2021-01-15,PF/BT,42860,C.S.A. 'FONDAZIONE CASA DI RIPOSO DI MEANO',VEN,50-59,1,11,0,8,4,0,0,12,0,12,Veneto,ITH3
2021-01-15,PF/BT,42860,C.S.A. 'FONDAZIONE CASA DI RIPOSO DI MEANO',VEN,60-69,1,9,0,5,4,1,0,10,0,10,Veneto,ITH3
2021-01-15,PF/BT,42860,C.S.A. 'FONDAZIONE CASA DI RIPOSO DI MEANO',VEN,70-79,4,2,0,1,0,5,0,6,0,6,Veneto,ITH3
2021-01-15,PF/BT,42860,C.S.A. 'FONDAZIONE CASA DI RIPOSO DI MEANO',VEN,80-89,2,9,0,0,0,11,0,11,0,11,Veneto,ITH3
2021-01-15,PF/BT,42860,C.S.A. 'FONDAZIONE CASA DI RIPOSO DI MEANO',VEN,90+,1,7,0,0,0,8,0,8,0,8,Veneto,ITH3
2021-01-15,PF/BT,441801,POLIAMB. OSPEDALE SAN MARCO,VEN,40-49,0,2,0,2,0,0,0,2,0,2,Veneto,ITH3
2021-01-15,PF/BT,441801,POLIAMB. OSPEDALE SAN MARCO,VEN,50-59,0,2,0,2,0,0,0,2,0,2,Veneto,ITH3
2021-01-15,PF/BT,441801,POLIAMB. OSPEDALE SAN MARCO,VEN,60-69,1,1,0,2,0,0,0,2,0,2,Veneto,ITH3
2021-01-15,PF/BT,445325,C. SERV.RES.ANZ.-S.LORENZO,VEN,20-29,0,1,0,1,0,0,0,1,0,1,Veneto,ITH3
2021-01-15,PF/BT,445325,C. SERV.RES.ANZ.-S.LORENZO,VEN,30-39,4,3,0,2,5,0,0,7,0,7,Veneto,ITH3
2021-01-15,PF/BT,445325,C. SERV.RES.ANZ.-S.LORENZO,VEN,40-49,7,11,0,6,12,0,0,18,0,18,Veneto,ITH3
2021-01-15,PF/BT,445325,C. SERV.RES.ANZ.-S.LORENZO,VEN,50-59,8,20,0,12,16,0,0,28,0,28,Veneto,ITH3
2021-01-15,PF/BT,445325,C. SERV.RES.ANZ.-S.LORENZO,VEN,60-69,1,5,0,4,2,0,0,6,0,6,Veneto,ITH3
2021-01-15,PF/BT,445325,C. SERV.RES.ANZ.-S.LORENZO,VEN,70-79,2,0,0,0,0,2,0,2,0,2,Veneto,ITH3
2021-01-15,PF/BT,445325,C. SERV.RES.ANZ.-S.LORENZO,VEN,80-89,0,3,0,0,0,3,0,3,0,3,Veneto,ITH3
2021-01-15,PF/BT,445325,C. SERV.RES.ANZ.-S.LORENZO,VEN,90+,0,1,0,0,0,1,0,1,0,1,Veneto,ITH3
2021-01-15,PF/BT,445326,C. SERV.RES.ANZ.-CARLO STEEB,VEN,20-29,0,1,0,1,0,0,0,1,0,1,Veneto,ITH3
2021-01-15,PF/BT,445326,C. SERV.RES.ANZ.-CARLO STEEB,VEN,30-39,0,1,0,1,0,0,0,1,0,1,Veneto,ITH3
2021-01-15,PF/BT,445326,C. SERV.RES.ANZ.-CARLO STEEB,VEN,40-49,0,1,0,1,0,0,0,1,0,1,Veneto,ITH3
2021-01-15,PF/BT,445326,C. SERV.RES.ANZ.-CARLO STEEB,VEN,50-59,1,1,0,1,0,1,0,2,0,2,Veneto,ITH3
2021-01-15,PF/BT,445326,C. SERV.RES.ANZ.-CARLO STEEB,VEN,60-69,1,1,0,0,0,2,0,2,0,2,Veneto,ITH3
2021-01-15,PF/BT,445326,C. SERV.RES.ANZ.-CARLO STEEB,VEN,70-79,4,3,0,0,0,7,0,7,0,7,Veneto,ITH3
2021-01-15,PF/BT,445326,C. SERV.RES.ANZ.-CARLO STEEB,VEN,80-89,7,7,0,0,0,14,0,14,0,14,Veneto,ITH3
2021-01-15,PF/BT,445326,C. SERV.RES.ANZ.-CARLO STEEB,VEN,90+,0,12,0,0,0,12,0,12,0,12,Veneto,ITH3
2021-01-15,PF/BT,445366,C. SERV.RES.ANZ.-NAZARET,VEN,50-59,1,0,0,1,0,0,0,1,0,1,Veneto,ITH3
2021-01-15,PF/BT,445366,C. SERV.RES.ANZ.-NAZARET,VEN,70-79,0,1,0,0,0,1,0,1,0,1,Veneto,ITH3
2021-01-15,PF/BT,445366,C. SERV.RES.ANZ.-NAZARET,VEN,80-89,0,2,0,0,0,2,0,2,0,2,Veneto,ITH3
2021-01-15,PF/BT,445366,C. SERV.RES.ANZ.-NAZARET,VEN,90+,0,2,0,0,0,2,0,2,0,2,Veneto,ITH3
2021-01-15,PF/BT,445385,C. SERV.RES.ANZ.-CONTARINI IRE,VEN,40-49,0,3,0,3,0,0,0,3,0,3,Veneto,ITH3
2021-01-15,PF/BT,445385,C. SERV.RES.ANZ.-CONTARINI IRE,VEN,50-59,0,1,0,1,0,0,0,1,0,1,Veneto,ITH3
2021-01-15,PF/BT,445385,C. SERV.RES.ANZ.-CONTARINI IRE,VEN,80-89,1,1,0,0,0,2,0,2,0,2,Veneto,ITH3
2021-01-15,PF/BT,445438,S.V.P. CENTRO SERV. ANTICA SCUOLA DEI BATTUTI,VEN,30-39,0,3,0,2,1,0,0,3,0,3,Veneto,ITH3
2021-01-15,PF/BT,445438,S.V.P. CENTRO SERV. ANTICA SCUOLA DEI BATTUTI,VEN,40-49,2,4,0,1,5,0,0,6,0,6,Veneto,ITH3
2021-01-15,PF/BT,445438,S.V.P. CENTRO SERV. ANTICA SCUOLA DEI BATTUTI,VEN,50-59,2,1,0,0,3,0,0,3,0,3,Veneto,ITH3
2021-01-15,PF/BT,445438,S.V.P. CENTRO SERV. ANTICA SCUOLA DEI BATTUTI,VEN,60-69,1,3,0,0,2,2,0,4,0,4,Veneto,ITH3
2021-01-15,PF/BT,445438,S.V.P. CENTRO SERV. ANTICA SCUOLA DEI BATTUTI,VEN,70-79,1,1,0,0,0,2,0,2,0,2,Veneto,ITH3
2021-01-15,PF/BT,445438,S.V.P. CENTRO SERV. ANTICA SCUOLA DEI BATTUTI,VEN,80-89,3,15,0,0,0,18,0,18,0,18,Veneto,ITH3
2021-01-15,PF/BT,445438,S.V.P. CENTRO SERV. ANTICA SCUOLA DEI BATTUTI,VEN,90+,2,17,0,0,0,19,0,19,0,19,Veneto,ITH3
2021-01-15,PF/BT,445450,C. SERV.RES.ANZ.-SAN CAMILLO - STELLA MARIS,VEN,30-39,0,2,0,2,0,0,0,2,0,2,Veneto,ITH3
2021-01-15,PF/BT,445450,C. SERV.RES.ANZ.-SAN CAMILLO - STELLA MARIS,VEN,40-49,0,3,0,2,0,0,1,3,0,3,Veneto,ITH3
2021-01-15,PF/BT,445450,C. SERV.RES.ANZ.-SAN CAMILLO - STELLA MARIS,VEN,50-59,1,2,0,1,0,0,2,3,0,3,Veneto,ITH3
2021-01-15,PF/BT,445450,C. SERV.RES.ANZ.-SAN CAMILLO - STELLA MARIS,VEN,70-79,0,1,0,0,0,1,0,1,0,1,Veneto,ITH3
2021-01-15,PF/BT,486011,RESIDENZA DELLA SALUTE - FIESSO D'ARTICO,VEN,40-49,0,1,0,1,0,0,0,1,0,1,Veneto,ITH3
2021-01-15,PF/BT,486011,RESIDENZA DELLA SALUTE - FIESSO D'ARTICO,VEN,60-69,1,0,0,1,0,0,0,1,0,1,Veneto,ITH3
2021-01-15,PF/BT,486011,RESIDENZA DELLA SALUTE - FIESSO D'ARTICO,VEN,80-89,2,0,0,0,0,2,0,2,0,2,Veneto,ITH3
2021-01-15,PF/BT,5001700,OSPEDALE SACRO CUORE DI NEGRAR,VEN,30-39,0,1,0,0,1,0,0,1,0,1,Veneto,ITH3
2021-01-15,PF/BT,5001700,OSPEDALE SACRO CUORE DI NEGRAR,VEN,40-49,2,0,0,1,1,0,0,2,0,2,Veneto,ITH3
2021-01-15,PF/BT,5001700,OSPEDALE SACRO CUORE DI NEGRAR,VEN,50-59,3,2,0,1,4,0,0,5,0,5,Veneto,ITH3
2021-01-15,PF/BT,5001700,OSPEDALE SACRO CUORE DI NEGRAR,VEN,60-69,1,1,0,1,1,0,0,2,0,2,Veneto,ITH3
2021-01-15,PF/BT,5001700,OSPEDALE SACRO CUORE DI NEGRAR,VEN,70-79,2,0,0,1,1,0,0,2,0,2,Veneto,ITH3
2021-01-15,PF/BT,5002200,OSPEDALE P. PEDERZOLI,VEN,20-29,7,12,0,19,0,0,0,19,0,19,Veneto,ITH3
2021-01-15,PF/BT,5002200,OSPEDALE P. PEDERZOLI,VEN,30-39,6,13,0,19,0,0,0,19,0,19,Veneto,ITH3
2021-01-15,PF/BT,5002200,OSPEDALE P. PEDERZOLI,VEN,40-49,11,11,0,22,0,0,0,22,0,22,Veneto,ITH3
2021-01-15,PF/BT,5002200,OSPEDALE P. PEDERZOLI,VEN,50-59,11,15,0,26,0,0,0,26,0,26,Veneto,ITH3
2021-01-15,PF/BT,5002200,OSPEDALE P. PEDERZOLI,VEN,60-69,4,4,0,8,0,0,0,8,0,8,Veneto,ITH3
2021-01-15,PF/BT,5002200,OSPEDALE P. PEDERZOLI,VEN,70-79,1,0,0,1,0,0,0,1,0,1,Veneto,ITH3
2021-01-15,PF/BT,5007200,OSPEDALE ORAS MOTTA,VEN,20-29,8,20,0,22,6,0,0,28,0,28,Veneto,ITH3
2021-01-15,PF/BT,5007200,OSPEDALE ORAS MOTTA,VEN,30-39,10,40,0,41,9,0,0,50,0,50,Veneto,ITH3
2021-01-15,PF/BT,5007200,OSPEDALE ORAS MOTTA,VEN,40-49,14,44,0,41,16,0,1,58,0,58,Veneto,ITH3
2021-01-15,PF/BT,5007200,OSPEDALE ORAS MOTTA,VEN,50-59,8,19,0,19,8,0,0,27,0,27,Veneto,ITH3
2021-01-15,PF/BT,5007200,OSPEDALE ORAS MOTTA,VEN,60-69,13,6,0,19,0,0,0,19,0,19,Veneto,ITH3
2021-01-15,PF/BT,5007200,OSPEDALE ORAS MOTTA,VEN,70-79,8,0,0,8,0,0,0,8,0,8,Veneto,ITH3
2021-01-15,PF/BT,5007900,OSPEDALE SAN CAMILLO,VEN,20-29,12,7,0,17,2,0,0,19,0,19,Veneto,ITH3
2021-01-15,PF/BT,5007900,OSPEDALE SAN CAMILLO,VEN,30-39,13,8,0,15,6,0,0,21,0,21,Veneto,ITH3
2021-01-15,PF/BT,5007900,OSPEDALE SAN CAMILLO,VEN,40-49,8,38,0,35,8,0,3,46,0,46,Veneto,ITH3
2021-01-15,PF/BT,5007900,OSPEDALE SAN CAMILLO,VEN,50-59,19,35,0,42,12,0,0,54,0,54,Veneto,ITH3
2021-01-15,PF/BT,5007900,OSPEDALE SAN CAMILLO,VEN,60-69,20,4,0,20,3,0,1,24,0,24,Veneto,ITH3
2021-01-15,PF/BT,5007900,OSPEDALE SAN CAMILLO,VEN,70-79,8,1,0,9,0,0,0,9,0,9,Veneto,ITH3
2021-01-15,PF/BT,5007900,OSPEDALE SAN CAMILLO,VEN,80-89,0,1,0,1,0,0,0,1,0,1,Veneto,ITH3
2021-01-15,PF/BT,5008100,CASA DI CURA GIOVANNI XXIII,VEN,20-29,14,26,0,33,7,0,0,40,0,40,Veneto,ITH3
2021-01-15,PF/BT,5008100,CASA DI CURA GIOVANNI XXIII,VEN,30-39,20,34,0,47,7,0,0,54,0,54,Veneto,ITH3
2021-01-15,PF/BT,5008100,CASA DI CURA GIOVANNI XXIII,VEN,40-49,12,49,0,45,16,0,0,61,0,61,Veneto,ITH3
2021-01-15,PF/BT,5008100,CASA DI CURA GIOVANNI XXIII,VEN,50-59,21,49,0,52,18,0,0,70,0,70,Veneto,ITH3
2021-01-15,PF/BT,5008100,CASA DI CURA GIOVANNI XXIII,VEN,60-69,14,5,0,15,4,0,0,19,0,19,Veneto,ITH3
2021-01-15,PF/BT,5008100,CASA DI CURA GIOVANNI XXIII,VEN,70-79,8,0,0,7,1,0,0,8,0,8,Veneto,ITH3
2021-01-15,PF/BT,50501,FELTRE,VEN,20-29,0,2,0,2,0,0,0,2,0,2,Veneto,ITH3
2021-01-15,PF/BT,50501,FELTRE,VEN,30-39,2,7,0,9,0,0,0,9,0,9,Veneto,ITH3
2021-01-15,PF/BT,50501,FELTRE,VEN,40-49,1,9,0,10,0,0,0,10,0,10,Veneto,ITH3
2021-01-15,PF/BT,50501,FELTRE,VEN,50-59,1,18,0,18,1,0,0,19,0,19,Veneto,ITH3
2021-01-15,PF/BT,50501,FELTRE,VEN,60-69,1,4,0,5,0,0,0,5,0,5,Veneto,ITH3
2021-01-15,PF/BT,50502,ODERZO.,VEN,20-29,0,1,0,1,0,0,0,1,0,1,Veneto,ITH3
2021-01-15,PF/BT,50502,ODERZO.,VEN,30-39,0,1,0,1,0,0,0,1,0,1,Veneto,ITH3
2021-01-15,PF/BT,50502,ODERZO.,VEN,40-49,0,1,0,1,0,0,0,1,0,1,Veneto,ITH3
2021-01-15,PF/BT,50502,ODERZO.,VEN,50-59,1,2,0,1,2,0,0,3,0,3,Veneto,ITH3
2021-01-15,PF/BT,50502,SISP - AMBULATORIO VIAGGIATORI,VEN,50-59,0,2,0,2,0,0,0,2,0,2,Veneto,ITH3
2021-01-15,PF/BT,50503,S.I.S.P. MESTRE,VEN,20-29,5,6,0,11,0,0,0,11,0,11,Veneto,ITH3
2021-01-15,PF/BT,50503,S.I.S.P. MESTRE,VEN,30-39,7,31,0,30,2,0,6,38,0,38,Veneto,ITH3
2021-01-15,PF/BT,50503,S.I.S.P. MESTRE,VEN,40-49,6,26,0,28,0,0,4,32,0,32,Veneto,ITH3
2021-01-15,PF/BT,50503,S.I.S.P. MESTRE,VEN,50-59,9,42,0,48,2,0,1,51,0,51,Veneto,ITH3
2021-01-15,PF/BT,50503,S.I.S.P. MESTRE,VEN,60-69,18,12,0,27,0,0,3,30,0,30,Veneto,ITH3
2021-01-15,PF/BT,50503,S.I.S.P. MESTRE,VEN,70-79,2,3,0,5,0,0,0,5,0,5,Veneto,ITH3
2021-01-15,PF/BT,50503,S.I.S.P. MESTRE,VEN,80-89,0,1,0,1,0,0,0,1,0,1,Veneto,ITH3
2021-01-15,PF/BT,50503,S.I.S.P. VENEZIA,VEN,20-29,1,3,0,4,0,0,0,4,0,4,Veneto,ITH3
2021-01-15,PF/BT,50503,S.I.S.P. VENEZIA,VEN,30-39,2,7,0,9,0,0,0,9,0,9,Veneto,ITH3
2021-01-15,PF/BT,50503,S.I.S.P. VENEZIA,VEN,40-49,5,5,0,10,0,0,0,10,0,10,Veneto,ITH3
2021-01-15,PF/BT,50503,S.I.S.P. VENEZIA,VEN,50-59,3,10,0,10,3,0,0,13,0,13,Veneto,ITH3
2021-01-15,PF/BT,50503,S.I.S.P. VENEZIA,VEN,60-69,5,5,0,7,3,0,0,10,0,10,Veneto,ITH3
2021-01-15,PF/BT,50503,S.I.S.P. VENEZIA,VEN,70-79,0,1,0,1,0,0,0,1,0,1,Veneto,ITH3
2021-01-15,PF/BT,50503,S.I.S.P. VENEZIA,VEN,90+,1,0,0,1,0,0,0,1,0,1,Veneto,ITH3
2021-01-15,PF/BT,50504,C. V. TERR. PORTOGRUARO,VEN,20-29,0,1,0,1,0,0,0,1,0,1,Veneto,ITH3
2021-01-15,PF/BT,50504,C. V. TERR. PORTOGRUARO,VEN,30-39,3,3,0,6,0,0,0,6,0,6,Veneto,ITH3
2021-01-15,PF/BT,50504,C. V. TERR. PORTOGRUARO,VEN,40-49,0,3,0,3,0,0,0,3,0,3,Veneto,ITH3
2021-01-15,PF/BT,50504,C. V. TERR. PORTOGRUARO,VEN,50-59,0,4,0,2,1,1,0,4,0,4,Veneto,ITH3
2021-01-15,PF/BT,50504,C. V. TERR. PORTOGRUARO,VEN,60-69,1,0,0,1,0,0,0,1,0,1,Veneto,ITH3
2021-01-15,PF/BT,50504,C. V. TERR. PORTOGRUARO,VEN,70-79,2,3,0,0,0,5,0,5,0,5,Veneto,ITH3
2021-01-15,PF/BT,50504,C. V. TERR. PORTOGRUARO,VEN,80-89,1,7,0,0,0,8,0,8,0,8,Veneto,ITH3
2021-01-15,PF/BT,50504,C. V. TERR. PORTOGRUARO,VEN,90+,2,6,0,0,0,8,0,8,0,8,Veneto,ITH3
2021-01-15,PF/BT,50506,AZ OSPEDALIERA DI PADOVA MAL. INFET.E TR,VEN,20-29,0,1,0,1,0,0,0,1,0,1,Veneto,ITH3
2021-01-15,PF/BT,50506,AZ OSPEDALIERA DI PADOVA MAL. INFET.E TR,VEN,40-49,0,1,0,1,0,0,0,1,0,1,Veneto,ITH3
2021-01-15,PF/BT,50506,AZ OSPEDALIERA DI PADOVA MAL. INFET.E TR,VEN,50-59,16,49,0,65,0,0,0,65,0,65,Veneto,ITH3
2021-01-15,PF/BT,50506,AZ OSPEDALIERA DI PADOVA MAL. INFET.E TR,VEN,60-69,14,9,0,23,0,0,0,23,0,23,Veneto,ITH3
2021-01-15,PF/BT,50506,CAMPOSAMPIERO,VEN,20-29,0,8,0,3,1,0,4,8,0,8,Veneto,ITH3
2021-01-15,PF/BT,50506,CAMPOSAMPIERO,VEN,30-39,3,10,0,10,2,0,1,13,0,13,Veneto,ITH3
2021-01-15,PF/BT,50506,CAMPOSAMPIERO,VEN,40-49,7,20,0,18,5,0,4,27,0,27,Veneto,ITH3
2021-01-15,PF/BT,50506,CAMPOSAMPIERO,VEN,50-59,7,25,0,27,3,0,2,32,0,32,Veneto,ITH3
2021-01-15,PF/BT,50506,CAMPOSAMPIERO,VEN,60-69,5,9,0,9,0,0,5,14,0,14,Veneto,ITH3
2021-01-15,PF/BT,50506,CAMPOSAMPIERO,VEN,70-79,2,0,0,2,0,0,0,2,0,2,Veneto,ITH3
2021-01-15,PF/BT,50506,CAMPOSAMPIERO MEDICO COMPETENT,VEN,20-29,3,3,0,3,3,0,0,6,0,6,Veneto,ITH3
2021-01-15,PF/BT,50506,CAMPOSAMPIERO MEDICO COMPETENT,VEN,30-39,3,6,0,6,3,0,0,9,0,9,Veneto,ITH3
2021-01-15,PF/BT,50506,CAMPOSAMPIERO MEDICO COMPETENT,VEN,40-49,7,11,0,9,9,0,0,18,0,18,Veneto,ITH3
2021-01-15,PF/BT,50506,CAMPOSAMPIERO MEDICO COMPETENT,VEN,50-59,15,16,0,14,16,0,1,31,0,31,Veneto,ITH3
2021-01-15,PF/BT,50506,CAMPOSAMPIERO MEDICO COMPETENT,VEN,60-69,1,1,0,1,1,0,0,2,0,2,Veneto,ITH3
2021-01-15,PF/BT,50506,CITTADELLA MEDICO COMPETENTE,VEN,20-29,7,7,0,9,2,0,3,14,0,14,Veneto,ITH3
2021-01-15,PF/BT,50506,CITTADELLA MEDICO COMPETENTE,VEN,30-39,8,3,0,4,2,0,5,11,0,11,Veneto,ITH3
2021-01-15,PF/BT,50506,CITTADELLA MEDICO COMPETENTE,VEN,40-49,4,5,0,3,4,0,2,9,0,9,Veneto,ITH3
2021-01-15,PF/BT,50506,CITTADELLA MEDICO COMPETENTE,VEN,50-59,14,7,0,3,12,0,6,21,0,21,Veneto,ITH3
2021-01-15,PF/BT,50506,CITTADELLA MEDICO COMPETENTE,VEN,60-69,3,9,0,0,12,0,0,12,0,12,Veneto,ITH3
2021-01-15,PF/BT,50506,CITTADELLA MEDICO COMPETENTE,VEN,70-79,1,10,0,0,10,0,1,11,0,11,Veneto,ITH3
2021-01-15,PF/BT,50506,COLLI VACC. ADULTI,VEN,20-29,6,2,0,1,0,5,2,8,0,8,Veneto,ITH3
2021-01-15,PF/BT,50506,COLLI VACC. ADULTI,VEN,30-39,4,6,0,6,1,2,1,10,0,10,Veneto,ITH3
2021-01-15,PF/BT,50506,COLLI VACC. ADULTI,VEN,40-49,9,6,0,5,2,8,0,15,0,15,Veneto,ITH3
2021-01-15,PF/BT,50506,COLLI VACC. ADULTI,VEN,50-59,9,5,0,8,1,5,0,14,0,14,Veneto,ITH3
2021-01-15,PF/BT,50506,COLLI VACC. ADULTI,VEN,60-69,5,1,0,4,0,2,0,6,0,6,Veneto,ITH3
2021-01-15,PF/BT,50506,COLLI VACC. ADULTI,VEN,70-79,1,0,0,1,0,0,0,1,0,1,Veneto,ITH3
2021-01-15,PF/BT,50506,DISTR. 3 ALBIGNASEGO AMB.IGIEN,VEN,20-29,1,4,0,0,5,0,0,5,0,5,Veneto,ITH3
2021-01-15,PF/BT,50506,DISTR. 3 ALBIGNASEGO AMB.IGIEN,VEN,30-39,3,13,0,4,8,4,0,16,0,16,Veneto,ITH3
2021-01-15,PF/BT,50506,DISTR. 3 ALBIGNASEGO AMB.IGIEN,VEN,40-49,3,2,0,1,4,0,0,5,0,5,Veneto,ITH3
2021-01-15,PF/BT,50506,DISTR. 3 ALBIGNASEGO AMB.IGIEN,VEN,50-59,2,5,0,3,3,1,0,7,0,7,Veneto,ITH3
2021-01-15,PF/BT,50506,DISTR. 3 ALBIGNASEGO AMB.IGIEN,VEN,60-69,2,1,0,2,1,0,0,3,0,3,Veneto,ITH3
2021-01-15,PF/BT,50506,IGIENE PUBBLICA RUBANO,VEN,20-29,3,5,0,2,1,3,2,8,0,8,Veneto,ITH3
2021-01-15,PF/BT,50506,IGIENE PUBBLICA RUBANO,VEN,30-39,5,12,0,9,3,1,4,17,0,17,Veneto,ITH3
2021-01-15,PF/BT,50506,IGIENE PUBBLICA RUBANO,VEN,40-49,13,24,0,12,9,9,7,37,0,37,Veneto,ITH3
2021-01-15,PF/BT,50506,IGIENE PUBBLICA RUBANO,VEN,50-59,22,19,0,18,8,9,6,41,0,41,Veneto,ITH3
2021-01-15,PF/BT,50506,IGIENE PUBBLICA RUBANO,VEN,60-69,6,7,0,6,4,2,1,13,0,13,Veneto,ITH3
2021-01-15,PF/BT,50506,IGIENE PUBBLICA RUBANO,VEN,70-79,1,0,0,0,0,1,0,1,0,1,Veneto,ITH3
2021-01-15,PF/BT,50506,MONSELICE,VEN,16-19,1,0,0,0,0,1,0,1,0,1,Veneto,ITH3
2021-01-15,PF/BT,50506,MONSELICE,VEN,20-29,6,7,0,4,2,7,0,13,0,13,Veneto,ITH3
2021-01-15,PF/BT,50506,MONSELICE,VEN,30-39,8,14,0,6,9,6,1,22,0,22,Veneto,ITH3
2021-01-15,PF/BT,50506,MONSELICE,VEN,40-49,6,14,0,5,8,4,3,20,0,20,Veneto,ITH3
2021-01-15,PF/BT,50506,MONSELICE,VEN,50-59,9,21,0,9,5,14,2,30,0,30,Veneto,ITH3
2021-01-15,PF/BT,50506,MONSELICE,VEN,60-69,13,16,0,13,8,5,3,29,0,29,Veneto,ITH3
2021-01-15,PF/BT,50506,MONSELICE,VEN,70-79,0,2,0,1,1,0,0,2,0,2,Veneto,ITH3
2021-01-15,PF/BT,50506,PIOVE DI SACCO - SERV. IGIENE E SANITA',VEN,16-19,0,2,0,0,1,1,0,2,0,2,Veneto,ITH3
2021-01-15,PF/BT,50506,PIOVE DI SACCO - SERV. IGIENE E SANITA',VEN,20-29,6,6,0,3,0,7,2,12,0,12,Veneto,ITH3
2021-01-15,PF/BT,50506,PIOVE DI SACCO - SERV. IGIENE E SANITA',VEN,30-39,10,10,0,4,2,10,4,20,0,20,Veneto,ITH3
2021-01-15,PF/BT,50506,PIOVE DI SACCO - SERV. IGIENE E SANITA',VEN,40-49,10,15,0,9,3,5,8,25,0,25,Veneto,ITH3
2021-01-15,PF/BT,50506,PIOVE DI SACCO - SERV. IGIENE E SANITA',VEN,50-59,6,23,0,12,5,9,3,29,0,29,Veneto,ITH3
2021-01-15,PF/BT,50506,PIOVE DI SACCO - SERV. IGIENE E SANITA',VEN,60-69,5,7,0,5,1,5,1,12,0,12,Veneto,ITH3
2021-01-15,PF/BT,50506,PIOVE DI SACCO - SERV. IGIENE E SANITA',VEN,70-79,1,0,0,1,0,0,0,1,0,1,Veneto,ITH3
2021-01-15,PF/BT,50506,RUBANO,VEN,40-49,0,1,0,0,0,0,1,1,0,1,Veneto,ITH3
2021-01-15,PF/BT,50506,SCHIAVONIA AMBULATORIO,VEN,20-29,4,29,0,30,3,0,0,33,0,33,Veneto,ITH3
2021-01-15,PF/BT,50506,SCHIAVONIA AMBULATORIO,VEN,30-39,1,4,0,4,1,0,0,5,0,5,Veneto,ITH3
2021-01-15,PF/BT,50506,SCHIAVONIA AMBULATORIO,VEN,40-49,1,6,0,6,1,0,0,7,0,7,Veneto,ITH3
2021-01-15,PF/BT,50506,SCHIAVONIA AMBULATORIO,VEN,50-59,1,7,0,7,1,0,0,8,0,8,Veneto,ITH3
2021-01-15,PF/BT,50506,SCHIAVONIA AMBULATORIO,VEN,60-69,0,1,0,1,0,0,0,1,0,1,Veneto,ITH3
2021-01-15,PF/BT,50506,SET.IGIENE PUBBLICA EPID.E PROF. MAL.INF,VEN,20-29,1,2,0,3,0,0,0,3,0,3,Veneto,ITH3
2021-01-15,PF/BT,50506,SET.IGIENE PUBBLICA EPID.E PROF. MAL.INF,VEN,30-39,2,7,0,6,2,0,1,9,0,9,Veneto,ITH3
2021-01-15,PF/BT,50506,SET.IGIENE PUBBLICA EPID.E PROF. MAL.INF,VEN,40-49,6,4,0,9,1,0,0,10,0,10,Veneto,ITH3
2021-01-15,PF/BT,50506,SET.IGIENE PUBBLICA EPID.E PROF. MAL.INF,VEN,50-59,9,2,0,8,3,0,0,11,0,11,Veneto,ITH3
2021-01-15,PF/BT,50506,SET.IGIENE PUBBLICA EPID.E PROF. MAL.INF,VEN,60-69,4,3,0,7,0,0,0,7,0,7,Veneto,ITH3
2021-01-15,PF/BT,50506,SET.IGIENE PUBBLICA EPID.E PROF. MAL.INF,VEN,70-79,2,0,0,2,0,0,0,2,0,2,Veneto,ITH3
2021-01-15,PF/BT,50506,VIA SCROVEGNI ANTI INFLUENZALE,VEN,16-19,1,0,0,0,0,1,0,1,0,1,Veneto,ITH3
2021-01-15,PF/BT,50506,VIA SCROVEGNI ANTI INFLUENZALE,VEN,20-29,4,2,0,0,2,4,0,6,0,6,Veneto,ITH3
2021-01-15,PF/BT,50506,VIA SCROVEGNI ANTI INFLUENZALE,VEN,30-39,2,4,0,1,3,1,1,6,0,6,Veneto,ITH3
2021-01-15,PF/BT,50506,VIA SCROVEGNI ANTI INFLUENZALE,VEN,40-49,2,4,0,0,3,3,0,6,0,6,Veneto,ITH3
2021-01-15,PF/BT,50506,VIA SCROVEGNI ANTI INFLUENZALE,VEN,50-59,2,11,0,0,10,3,0,13,0,13,Veneto,ITH3
2021-01-15,PF/BT,50506,VIA SCROVEGNI ANTI INFLUENZALE,VEN,60-69,0,4,0,0,4,0,0,4,0,4,Veneto,ITH3
2021-01-15,PF/BT,50507,DIPARTIMENTO DI PREVENZIONE,VEN,20-29,0,9,0,9,0,0,0,9,0,9,Veneto,ITH3
2021-01-15,PF/BT,50507,DIPARTIMENTO DI PREVENZIONE,VEN,30-39,1,4,0,5,0,0,0,5,0,5,Veneto,ITH3
2021-01-15,PF/BT,50507,DIPARTIMENTO DI PREVENZIONE,VEN,40-49,4,17,0,16,5,0,0,21,0,21,Veneto,ITH3
2021-01-15,PF/BT,50507,DIPARTIMENTO DI PREVENZIONE,VEN,50-59,4,20,0,18,6,0,0,24,0,24,Veneto,ITH3
2021-01-15,PF/BT,50507,DIPARTIMENTO DI PREVENZIONE,VEN,60-69,5,7,0,5,4,3,0,12,0,12,Veneto,ITH3
2021-01-15,PF/BT,50507,DIPARTIMENTO DI PREVENZIONE,VEN,70-79,10,4,0,0,2,12,0,14,0,14,Veneto,ITH3
2021-01-15,PF/BT,50507,DIPARTIMENTO DI PREVENZIONE,VEN,80-89,13,23,0,0,1,35,0,36,0,36,Veneto,ITH3
2021-01-15,PF/BT,50507,DIPARTIMENTO DI PREVENZIONE,VEN,90+,8,7,0,0,0,15,0,15,0,15,Veneto,ITH3
2021-01-15,PF/BT,50507,EX OSPEDALE - BOLDRINI,VEN,20-29,8,23,0,30,0,0,1,31,0,31,Veneto,ITH3
2021-01-15,PF/BT,50507,EX OSPEDALE - BOLDRINI,VEN,30-39,10,33,0,43,0,0,0,43,0,43,Veneto,ITH3
2021-01-15,PF/BT,50507,EX OSPEDALE - BOLDRINI,VEN,40-49,8,27,0,35,0,0,0,35,0,35,Veneto,ITH3
2021-01-15,PF/BT,50507,EX OSPEDALE - BOLDRINI,VEN,50-59,14,24,0,37,0,0,1,38,0,38,Veneto,ITH3
2021-01-15,PF/BT,50507,EX OSPEDALE - BOLDRINI,VEN,60-69,18,14,0,32,0,0,0,32,0,32,Veneto,ITH3
2021-01-15,PF/BT,50507,EX OSPEDALE - BOLDRINI,VEN,70-79,7,1,0,8,0,0,0,8,0,8,Veneto,ITH3
2021-01-15,PF/BT,50507,SANTORSO,VEN,20-29,1,2,0,3,0,0,0,3,0,3,Veneto,ITH3
2021-01-15,PF/BT,50507,SANTORSO,VEN,30-39,2,6,0,8,0,0,0,8,0,8,Veneto,ITH3
2021-01-15,PF/BT,50507,SANTORSO,VEN,40-49,1,3,0,4,0,0,0,4,0,4,Veneto,ITH3
2021-01-15,PF/BT,50507,SANTORSO,VEN,50-59,0,3,0,3,0,0,0,3,0,3,Veneto,ITH3
2021-01-15,PF/BT,50507,SANTORSO,VEN,60-69,1,0,0,1,0,0,0,1,0,1,Veneto,ITH3
2021-01-15,PF/BT,50507,SANTORSO,VEN,70-79,0,1,0,1,0,0,0,1,0,1,Veneto,ITH3
2021-01-15,PF/BT,5050801,MED.COMP. - OSP. SAN BORTOLO,VEN,16-19,0,3,0,0,2,0,1,3,0,3,Veneto,ITH3
2021-01-15,PF/BT,5050801,MED.COMP. - OSP. SAN BORTOLO,VEN,20-29,15,22,0,15,14,0,8,37,0,37,Veneto,ITH3
2021-01-15,PF/BT,5050801,MED.COMP. - OSP. SAN BORTOLO,VEN,30-39,22,26,0,23,16,0,9,48,0,48,Veneto,ITH3
2021-01-15,PF/BT,5050801,MED.COMP. - OSP. SAN BORTOLO,VEN,40-49,26,26,0,23,24,0,5,52,0,52,Veneto,ITH3
2021-01-15,PF/BT,5050801,MED.COMP. - OSP. SAN BORTOLO,VEN,50-59,22,46,0,28,26,0,14,68,0,68,Veneto,ITH3
2021-01-15,PF/BT,5050801,MED.COMP. - OSP. SAN BORTOLO,VEN,60-69,8,9,0,5,9,0,3,17,0,17,Veneto,ITH3
2021-01-15,PF/BT,5050801,MED.COMP. - OSP. SAN BORTOLO,VEN,70-79,2,2,0,2,2,0,0,4,0,4,Veneto,ITH3
2021-01-15,PF/BT,5050803,MED.COMP. - OSP. CAZZAVILLAN,VEN,20-29,7,10,0,8,7,0,2,17,0,17,Veneto,ITH3
2021-01-15,PF/BT,5050803,MED.COMP. - OSP. CAZZAVILLAN,VEN,30-39,9,17,0,13,11,0,2,26,0,26,Veneto,ITH3
2021-01-15,PF/BT,5050803,MED.COMP. - OSP. CAZZAVILLAN,VEN,40-49,6,20,0,11,10,0,5,26,0,26,Veneto,ITH3
2021-01-15,PF/BT,5050803,MED.COMP. - OSP. CAZZAVILLAN,VEN,50-59,14,35,0,23,21,0,5,49,0,49,Veneto,ITH3
2021-01-15,PF/BT,5050803,MED.COMP. - OSP. CAZZAVILLAN,VEN,60-69,8,3,0,7,3,0,1,11,0,11,Veneto,ITH3
2021-01-15,PF/BT,5050803,MED.COMP. - OSP. CAZZAVILLAN,VEN,70-79,1,0,0,1,0,0,0,1,0,1,Veneto,ITH3
2021-01-15,PF/BT,521630,R.S.A. 'IL GIRASOLE',VEN,30-39,0,4,0,4,0,0,0,4,0,4,Veneto,ITH3
2021-01-15,PF/BT,521630,R.S.A. 'IL GIRASOLE',VEN,40-49,2,2,0,2,2,0,0,4,0,4,Veneto,ITH3
2021-01-15,PF/BT,521630,R.S.A. 'IL GIRASOLE',VEN,60-69,1,5,0,3,2,1,0,6,0,6,Veneto,ITH3
2021-01-15,PF/BT,563034,C.D.R. A.M. BONORA,VEN,20-29,4,3,0,3,4,0,0,7,0,7,Veneto,ITH3
2021-01-15,PF/BT,563034,C.D.R. A.M. BONORA,VEN,30-39,2,10,0,8,3,1,0,12,0,12,Veneto,ITH3
2021-01-15,PF/BT,563034,C.D.R. A.M. BONORA,VEN,40-49,4,14,0,7,10,1,0,18,0,18,Veneto,ITH3
2021-01-15,PF/BT,563034,C.D.R. A.M. BONORA,VEN,50-59,5,22,0,8,18,1,0,27,0,27,Veneto,ITH3
2021-01-15,PF/BT,563034,C.D.R. A.M. BONORA,VEN,60-69,5,3,0,1,6,1,0,8,0,8,Veneto,ITH3
2021-01-15,PF/BT,563034,C.D.R. A.M. BONORA,VEN,70-79,8,4,0,0,4,8,0,12,0,12,Veneto,ITH3
2021-01-15,PF/BT,563034,C.D.R. A.M. BONORA,VEN,80-89,5,18,0,0,0,23,0,23,0,23,Veneto,ITH3
2021-01-15,PF/BT,563034,C.D.R. A.M. BONORA,VEN,90+,0,11,0,0,0,11,0,11,0,11,Veneto,ITH3
2021-01-15,PF/BT,563041,C. DIURNO A.M. BONORA,VEN,60-69,0,1,0,0,0,1,0,1,0,1,Veneto,ITH3
2021-01-15,PF/BT,563041,C. DIURNO A.M. BONORA,VEN,70-79,0,1,0,0,0,1,0,1,0,1,Veneto,ITH3
2021-01-15,PF/BT,563041,C. DIURNO A.M. BONORA,VEN,80-89,1,5,0,0,0,6,0,6,0,6,Veneto,ITH3
2021-01-15,PF/BT,563041,C. DIURNO A.M. BONORA,VEN,90+,0,1,0,0,0,1,0,1,0,1,Veneto,ITH3
2021-01-15,PF/BT,563044,C.D.R. DON ORIONE,VEN,20-29,0,4,0,3,1,0,0,4,0,4,Veneto,ITH3
2021-01-15,PF/BT,563044,C.D.R. DON ORIONE,VEN,30-39,0,4,0,4,0,0,0,4,0,4,Veneto,ITH3
2021-01-15,PF/BT,563044,C.D.R. DON ORIONE,VEN,40-49,1,8,0,6,3,0,0,9,0,9,Veneto,ITH3
2021-01-15,PF/BT,563044,C.D.R. DON ORIONE,VEN,50-59,0,12,0,7,5,0,0,12,0,12,Veneto,ITH3
2021-01-15,PF/BT,563044,C.D.R. DON ORIONE,VEN,60-69,0,3,0,2,1,0,0,3,0,3,Veneto,ITH3
2021-01-15,PF/BT,563047,R.S.A. PER DISABILI -C.S.PIERO,VEN,20-29,1,1,0,1,1,0,0,2,0,2,Veneto,ITH3
2021-01-15,PF/BT,563047,R.S.A. PER DISABILI -C.S.PIERO,VEN,30-39,5,9,0,7,6,1,0,14,0,14,Veneto,ITH3
2021-01-15,PF/BT,563047,R.S.A. PER DISABILI -C.S.PIERO,VEN,40-49,3,8,0,8,2,1,0,11,0,11,Veneto,ITH3
2021-01-15,PF/BT,563047,R.S.A. PER DISABILI -C.S.PIERO,VEN,50-59,2,9,0,4,6,1,0,11,0,11,Veneto,ITH3
2021-01-15,PF/BT,563047,R.S.A. PER DISABILI -C.S.PIERO,VEN,60-69,2,2,0,1,3,0,0,4,0,4,Veneto,ITH3
2021-01-15,PF/BT,563068,CASA DON L. MARAN,VEN,20-29,3,15,0,17,1,0,0,18,0,18,Veneto,ITH3
2021-01-15,PF/BT,563068,CASA DON L. MARAN,VEN,30-39,2,17,0,14,5,0,0,19,0,19,Veneto,ITH3
2021-01-15,PF/BT,563068,CASA DON L. MARAN,VEN,40-49,3,41,0,32,11,0,1,44,0,44,Veneto,ITH3
2021-01-15,PF/BT,563068,CASA DON L. MARAN,VEN,50-59,2,46,0,26,15,0,7,48,0,48,Veneto,ITH3
2021-01-15,PF/BT,563068,CASA DON L. MARAN,VEN,60-69,0,12,0,5,6,0,1,12,0,12,Veneto,ITH3
2021-01-15,PF/BT,563068,CASA DON L. MARAN,VEN,70-79,0,7,0,0,5,0,2,7,0,7,Veneto,ITH3
2021-01-15,PF/BT,563068,CASA DON L. MARAN,VEN,80-89,0,14,0,0,10,0,4,14,0,14,Veneto,ITH3
2021-01-15,PF/BT,610955,OPSA - OPERA PROVVIDENZA S.ANTONIO DISABILI,VEN,16-19,0,1,0,1,0,0,0,1,0,1,Veneto,ITH3
2021-01-15,PF/BT,610955,OPSA - OPERA PROVVIDENZA S.ANTONIO DISABILI,VEN,20-29,0,6,0,6,0,0,0,6,0,6,Veneto,ITH3
2021-01-15,PF/BT,610955,OPSA - OPERA PROVVIDENZA S.ANTONIO DISABILI,VEN,30-39,0,7,0,6,0,0,1,7,0,7,Veneto,ITH3
2021-01-15,PF/BT,610955,OPSA - OPERA PROVVIDENZA S.ANTONIO DISABILI,VEN,40-49,1,9,0,10,0,0,0,10,0,10,Veneto,ITH3
2021-01-15,PF/BT,610955,OPSA - OPERA PROVVIDENZA S.ANTONIO DISABILI,VEN,50-59,1,12,0,12,0,1,0,13,0,13,Veneto,ITH3
2021-01-15,PF/BT,610955,OPSA - OPERA PROVVIDENZA S.ANTONIO DISABILI,VEN,60-69,5,0,0,1,0,4,0,5,0,5,Veneto,ITH3
2021-01-15,PF/BT,610955,OPSA - OPERA PROVVIDENZA S.ANTONIO DISABILI,VEN,80-89,1,0,0,0,0,1,0,1,0,1,Veneto,ITH3
2021-01-15,PF/BT,611110,C.D. IRPEA - SANTA ROSA 1,VEN,16-19,1,1,0,0,0,2,0,2,0,2,Veneto,ITH3
2021-01-15,PF/BT,611110,C.D. IRPEA - SANTA ROSA 1,VEN,20-29,3,3,0,0,0,6,0,6,0,6,Veneto,ITH3
2021-01-15,PF/BT,611110,C.D. IRPEA - SANTA ROSA 1,VEN,30-39,7,3,0,0,0,10,0,10,0,10,Veneto,ITH3
2021-01-15,PF/BT,611110,C.D. IRPEA - SANTA ROSA 1,VEN,40-49,0,2,0,0,0,2,0,2,0,2,Veneto,ITH3
2021-01-15,PF/BT,611110,C.D. IRPEA - SANTA ROSA 1,VEN,50-59,2,0,0,0,0,2,0,2,0,2,Veneto,ITH3
2021-01-15,PF/BT,611145,OIC - CENTRO RESIDENZIALE CIVITAS VITAE,VEN,20-29,1,0,0,0,1,0,0,1,0,1,Veneto,ITH3
2021-01-15,PF/BT,611145,OIC - CENTRO RESIDENZIALE CIVITAS VITAE,VEN,30-39,1,0,0,0,1,0,0,1,0,1,Veneto,ITH3
2021-01-15,PF/BT,611145,OIC - CENTRO RESIDENZIALE CIVITAS VITAE,VEN,40-49,0,3,0,2,1,0,0,3,0,3,Veneto,ITH3
2021-01-15,PF/BT,611145,OIC - CENTRO RESIDENZIALE CIVITAS VITAE,VEN,50-59,0,4,0,2,2,0,0,4,0,4,Veneto,ITH3
2021-01-15,PF/BT,611145,OIC - CENTRO RESIDENZIALE CIVITAS VITAE,VEN,60-69,1,1,0,0,1,1,0,2,0,2,Veneto,ITH3
2021-01-15,PF/BT,611145,OIC - CENTRO RESIDENZIALE CIVITAS VITAE,VEN,70-79,2,6,0,0,0,8,0,8,0,8,Veneto,ITH3
2021-01-15,PF/BT,611145,OIC - CENTRO RESIDENZIALE CIVITAS VITAE,VEN,80-89,6,18,0,0,0,24,0,24,0,24,Veneto,ITH3
2021-01-15,PF/BT,611145,OIC - CENTRO RESIDENZIALE CIVITAS VITAE,VEN,90+,1,10,0,0,0,11,0,11,0,11,Veneto,ITH3
2021-01-15,PF/BT,611165,CRAUP - RSA VIA BOTTA,VEN,20-29,1,2,0,1,2,0,0,3,0,3,Veneto,ITH3
2021-01-15,PF/BT,611165,CRAUP - RSA VIA BOTTA,VEN,30-39,1,3,0,4,0,0,0,4,0,4,Veneto,ITH3
2021-01-15,PF/BT,611165,CRAUP - RSA VIA BOTTA,VEN,40-49,0,3,0,1,2,0,0,3,0,3,Veneto,ITH3
2021-01-15,PF/BT,611165,CRAUP - RSA VIA BOTTA,VEN,50-59,3,11,0,7,7,0,0,14,0,14,Veneto,ITH3
2021-01-15,PF/BT,611165,CRAUP - RSA VIA BOTTA,VEN,60-69,0,5,0,2,2,1,0,5,0,5,Veneto,ITH3
2021-01-15,PF/BT,611165,CRAUP - RSA VIA BOTTA,VEN,70-79,1,2,0,0,0,3,0,3,0,3,Veneto,ITH3
2021-01-15,PF/BT,611165,CRAUP - RSA VIA BOTTA,VEN,80-89,4,14,0,0,0,18,0,18,0,18,Veneto,ITH3
2021-01-15,PF/BT,611165,CRAUP - RSA VIA BOTTA,VEN,90+,3,6,0,0,0,9,0,9,0,9,Veneto,ITH3
2021-01-15,PF/BT,611172,C.D. IRPEA - SANTA ROSA NUCLEO 2,VEN,20-29,3,1,0,0,0,4,0,4,0,4,Veneto,ITH3
2021-01-15,PF/BT,611172,C.D. IRPEA - SANTA ROSA NUCLEO 2,VEN,30-39,3,1,0,0,0,4,0,4,0,4,Veneto,ITH3
2021-01-15,PF/BT,611172,C.D. IRPEA - SANTA ROSA NUCLEO 2,VEN,40-49,2,0,0,0,0,2,0,2,0,2,Veneto,ITH3
2021-01-15,PF/BT,611172,C.D. IRPEA - SANTA ROSA NUCLEO 2,VEN,50-59,0,2,0,0,0,2,0,2,0,2,Veneto,ITH3
2021-01-15,PF/BT,611172,C.D. IRPEA - SANTA ROSA NUCLEO 2,VEN,60-69,0,2,0,0,0,2,0,2,0,2,Veneto,ITH3
2021-01-15,PF/BT,611198,OPSA - CASA MASSIMILIANO KOLBE,VEN,30-39,0,1,0,1,0,0,0,1,0,1,Veneto,ITH3
2021-01-15,PF/BT,611198,OPSA - CASA MASSIMILIANO KOLBE,VEN,40-49,1,1,0,2,0,0,0,2,0,2,Veneto,ITH3
2021-01-15,PF/BT,611198,OPSA - CASA MASSIMILIANO KOLBE,VEN,70-79,1,0,0,0,0,1,0,1,0,1,Veneto,ITH3
2021-01-15,PF/BT,611198,OPSA - CASA MASSIMILIANO KOLBE,VEN,90+,1,0,0,0,0,1,0,1,0,1,Veneto,ITH3
2021-01-15,PF/BT,611211,C.D. IRPEA - SAN GIUSEPPE 1,VEN,20-29,2,0,0,0,0,2,0,2,0,2,Veneto,ITH3
2021-01-15,PF/BT,611211,C.D. IRPEA - SAN GIUSEPPE 1,VEN,30-39,2,1,0,0,0,3,0,3,0,3,Veneto,ITH3
2021-01-15,PF/BT,611211,C.D. IRPEA - SAN GIUSEPPE 1,VEN,40-49,1,2,0,1,0,1,1,3,0,3,Veneto,ITH3
2021-01-15,PF/BT,611211,C.D. IRPEA - SAN GIUSEPPE 1,VEN,50-59,6,9,0,1,0,12,2,15,0,15,Veneto,ITH3
2021-01-15,PF/BT,611211,C.D. IRPEA - SAN GIUSEPPE 1,VEN,60-69,2,0,0,0,0,1,1,2,0,2,Veneto,ITH3
2021-01-15,PF/BT,611212,C.D. IRPEA - SAN GIUSEPPE 2,VEN,20-29,6,6,0,0,0,12,0,12,0,12,Veneto,ITH3
2021-01-15,PF/BT,611212,C.D. IRPEA - SAN GIUSEPPE 2,VEN,30-39,2,2,0,0,0,4,0,4,0,4,Veneto,ITH3
2021-01-15,PF/BT,611212,C.D. IRPEA - SAN GIUSEPPE 2,VEN,40-49,1,2,0,1,0,2,0,3,0,3,Veneto,ITH3
2021-01-15,PF/BT,611212,C.D. IRPEA - SAN GIUSEPPE 2,VEN,50-59,1,1,0,0,0,2,0,2,0,2,Veneto,ITH3
2021-01-15,PF/BT,611223,OPSA CENTRO DIURNO SAN RAFFAELE,VEN,70-79,3,1,0,0,0,4,0,4,0,4,Veneto,ITH3
2021-01-15,PF/BT,611223,OPSA CENTRO DIURNO SAN RAFFAELE,VEN,80-89,0,2,0,0,0,2,0,2,0,2,Veneto,ITH3
2021-01-15,PF/BT,611223,OPSA CENTRO DIURNO SAN RAFFAELE,VEN,90+,0,1,0,0,0,1,0,1,0,1,Veneto,ITH3
2021-01-15,PF/BT,611224,OPSA -CENTRO DIURNO SAN CAMILLO,VEN,50-59,0,1,0,0,0,1,0,1,0,1,Veneto,ITH3
2021-01-15,PF/BT,611224,OPSA -CENTRO DIURNO SAN CAMILLO,VEN,60-69,1,1,0,0,0,2,0,2,0,2,Veneto,ITH3
2021-01-15,PF/BT,611224,OPSA -CENTRO DIURNO SAN CAMILLO,VEN,70-79,0,1,0,0,0,1,0,1,0,1,Veneto,ITH3
2021-01-15,PF/BT,611224,OPSA -CENTRO DIURNO SAN CAMILLO,VEN,80-89,0,3,0,0,0,3,0,3,0,3,Veneto,ITH3
2021-01-15,PF/BT,611226,C.D. RAGGIO DI SOLE,VEN,20-29,4,3,0,2,0,5,0,7,0,7,Veneto,ITH3
2021-01-15,PF/BT,611226,C.D. RAGGIO DI SOLE,VEN,30-39,2,1,0,0,0,3,0,3,0,3,Veneto,ITH3
2021-01-15,PF/BT,611226,C.D. RAGGIO DI SOLE,VEN,40-49,7,6,0,1,0,12,0,13,0,13,Veneto,ITH3
2021-01-15,PF/BT,611226,C.D. RAGGIO DI SOLE,VEN,50-59,7,0,0,0,0,7,0,7,0,7,Veneto,ITH3
2021-01-15,PF/BT,611226,C.D. RAGGIO DI SOLE,VEN,60-69,2,0,0,0,0,2,0,2,0,2,Veneto,ITH3
2021-01-15,PF/BT,611243,CENTRO DI RIFERIMENTO PER LE GRAVI DISABILITA' E DISTIURBI DEL COMPORTAMENTO,VEN,50-59,2,0,0,0,0,2,0,2,0,2,Veneto,ITH3
2021-01-15,PF/BT,642095,CASA DI RIPOSO MONSELICE,VEN,40-49,0,1,0,1,0,0,0,1,0,1,Veneto,ITH3
2021-01-15,PF/BT,642095,CASA DI RIPOSO MONSELICE,VEN,50-59,1,4,0,4,1,0,0,5,0,5,Veneto,ITH3
2021-01-15,PF/BT,642095,CASA DI RIPOSO MONSELICE,VEN,60-69,3,2,0,0,3,2,0,5,0,5,Veneto,ITH3
2021-01-15,PF/BT,642095,CASA DI RIPOSO MONSELICE,VEN,90+,0,1,0,0,0,1,0,1,0,1,Veneto,ITH3
2021-01-15,PF/BT,642147,"C.S.A. NON AUTOSUFFICIENTI ""RESIDENZA AL PARCO"" GALZIGNANO TERME",VEN,20-29,0,2,0,1,1,0,0,2,0,2,Veneto,ITH3
2021-01-15,PF/BT,642147,"C.S.A. NON AUTOSUFFICIENTI ""RESIDENZA AL PARCO"" GALZIGNANO TERME",VEN,30-39,2,2,0,1,3,0,0,4,0,4,Veneto,ITH3
2021-01-15,PF/BT,642147,"C.S.A. NON AUTOSUFFICIENTI ""RESIDENZA AL PARCO"" GALZIGNANO TERME",VEN,40-49,0,4,0,1,3,0,0,4,0,4,Veneto,ITH3
2021-01-15,PF/BT,642147,"C.S.A. NON AUTOSUFFICIENTI ""RESIDENZA AL PARCO"" GALZIGNANO TERME",VEN,50-59,0,5,0,1,4,0,0,5,0,5,Veneto,ITH3
2021-01-15,PF/BT,642147,"C.S.A. NON AUTOSUFFICIENTI ""RESIDENZA AL PARCO"" GALZIGNANO TERME",VEN,60-69,0,1,0,1,0,0,0,1,0,1,Veneto,ITH3
2021-01-15,PF/BT,642147,"C.S.A. NON AUTOSUFFICIENTI ""RESIDENZA AL PARCO"" GALZIGNANO TERME",VEN,70-79,1,2,0,0,0,3,0,3,0,3,Veneto,ITH3
2021-01-15,PF/BT,642147,"C.S.A. NON AUTOSUFFICIENTI ""RESIDENZA AL PARCO"" GALZIGNANO TERME",VEN,80-89,3,18,0,0,0,21,0,21,0,21,Veneto,ITH3
2021-01-15,PF/BT,642147,"C.S.A. NON AUTOSUFFICIENTI ""RESIDENZA AL PARCO"" GALZIGNANO TERME",VEN,90+,4,14,0,0,0,18,0,18,0,18,Veneto,ITH3
2021-01-15,PF/BT,765019,C.D.R. 'DON B. MUSSOLIN',VEN,30-39,0,1,0,1,0,0,0,1,0,1,Veneto,ITH3
2021-01-15,PF/BT,765019,C.D.R. 'DON B. MUSSOLIN',VEN,40-49,0,2,0,1,1,0,0,2,0,2,Veneto,ITH3
2021-01-15,PF/BT,765019,C.D.R. 'DON B. MUSSOLIN',VEN,50-59,0,1,0,1,0,0,0,1,0,1,Veneto,ITH3
2021-01-15,PF/BT,765019,C.D.R. 'DON B. MUSSOLIN',VEN,60-69,1,0,0,1,0,0,0,1,0,1,Veneto,ITH3
2021-01-15,PF/BT,765019,C.D.R. 'DON B. MUSSOLIN',VEN,80-89,1,0,0,0,0,1,0,1,0,1,Veneto,ITH3
2021-01-15,PF/BT,765058,SOGGIORNO PER ANZIANI 'VILLA SPREA',VEN,30-39,0,2,0,0,2,0,0,2,0,2,Veneto,ITH3
2021-01-15,PF/BT,765058,SOGGIORNO PER ANZIANI 'VILLA SPREA',VEN,40-49,0,1,0,0,1,0,0,1,0,1,Veneto,ITH3
2021-01-15,PF/BT,765058,SOGGIORNO PER ANZIANI 'VILLA SPREA',VEN,80-89,1,2,0,0,0,3,0,3,0,3,Veneto,ITH3
2021-01-15,PF/BT,765066,CASA SOGG. 'P.C.C. BRESCIANI',VEN,20-29,0,1,0,1,0,0,0,1,0,1,Veneto,ITH3
2021-01-15,PF/BT,765066,CASA SOGG. 'P.C.C. BRESCIANI',VEN,30-39,0,2,0,2,0,0,0,2,0,2,Veneto,ITH3
2021-01-15,PF/BT,765066,CASA SOGG. 'P.C.C. BRESCIANI',VEN,40-49,2,1,0,2,1,0,0,3,0,3,Veneto,ITH3
2021-01-15,PF/BT,765066,CASA SOGG. 'P.C.C. BRESCIANI',VEN,50-59,2,7,0,8,1,0,0,9,0,9,Veneto,ITH3
2021-01-15,PF/BT,765066,CASA SOGG. 'P.C.C. BRESCIANI',VEN,60-69,1,0,0,0,1,0,0,1,0,1,Veneto,ITH3
2021-01-15,PF/BT,765066,CASA SOGG. 'P.C.C. BRESCIANI',VEN,70-79,5,0,0,0,5,0,0,5,0,5,Veneto,ITH3
2021-01-15,PF/BT,765066,CASA SOGG. 'P.C.C. BRESCIANI',VEN,80-89,2,0,0,0,2,0,0,2,0,2,Veneto,ITH3
2021-01-15,PF/BT,768005,C.D.R. 'CITTA' DI VERONA',VEN,20-29,6,3,0,8,1,0,0,9,0,9,Veneto,ITH3
2021-01-15,PF/BT,768005,C.D.R. 'CITTA' DI VERONA',VEN,30-39,3,3,0,5,1,0,0,6,0,6,Veneto,ITH3
2021-01-15,PF/BT,768005,C.D.R. 'CITTA' DI VERONA',VEN,40-49,3,14,0,12,5,0,0,17,0,17,Veneto,ITH3
2021-01-15,PF/BT,768005,C.D.R. 'CITTA' DI VERONA',VEN,50-59,0,18,0,12,6,0,0,18,0,18,Veneto,ITH3
2021-01-15,PF/BT,768005,C.D.R. 'CITTA' DI VERONA',VEN,60-69,0,1,0,1,0,0,0,1,0,1,Veneto,ITH3
2021-01-15,PF/BT,768037,CEN. RES. PIA OPERA CICCARELLI,VEN,16-19,0,1,0,1,0,0,0,1,0,1,Veneto,ITH3
2021-01-15,PF/BT,768037,CEN. RES. PIA OPERA CICCARELLI,VEN,20-29,1,4,0,4,1,0,0,5,0,5,Veneto,ITH3
2021-01-15,PF/BT,768037,CEN. RES. PIA OPERA CICCARELLI,VEN,30-39,0,6,0,6,0,0,0,6,0,6,Veneto,ITH3
2021-01-15,PF/BT,768037,CEN. RES. PIA OPERA CICCARELLI,VEN,40-49,3,12,0,11,0,4,0,15,0,15,Veneto,ITH3
2021-01-15,PF/BT,768037,CEN. RES. PIA OPERA CICCARELLI,VEN,50-59,7,26,0,19,1,13,0,33,0,33,Veneto,ITH3
2021-01-15,PF/BT,768037,CEN. RES. PIA OPERA CICCARELLI,VEN,60-69,7,4,0,1,0,10,0,11,0,11,Veneto,ITH3
2021-01-15,PF/BT,768037,CEN. RES. PIA OPERA CICCARELLI,VEN,70-79,0,2,0,0,0,2,0,2,0,2,Veneto,ITH3
2021-01-15,PF/BT,768203,CENTRO SERVIZI PER ANZIANI LE BETULLE,VEN,40-49,1,0,0,0,1,0,0,1,0,1,Veneto,ITH3
2021-01-15,PF/BT,768203,CENTRO SERVIZI PER ANZIANI LE BETULLE,VEN,60-69,2,1,0,0,3,0,0,3,0,3,Veneto,ITH3
2021-01-15,PF/BT,768203,CENTRO SERVIZI PER ANZIANI LE BETULLE,VEN,70-79,3,1,0,3,0,1,0,4,0,4,Veneto,ITH3
2021-01-15,PF/BT,768203,CENTRO SERVIZI PER ANZIANI LE BETULLE,VEN,80-89,1,5,0,0,0,6,0,6,0,6,Veneto,ITH3
2021-01-15,PF/BT,768203,CENTRO SERVIZI PER ANZIANI LE BETULLE,VEN,90+,0,3,0,0,0,3,0,3,0,3,Veneto,ITH3
2021-01-15,PF/BT,802092,CASA DI RIPOSO SAN BIAGIO,VEN,30-39,0,1,0,1,0,0,0,1,0,1,Veneto,ITH3
2021-01-15,PF/BT,802092,CASA DI RIPOSO SAN BIAGIO,VEN,40-49,1,1,0,2,0,0,0,2,0,2,Veneto,ITH3
2021-01-15,PF/BT,802092,CASA DI RIPOSO SAN BIAGIO,VEN,50-59,0,5,0,4,1,0,0,5,0,5,Veneto,ITH3
2021-01-15,PF/BT,802092,CASA DI RIPOSO SAN BIAGIO,VEN,70-79,2,1,0,0,0,3,0,3,0,3,Veneto,ITH3
2021-01-15,PF/BT,802092,CASA DI RIPOSO SAN BIAGIO,VEN,80-89,1,3,0,0,0,4,0,4,0,4,Veneto,ITH3
2021-01-15,PF/BT,802092,CASA DI RIPOSO SAN BIAGIO,VEN,90+,0,2,0,0,0,2,0,2,0,2,Veneto,ITH3
2021-01-15,PF/BT,802093,CASA DI RIPOSO EUFEMIA CAR.,VEN,20-29,1,1,0,0,2,0,0,2,0,2,Veneto,ITH3
2021-01-15,PF/BT,802093,CASA DI RIPOSO EUFEMIA CAR.,VEN,30-39,0,1,0,0,1,0,0,1,0,1,Veneto,ITH3
2021-01-15,PF/BT,802093,CASA DI RIPOSO EUFEMIA CAR.,VEN,40-49,1,2,0,2,1,0,0,3,0,3,Veneto,ITH3
2021-01-15,PF/BT,802093,CASA DI RIPOSO EUFEMIA CAR.,VEN,50-59,0,5,0,4,1,0,0,5,0,5,Veneto,ITH3
2021-01-15,PF/BT,802093,CASA DI RIPOSO EUFEMIA CAR.,VEN,60-69,1,2,0,2,1,0,0,3,0,3,Veneto,ITH3
2021-01-15,PF/BT,802093,CASA DI RIPOSO EUFEMIA CAR.,VEN,70-79,1,0,0,0,0,1,0,1,0,1,Veneto,ITH3
2021-01-15,PF/BT,802093,CASA DI RIPOSO EUFEMIA CAR.,VEN,80-89,1,1,0,0,0,2,0,2,0,2,Veneto,ITH3
2021-01-15,PF/BT,802094,IST.PER ANZIANI DE BATTISTI,VEN,60-69,1,0,0,0,0,1,0,1,0,1,Veneto,ITH3
2021-01-15,PF/BT,802094,IST.PER ANZIANI DE BATTISTI,VEN,80-89,0,4,0,0,0,4,0,4,0,4,Veneto,ITH3
2021-01-15,PF/BT,802094,IST.PER ANZIANI DE BATTISTI,VEN,90+,0,1,0,0,0,1,0,1,0,1,Veneto,ITH3
2021-01-15,PF/BT,802096,FONDAZIONE LUIGI FERRARI,VEN,20-29,1,3,0,2,2,0,0,4,0,4,Veneto,ITH3
2021-01-15,PF/BT,802096,FONDAZIONE LUIGI FERRARI,VEN,30-39,0,4,0,2,2,0,0,4,0,4,Veneto,ITH3
2021-01-15,PF/BT,802096,FONDAZIONE LUIGI FERRARI,VEN,40-49,0,11,0,10,1,0,0,11,0,11,Veneto,ITH3
2021-01-15,PF/BT,802096,FONDAZIONE LUIGI FERRARI,VEN,50-59,2,2,0,2,2,0,0,4,0,4,Veneto,ITH3
2021-01-15,PF/BT,802096,FONDAZIONE LUIGI FERRARI,VEN,60-69,0,1,0,1,0,0,0,1,0,1,Veneto,ITH3
2021-01-15,PF/BT,802096,FONDAZIONE LUIGI FERRARI,VEN,70-79,1,0,0,1,0,0,0,1,0,1,Veneto,ITH3
2021-01-15,PF/BT,802096,FONDAZIONE LUIGI FERRARI,VEN,80-89,1,1,0,0,0,0,2,2,0,2,Veneto,ITH3
2021-01-15,PF/BT,802096,FONDAZIONE LUIGI FERRARI,VEN,90+,1,1,0,0,0,0,2,2,0,2,Veneto,ITH3
2021-01-15,PF/BT,802097,CASA DI RIPOSO LEGNAGO,VEN,50-59,1,2,0,2,1,0,0,3,0,3,Veneto,ITH3
2021-01-15,PF/BT,802097,CASA DI RIPOSO LEGNAGO,VEN,60-69,1,0,0,0,0,1,0,1,0,1,Veneto,ITH3
2021-01-15,PF/BT,802097,CASA DI RIPOSO LEGNAGO,VEN,70-79,6,5,0,0,0,11,0,11,0,11,Veneto,ITH3
2021-01-15,PF/BT,802097,CASA DI RIPOSO LEGNAGO,VEN,80-89,6,21,0,0,0,27,0,27,0,27,Veneto,ITH3
2021-01-15,PF/BT,802097,CASA DI RIPOSO LEGNAGO,VEN,90+,0,14,0,0,0,14,0,14,0,14,Veneto,ITH3
2021-01-15,PF/BT,802203,CASA ALBERGO,VEN,20-29,1,3,0,3,1,0,0,4,0,4,Veneto,ITH3
2021-01-15,PF/BT,802203,CASA ALBERGO,VEN,30-39,2,4,0,5,1,0,0,6,0,6,Veneto,ITH3
2021-01-15,PF/BT,802203,CASA ALBERGO,VEN,40-49,2,8,0,6,4,0,0,10,0,10,Veneto,ITH3
2021-01-15,PF/BT,802203,CASA ALBERGO,VEN,50-59,1,24,0,16,8,1,0,25,0,25,Veneto,ITH3
2021-01-15,PF/BT,802203,CASA ALBERGO,VEN,60-69,0,4,0,1,0,3,0,4,0,4,Veneto,ITH3
2021-01-15,PF/BT,802203,CASA ALBERGO,VEN,70-79,4,3,0,0,0,7,0,7,0,7,Veneto,ITH3
2021-01-15,PF/BT,802203,CASA ALBERGO,VEN,80-89,4,19,0,0,0,23,0,23,0,23,Veneto,ITH3
2021-01-15,PF/BT,802203,CASA ALBERGO,VEN,90+,0,11,0,0,0,11,0,11,0,11,Veneto,ITH3
2021-01-15,PF/BT,802204,FONDAZIONE 'M.ZANETTI',VEN,80-89,0,1,0,0,0,1,0,1,0,1,Veneto,ITH3
2021-01-15,PF/BT,802204,FONDAZIONE 'M.ZANETTI',VEN,90+,0,1,0,0,0,1,0,1,0,1,Veneto,ITH3
2021-01-15,PF/BT,803004,FONDAZIONE GIOVANNI MERITANI,VEN,20-29,2,8,0,10,0,0,0,10,0,10,Veneto,ITH3
2021-01-15,PF/BT,803004,FONDAZIONE GIOVANNI MERITANI,VEN,30-39,1,1,0,2,0,0,0,2,0,2,Veneto,ITH3
2021-01-15,PF/BT,803004,FONDAZIONE GIOVANNI MERITANI,VEN,40-49,1,8,0,5,4,0,0,9,0,9,Veneto,ITH3
2021-01-15,PF/BT,803004,FONDAZIONE GIOVANNI MERITANI,VEN,50-59,0,10,0,8,2,0,0,10,0,10,Veneto,ITH3
2021-01-15,PF/BT,803004,FONDAZIONE GIOVANNI MERITANI,VEN,60-69,0,5,0,2,3,0,0,5,0,5,Veneto,ITH3
2021-01-15,PF/BT,803004,FONDAZIONE GIOVANNI MERITANI,VEN,70-79,0,2,0,0,0,2,0,2,0,2,Veneto,ITH3
2021-01-15,PF/BT,803004,FONDAZIONE GIOVANNI MERITANI,VEN,80-89,1,3,0,0,0,4,0,4,0,4,Veneto,ITH3
2021-01-15,PF/BT,803004,FONDAZIONE GIOVANNI MERITANI,VEN,90+,1,0,0,0,0,1,0,1,0,1,Veneto,ITH3
2021-01-15,PF/BT,84014,CASA VILLA SERENA,VEN,20-29,4,3,0,6,1,0,0,7,0,7,Veneto,ITH3
2021-01-15,PF/BT,84014,CASA VILLA SERENA,VEN,30-39,4,6,0,6,2,2,0,10,0,10,Veneto,ITH3
2021-01-15,PF/BT,84014,CASA VILLA SERENA,VEN,40-49,2,7,0,5,4,0,0,9,0,9,Veneto,ITH3
2021-01-15,PF/BT,84014,CASA VILLA SERENA,VEN,50-59,2,6,0,3,3,2,0,8,0,8,Veneto,ITH3
2021-01-15,PF/BT,84014,CASA VILLA SERENA,VEN,60-69,2,0,0,0,1,1,0,2,0,2,Veneto,ITH3
2021-01-15,PF/BT,84014,CASA VILLA SERENA,VEN,70-79,2,1,0,0,0,3,0,3,0,3,Veneto,ITH3
2021-01-15,PF/BT,84014,CASA VILLA SERENA,VEN,80-89,0,2,0,0,0,2,0,2,0,2,Veneto,ITH3
2021-01-15,PF/BT,84014,CASA VILLA SERENA,VEN,90+,0,3,0,0,0,3,0,3,0,3,Veneto,ITH3
2021-01-15,PF/BT,845224,IST. IMMACOLATA DI LOURDES,VEN,50-59,0,2,0,1,1,0,0,2,0,2,Veneto,ITH3
2021-01-15,PF/BT,845224,IST. IMMACOLATA DI LOURDES,VEN,70-79,0,1,0,0,0,1,0,1,0,1,Veneto,ITH3
2021-01-15,PF/BT,845224,IST. IMMACOLATA DI LOURDES,VEN,80-89,1,2,0,0,0,3,0,3,0,3,Veneto,ITH3
2021-01-15,PF/BT,845231,CASA RIPOSO SPAZIO APERTO LAZISE,VEN,60-69,0,1,0,1,0,0,0,1,0,1,Veneto,ITH3
2021-01-15,PF/BT,845239,IPAB PIO RICOVERO P.SEGATTINI,VEN,50-59,1,0,0,0,1,0,0,1,0,1,Veneto,ITH3
2021-01-15,PF/BT,845274,RESIDENZA PER ANZIANI GAETANO TOFFOLI,VEN,20-29,0,1,0,1,0,0,0,1,0,1,Veneto,ITH3
2021-01-15,PF/BT,845274,RESIDENZA PER ANZIANI GAETANO TOFFOLI,VEN,40-49,0,1,0,1,0,0,0,1,0,1,Veneto,ITH3
2021-01-15,PF/BT,845274,RESIDENZA PER ANZIANI GAETANO TOFFOLI,VEN,50-59,0,4,0,4,0,0,0,4,0,4,Veneto,ITH3
2021-01-15,PF/BT,CROCEVER,PIA OPERA CROCE VERDE,VEN,16-19,1,0,0,0,1,0,0,1,0,1,Veneto,ITH3
2021-01-15,PF/BT,CROCEVER,PIA OPERA CROCE VERDE,VEN,20-29,7,14,0,0,21,0,0,21,0,21,Veneto,ITH3
2021-01-15,PF/BT,CROCEVER,PIA OPERA CROCE VERDE,VEN,30-39,12,8,0,0,20,0,0,20,0,20,Veneto,ITH3
2021-01-15,PF/BT,CROCEVER,PIA OPERA CROCE VERDE,VEN,40-49,13,8,0,0,21,0,0,21,0,21,Veneto,ITH3
2021-01-15,PF/BT,CROCEVER,PIA OPERA CROCE VERDE,VEN,50-59,21,6,0,0,27,0,0,27,0,27,Veneto,ITH3
2021-01-15,PF/BT,CROCEVER,PIA OPERA CROCE VERDE,VEN,60-69,25,1,0,0,26,0,0,26,0,26,Veneto,ITH3
2021-01-15,PF/BT,CROCEVER,PIA OPERA CROCE VERDE,VEN,70-79,14,4,0,0,17,0,1,18,0,18,Veneto,ITH3
2021-01-15,PF/BT,CROCEVER,PIA OPERA CROCE VERDE,VEN,80-89,2,0,0,0,2,0,0,2,0,2,Veneto,ITH3
2021-01-15,PF/BT,MARCON,RSA SERENI ORIZZONTI,VEN,20-29,3,1,0,3,1,0,0,4,0,4,Veneto,ITH3
2021-01-15,PF/BT,MARCON,RSA SERENI ORIZZONTI,VEN,30-39,2,6,0,4,4,0,0,8,0,8,Veneto,ITH3
2021-01-15,PF/BT,MARCON,RSA SERENI ORIZZONTI,VEN,40-49,2,5,0,4,3,0,0,7,0,7,Veneto,ITH3
2021-01-15,PF/BT,MARCON,RSA SERENI ORIZZONTI,VEN,50-59,3,5,0,8,0,0,0,8,0,8,Veneto,ITH3
2021-01-15,PF/BT,MARCON,RSA SERENI ORIZZONTI,VEN,60-69,0,2,0,1,0,1,0,2,0,2,Veneto,ITH3
2021-01-15,PF/BT,MARCON,RSA SERENI ORIZZONTI,VEN,70-79,1,4,0,0,0,5,0,5,0,5,Veneto,ITH3
2021-01-15,PF/BT,MARCON,RSA SERENI ORIZZONTI,VEN,80-89,3,8,0,0,0,11,0,11,0,11,Veneto,ITH3
2021-01-15,PF/BT,MARCON,RSA SERENI ORIZZONTI,VEN,90+,3,5,0,0,0,8,0,8,0,8,Veneto,ITH3
2021-01-16,PF/BT,0,Mancante,VEN,16-19,4,5,0,0,9,0,0,9,0,9,Veneto,ITH3
2021-01-16,PF/BT,0,Mancante,VEN,20-29,29,51,0,0,80,0,0,80,0,80,Veneto,ITH3
2021-01-16,PF/BT,0,Mancante,VEN,30-39,29,22,0,0,51,0,0,51,0,51,Veneto,ITH3
2021-01-16,PF/BT,0,Mancante,VEN,40-49,32,27,0,0,59,0,0,59,0,59,Veneto,ITH3
2021-01-16,PF/BT,0,Mancante,VEN,50-59,46,34,0,0,80,0,0,80,0,80,Veneto,ITH3
2021-01-16,PF/BT,0,Mancante,VEN,60-69,30,11,0,0,41,0,0,41,0,41,Veneto,ITH3
2021-01-16,PF/BT,0,Mancante,VEN,70-79,11,2,0,0,13,0,0,13,0,13,Veneto,ITH3
2021-01-16,PF/BT,0,Mancante,VEN,80-89,1,3,0,0,4,0,0,4,0,4,Veneto,ITH3
2021-01-16,PF/BT,244012,"CENTRO DI SERVIZI RESIDENZIALE ""F.LLI MOZZETTI"" - VAZZOLA",VEN,20-29,1,3,0,3,1,0,0,4,0,4,Veneto,ITH3
2021-01-16,PF/BT,244012,"CENTRO DI SERVIZI RESIDENZIALE ""F.LLI MOZZETTI"" - VAZZOLA",VEN,30-39,0,5,0,4,1,0,0,5,0,5,Veneto,ITH3
2021-01-16,PF/BT,244012,"CENTRO DI SERVIZI RESIDENZIALE ""F.LLI MOZZETTI"" - VAZZOLA",VEN,40-49,5,16,0,15,6,0,0,21,0,21,Veneto,ITH3
2021-01-16,PF/BT,244012,"CENTRO DI SERVIZI RESIDENZIALE ""F.LLI MOZZETTI"" - VAZZOLA",VEN,50-59,5,18,0,16,7,0,0,23,0,23,Veneto,ITH3
2021-01-16,PF/BT,244012,"CENTRO DI SERVIZI RESIDENZIALE ""F.LLI MOZZETTI"" - VAZZOLA",VEN,60-69,4,3,0,2,4,1,0,7,0,7,Veneto,ITH3
2021-01-16,PF/BT,244012,"CENTRO DI SERVIZI RESIDENZIALE ""F.LLI MOZZETTI"" - VAZZOLA",VEN,70-79,3,8,0,0,0,11,0,11,0,11,Veneto,ITH3
2021-01-16,PF/BT,244012,"CENTRO DI SERVIZI RESIDENZIALE ""F.LLI MOZZETTI"" - VAZZOLA",VEN,80-89,11,27,0,0,0,38,0,38,0,38,Veneto,ITH3
2021-01-16,PF/BT,244012,"CENTRO DI SERVIZI RESIDENZIALE ""F.LLI MOZZETTI"" - VAZZOLA",VEN,90+,1,23,0,0,0,24,0,24,0,24,Veneto,ITH3
2021-01-16,PF/BT,244014,"CENTRO DI SERVIZI RESIDENZIALE ""ISTITUTO BON BOZZOLLA"" - FARRA DI SOLIGO",VEN,20-29,5,6,0,9,2,0,0,11,0,11,Veneto,ITH3
2021-01-16,PF/BT,244014,"CENTRO DI SERVIZI RESIDENZIALE ""ISTITUTO BON BOZZOLLA"" - FARRA DI SOLIGO",VEN,30-39,12,11,0,19,4,0,0,23,0,23,Veneto,ITH3
2021-01-16,PF/BT,244014,"CENTRO DI SERVIZI RESIDENZIALE ""ISTITUTO BON BOZZOLLA"" - FARRA DI SOLIGO",VEN,40-49,1,17,0,13,5,0,0,18,0,18,Veneto,ITH3
2021-01-16,PF/BT,244014,"CENTRO DI SERVIZI RESIDENZIALE ""ISTITUTO BON BOZZOLLA"" - FARRA DI SOLIGO",VEN,50-59,3,21,0,14,7,3,0,24,0,24,Veneto,ITH3
2021-01-16,PF/BT,244014,"CENTRO DI SERVIZI RESIDENZIALE ""ISTITUTO BON BOZZOLLA"" - FARRA DI SOLIGO",VEN,60-69,3,7,0,3,1,6,0,10,0,10,Veneto,ITH3
2021-01-16,PF/BT,244014,"CENTRO DI SERVIZI RESIDENZIALE ""ISTITUTO BON BOZZOLLA"" - FARRA DI SOLIGO",VEN,70-79,6,11,0,0,0,17,0,17,0,17,Veneto,ITH3
2021-01-16,PF/BT,244014,"CENTRO DI SERVIZI RESIDENZIALE ""ISTITUTO BON BOZZOLLA"" - FARRA DI SOLIGO",VEN,80-89,8,20,0,0,0,28,0,28,0,28,Veneto,ITH3
2021-01-16,PF/BT,244014,"CENTRO DI SERVIZI RESIDENZIALE ""ISTITUTO BON BOZZOLLA"" - FARRA DI SOLIGO",VEN,90+,5,18,0,0,0,23,0,23,0,23,Veneto,ITH3
2021-01-16,PF/BT,284027,"CENTRO DI SERVIZI RESIDENZIALE ""SAN GREGORIO"" VALDOBBIADENE",VEN,16-19,0,1,0,0,0,1,0,1,0,1,Veneto,ITH3
2021-01-16,PF/BT,284027,"CENTRO DI SERVIZI RESIDENZIALE ""SAN GREGORIO"" VALDOBBIADENE",VEN,20-29,5,17,0,19,3,0,0,22,0,22,Veneto,ITH3
2021-01-16,PF/BT,284027,"CENTRO DI SERVIZI RESIDENZIALE ""SAN GREGORIO"" VALDOBBIADENE",VEN,30-39,9,36,0,30,10,5,0,45,0,45,Veneto,ITH3
2021-01-16,PF/BT,284027,"CENTRO DI SERVIZI RESIDENZIALE ""SAN GREGORIO"" VALDOBBIADENE",VEN,40-49,26,77,0,59,31,13,0,103,0,103,Veneto,ITH3
2021-01-16,PF/BT,284027,"CENTRO DI SERVIZI RESIDENZIALE ""SAN GREGORIO"" VALDOBBIADENE",VEN,50-59,46,78,0,64,30,30,0,124,0,124,Veneto,ITH3
2021-01-16,PF/BT,284027,"CENTRO DI SERVIZI RESIDENZIALE ""SAN GREGORIO"" VALDOBBIADENE",VEN,60-69,19,31,0,11,6,33,0,50,0,50,Veneto,ITH3
2021-01-16,PF/BT,284027,"CENTRO DI SERVIZI RESIDENZIALE ""SAN GREGORIO"" VALDOBBIADENE",VEN,70-79,35,23,0,0,0,58,0,58,0,58,Veneto,ITH3
2021-01-16,PF/BT,284027,"CENTRO DI SERVIZI RESIDENZIALE ""SAN GREGORIO"" VALDOBBIADENE",VEN,80-89,15,45,0,0,0,60,0,60,0,60,Veneto,ITH3
2021-01-16,PF/BT,284027,"CENTRO DI SERVIZI RESIDENZIALE ""SAN GREGORIO"" VALDOBBIADENE",VEN,90+,8,42,0,0,0,50,0,50,0,50,Veneto,ITH3
2021-01-16,PF/BT,363759,ANNI SERENI CITTA' DI ERACLEA,VEN,20-29,4,9,0,7,0,0,6,13,0,13,Veneto,ITH3
2021-01-16,PF/BT,363759,ANNI SERENI CITTA' DI ERACLEA,VEN,30-39,4,9,0,3,0,0,10,13,0,13,Veneto,ITH3
2021-01-16,PF/BT,363759,ANNI SERENI CITTA' DI ERACLEA,VEN,40-49,0,9,0,1,0,0,8,9,0,9,Veneto,ITH3
2021-01-16,PF/BT,363759,ANNI SERENI CITTA' DI ERACLEA,VEN,50-59,5,19,0,11,0,1,12,24,0,24,Veneto,ITH3
2021-01-16,PF/BT,363759,ANNI SERENI CITTA' DI ERACLEA,VEN,60-69,7,11,0,2,0,4,12,18,0,18,Veneto,ITH3
2021-01-16,PF/BT,363759,ANNI SERENI CITTA' DI ERACLEA,VEN,70-79,10,5,0,1,0,7,7,15,0,15,Veneto,ITH3
2021-01-16,PF/BT,363759,ANNI SERENI CITTA' DI ERACLEA,VEN,80-89,2,13,0,0,0,15,0,15,0,15,Veneto,ITH3
2021-01-16,PF/BT,363759,ANNI SERENI CITTA' DI ERACLEA,VEN,90+,2,8,0,0,0,9,1,10,0,10,Veneto,ITH3
2021-01-16,PF/BT,363785,RESIDENZA PER ANZIANI 'STELLA MARINA',VEN,20-29,2,0,0,0,2,0,0,2,0,2,Veneto,ITH3
2021-01-16,PF/BT,363785,RESIDENZA PER ANZIANI 'STELLA MARINA',VEN,30-39,3,3,0,4,2,0,0,6,0,6,Veneto,ITH3
2021-01-16,PF/BT,363785,RESIDENZA PER ANZIANI 'STELLA MARINA',VEN,40-49,2,3,0,2,3,0,0,5,0,5,Veneto,ITH3
2021-01-16,PF/BT,363785,RESIDENZA PER ANZIANI 'STELLA MARINA',VEN,50-59,1,4,0,1,4,0,0,5,0,5,Veneto,ITH3
2021-01-16,PF/BT,486011,RESIDENZA DELLA SALUTE - FIESSO D'ARTICO,VEN,20-29,0,1,0,1,0,0,0,1,0,1,Veneto,ITH3
2021-01-16,PF/BT,5002200,OSPEDALE P. PEDERZOLI,VEN,20-29,1,10,0,11,0,0,0,11,0,11,Veneto,ITH3
2021-01-16,PF/BT,5002200,OSPEDALE P. PEDERZOLI,VEN,30-39,3,5,0,8,0,0,0,8,0,8,Veneto,ITH3
2021-01-16,PF/BT,5002200,OSPEDALE P. PEDERZOLI,VEN,40-49,5,13,0,18,0,0,0,18,0,18,Veneto,ITH3
2021-01-16,PF/BT,5002200,OSPEDALE P. PEDERZOLI,VEN,50-59,4,7,0,11,0,0,0,11,0,11,Veneto,ITH3
2021-01-16,PF/BT,5002200,OSPEDALE P. PEDERZOLI,VEN,60-69,1,4,0,5,0,0,0,5,0,5,Veneto,ITH3
2021-01-16,PF/BT,5002200,OSPEDALE P. PEDERZOLI,VEN,70-79,0,1,0,1,0,0,0,1,0,1,Veneto,ITH3
2021-01-16,PF/BT,5007200,OSPEDALE ORAS MOTTA,VEN,20-29,6,23,0,26,2,0,1,29,0,29,Veneto,ITH3
2021-01-16,PF/BT,5007200,OSPEDALE ORAS MOTTA,VEN,30-39,14,19,0,22,10,0,1,33,0,33,Veneto,ITH3
2021-01-16,PF/BT,5007200,OSPEDALE ORAS MOTTA,VEN,40-49,12,34,0,31,12,0,3,46,0,46,Veneto,ITH3
2021-01-16,PF/BT,5007200,OSPEDALE ORAS MOTTA,VEN,50-59,18,33,0,30,14,0,7,51,0,51,Veneto,ITH3
2021-01-16,PF/BT,5007200,OSPEDALE ORAS MOTTA,VEN,60-69,16,10,0,22,4,0,0,26,0,26,Veneto,ITH3
2021-01-16,PF/BT,5007200,OSPEDALE ORAS MOTTA,VEN,70-79,2,2,0,4,0,0,0,4,0,4,Veneto,ITH3
2021-01-16,PF/BT,5007900,OSPEDALE SAN CAMILLO,VEN,20-29,5,11,0,14,0,0,2,16,0,16,Veneto,ITH3
2021-01-16,PF/BT,5007900,OSPEDALE SAN CAMILLO,VEN,30-39,2,8,0,7,1,0,2,10,0,10,Veneto,ITH3
2021-01-16,PF/BT,5007900,OSPEDALE SAN CAMILLO,VEN,40-49,8,20,0,24,3,0,1,28,0,28,Veneto,ITH3
2021-01-16,PF/BT,5007900,OSPEDALE SAN CAMILLO,VEN,50-59,8,20,0,22,1,0,5,28,0,28,Veneto,ITH3
2021-01-16,PF/BT,5007900,OSPEDALE SAN CAMILLO,VEN,60-69,4,4,0,6,0,0,2,8,0,8,Veneto,ITH3
2021-01-16,PF/BT,5007900,OSPEDALE SAN CAMILLO,VEN,70-79,4,0,0,4,0,0,0,4,0,4,Veneto,ITH3
2021-01-16,PF/BT,5008100,CASA DI CURA GIOVANNI XXIII,VEN,20-29,8,23,0,26,5,0,0,31,0,31,Veneto,ITH3
2021-01-16,PF/BT,5008100,CASA DI CURA GIOVANNI XXIII,VEN,30-39,12,16,0,24,4,0,0,28,0,28,Veneto,ITH3
2021-01-16,PF/BT,5008100,CASA DI CURA GIOVANNI XXIII,VEN,40-49,5,33,0,38,0,0,0,38,0,38,Veneto,ITH3
2021-01-16,PF/BT,5008100,CASA DI CURA GIOVANNI XXIII,VEN,50-59,12,33,0,38,7,0,0,45,0,45,Veneto,ITH3
2021-01-16,PF/BT,5008100,CASA DI CURA GIOVANNI XXIII,VEN,60-69,22,5,0,25,2,0,0,27,0,27,Veneto,ITH3
2021-01-16,PF/BT,5008100,CASA DI CURA GIOVANNI XXIII,VEN,70-79,8,1,0,9,0,0,0,9,0,9,Veneto,ITH3
2021-01-16,PF/BT,50503,CHIOGGIA,VEN,20-29,6,17,0,22,0,0,1,23,0,23,Veneto,ITH3
2021-01-16,PF/BT,50503,CHIOGGIA,VEN,30-39,8,30,0,37,0,0,1,38,0,38,Veneto,ITH3
2021-01-16,PF/BT,50503,CHIOGGIA,VEN,40-49,13,18,0,31,0,0,0,31,0,31,Veneto,ITH3
2021-01-16,PF/BT,50503,CHIOGGIA,VEN,50-59,7,16,0,22,0,0,1,23,0,23,Veneto,ITH3
2021-01-16,PF/BT,50503,CHIOGGIA,VEN,60-69,16,5,0,21,0,0,0,21,0,21,Veneto,ITH3
2021-01-16,PF/BT,50503,CHIOGGIA,VEN,70-79,2,0,0,2,0,0,0,2,0,2,Veneto,ITH3
2021-01-16,PF/BT,50503,S.I.S.P. MESTRE,VEN,20-29,8,15,0,23,0,0,0,23,0,23,Veneto,ITH3
2021-01-16,PF/BT,50503,S.I.S.P. MESTRE,VEN,30-39,9,32,0,41,0,0,0,41,0,41,Veneto,ITH3
2021-01-16,PF/BT,50503,S.I.S.P. MESTRE,VEN,40-49,15,34,0,49,0,0,0,49,0,49,Veneto,ITH3
2021-01-16,PF/BT,50503,S.I.S.P. MESTRE,VEN,50-59,18,45,0,63,0,0,0,63,0,63,Veneto,ITH3
2021-01-16,PF/BT,50503,S.I.S.P. MESTRE,VEN,60-69,38,17,0,55,0,0,0,55,0,55,Veneto,ITH3
2021-01-16,PF/BT,50503,S.I.S.P. MESTRE,VEN,70-79,8,0,0,8,0,0,0,8,0,8,Veneto,ITH3
2021-01-16,PF/BT,50503,S.I.S.P. VENEZIA,VEN,20-29,2,9,0,11,0,0,0,11,0,11,Veneto,ITH3
2021-01-16,PF/BT,50503,S.I.S.P. VENEZIA,VEN,30-39,5,18,0,23,0,0,0,23,0,23,Veneto,ITH3
2021-01-16,PF/BT,50503,S.I.S.P. VENEZIA,VEN,40-49,1,20,0,21,0,0,0,21,0,21,Veneto,ITH3
2021-01-16,PF/BT,50503,S.I.S.P. VENEZIA,VEN,50-59,6,29,0,35,0,0,0,35,0,35,Veneto,ITH3
2021-01-16,PF/BT,50503,S.I.S.P. VENEZIA,VEN,60-69,23,13,0,36,0,0,0,36,0,36,Veneto,ITH3
2021-01-16,PF/BT,50503,S.I.S.P. VENEZIA,VEN,70-79,11,4,0,15,0,0,0,15,0,15,Veneto,ITH3
2021-01-16,PF/BT,50503,S.I.S.P. VENEZIA,VEN,80-89,2,0,0,2,0,0,0,2,0,2,Veneto,ITH3
2021-01-16,PF/BT,50503,SISP DOLO ADULTI,VEN,16-19,1,0,0,1,0,0,0,1,0,1,Veneto,ITH3
2021-01-16,PF/BT,50503,SISP DOLO ADULTI,VEN,20-29,12,35,0,47,0,0,0,47,0,47,Veneto,ITH3
2021-01-16,PF/BT,50503,SISP DOLO ADULTI,VEN,30-39,18,37,0,55,0,0,0,55,0,55,Veneto,ITH3
2021-01-16,PF/BT,50503,SISP DOLO ADULTI,VEN,40-49,16,38,0,54,0,0,0,54,0,54,Veneto,ITH3
2021-01-16,PF/BT,50503,SISP DOLO ADULTI,VEN,50-59,25,36,0,61,0,0,0,61,0,61,Veneto,ITH3
2021-01-16,PF/BT,50503,SISP DOLO ADULTI,VEN,60-69,19,12,0,31,0,0,0,31,0,31,Veneto,ITH3
2021-01-16,PF/BT,50503,SISP DOLO ADULTI,VEN,70-79,7,0,0,7,0,0,0,7,0,7,Veneto,ITH3
2021-01-16,PF/BT,50503,SISP DOLO ADULTI,VEN,80-89,1,0,0,1,0,0,0,1,0,1,Veneto,ITH3
2021-01-16,PF/BT,50504,C. V. TERR. SAN DONA' DI PIAVE,VEN,20-29,4,10,0,12,2,0,0,14,0,14,Veneto,ITH3
2021-01-16,PF/BT,50504,C. V. TERR. SAN DONA' DI PIAVE,VEN,30-39,6,18,0,16,6,0,2,24,0,24,Veneto,ITH3
2021-01-16,PF/BT,50504,C. V. TERR. SAN DONA' DI PIAVE,VEN,40-49,7,28,0,19,13,0,3,35,0,35,Veneto,ITH3
2021-01-16,PF/BT,50504,C. V. TERR. SAN DONA' DI PIAVE,VEN,50-59,15,46,0,33,24,0,4,61,0,61,Veneto,ITH3
2021-01-16,PF/BT,50504,C. V. TERR. SAN DONA' DI PIAVE,VEN,60-69,15,15,0,20,8,1,1,30,0,30,Veneto,ITH3
2021-01-16,PF/BT,50504,C. V. TERR. SAN DONA' DI PIAVE,VEN,70-79,2,7,0,1,1,6,1,9,0,9,Veneto,ITH3
2021-01-16,PF/BT,50504,C. V. TERR. SAN DONA' DI PIAVE,VEN,80-89,2,7,0,0,3,5,1,9,0,9,Veneto,ITH3
2021-01-16,PF/BT,50504,C. V. TERR. SAN DONA' DI PIAVE,VEN,90+,0,4,0,0,0,4,0,4,0,4,Veneto,ITH3
2021-01-16,PF/BT,50505,MAGAZZINO MED. COMPETENTE 05,VEN,16-19,1,2,0,0,2,0,1,3,0,3,Veneto,ITH3
2021-01-16,PF/BT,50505,MAGAZZINO MED. COMPETENTE 05,VEN,20-29,3,7,0,2,7,0,1,10,0,10,Veneto,ITH3
2021-01-16,PF/BT,50505,MAGAZZINO MED. COMPETENTE 05,VEN,30-39,2,14,0,8,4,0,4,16,0,16,Veneto,ITH3
2021-01-16,PF/BT,50505,MAGAZZINO MED. COMPETENTE 05,VEN,40-49,3,26,0,15,7,0,7,29,0,29,Veneto,ITH3
2021-01-16,PF/BT,50505,MAGAZZINO MED. COMPETENTE 05,VEN,50-59,12,41,0,30,5,0,18,53,0,53,Veneto,ITH3
2021-01-16,PF/BT,50505,MAGAZZINO MED. COMPETENTE 05,VEN,60-69,7,9,0,6,6,0,4,16,0,16,Veneto,ITH3
2021-01-16,PF/BT,50505,MAGAZZINO MED. COMPETENTE 05,VEN,70-79,4,1,0,1,3,0,1,5,0,5,Veneto,ITH3
2021-01-16,PF/BT,50506,AZ OSPEDALIERA DI PADOVA MAL. INFET.E TR,VEN,20-29,27,31,0,58,0,0,0,58,0,58,Veneto,ITH3
2021-01-16,PF/BT,50506,AZ OSPEDALIERA DI PADOVA MAL. INFET.E TR,VEN,30-39,12,23,0,35,0,0,0,35,0,35,Veneto,ITH3
2021-01-16,PF/BT,50506,AZ OSPEDALIERA DI PADOVA MAL. INFET.E TR,VEN,40-49,35,96,0,131,0,0,0,131,0,131,Veneto,ITH3
2021-01-16,PF/BT,50506,AZ OSPEDALIERA DI PADOVA MAL. INFET.E TR,VEN,50-59,60,179,0,239,0,0,0,239,0,239,Veneto,ITH3
2021-01-16,PF/BT,50506,AZ OSPEDALIERA DI PADOVA MAL. INFET.E TR,VEN,60-69,12,11,0,23,0,0,0,23,0,23,Veneto,ITH3
2021-01-16,PF/BT,50506,COLLI VACC. ADULTI,VEN,20-29,2,1,0,0,1,2,0,3,0,3,Veneto,ITH3
2021-01-16,PF/BT,50506,COLLI VACC. ADULTI,VEN,30-39,1,4,0,2,0,3,0,5,0,5,Veneto,ITH3
2021-01-16,PF/BT,50506,COLLI VACC. ADULTI,VEN,40-49,8,8,0,5,0,7,4,16,0,16,Veneto,ITH3
2021-01-16,PF/BT,50506,COLLI VACC. ADULTI,VEN,50-59,9,11,0,6,0,10,4,20,0,20,Veneto,ITH3
2021-01-16,PF/BT,50506,COLLI VACC. ADULTI,VEN,60-69,2,4,0,3,0,2,1,6,0,6,Veneto,ITH3
2021-01-16,PF/BT,50506,COLLI VACC. ADULTI,VEN,70-79,2,2,0,0,0,2,2,4,0,4,Veneto,ITH3
2021-01-16,PF/BT,50506,DISTR. 3 ALBIGNASEGO AMB.IGIEN,VEN,20-29,5,5,0,4,3,3,0,10,0,10,Veneto,ITH3
2021-01-16,PF/BT,50506,DISTR. 3 ALBIGNASEGO AMB.IGIEN,VEN,30-39,4,8,0,1,5,6,0,12,0,12,Veneto,ITH3
2021-01-16,PF/BT,50506,DISTR. 3 ALBIGNASEGO AMB.IGIEN,VEN,40-49,6,2,0,1,2,5,0,8,0,8,Veneto,ITH3
2021-01-16,PF/BT,50506,DISTR. 3 ALBIGNASEGO AMB.IGIEN,VEN,50-59,3,7,0,2,4,4,0,10,0,10,Veneto,ITH3
2021-01-16,PF/BT,50506,DISTR. 3 ALBIGNASEGO AMB.IGIEN,VEN,60-69,0,2,0,1,1,0,0,2,0,2,Veneto,ITH3
2021-01-16,PF/BT,50506,IGIENE PUBBLICA RUBANO,VEN,20-29,3,0,0,0,0,3,0,3,0,3,Veneto,ITH3
2021-01-16,PF/BT,50506,IGIENE PUBBLICA RUBANO,VEN,30-39,6,4,0,4,0,6,0,10,0,10,Veneto,ITH3
2021-01-16,PF/BT,50506,IGIENE PUBBLICA RUBANO,VEN,40-49,5,8,0,7,0,6,0,13,0,13,Veneto,ITH3
2021-01-16,PF/BT,50506,IGIENE PUBBLICA RUBANO,VEN,50-59,8,9,0,10,0,7,0,17,0,17,Veneto,ITH3
2021-01-16,PF/BT,50506,IGIENE PUBBLICA RUBANO,VEN,60-69,1,4,0,4,0,1,0,5,0,5,Veneto,ITH3
2021-01-16,PF/BT,50506,MONSELICE,VEN,16-19,6,8,0,0,14,0,0,14,0,14,Veneto,ITH3
2021-01-16,PF/BT,50506,MONSELICE,VEN,20-29,15,21,0,0,36,0,0,36,0,36,Veneto,ITH3
2021-01-16,PF/BT,50506,MONSELICE,VEN,30-39,10,6,0,1,15,0,0,16,0,16,Veneto,ITH3
2021-01-16,PF/BT,50506,MONSELICE,VEN,40-49,9,13,0,0,22,0,0,22,0,22,Veneto,ITH3
2021-01-16,PF/BT,50506,MONSELICE,VEN,50-59,18,7,0,0,25,0,0,25,0,25,Veneto,ITH3
2021-01-16,PF/BT,50506,MONSELICE,VEN,60-69,8,5,0,0,13,0,0,13,0,13,Veneto,ITH3
2021-01-16,PF/BT,50506,MONSELICE,VEN,70-79,1,1,0,0,2,0,0,2,0,2,Veneto,ITH3
2021-01-16,PF/BT,50506,PIOVE DI SACCO - SERV. IGIENE E SANITA',VEN,20-29,2,5,0,1,2,4,0,7,0,7,Veneto,ITH3
2021-01-16,PF/BT,50506,PIOVE DI SACCO - SERV. IGIENE E SANITA',VEN,30-39,2,2,0,0,2,2,0,4,0,4,Veneto,ITH3
2021-01-16,PF/BT,50506,PIOVE DI SACCO - SERV. IGIENE E SANITA',VEN,40-49,7,8,0,4,0,11,0,15,0,15,Veneto,ITH3
2021-01-16,PF/BT,50506,PIOVE DI SACCO - SERV. IGIENE E SANITA',VEN,50-59,4,11,0,3,6,6,0,15,0,15,Veneto,ITH3
2021-01-16,PF/BT,50506,PIOVE DI SACCO - SERV. IGIENE E SANITA',VEN,60-69,1,4,0,2,1,2,0,5,0,5,Veneto,ITH3
2021-01-16,PF/BT,50506,PIOVE DI SACCO - SERV. IGIENE E SANITA',VEN,70-79,2,0,0,1,1,0,0,2,0,2,Veneto,ITH3
2021-01-16,PF/BT,50506,VIA SCROVEGNI ANTI INFLUENZALE,VEN,16-19,2,1,0,0,1,2,0,3,0,3,Veneto,ITH3
2021-01-16,PF/BT,50506,VIA SCROVEGNI ANTI INFLUENZALE,VEN,20-29,3,6,0,2,1,6,0,9,0,9,Veneto,ITH3
2021-01-16,PF/BT,50506,VIA SCROVEGNI ANTI INFLUENZALE,VEN,30-39,0,2,0,2,0,0,0,2,0,2,Veneto,ITH3
2021-01-16,PF/BT,50506,VIA SCROVEGNI ANTI INFLUENZALE,VEN,40-49,0,4,0,2,2,0,0,4,0,4,Veneto,ITH3
2021-01-16,PF/BT,50506,VIA SCROVEGNI ANTI INFLUENZALE,VEN,50-59,4,5,0,7,2,0,0,9,0,9,Veneto,ITH3
2021-01-16,PF/BT,50506,VIA SCROVEGNI ANTI INFLUENZALE,VEN,60-69,4,5,0,7,2,0,0,9,0,9,Veneto,ITH3
2021-01-16,PF/BT,50507,H MAROSTICA,VEN,20-29,6,9,0,13,2,0,0,15,0,15,Veneto,ITH3
2021-01-16,PF/BT,50507,H MAROSTICA,VEN,30-39,4,17,0,20,1,0,0,21,0,21,Veneto,ITH3
2021-01-16,PF/BT,50507,H MAROSTICA,VEN,40-49,5,13,0,15,3,0,0,18,0,18,Veneto,ITH3
2021-01-16,PF/BT,50507,H MAROSTICA,VEN,50-59,0,16,0,8,8,0,0,16,0,16,Veneto,ITH3
2021-01-16,PF/BT,50507,H MAROSTICA,VEN,60-69,0,5,0,3,2,0,0,5,0,5,Veneto,ITH3
2021-01-16,PF/BT,50507,H MAROSTICA,VEN,70-79,1,1,0,2,0,0,0,2,0,2,Veneto,ITH3
2021-01-16,PF/BT,5050801,MED.COMP. - OSP. SAN BORTOLO,VEN,20-29,23,27,0,14,23,0,13,50,0,50,Veneto,ITH3
2021-01-16,PF/BT,5050801,MED.COMP. - OSP. SAN BORTOLO,VEN,30-39,21,21,0,12,19,0,11,42,0,42,Veneto,ITH3
2021-01-16,PF/BT,5050801,MED.COMP. - OSP. SAN BORTOLO,VEN,40-49,19,41,0,18,27,0,15,60,0,60,Veneto,ITH3
2021-01-16,PF/BT,5050801,MED.COMP. - OSP. SAN BORTOLO,VEN,50-59,14,41,0,18,23,0,14,55,0,55,Veneto,ITH3
2021-01-16,PF/BT,5050801,MED.COMP. - OSP. SAN BORTOLO,VEN,60-69,9,9,0,5,10,0,3,18,0,18,Veneto,ITH3
2021-01-16,PF/BT,5050801,MED.COMP. - OSP. SAN BORTOLO,VEN,70-79,3,4,0,2,4,0,1,7,0,7,Veneto,ITH3
2021-01-16,PF/BT,5050801,MED.COMP. - OSP. SAN BORTOLO,VEN,80-89,2,0,0,1,1,0,0,2,0,2,Veneto,ITH3
2021-01-16,PF/BT,642131,CENTRO SERVIZI NON AUTOSUFF. LE ROSE,VEN,20-29,2,0,0,2,0,0,0,2,0,2,Veneto,ITH3
2021-01-16,PF/BT,642131,CENTRO SERVIZI NON AUTOSUFF. LE ROSE,VEN,70-79,0,1,0,0,0,1,0,1,0,1,Veneto,ITH3
2021-01-16,PF/BT,642131,CENTRO SERVIZI NON AUTOSUFF. LE ROSE,VEN,80-89,0,1,0,0,0,1,0,1,0,1,Veneto,ITH3
2021-01-16,PF/BT,768005,C.D.R. 'CITTA' DI VERONA',VEN,70-79,0,1,0,0,0,1,0,1,0,1,Veneto,ITH3
2021-01-16,PF/BT,768005,C.D.R. 'CITTA' DI VERONA',VEN,90+,0,1,0,0,0,1,0,1,0,1,Veneto,ITH3
2021-01-16,PF/BT,768037,CEN. RES. PIA OPERA CICCARELLI,VEN,16-19,0,1,0,1,0,0,0,1,0,1,Veneto,ITH3
2021-01-16,PF/BT,768037,CEN. RES. PIA OPERA CICCARELLI,VEN,20-29,4,14,0,15,3,0,0,18,0,18,Veneto,ITH3
2021-01-16,PF/BT,768037,CEN. RES. PIA OPERA CICCARELLI,VEN,30-39,3,22,0,16,9,0,0,25,0,25,Veneto,ITH3
2021-01-16,PF/BT,768037,CEN. RES. PIA OPERA CICCARELLI,VEN,40-49,5,41,0,33,13,0,0,46,0,46,Veneto,ITH3
2021-01-16,PF/BT,768037,CEN. RES. PIA OPERA CICCARELLI,VEN,50-59,5,48,0,34,19,0,0,53,0,53,Veneto,ITH3
2021-01-16,PF/BT,768037,CEN. RES. PIA OPERA CICCARELLI,VEN,60-69,3,10,0,8,5,0,0,13,0,13,Veneto,ITH3
2021-01-16,PF/BT,768104,CASA DI RIPOSO NUOVA RSA SOAVE - SAN GIOVANNI BATTISTA,VEN,20-29,0,4,0,3,1,0,0,4,0,4,Veneto,ITH3
2021-01-16,PF/BT,768104,CASA DI RIPOSO NUOVA RSA SOAVE - SAN GIOVANNI BATTISTA,VEN,30-39,1,3,0,3,1,0,0,4,0,4,Veneto,ITH3
2021-01-16,PF/BT,768104,CASA DI RIPOSO NUOVA RSA SOAVE - SAN GIOVANNI BATTISTA,VEN,40-49,0,7,0,5,2,0,0,7,0,7,Veneto,ITH3
2021-01-16,PF/BT,768104,CASA DI RIPOSO NUOVA RSA SOAVE - SAN GIOVANNI BATTISTA,VEN,50-59,0,10,0,8,2,0,0,10,0,10,Veneto,ITH3
2021-01-16,PF/BT,768104,CASA DI RIPOSO NUOVA RSA SOAVE - SAN GIOVANNI BATTISTA,VEN,60-69,1,2,0,3,0,0,0,3,0,3,Veneto,ITH3
2021-01-16,PF/BT,768177,AL BARANA,VEN,20-29,2,7,0,8,1,0,0,9,0,9,Veneto,ITH3
2021-01-16,PF/BT,768177,AL BARANA,VEN,30-39,1,6,0,5,2,0,0,7,0,7,Veneto,ITH3
2021-01-16,PF/BT,768177,AL BARANA,VEN,40-49,5,14,0,11,8,0,0,19,0,19,Veneto,ITH3
2021-01-16,PF/BT,768177,AL BARANA,VEN,50-59,1,16,0,13,4,0,0,17,0,17,Veneto,ITH3
2021-01-16,PF/BT,768177,AL BARANA,VEN,60-69,2,3,0,1,2,2,0,5,0,5,Veneto,ITH3
2021-01-16,PF/BT,768177,AL BARANA,VEN,70-79,2,4,0,0,0,6,0,6,0,6,Veneto,ITH3
2021-01-16,PF/BT,768177,AL BARANA,VEN,80-89,7,16,0,0,0,23,0,23,0,23,Veneto,ITH3
2021-01-16,PF/BT,768177,AL BARANA,VEN,90+,4,26,0,0,0,30,0,30,0,30,Veneto,ITH3
2021-01-16,PF/BT,802093,CASA DI RIPOSO EUFEMIA CAR.,VEN,40-49,0,1,0,0,1,0,0,1,0,1,Veneto,ITH3
2021-01-16,PF/BT,802094,IST.PER ANZIANI DE BATTISTI,VEN,70-79,3,2,0,0,0,5,0,5,0,5,Veneto,ITH3
2021-01-16,PF/BT,802094,IST.PER ANZIANI DE BATTISTI,VEN,80-89,1,7,0,0,0,8,0,8,0,8,Veneto,ITH3
2021-01-16,PF/BT,802094,IST.PER ANZIANI DE BATTISTI,VEN,90+,1,4,0,0,0,5,0,5,0,5,Veneto,ITH3
2021-01-16,PF/BT,802097,CASA DI RIPOSO LEGNAGO,VEN,40-49,0,1,0,0,1,0,0,1,0,1,Veneto,ITH3
2021-01-16,PF/BT,803004,FONDAZIONE GIOVANNI MERITANI,VEN,30-39,0,2,0,1,1,0,0,2,0,2,Veneto,ITH3
2021-01-16,PF/BT,803004,FONDAZIONE GIOVANNI MERITANI,VEN,40-49,0,1,0,1,0,0,0,1,0,1,Veneto,ITH3
2021-01-16,PF/BT,803004,FONDAZIONE GIOVANNI MERITANI,VEN,70-79,1,0,0,0,1,0,0,1,0,1,Veneto,ITH3
2021-01-17,PF/BT,0,Mancante,VEN,16-19,0,1,0,0,1,0,0,1,0,1,Veneto,ITH3
2021-01-17,PF/BT,0,Mancante,VEN,20-29,18,7,0,0,25,0,0,25,0,25,Veneto,ITH3
2021-01-17,PF/BT,0,Mancante,VEN,30-39,10,9,0,0,19,0,0,19,0,19,Veneto,ITH3
2021-01-17,PF/BT,0,Mancante,VEN,40-49,15,7,0,0,22,0,0,22,0,22,Veneto,ITH3
2021-01-17,PF/BT,0,Mancante,VEN,50-59,26,7,0,0,33,0,0,33,0,33,Veneto,ITH3
2021-01-17,PF/BT,0,Mancante,VEN,60-69,22,4,0,0,26,0,0,26,0,26,Veneto,ITH3
2021-01-17,PF/BT,0,Mancante,VEN,70-79,9,1,0,0,10,0,0,10,0,10,Veneto,ITH3
2021-01-17,PF/BT,0,Mancante,VEN,80-89,4,0,0,0,4,0,0,4,0,4,Veneto,ITH3
2021-01-17,PF/BT,323206,"CENTRO DI SERVIZI RESIDENZIALE ""SEDE AMMINISTRATIVA"" - ODERZO",VEN,20-29,1,5,0,4,2,0,0,6,0,6,Veneto,ITH3
2021-01-17,PF/BT,323206,"CENTRO DI SERVIZI RESIDENZIALE ""SEDE AMMINISTRATIVA"" - ODERZO",VEN,30-39,2,6,0,7,1,0,0,8,0,8,Veneto,ITH3
2021-01-17,PF/BT,323206,"CENTRO DI SERVIZI RESIDENZIALE ""SEDE AMMINISTRATIVA"" - ODERZO",VEN,40-49,1,21,0,17,4,1,0,22,0,22,Veneto,ITH3
2021-01-17,PF/BT,323206,"CENTRO DI SERVIZI RESIDENZIALE ""SEDE AMMINISTRATIVA"" - ODERZO",VEN,50-59,6,29,0,26,5,4,0,35,0,35,Veneto,ITH3
2021-01-17,PF/BT,323206,"CENTRO DI SERVIZI RESIDENZIALE ""SEDE AMMINISTRATIVA"" - ODERZO",VEN,60-69,2,14,0,9,3,4,0,16,0,16,Veneto,ITH3
2021-01-17,PF/BT,323206,"CENTRO DI SERVIZI RESIDENZIALE ""SEDE AMMINISTRATIVA"" - ODERZO",VEN,70-79,4,11,0,0,0,15,0,15,0,15,Veneto,ITH3
2021-01-17,PF/BT,323206,"CENTRO DI SERVIZI RESIDENZIALE ""SEDE AMMINISTRATIVA"" - ODERZO",VEN,80-89,14,24,0,0,0,38,0,38,0,38,Veneto,ITH3
2021-01-17,PF/BT,323206,"CENTRO DI SERVIZI RESIDENZIALE ""SEDE AMMINISTRATIVA"" - ODERZO",VEN,90+,3,24,0,0,0,27,0,27,0,27,Veneto,ITH3
2021-01-17,PF/BT,50501,"BELLUNO ""DRIVE-IN""",VEN,20-29,15,38,0,44,0,0,9,53,0,53,Veneto,ITH3
2021-01-17,PF/BT,50501,"BELLUNO ""DRIVE-IN""",VEN,30-39,34,46,0,71,0,0,9,80,0,80,Veneto,ITH3
2021-01-17,PF/BT,50501,"BELLUNO ""DRIVE-IN""",VEN,40-49,33,59,0,77,0,0,15,92,0,92,Veneto,ITH3
2021-01-17,PF/BT,50501,"BELLUNO ""DRIVE-IN""",VEN,50-59,28,47,0,51,0,0,24,75,0,75,Veneto,ITH3
2021-01-17,PF/BT,50501,"BELLUNO ""DRIVE-IN""",VEN,60-69,68,44,0,100,0,0,12,112,0,112,Veneto,ITH3
2021-01-17,PF/BT,50501,"BELLUNO ""DRIVE-IN""",VEN,70-79,32,10,0,36,0,0,6,42,0,42,Veneto,ITH3
2021-01-17,PF/BT,50501,"BELLUNO ""DRIVE-IN""",VEN,80-89,4,1,0,4,0,0,1,5,0,5,Veneto,ITH3
2021-01-17,PF/BT,50501,"BELLUNO ""DRIVE-IN""",VEN,90+,1,0,0,1,0,0,0,1,0,1,Veneto,ITH3
2021-01-17,PF/BT,5050201,OSPEDALE CA' FONCELLO,VEN,40-49,1,0,0,1,0,0,0,1,0,1,Veneto,ITH3
2021-01-17,PF/BT,5050201,OSPEDALE CA' FONCELLO,VEN,50-59,0,1,0,1,0,0,0,1,0,1,Veneto,ITH3
2021-01-17,PF/BT,5050201,OSPEDALE CA' FONCELLO,VEN,70-79,0,1,0,1,0,0,0,1,0,1,Veneto,ITH3
2021-01-17,PF/BT,50504,PORTOGRUARO,VEN,20-29,3,12,0,11,0,0,4,15,0,15,Veneto,ITH3
2021-01-17,PF/BT,50504,PORTOGRUARO,VEN,30-39,7,8,0,10,2,0,3,15,0,15,Veneto,ITH3
2021-01-17,PF/BT,50504,PORTOGRUARO,VEN,40-49,9,32,0,25,6,0,10,41,0,41,Veneto,ITH3
2021-01-17,PF/BT,50504,PORTOGRUARO,VEN,50-59,6,29,0,23,4,0,8,35,0,35,Veneto,ITH3
2021-01-17,PF/BT,50504,PORTOGRUARO,VEN,60-69,12,18,0,23,3,0,4,30,0,30,Veneto,ITH3
2021-01-17,PF/BT,50504,PORTOGRUARO,VEN,70-79,7,0,0,7,0,0,0,7,0,7,Veneto,ITH3
2021-01-17,PF/BT,50504,PORTOGRUARO,VEN,80-89,1,0,0,0,0,0,1,1,0,1,Veneto,ITH3
2021-01-17,PF/BT,50505,TRECENTA,VEN,20-29,1,2,0,3,0,0,0,3,0,3,Veneto,ITH3
2021-01-17,PF/BT,50505,TRECENTA,VEN,30-39,0,2,0,2,0,0,0,2,0,2,Veneto,ITH3
2021-01-17,PF/BT,50505,TRECENTA,VEN,40-49,2,6,0,5,0,0,3,8,0,8,Veneto,ITH3
2021-01-17,PF/BT,50505,TRECENTA,VEN,50-59,0,8,0,1,0,0,7,8,0,8,Veneto,ITH3
2021-01-17,PF/BT,50505,TRECENTA,VEN,60-69,0,3,0,0,0,0,3,3,0,3,Veneto,ITH3
2021-01-17,PF/BT,50506,AZ OSPEDALIERA DI PADOVA MAL. INFET.E TR,VEN,20-29,6,7,0,13,0,0,0,13,0,13,Veneto,ITH3
2021-01-17,PF/BT,50506,AZ OSPEDALIERA DI PADOVA MAL. INFET.E TR,VEN,30-39,4,11,0,15,0,0,0,15,0,15,Veneto,ITH3
2021-01-17,PF/BT,50506,AZ OSPEDALIERA DI PADOVA MAL. INFET.E TR,VEN,40-49,9,37,0,46,0,0,0,46,0,46,Veneto,ITH3
2021-01-17,PF/BT,50506,AZ OSPEDALIERA DI PADOVA MAL. INFET.E TR,VEN,50-59,17,56,0,73,0,0,0,73,0,73,Veneto,ITH3
2021-01-17,PF/BT,50506,AZ OSPEDALIERA DI PADOVA MAL. INFET.E TR,VEN,60-69,3,7,0,10,0,0,0,10,0,10,Veneto,ITH3
2021-01-17,PF/BT,50506,COLLI VACC. ADULTI,VEN,20-29,2,4,0,2,0,4,0,6,0,6,Veneto,ITH3
2021-01-17,PF/BT,50506,COLLI VACC. ADULTI,VEN,30-39,3,8,0,3,0,6,2,11,0,11,Veneto,ITH3
2021-01-17,PF/BT,50506,COLLI VACC. ADULTI,VEN,40-49,6,9,0,4,0,9,2,15,0,15,Veneto,ITH3
2021-01-17,PF/BT,50506,COLLI VACC. ADULTI,VEN,50-59,10,10,0,8,0,9,3,20,0,20,Veneto,ITH3
2021-01-17,PF/BT,50506,COLLI VACC. ADULTI,VEN,60-69,4,4,0,4,0,3,1,8,0,8,Veneto,ITH3
2021-01-17,PF/BT,50506,MONSELICE,VEN,16-19,4,7,0,0,11,0,0,11,0,11,Veneto,ITH3
2021-01-17,PF/BT,50506,MONSELICE,VEN,20-29,6,12,0,0,18,0,0,18,0,18,Veneto,ITH3
2021-01-17,PF/BT,50506,MONSELICE,VEN,30-39,9,12,0,1,20,0,0,21,0,21,Veneto,ITH3
2021-01-17,PF/BT,50506,MONSELICE,VEN,40-49,11,10,0,2,19,0,0,21,0,21,Veneto,ITH3
2021-01-17,PF/BT,50506,MONSELICE,VEN,50-59,9,8,0,1,16,0,0,17,0,17,Veneto,ITH3
2021-01-17,PF/BT,50506,MONSELICE,VEN,60-69,3,6,0,1,8,0,0,9,0,9,Veneto,ITH3
2021-01-17,PF/BT,50506,MONSELICE,VEN,70-79,0,1,0,0,1,0,0,1,0,1,Veneto,ITH3
2021-01-17,PF/BT,50506,MONSELICE,VEN,80-89,1,0,0,0,1,0,0,1,0,1,Veneto,ITH3
2021-01-17,PF/BT,5091201,AOUIVR,VEN,20-29,1,0,0,1,0,0,0,1,0,1,Veneto,ITH3
2021-01-17,PF/BT,5091201,AOUIVR,VEN,50-59,1,1,0,2,0,0,0,2,0,2,Veneto,ITH3
2021-01-17,PF/BT,5095201,IOV,VEN,30-39,0,1,0,1,0,0,0,1,0,1,Veneto,ITH3
2021-01-17,PF/BT,5095201,IOV,VEN,40-49,1,0,0,1,0,0,0,1,0,1,Veneto,ITH3
2021-01-17,PF/BT,5095201,IOV,VEN,50-59,0,2,0,2,0,0,0,2,0,2,Veneto,ITH3
2021-01-17,PF/BT,802094,IST.PER ANZIANI DE BATTISTI,VEN,20-29,1,5,0,5,1,0,0,6,0,6,Veneto,ITH3
2021-01-17,PF/BT,802094,IST.PER ANZIANI DE BATTISTI,VEN,30-39,4,12,0,12,4,0,0,16,0,16,Veneto,ITH3
2021-01-17,PF/BT,802094,IST.PER ANZIANI DE BATTISTI,VEN,40-49,7,22,0,19,10,0,0,29,0,29,Veneto,ITH3
2021-01-17,PF/BT,802094,IST.PER ANZIANI DE BATTISTI,VEN,50-59,4,19,0,17,6,0,0,23,0,23,Veneto,ITH3
2021-01-17,PF/BT,802094,IST.PER ANZIANI DE BATTISTI,VEN,60-69,1,14,0,12,3,0,0,15,0,15,Veneto,ITH3
